ibge;anomes;cadunico_tot_fam;cadunico_tot_pes;cadunico_tot_fam_rpc_ate_meio_sm;cadunico_tot_pes_rpc_ate_meio_sm;cadunico_tot_fam_pob;cadunico_tot_pes_pob;cadunico_tot_fam_ext_pob;cadunico_tot_pes_ext_pob;cadunico_tot_fam_pob_e_ext_pob;cadunico_tot_pes_pob_e_ext_pob
110001;202212;4900;12695;3231;9574;758;2503;1063;3005;1821;5508
110002;202212;16852;39857;12160;32098;3131;8917;3467;8743;6598;17660
110003;202212;910;2504;648;1990;161;523;145;385;306;908
110004;202212;17295;40718;11791;31406;2614;7373;4150;10481;6764;17854
110005;202212;3131;7631;2202;6139;517;1451;678;1965;1195;3416
110006;202212;1763;4707;1078;3306;202;676;223;616;425;1292
110007;202212;1519;3645;963;2703;276;790;221;704;497;1494
110008;202212;4289;10035;3189;8518;645;1514;1767;5291;2412;6805
110009;202212;5532;14303;3530;10698;783;2591;1304;3745;2087;6336
110010;202212;10106;27868;7705;23644;1809;5048;3624;12666;5433;17714
110011;202212;9381;22914;6426;17750;1822;5232;1411;3739;3233;8971
110012;202212;21509;50021;14088;37678;3634;9852;3286;8255;6920;18107
110013;202212;7132;18736;4877;14421;1807;5695;818;2404;2625;8099
110014;202212;4703;11324;3167;8504;486;1438;1589;4066;2075;5504
110015;202212;7487;17688;4793;12823;984;2978;1507;3375;2491;6353
110018;202212;5572;13095;3516;9603;742;2158;885;2180;1627;4338
110020;202212;115177;241179;87616;204356;18402;44061;45691;106540;64093;150601
110025;202212;5877;13287;4212;10543;659;1854;2247;5297;2906;7151
110026;202212;695;1742;491;1402;112;336;147;430;259;766
110028;202212;9134;21750;5729;15866;1405;4369;667;1784;2072;6153
110029;202212;1914;4439;1170;3192;216;577;468;1272;684;1849
110030;202212;17208;37847;10785;28243;3089;8716;1511;4033;4600;12749
110032;202212;4553;11677;2722;8025;877;2597;477;1469;1354;4066
110033;202212;5828;15871;4331;13106;1372;4278;1412;4482;2784;8760
110034;202212;3873;8648;2609;6877;922;2691;619;1762;1541;4453
110037;202212;1931;5335;1331;4202;360;1172;411;1277;771;2449
110040;202212;3579;9272;2563;7469;667;2121;694;1860;1361;3981
110045;202212;5550;14735;4040;12038;1147;3703;1349;3938;2496;7641
110050;202212;2095;5309;1360;4015;442;1488;184;443;626;1931
110060;202212;1138;3138;737;2217;189;594;175;506;364;1100
110070;202212;1882;5393;1311;4153;337;1174;319;873;656;2047
110080;202212;7994;17787;5957;15089;1307;3407;2865;7503;4172;10910
110090;202212;705;1826;483;1417;117;394;141;389;258;783
110092;202212;1649;4404;1157;3501;260;813;562;1712;822;2525
110094;202212;3437;9367;2528;7659;971;3103;342;1077;1313;4180
110100;202212;2163;5732;1692;4895;604;1820;535;1567;1139;3387
110110;202212;2196;5496;1556;4485;467;1460;308;935;775;2395
110120;202212;1619;4254;1120;3295;281;864;316;910;597;1774
110130;202212;3350;7768;2005;5384;402;1109;259;661;661;1770
110140;202212;3022;7850;2207;6302;452;1438;1010;2692;1462;4130
110143;202212;1731;4373;1231;3469;345;1091;395;1024;740;2115
110145;202212;1167;2820;708;1974;175;478;281;806;456;1284
110146;202212;629;1549;417;1189;125;340;146;465;271;805
110147;202212;957;2276;631;1682;88;265;322;754;410;1019
110148;202212;1169;3005;594;1769;143;475;65;141;208;616
110149;202212;4216;10043;2868;7953;987;2851;679;1978;1666;4829
110150;202212;3035;7306;1940;5589;608;1925;313;950;921;2875
110155;202212;1024;2753;699;1998;137;444;291;731;428;1175
110160;202212;1756;4846;1255;3809;446;1403;230;698;676;2101
110170;202212;2552;6035;1636;4380;250;747;943;2324;1193;3071
110175;202212;2615;6788;1779;5060;331;1019;777;2085;1108;3104
110180;202212;1615;4042;1126;3122;162;476;545;1479;707;1955
120001;202212;4311;10872;3474;9638;482;1573;2284;6142;2766;7715
120005;202212;2415;8194;2150;7761;250;930;1587;5849;1837;6779
120010;202212;7615;18161;6565;16684;558;1331;5126;13104;5684;14435
120013;202212;3097;8825;2651;8208;820;2455;1154;4023;1974;6478
120017;202212;3775;9063;3202;8265;452;1105;2078;5676;2530;6781
120020;202212;19615;60517;18059;57798;1266;4462;14324;45671;15590;50133
120025;202212;4699;10550;3855;9585;563;1388;2554;6634;3117;8022
120030;202212;7667;27327;7064;26297;497;2170;5319;20273;5816;22443
120032;202212;2108;8294;1976;8034;101;609;1666;6657;1767;7266
120033;202212;5345;16079;4990;15473;117;541;4402;13438;4519;13979
120034;202212;3580;10631;3095;9864;168;688;2581;8075;2749;8763
120035;202212;5132;15807;4745;15163;266;975;4056;12846;4322;13821
120038;202212;3986;10303;3409;9433;509;1484;2090;5896;2599;7380
120039;202212;2472;9293;2290;8944;151;743;1834;7128;1985;7871
120040;202212;76542;184085;66061;168848;8369;22815;43936;110438;52305;133253
120042;202212;4345;13064;3981;12439;200;775;3301;10150;3501;10925
120043;202212;1815;6444;1536;6043;56;358;1268;4900;1324;5258
120045;202212;7414;16805;6187;15326;563;1499;4691;11609;5254;13108
120050;202212;12274;36314;11270;34916;532;1970;9526;29450;10058;31420
120060;202212;12138;40257;11066;38696;507;2361;9490;32972;9997;35333
120070;202212;4269;11735;3653;10889;611;1685;2273;7246;2884;8931
120080;202212;6903;15941;6188;14951;742;1734;4688;11395;5430;13129
130002;202212;4127;13153;3616;12453;464;1223;2830;10360;3294;11583
130006;202212;3130;9834;2594;9005;603;1905;1406;5467;2009;7372
130008;202212;3292;9898;2829;9242;181;586;2272;7623;2453;8209
130010;202212;5421;12694;4665;11821;163;378;4203;10681;4366;11059
130014;202212;4868;12210;3630;10357;697;2001;2051;6133;2748;8134
130020;202212;3368;11873;2935;11254;136;766;2389;9042;2525;9808
130030;202212;19861;40654;18541;39180;198;512;17733;37127;17931;37639
130040;202212;4945;13292;4059;12158;568;1601;2909;9038;3477;10639
130050;202212;8891;28971;7484;27139;397;1361;6400;23745;6797;25106
130060;202212;9017;32139;7669;30388;393;2196;6407;24958;6800;27154
130063;202212;7777;22663;6854;21617;190;836;6254;19628;6444;20464
130068;202212;4687;13430;3917;12409;213;884;3116;9770;3329;10654
130070;202212;9211;23342;7559;21532;666;1620;5864;17333;6530;18953
130080;202212;9377;27833;8051;26296;404;1195;6929;23087;7333;24282
130083;202212;3444;9917;3011;9373;266;812;2383;7675;2649;8487
130090;202212;5161;12492;4603;11856;99;218;4079;10801;4178;11019
130100;202212;9170;25308;7656;23700;161;419;7057;22177;7218;22596
130110;202212;10888;26280;8854;23753;1698;4064;5519;16290;7217;20354
130115;202212;6297;17274;5396;16226;155;457;4683;14261;4838;14718
130120;202212;20386;56052;18154;53214;1511;4833;15103;44090;16614;48923
130130;202212;7317;19172;5664;17099;635;1771;4069;13066;4704;14837
130140;202212;8782;26862;7703;25641;357;1434;6634;22175;6991;23609
130150;202212;4783;14281;4493;13958;77;387;4171;12915;4248;13302
130160;202212;8039;21171;6941;19843;369;892;6086;17660;6455;18552
130165;202212;4079;13338;3836;13062;164;625;3406;11652;3570;12277
130170;202212;17417;39505;14501;36280;450;1402;12982;32200;13432;33602
130180;202212;5327;15060;5088;14800;39;228;4919;14237;4958;14465
130185;202212;25024;52585;20647;47881;1658;2128;17489;42826;19147;44954
130190;202212;25799;71949;21130;65315;1893;5617;16046;50312;17939;55929
130195;202212;3020;9766;2541;9180;117;457;2133;7839;2250;8296
130200;202212;3765;8702;3080;7820;198;621;2469;6114;2667;6735
130210;202212;1916;6303;1712;6046;155;677;1352;4728;1507;5405
130220;202212;3121;8673;2565;8015;87;281;2288;7290;2375;7571
130230;202212;6203;21564;5415;20516;200;1043;4794;18169;4994;19212
130240;202212;18024;40062;15033;36364;151;691;14059;33471;14210;34162
130250;202212;32225;84945;27520;79496;1716;4220;22494;67119;24210;71339
130255;202212;6166;16522;5246;14968;252;677;4301;12232;4553;12909
130260;202212;455260;1000705;387446;911782;71647;181376;252205;577928;323852;759304
130270;202212;12161;37284;10064;34170;1969;6158;6313;22572;8282;28730
130280;202212;4571;15039;4162;14572;154;599;3826;13448;3980;14047
130290;202212;21447;50804;19278;48226;638;1771;17770;44206;18408;45977
130300;202212;6155;17537;5454;16599;150;639;4719;14225;4869;14864
130310;202212;10754;24650;9514;23167;433;1077;8389;20337;8822;21414
130320;202212;4200;12521;3480;11528;454;1427;2466;8483;2920;9910
130330;202212;5599;15597;4498;14303;215;783;3777;12210;3992;12993
130340;202212;31207;79449;26856;74617;1568;3823;22764;65098;24332;68921
130350;202212;4594;15077;4088;14425;160;758;3549;12498;3709;13256
130353;202212;9985;23730;8108;21306;1270;3058;5417;14899;6687;17957
130356;202212;7107;19227;6008;17585;1157;3313;3559;10917;4716;14230
130360;202212;3667;10867;2949;9977;86;363;2622;8878;2708;9241
130370;202212;6146;24344;5162;22885;754;3984;3107;13860;3861;17844
130380;202212;9362;36787;8721;35820;747;3559;6987;28650;7734;32209
130390;202212;8892;30022;7768;28389;403;1848;6865;24927;7268;26775
130395;202212;3059;8493;2529;7670;180;624;2045;6093;2225;6717
130400;202212;3494;9427;2949;8700;102;321;2600;7698;2702;8019
130406;202212;14353;44505;12177;41829;2422;7581;8007;29011;10429;36592
130410;202212;5482;16724;4722;15562;1269;4263;2551;8753;3820;13016
130420;202212;18616;55369;15631;51646;1927;6297;11119;37670;13046;43967
130423;202212;5336;15083;4624;14237;246;1007;4011;12156;4257;13163
130426;202212;3930;12137;3519;11673;65;194;3113;10875;3178;11069
130430;202212;6193;13528;5322;12440;207;503;4744;10946;4951;11449
130440;202212;7337;17276;6320;16075;121;383;5952;15082;6073;15465
140002;202212;3071;8040;2636;7524;210;539;2076;6157;2286;6696
140005;202212;4033;10479;3505;9860;906;2442;2149;6384;3055;8826
140010;202212;64564;164918;51674;146037;12617;37479;21235;61067;33852;98546
140015;202212;6540;14096;5595;13067;357;717;4888;11688;5245;12405
140017;202212;7381;16694;6485;15600;412;934;5432;13247;5844;14181
140020;202212;7152;17364;6130;16105;472;1261;4777;12694;5249;13955
140023;202212;3442;8767;2758;7839;331;1000;2065;5914;2396;6914
140028;202212;2539;5868;2117;5346;138;362;1648;4161;1786;4523
140030;202212;8063;16355;7317;15508;357;507;6651;14397;7008;14904
140040;202212;3550;12210;3252;11820;108;543;2960;10731;3068;11274
140045;202212;4516;14327;3917;13529;1048;2891;2131;8497;3179;11388
140047;202212;7702;19737;6425;17884;844;2422;4415;12502;5259;14924
140050;202212;2163;5507;1829;5036;318;776;1188;3425;1506;4201
140060;202212;2758;5811;2461;5420;256;480;2035;4560;2291;5040
140070;202212;2495;11685;2408;11520;154;1024;2049;9630;2203;10654
150010;202212;65308;132838;58706;124573;1434;2762;53010;111271;54444;114033
150013;202212;2751;5652;2318;5180;150;255;1953;4456;2103;4711
150020;202212;19199;47812;17578;45623;1780;3620;14054;37813;15834;41433
150030;202212;11509;35778;10341;34422;770;2048;8364;29907;9134;31955
150034;202212;5500;11646;4413;10306;266;595;3668;8644;3934;9239
150040;202212;20123;46356;17637;43616;1165;1529;15542;40373;16707;41902
150050;202212;9888;26452;8924;25197;241;654;8105;23149;8346;23803
150060;202212;29500;71183;23764;62778;3467;9228;15093;40373;18560;49601
150070;202212;11021;30343;9787;28907;226;828;9102;26811;9328;27639
150080;202212;114590;241945;94283;215097;25561;58094;31924;82840;57485;140934
150085;202212;12204;26958;11100;25672;169;386;10488;24290;10657;24676
150090;202212;15787;39951;14688;38186;612;1602;12960;33313;13572;34915
150095;202212;9254;19525;8119;18170;922;1177;6638;15693;7560;16870
150100;202212;3625;11232;3166;10506;228;717;2563;8660;2791;9377
150110;202212;5745;19497;5329;19036;172;659;4921;17847;5093;18506
150120;202212;9933;26592;9175;25685;359;674;8162;23316;8521;23990
150125;202212;1099;2540;792;2107;102;309;497;1288;599;1597
150130;202212;30514;76272;25998;69573;5118;12123;15711;44779;20829;56902
150140;202212;373991;719301;319412;649907;30660;62486;231579;459095;262239;521581
150145;202212;5085;14605;4160;13165;1540;4776;1430;5296;2970;10072
150150;202212;22605;48971;19153;44666;1549;3382;14575;33958;16124;37340
150157;202212;4494;10992;3523;9664;443;1191;2286;6460;2729;7651
150160;202212;5105;10674;4719;10164;389;936;3833;8008;4222;8944
150170;202212;36146;90306;32078;83904;5444;12381;20855;58039;26299;70420
150172;202212;7278;15973;5915;14166;331;813;4703;11190;5034;12003
150175;202212;2364;5966;1975;5340;181;633;1481;3813;1662;4446
150178;202212;15841;32891;12076;28591;1248;1667;9477;24386;10725;26053
150180;202212;35986;90380;32508;86517;2862;4728;26291;75754;29153;80482
150190;202212;9683;23438;8919;22533;142;465;8344;20907;8486;21372
150195;202212;6448;17482;5965;16819;189;660;5428;15175;5617;15835
150200;202212;7202;18182;6464;17338;51;165;5964;16015;6015;16180
150210;202212;40916;105113;38550;102269;1288;3323;34651;92644;35939;95967
150215;202212;12974;33158;11012;30011;1875;5270;6612;17892;8487;23162
150220;202212;17160;40591;14984;37664;827;2022;11646;28869;12473;30891
150230;202212;17659;41295;15660;38670;1249;2678;11988;30034;13237;32712
150240;202212;45689;109854;38033;97474;8046;21202;17995;44034;26041;65236
150250;202212;5259;17424;4917;17051;451;1607;4231;14851;4682;16458
150260;202212;3585;9560;3119;8864;101;311;2669;7524;2770;7835
150270;202212;11075;28489;7731;22595;2156;6588;2195;6550;4351;13138
150275;202212;9648;24157;8804;23042;195;698;7893;20213;8088;20911
150276;202212;2914;7063;2533;6599;303;694;1784;5037;2087;5731
150277;202212;7045;15149;5583;13476;692;1722;4015;9838;4707;11560
150280;202212;9054;29410;8690;28869;610;1645;7339;25252;7949;26897
150285;202212;4382;12685;3763;11693;234;679;2957;9228;3191;9907
150290;202212;13872;31965;12526;30538;530;786;11320;28281;11850;29067
150293;202212;12227;26516;9534;23049;1037;2560;6642;15983;7679;18543
150295;202212;9217;22296;6455;18416;2141;6033;2174;7107;4315;13140
150300;202212;4236;8568;3886;8155;37;106;3683;7644;3720;7750
150304;202212;5445;13977;4527;12589;669;1646;3090;8942;3759;10588
150307;202212;7068;19825;6346;18671;304;878;5099;15008;5403;15886
150309;202212;8050;20483;6478;17961;861;2308;4084;11563;4945;13871
150310;202212;8897;30723;8337;30018;273;1186;7367;26884;7640;28070
150320;202212;11666;27285;10538;25707;867;1927;7954;19513;8821;21440
150330;202212;18995;50070;17441;47967;2367;4993;12145;36575;14512;41568
150340;202212;2966;7923;2581;7379;324;863;1857;5338;2181;6201
150345;202212;11351;26805;9991;25070;381;1063;8772;21816;9153;22879
150350;202212;12825;26032;11512;24380;862;1370;9777;20974;10639;22344
150360;202212;31382;76363;25110;68551;2518;4820;18928;54250;21446;59070
150370;202212;14309;36691;11675;33185;1513;3583;8321;25242;9834;28825
150375;202212;4826;17315;4346;16661;278;1066;3772;14588;4050;15654
150380;202212;13015;28809;10459;25462;262;778;9018;21632;9280;22410
150390;202212;9411;33405;8251;31500;1767;5726;4985;20955;6752;26681
150400;202212;8127;25201;7661;24457;154;531;6546;21501;6700;22032
150405;202212;11046;25195;9498;23382;746;1278;7512;19222;8258;20500
150410;202212;2394;6442;2007;5828;195;495;1412;4157;1607;4652
150420;202212;58233;139924;45627;121848;10442;29240;21930;59810;32372;89050
150430;202212;10149;25629;9187;24447;660;1294;7773;21082;8433;22376
150440;202212;8266;19674;7480;18673;507;1193;6237;15532;6744;16725
150442;202212;38967;77820;32878;70605;2063;4467;26281;55183;28344;59650
150445;202212;10117;23288;9065;21834;181;486;8331;19848;8512;20334
150450;202212;8019;23713;7469;23003;315;1463;6835;20521;7150;21984
150460;202212;10760;29269;9690;27942;520;1230;8059;24144;8579;25374
150470;202212;25832;60815;22967;57359;427;1484;20968;51676;21395;53160
150475;202212;6886;18586;5805;16916;950;2412;3792;11678;4742;14090
150480;202212;17835;47160;15984;44559;3487;8151;10136;30942;13623;39093
150490;202212;10093;31119;9053;29671;716;1983;7187;24466;7903;26449
150495;202212;6914;18821;6472;18245;166;663;5914;16487;6080;17150
150497;202212;3381;9467;2661;8231;534;1688;1446;4695;1980;6383
150500;202212;3878;9033;3387;8323;211;535;2703;6476;2914;7011
150503;202212;6979;16643;5025;14133;1638;4185;1876;5894;3514;10079
150506;202212;16635;40799;14213;37574;2415;5836;9584;26885;11999;32721
150510;202212;15711;41045;13650;37717;1141;2966;10733;29720;11874;32686
150520;202212;10159;30811;9701;30266;150;846;9165;28327;9315;29173
150530;202212;15216;45815;13133;42844;1163;3237;10179;34140;11342;37377
150540;202212;6619;14743;5660;13337;334;746;4730;11027;5064;11773
150543;202212;9142;22781;7533;20736;651;1806;5681;15995;6332;17801
150548;202212;13062;34755;11556;32646;534;1468;9995;28418;10529;29886
150549;202212;2400;6020;1996;5443;83;261;1620;4384;1703;4645
150550;202212;25419;67115;20532;59265;5509;16313;7932;23686;13441;39999
150553;202212;48198;120004;36603;100488;9396;26628;15695;42826;25091;69454
150555;202212;2514;5961;1942;5105;187;456;1288;3491;1475;3947
150560;202212;2421;6014;2135;5526;246;607;1417;3655;1663;4262
150563;202212;3278;8696;2647;7584;545;1626;1429;4054;1974;5680
150565;202212;5459;15685;4782;14640;137;476;3818;11872;3955;12348
150570;202212;9884;23141;9057;22063;297;873;8097;19453;8394;20326
150580;202212;14069;47489;12011;45212;1542;4550;9276;37313;10818;41863
150590;202212;10341;30066;8842;28293;245;957;8010;25654;8255;26611
150600;202212;13101;34168;12082;32926;407;1019;10924;30045;11331;31064
150610;202212;4067;9131;3603;8445;142;411;3120;7123;3262;7534
150611;202212;4092;9676;3535;8916;80;266;3105;7643;3185;7909
150613;202212;18314;45626;13863;38307;2659;7851;6960;18554;9619;26405
150616;202212;4706;11921;3353;9570;662;2052;1564;4274;2226;6326
150618;202212;8979;22698;7246;20012;1012;2995;4470;12310;5482;15305
150619;202212;8233;20749;6687;18613;740;1707;4854;14021;5594;15728
150620;202212;9292;26697;8073;24649;1670;4670;4512;14579;6182;19249
150630;202212;8928;18711;8152;17783;155;380;7458;16006;7613;16386
150635;202212;6835;16144;5689;14327;704;1621;3758;9555;4462;11176
150640;202212;2563;6827;2317;6520;48;135;2100;5946;2148;6081
150650;202212;15125;36226;13055;33080;3543;8604;5951;16029;9494;24633
150655;202212;6916;17136;6203;16125;105;364;5584;14284;5689;14648
150658;202212;5492;14570;3952;11975;991;3150;1719;5280;2710;8430
150660;202212;6948;17665;6023;16307;1253;3283;3435;9316;4688;12599
150670;202212;12584;24310;10008;21368;879;1770;7908;17230;8787;19000
150680;202212;97504;241693;77605;212047;16867;43429;40986;119132;57853;162561
150690;202212;3281;7050;2818;6509;132;234;2446;5743;2578;5977
150700;202212;8499;21274;7526;20065;930;1861;5547;15689;6477;17550
150710;202212;4720;13414;4192;12601;523;1500;2930;9037;3453;10537
150715;202212;6844;16164;5590;14388;326;814;4586;11765;4912;12579
150720;202212;10627;26086;9785;24956;356;1110;8690;21858;9046;22968
150730;202212;16434;43887;13930;40234;1946;5809;9643;28354;11589;34163
150740;202212;4951;12162;4267;11143;481;1002;3120;8428;3601;9430
150745;202212;6935;16990;5563;15063;709;2016;3906;10745;4615;12761
150746;202212;2172;5472;1904;5085;56;161;1596;4170;1652;4331
150747;202212;6735;16635;5961;15510;478;1069;4692;12350;5170;13419
150750;202212;4706;12487;3794;11186;427;1269;2624;8073;3051;9342
150760;202212;14579;37349;13037;35212;2455;6014;8239;23455;10694;29469
150770;202212;8778;25793;8041;24965;257;563;7317;23403;7574;23966
150775;202212;1478;3459;1154;3049;143;416;797;2090;940;2506
150780;202212;6161;16063;5441;15224;329;894;4778;13602;5107;14496
150790;202212;7638;17996;6399;16646;581;1136;4242;13158;4823;14294
150795;202212;20593;52607;17699;48478;3284;8940;10948;30749;14232;39689
150796;202212;5273;10460;4515;9599;208;395;3928;8348;4136;8743
150797;202212;5603;14339;4732;13110;527;1367;3685;10273;4212;11640
150800;202212;18135;48593;16122;45953;2724;7172;10562;31592;13286;38764
150803;202212;10842;25031;9964;23871;282;779;9037;21331;9319;22110
150805;202212;4458;12069;3746;11100;360;1021;2800;8489;3160;9510
150808;202212;8171;21774;5972;18143;2036;6900;908;2893;2944;9793
150810;202212;26917;60155;20444;52423;4510;11206;10605;29970;15115;41176
150812;202212;8226;18651;7273;17224;449;1365;5845;13140;6294;14505
150815;202212;11784;31031;9810;28670;1359;3945;7374;21951;8733;25896
150820;202212;19042;38453;16693;35694;1984;2959;12894;29406;14878;32365
150830;202212;16455;46003;15274;44568;648;1604;13604;40472;14252;42076
150835;202212;4434;11534;3778;10543;427;1217;2630;7277;3057;8494
150840;202212;10626;26331;8604;23221;1191;3623;5292;13735;6483;17358
160005;202212;1785;3762;1566;3509;76;192;1365;3029;1441;3221
160010;202212;2695;6580;2483;6356;21;89;2396;6088;2417;6177
160015;202212;5136;10306;4642;9745;84;206;4401;9161;4485;9367
160020;202212;3212;8111;2762;7526;349;809;2018;5799;2367;6608
160021;202212;1542;5012;1364;4797;65;268;1000;3662;1065;3930
160023;202212;1734;5177;1530;4845;286;839;925;3100;1211;3939
160025;202212;2464;6179;2287;5985;63;103;2176;5749;2239;5852
160027;202212;14687;29457;13267;27745;752;1661;11560;23915;12312;25576
160030;202212;110647;259476;91830;235275;17171;41777;54426;146582;71597;188359
160040;202212;7664;21607;6718;20335;480;1354;5712;17519;6192;18873
160050;202212;8053;19152;6753;17511;2575;5616;3064;9557;5639;15173
160053;202212;5425;13853;4748;12921;286;700;3939;10948;4225;11648
160055;202212;2103;3919;2021;3830;30;86;1949;3651;1979;3737
160060;202212;39080;81632;33066;74857;3157;5796;26290;61536;29447;67332
160070;202212;3814;11599;3317;10868;430;1145;2370;8393;2800;9538
160080;202212;4058;10569;3532;9997;55;165;3261;9338;3316;9503
170025;202212;765;1911;464;1340;84;236;140;383;224;619
170030;202212;1350;3759;985;3085;191;586;365;1184;556;1770
170035;202212;1766;4191;1280;3432;111;323;768;1958;879;2281
170040;202212;2259;5504;1738;4785;258;725;934;2671;1192;3396
170070;202212;2327;4923;1635;4043;96;257;969;2422;1065;2679
170100;202212;2987;7366;2404;6458;342;845;1513;4133;1855;4978
170105;202212;791;2096;520;1571;116;351;167;442;283;793
170110;202212;1241;3275;943;2793;69;274;582;1623;651;1897
170130;202212;1752;4357;1314;3650;128;407;828;2222;956;2629
170190;202212;1921;4442;1479;3775;205;649;901;2148;1106;2797
170200;202212;2440;5329;1577;3972;274;724;635;1508;909;2232
170210;202212;33617;83632;25131;69944;6995;20932;4770;13450;11765;34382
170215;202212;1540;3731;1212;3287;61;223;911;2423;972;2646
170220;202212;6893;19468;5566;17176;2213;6894;1352;4834;3565;11728
170230;202212;1500;3929;1113;3239;279;824;349;1001;628;1825
170240;202212;3540;8138;2828;7048;184;543;2115;5104;2299;5647
170255;202212;4532;12039;3284;9916;579;1808;1565;4734;2144;6542
170270;202212;1030;2352;686;1821;84;230;372;943;456;1173
170290;202212;3789;9302;3237;8555;289;539;2463;6817;2752;7356
170300;202212;2635;5931;2123;5184;154;371;1596;3769;1750;4140
170305;202212;804;2000;645;1726;79;204;344;927;423;1131
170307;202212;1302;3608;1074;3211;151;492;670;1903;821;2395
170310;202212;1906;4325;1342;3467;180;498;701;1792;881;2290
170320;202212;1276;3123;937;2577;122;377;554;1500;676;1877
170330;202212;1204;3247;1094;3087;32;139;957;2622;989;2761
170360;202212;699;1625;496;1318;25;83;328;789;353;872
170370;202212;1573;3633;1119;2924;187;501;564;1373;751;1874
170380;202212;2167;5640;1629;4816;135;444;952;2884;1087;3328
170382;202212;606;1599;487;1407;23;83;344;951;367;1034
170384;202212;2043;6232;1682;5589;329;1081;915;3004;1244;4085
170386;202212;1115;2875;671;2018;79;280;241;645;320;925
170388;202212;874;2121;619;1700;89;264;331;849;420;1113
170389;202212;1018;2922;805;2553;89;309;496;1599;585;1908
170390;202212;2213;4349;1668;3711;37;97;1452;3235;1489;3332
170410;202212;746;1695;539;1366;26;86;372;874;398;960
170460;202212;481;1227;377;1062;52;155;237;666;289;821
170510;202212;1090;2762;765;2213;33;131;499;1315;532;1446
170550;202212;8170;19745;6121;16600;1636;4886;1985;5105;3621;9991
170555;202212;1645;3946;1285;3397;143;325;638;1746;781;2071
170560;202212;1190;2989;891;2574;103;275;518;1552;621;1827
170600;202212;1667;4066;1287;3498;228;570;728;2032;956;2602
170610;202212;1998;4580;1475;3813;118;371;986;2419;1104;2790
170625;202212;526;1244;345;926;43;100;141;348;184;448
170650;202212;1806;4449;1468;3938;136;442;981;2503;1117;2945
170700;202212;4297;11447;3224;9421;656;1981;1418;3942;2074;5923
170710;202212;2031;4381;1532;3681;172;418;1043;2434;1215;2852
170720;202212;2167;4797;1626;3979;139;409;1142;2669;1281;3078
170730;202212;1304;3150;981;2672;112;262;601;1662;713;1924
170740;202212;2402;7075;2026;6413;150;562;1524;4704;1674;5266
170755;202212;1006;2465;703;1977;130;398;329;865;459;1263
170765;202212;1379;3236;957;2566;156;405;489;1289;645;1694
170770;202212;2229;5679;1781;5003;165;502;1285;3517;1450;4019
170820;202212;4752;12306;3624;10429;692;2030;1852;5227;2544;7257
170825;202212;1289;2584;1053;2283;104;216;802;1721;906;1937
170830;202212;1612;3805;1185;3121;273;862;574;1304;847;2166
170900;202212;3598;9728;3071;8984;374;939;2355;7104;2729;8043
170930;202212;4828;11977;3625;9823;839;2416;1185;2972;2024;5388
170950;202212;13974;36034;9803;28730;2904;9207;1334;3873;4238;13080
170980;202212;607;1394;416;1083;49;154;236;567;285;721
171050;202212;1986;5580;1693;5088;130;421;1296;3916;1426;4337
171070;202212;1609;4037;1353;3672;296;710;666;2100;962;2810
171090;202212;1192;2871;914;2453;151;418;467;1243;618;1661
171110;202212;675;1718;460;1320;64;195;216;567;280;762
171150;202212;1172;2695;710;1936;61;197;432;1129;493;1326
171180;202212;875;2249;547;1631;102;284;212;654;314;938
171190;202212;2356;6700;1962;6023;313;995;1150;3517;1463;4512
171195;202212;998;2799;771;2379;107;416;480;1370;587;1786
171200;202212;730;1889;522;1538;130;437;163;429;293;866
171215;202212;468;1137;362;966;41;121;192;494;233;615
171240;202212;901;2631;692;2274;16;97;479;1504;495;1601
171245;202212;903;2380;689;1968;56;185;406;1063;462;1248
171250;202212;1135;2909;780;2300;126;399;338;981;464;1380
171270;202212;568;1819;438;1536;70;298;212;727;282;1025
171280;202212;1055;2813;838;2459;67;204;540;1584;607;1788
171320;202212;4669;12063;3554;10135;705;2020;1418;4040;2123;6060
171330;202212;3422;8565;2599;7170;672;1925;1149;3102;1821;5027
171360;202212;1800;4507;1347;3869;141;389;863;2644;1004;3033
171370;202212;846;1946;632;1645;74;197;393;993;467;1190
171380;202212;1744;4388;1420;3945;180;449;959;2810;1139;3259
171395;202212;1196;2839;796;2173;98;293;486;1282;584;1575
171420;202212;2376;5922;1777;4873;321;950;926;2424;1247;3374
171430;202212;1305;3401;1054;2950;74;229;692;1811;766;2040
171488;202212;2984;7522;2288;6388;413;1150;1181;3269;1594;4419
171500;202212;1042;2456;724;1934;80;241;430;1108;510;1349
171510;202212;989;2790;838;2529;77;283;562;1633;639;1916
171515;202212;588;1327;413;1059;31;99;272;636;303;735
171525;202212;853;2059;636;1709;81;225;392;986;473;1211
171550;202212;397;1045;300;912;39;156;152;409;191;565
171570;202212;1291;3374;1061;2983;156;456;624;1755;780;2211
171575;202212;2003;4843;1302;3660;132;381;680;1841;812;2222
171610;202212;7257;18889;5297;15591;1296;4213;1156;3553;2452;7766
171620;202212;3600;8082;3064;7355;174;445;2531;6059;2705;6504
171630;202212;1319;3122;988;2648;137;390;634;1693;771;2083
171650;202212;2709;7052;2042;5952;502;1602;578;1675;1080;3277
171660;202212;2791;6414;1940;5074;174;471;1273;3259;1447;3730
171665;202212;1490;3815;1158;3290;245;743;502;1409;747;2152
171670;202212;2253;5472;1653;4482;247;716;774;2002;1021;2718
171700;202212;1380;3464;1001;2775;129;377;577;1547;706;1924
171720;202212;907;2135;681;1792;75;207;462;1202;537;1409
171750;202212;1694;4681;1191;3740;263;819;341;1248;604;2067
171780;202212;1554;3501;1093;2805;104;313;713;1749;817;2062
171790;202212;1641;4907;1285;4176;190;632;666;2108;856;2740
171800;202212;849;2074;642;1775;65;191;367;960;432;1151
171820;202212;14300;36770;10466;30455;2490;7833;2705;7997;5195;15830
171830;202212;1848;5222;1568;4767;303;864;799;2605;1102;3469
171840;202212;851;2050;625;1699;20;70;382;980;402;1050
171845;202212;814;1788;612;1497;49;157;428;970;477;1127
171850;202212;1181;3196;990;2822;41;176;785;2139;826;2315
171855;202212;1233;3429;1006;3026;107;332;587;1711;694;2043
171865;202212;592;1523;496;1379;59;190;304;785;363;975
171870;202212;941;2385;651;1883;112;341;308;870;420;1211
171875;202212;1758;4195;1440;3727;59;232;1142;2819;1201;3051
171880;202212;1767;4127;1528;3813;47;138;1239;3047;1286;3185
171884;202212;1336;3167;1009;2637;226;550;508;1343;734;1893
171886;202212;1786;4501;1294;3786;329;1061;337;1040;666;2101
171888;202212;680;1833;458;1401;30;117;263;756;293;873
171889;202212;505;1412;326;1044;78;271;108;313;186;584
171890;202212;1460;3839;1069;3200;142;464;643;1849;785;2313
171900;202212;662;2025;505;1717;73;216;233;793;306;1009
172000;202212;672;1852;514;1568;101;310;193;578;294;888
172010;202212;1504;4176;1247;3768;124;348;776;2355;900;2703
172015;202212;434;1374;328;1169;63;219;140;500;203;719
172020;202212;3456;8586;2994;8015;254;711;2164;5913;2418;6624
172025;202212;834;2075;586;1685;46;141;399;1120;445;1261
172030;202212;1453;3930;1165;3462;83;291;853;2474;936;2765
172049;202212;1450;3352;944;2636;127;352;481;1375;608;1727
172065;202212;1743;3959;1363;3468;153;298;941;2659;1094;2957
172080;202212;2836;7481;2264;6505;121;403;1519;4257;1640;4660
172085;202212;522;1324;327;927;58;173;116;293;174;466
172090;202212;4982;10713;3879;9280;146;371;3142;7319;3288;7690
172093;202212;535;1490;377;1205;31;139;219;652;250;791
172097;202212;823;1983;538;1504;87;268;200;520;287;788
172100;202212;61565;140260;45441;115906;8463;23941;19445;47665;27908;71606
172110;202212;2023;6302;1717;5843;113;476;1336;4509;1449;4985
172120;202212;6217;16204;4821;14003;494;1570;2952;8381;3446;9951
172125;202212;489;1205;366;1007;34;112;203;503;237;615
172130;202212;694;1635;518;1343;22;78;343;812;365;890
172208;202212;3043;6657;2343;5753;196;433;1695;4146;1891;4579
172210;202212;3173;7031;2442;6138;245;585;1608;4173;1853;4758
210005;202212;23272;60434;17403;51082;4536;14006;7317;21629;11853;35635
210010;202212;2643;6508;2423;6257;40;181;2236;5677;2276;5858
210015;202212;3727;10132;3182;9403;146;440;2639;7819;2785;8259
210020;202212;9965;19128;8638;17585;579;765;7599;15799;8178;16564
210030;202212;5301;16059;4788;15262;494;1634;3747;12031;4241;13665
210040;202212;2594;5021;2260;4626;59;165;2048;4088;2107;4253
210043;202212;6899;17690;5756;16155;381;1138;4529;12714;4910;13852
210047;202212;8156;21775;6410;19503;156;653;5536;16766;5692;17419
210050;202212;2938;8064;2336;7005;162;658;1770;5074;1932;5732
210055;202212;2493;6461;2170;6007;55;159;1890;5305;1945;5464
210060;202212;8775;28986;7697;27063;825;3021;5231;18812;6056;21833
210070;202212;8086;19076;7454;18280;96;247;6999;17095;7095;17342
210080;202212;5245;14486;4909;14110;45;235;4585;13104;4630;13339
210083;202212;7255;16626;6096;15360;104;332;5754;14420;5858;14752
210087;202212;3178;8219;2667;7538;158;505;2119;5924;2277;6429
210090;202212;10835;29767;9948;28340;393;1023;8613;24457;9006;25480
210095;202212;7425;22410;6688;21445;517;1576;5270;17602;5787;19178
210100;202212;7594;21090;6545;19282;906;2604;4267;12762;5173;15366
210110;202212;3625;9278;3312;8893;49;224;3015;7997;3064;8221
210120;202212;35081;74668;29891;68286;1570;3018;24097;55317;25667;58335
210125;202212;5273;12762;4559;11955;798;1581;3189;9020;3987;10601
210130;202212;4994;11388;4039;10208;82;198;3572;8983;3654;9181
210135;202212;2161;4738;1789;4216;55;124;1564;3649;1619;3773
210140;202212;25245;59845;19679;52665;2784;7389;12434;33516;15218;40905
210150;202212;5600;11840;4873;10869;119;321;4218;9182;4337;9503
210160;202212;26324;58891;22480;54095;1827;3866;17603;43024;19430;46890
210170;202212;21365;53071;19379;50439;1895;3993;15143;40856;17038;44849
210173;202212;2649;9093;2471;8807;96;477;2178;7672;2274;8149
210177;202212;3761;9527;3213;8823;459;1129;2366;6732;2825;7861
210180;202212;1832;4082;1604;3807;37;90;1447;3431;1484;3521
210190;202212;6747;15014;5579;13416;100;281;4894;11562;4994;11843
210193;202212;1613;4036;1372;3666;49;140;1067;2823;1116;2963
210197;202212;2323;6544;2080;6207;155;427;1659;5055;1814;5482
210200;202212;9553;26465;8335;24683;527;1688;6599;19453;7126;21141
210203;202212;8442;22108;7031;20282;570;1607;5498;16234;6068;17841
210207;202212;4531;9972;3701;9022;151;332;3073;7559;3224;7891
210210;202212;8766;24986;7835;23712;137;707;6754;20179;6891;20886
210215;202212;2837;8019;2449;7468;151;631;2002;6004;2153;6635
210220;202212;8249;22936;7744;22228;149;843;7022;19612;7171;20455
210230;202212;6863;17237;6193;16231;155;393;5637;14762;5792;15155
210232;202212;14373;38737;11762;34925;1692;4896;7819;24127;9511;29023
210235;202212;4034;10876;3492;10100;162;569;2912;8374;3074;8943
210237;202212;4898;10639;4195;9852;27;119;3996;9264;4023;9383
210240;202212;2967;8155;2631;7635;81;245;2158;6215;2239;6460
210250;202212;7181;17830;6477;16940;119;410;5928;15396;6047;15806
210255;202212;3116;8544;2621;7664;315;1018;1612;4541;1927;5559
210260;202212;6310;16800;5414;15513;418;1273;4343;12364;4761;13637
210270;202212;5783;13931;5071;13051;76;346;4582;11631;4658;11977
210275;202212;3997;9036;3363;8269;174;374;2764;6833;2938;7207
210280;202212;7515;17283;6194;15414;159;671;5135;12214;5294;12885
210290;202212;9912;21500;8862;20243;111;304;8388;19041;8499;19345
210300;202212;38638;97381;31120;86709;6122;16284;15450;47838;21572;64122
210310;202212;3588;8014;3099;7341;39;116;2845;6672;2884;6788
210312;202212;3429;7205;3038;6776;24;84;2807;6151;2831;6235
210315;202212;4393;9362;3925;8836;127;276;3640;8187;3767;8463
210317;202212;5172;14252;4676;13662;110;463;4256;12358;4366;12821
210320;202212;32286;68948;30034;66206;247;1131;28360;61348;28607;62479
210325;202212;4112;10577;3387;9599;411;1186;2485;7099;2896;8285
210330;202212;31203;74509;25102;67107;3902;8454;16553;48751;20455;57205
210340;202212;15216;33121;13671;31211;737;1367;11475;26713;12212;28080
210350;202212;11579;27652;10150;25906;133;428;9198;23254;9331;23682
210355;202212;4485;13683;3916;12784;107;492;3299;10709;3406;11201
210360;202212;14632;41926;13075;39477;562;2327;9839;28639;10401;30966
210370;202212;14385;26897;10771;23089;319;487;9921;21579;10240;22066
210375;202212;3855;9673;2786;8060;951;2916;663;2015;1614;4931
210380;202212;6599;14986;5676;13882;250;693;4911;11871;5161;12564
210390;202212;3827;9703;3547;9287;64;263;3252;8393;3316;8656
210400;202212;5475;14031;4806;13251;247;488;4259;12053;4506;12541
210405;202212;9020;20829;7330;18574;1206;2710;4495;11958;5701;14668
210407;202212;2425;6911;2001;6178;139;418;1534;4740;1673;5158
210408;202212;3174;10298;2919;9959;178;735;2338;8015;2516;8750
210409;202212;4459;13623;3967;12934;217;778;3199;10663;3416;11441
210410;202212;4265;11124;3578;9938;80;336;2957;7979;3037;8315
210420;202212;4395;12686;3856;11748;216;634;3163;9652;3379;10286
210430;202212;2634;6959;2275;6469;193;539;1849;5306;2042;5845
210440;202212;5070;12265;4383;11425;187;382;3906;10241;4093;10623
210450;202212;2672;7083;2285;6521;260;619;1673;4970;1933;5589
210455;202212;5782;13283;4471;11645;1047;2865;2172;5653;3219;8518
210460;202212;4170;11011;3458;10041;122;420;2893;8332;3015;8752
210462;202212;1937;5324;1607;4825;67;184;1257;3800;1324;3984
210465;202212;3116;8014;2677;7424;134;504;2237;6067;2371;6571
210467;202212;7367;19306;6322;17964;590;1507;4981;14541;5571;16048
210470;202212;2158;5482;1589;4684;162;445;1123;3367;1285;3812
210480;202212;19957;53239;16402;48900;2125;4578;11430;37661;13555;42239
210490;202212;3898;8851;3074;7753;92;232;2600;6516;2692;6748
210500;202212;7461;24866;6854;23879;358;1544;5780;19940;6138;21484
210510;202212;8022;20840;7152;19914;128;365;6652;18602;6780;18967
210515;202212;4445;11769;3752;10926;200;615;3100;9160;3300;9775
210520;202212;3028;7963;2693;7517;140;437;2257;6216;2397;6653
210530;202212;67021;150813;52285;129809;9862;26197;22425;58688;32287;84885
210535;202212;4359;12013;3939;11425;134;461;3457;10006;3591;10467
210540;202212;18067;46570;14954;42066;2107;5202;9832;29412;11939;34614
210542;202212;7612;16528;5887;14564;516;1197;4593;11484;5109;12681
210545;202212;2516;7102;2290;6730;52;192;1963;5693;2015;5885
210547;202212;4307;13818;3781;12898;221;762;2945;10249;3166;11011
210550;202212;6841;19173;5211;16571;644;2182;3191;10368;3835;12550
210560;202212;4285;12018;3746;11169;93;351;3204;9381;3297;9732
210565;202212;1756;4684;1431;4247;105;361;1075;3218;1180;3579
210570;202212;12770;31779;11255;29906;267;738;10070;26861;10337;27599
210580;202212;3426;8066;2675;7137;188;455;1952;5447;2140;5902
210590;202212;4808;13093;4085;12189;86;421;3616;10723;3702;11144
210592;202212;3349;8173;3098;7792;31;139;2744;6727;2775;6866
210594;202212;2856;7282;2218;6309;210;548;1542;4547;1752;5095
210596;202212;3411;10287;3011;9606;351;1114;2209;7256;2560;8370
210598;202212;2403;5821;2145;5481;85;244;1879;4772;1964;5016
210600;202212;3472;8787;2781;7803;334;863;1819;5140;2153;6003
210610;202212;3638;8333;3084;7672;55;214;2698;6595;2753;6809
210620;202212;3535;7728;2863;6888;152;318;2441;5796;2593;6114
210630;202212;3718;10684;3270;9943;174;633;2597;7812;2771;8445
210632;202212;7250;16358;6464;15342;187;616;5789;13402;5976;14018
210635;202212;1892;6221;1764;5989;193;589;1323;4629;1516;5218
210637;202212;3096;8772;2582;8043;165;575;1969;6210;2134;6785
210640;202212;5904;17002;5470;16508;61;311;5094;15291;5155;15602
210650;202212;8165;20730;7267;19589;112;385;6521;17498;6633;17883
210660;202212;9488;24589;8426;22910;163;722;7352;19355;7515;20077
210663;202212;3606;8166;3173;7644;321;504;2367;6209;2688;6713
210667;202212;2244;6490;1986;6099;57;193;1703;5341;1760;5534
210670;202212;6719;17032;6054;16025;121;490;5460;14175;5581;14665
210675;202212;6438;14402;5370;13059;585;1218;4149;10345;4734;11563
210680;202212;5796;11754;4895;10713;90;157;4587;10030;4677;10187
210690;202212;11211;24979;9528;23100;249;745;8715;20847;8964;21592
210700;202212;3285;8041;2590;7049;175;431;1985;5452;2160;5883
210710;202212;6304;16366;5500;15312;112;429;4948;13647;5060;14076
210720;202212;3583;10114;3099;9519;100;413;2718;8311;2818;8724
210725;202212;1532;4431;1304;4088;53;176;935;3031;988;3207
210730;202212;1718;3522;1428;3140;61;114;1245;2737;1306;2851
210735;202212;5376;13724;4522;12657;315;760;3674;10686;3989;11446
210740;202212;6114;13969;5159;12880;126;272;4399;10903;4525;11175
210745;202212;4941;12117;4444;11495;56;195;3999;10254;4055;10449
210750;202212;30898;72711;26726;67396;4071;8913;17107;45720;21178;54633
210760;202212;7580;15476;6419;14248;124;231;5965;13431;6089;13662
210770;202212;7361;16290;6263;15040;53;221;5865;13909;5918;14130
210780;202212;8726;24232;7482;22219;517;1550;5840;17296;6357;18846
210790;202212;5182;14101;4554;13266;286;758;3716;11106;4002;11864
210800;202212;5785;13702;4923;12542;78;295;4464;11151;4542;11446
210805;202212;4849;15233;4419;14599;208;705;3711;12365;3919;13070
210810;202212;5756;14989;5170;14252;421;1009;4213;11943;4634;12952
210820;202212;8469;21846;7007;19553;1019;2653;4170;12048;5189;14701
210825;202212;9863;23095;8951;21948;220;643;8202;19906;8422;20549
210830;202212;10609;24400;9603;23178;927;1540;7816;19794;8743;21334
210840;202212;5871;10154;5395;9592;30;121;5136;8892;5166;9013
210845;202212;7246;17369;6360;16385;55;154;6077;15693;6132;15847
210850;202212;8276;21980;6848;19909;477;1372;5489;16027;5966;17399
210860;202212;25342;55732;20948;50495;956;2111;17460;42965;18416;45076
210870;202212;8867;19505;7031;17432;176;415;6279;15517;6455;15932
210880;202212;4846;13012;4275;12263;220;661;3379;9631;3599;10292
210890;202212;5938;12962;5430;12378;193;495;4888;10961;5081;11456
210900;202212;5754;15154;4431;12841;1594;4663;919;3012;2513;7675
210905;202212;2685;5614;2288;5126;45;78;2150;4819;2195;4897
210910;202212;8673;24422;7130;21957;990;2994;4509;13989;5499;16983
210920;202212;3701;10345;3234;9726;66;290;2938;8724;3004;9014
210923;202212;2321;5198;1987;4725;94;230;1643;3807;1737;4037
210927;202212;5383;16159;4635;15230;657;2092;3062;10527;3719;12619
210930;202212;3471;8974;3040;8211;85;354;2650;6900;2735;7254
210940;202212;4201;11014;3778;10497;339;1521;3071;7798;3410;9319
210945;202212;9893;22430;8826;21216;792;1287;7054;17853;7846;19140
210950;202212;6381;15765;4898;13693;610;1321;3307;9934;3917;11255
210955;202212;1774;4917;1465;4425;267;784;872;2669;1139;3453
210960;202212;10775;29006;9175;26537;2985;8537;3685;11712;6670;20249
210970;202212;2035;4719;1672;4145;92;276;1404;3335;1496;3611
210975;202212;2018;5565;1811;5254;197;566;1313;3809;1510;4375
210980;202212;12771;24589;11349;23109;181;293;10737;21870;10918;22163
210990;202212;20934;51606;16232;45627;1680;4061;11414;33489;13094;37550
211000;202212;17294;43949;14177;40095;2735;6801;9201;27836;11936;34637
211003;202212;7467;17538;6246;16114;111;423;5550;14294;5661;14717
211010;202212;8245;23460;7427;22454;78;363;6821;20684;6899;21047
211020;202212;10639;25504;9331;24053;203;630;8298;21697;8501;22327
211023;202212;2442;6996;2226;6720;139;410;1807;5446;1946;5856
211027;202212;4597;11187;4337;10800;101;329;4022;9848;4123;10177
211030;202212;4545;11273;4012;10608;394;968;2969;8022;3363;8990
211040;202212;5196;16580;4742;15817;124;623;4219;13948;4343;14571
211050;202212;10955;24508;9763;23029;125;384;8934;20910;9059;21294
211060;202212;9070;22225;8202;21083;172;614;7403;18712;7575;19326
211065;202212;2951;6680;2458;6068;123;247;2114;5290;2237;5537
211070;202212;9993;26796;8458;24560;349;1089;7162;20723;7511;21812
211080;202212;1573;3781;1231;3267;31;164;951;2332;982;2496
211085;202212;2579;6400;2132;5832;202;386;1648;4787;1850;5173
211090;202212;3674;9003;3291;8565;32;125;3049;7872;3081;7997
211100;202212;8600;18004;7883;17182;37;107;7443;16152;7480;16259
211102;202212;3957;11090;3565;10529;361;1081;2800;8311;3161;9392
211105;202212;2755;7752;2301;6977;122;376;1769;5270;1891;5646
211107;202212;5485;15610;4612;14326;171;568;3706;11954;3877;12522
211110;202212;7702;17751;6111;15441;260;757;5016;12316;5276;13073
211120;202212;59458;129459;48700;116750;8123;17932;30999;77102;39122;95034
211125;202212;2242;6124;1882;5585;32;152;1606;4732;1638;4884
211130;202212;227617;487062;195135;444936;26433;54081;127583;298542;154016;352623
211140;202212;5467;14734;4698;13736;173;531;3970;11675;4143;12206
211150;202212;11542;27005;9638;24656;576;1138;7763;20450;8339;21588
211153;202212;3491;8452;2410;7103;437;1154;1470;4611;1907;5765
211157;202212;1489;4097;1254;3661;88;249;907;2635;995;2884
211160;202212;6379;13955;5188;12342;133;458;4324;9736;4457;10194
211163;202212;1743;5050;1562;4791;61;203;1335;4129;1396;4332
211167;202212;2017;5188;1862;4979;31;108;1727;4585;1758;4693
211170;202212;8735;17020;8046;16217;65;169;7661;15262;7726;15431
211172;202212;3003;7551;2493;6784;84;277;2028;5271;2112;5548
211174;202212;3377;8482;3036;8106;31;159;2877;7602;2908;7761
211176;202212;4960;12723;3854;11129;307;955;2994;8586;3301;9541
211178;202212;6345;12064;5476;11141;36;123;5283;10642;5319;10765
211180;202212;4903;14299;4459;13665;169;681;3681;11135;3850;11816
211190;202212;3883;9507;3270;8638;32;168;2981;7742;3013;7910
211195;202212;1904;4377;1648;4012;64;152;1441;3495;1505;3647
211200;202212;2493;6707;1936;5821;200;628;1340;3965;1540;4593
211210;202212;7215;20004;6409;18891;511;1509;5116;15142;5627;16651
211220;202212;51914;110447;43250;99974;4110;8843;32655;75625;36765;84468
211223;202212;6276;15155;5033;13493;655;1769;3243;8717;3898;10486
211227;202212;1970;5587;1684;5182;57;217;1392;4293;1449;4510
211230;202212;10200;24715;8717;22653;319;673;7539;19676;7858;20349
211240;202212;12317;27714;11606;26851;145;568;11074;25185;11219;25753
211245;202212;9424;22882;8308;21701;172;408;7900;20655;8072;21063
211250;202212;18201;46493;16387;43809;1411;3728;12763;34003;14174;37731
211260;202212;9780;26901;8370;25269;178;701;7551;22867;7729;23568
211270;202212;11949;33392;10141;31076;405;1513;8288;25537;8693;27050
211280;202212;18959;39898;16953;37456;378;843;15628;34333;16006;35176
211285;202212;2364;6554;2088;6206;170;556;1572;4661;1742;5217
211290;202212;8426;22713;7489;21437;342;1031;6124;17441;6466;18472
211300;202212;8410;22579;7255;20685;482;1442;5514;15454;5996;16896
211400;202212;14047;34550;11348;30869;1510;3896;7465;21235;8975;25131
220005;202212;2355;5238;2118;4910;56;129;1784;3996;1840;4125
220010;202212;1758;4463;1408;3880;65;153;1088;2988;1153;3141
220020;202212;5516;11570;4788;10622;257;540;4128;9014;4385;9554
220025;202212;2775;5405;2362;4810;65;113;1990;3901;2055;4014
220027;202212;1644;3521;1406;3196;30;90;1229;2719;1259;2809
220030;202212;4666;9644;4289;9154;97;254;3830;7969;3927;8223
220040;202212;9642;25822;8315;23380;1563;4090;4755;13779;6318;17869
220045;202212;1902;4812;1571;4305;21;103;1358;3602;1379;3705
220050;202212;6628;14038;5755;12964;65;218;5420;11990;5485;12208
220060;202212;3528;5902;3042;5345;71;92;2864;5022;2935;5114
220070;202212;2828;6533;2330;5822;68;153;1947;4781;2015;4934
220080;202212;869;2243;748;2072;19;77;626;1687;645;1764
220090;202212;2020;4328;1629;3758;68;103;1355;3143;1423;3246
220095;202212;1189;2087;1130;2024;18;30;1060;1882;1078;1912
220100;202212;1684;4022;1323;3477;33;134;1081;2699;1114;2833
220105;202212;2423;6562;2073;5975;161;501;1527;4366;1688;4867
220110;202212;4231;9927;3656;9012;43;173;3261;7895;3304;8068
220115;202212;3421;8605;3114;8213;161;458;2705;7047;2866;7505
220117;202212;1644;3486;1282;2989;18;58;1074;2411;1092;2469
220120;202212;20905;39405;19272;37368;86;287;18429;35134;18515;35421
220130;202212;1338;3126;1106;2815;29;116;984;2424;1013;2540
220140;202212;2828;5043;2402;4556;87;158;2147;4107;2234;4265
220150;202212;7717;19486;6916;18167;147;544;5831;14852;5978;15396
220155;202212;1388;3609;1092;3086;23;85;784;2126;807;2211
220157;202212;1326;2770;1108;2457;33;74;895;1938;928;2012
220160;202212;3356;8193;2850;7314;59;201;2331;5773;2390;5974
220170;202212;1834;4437;1520;3983;35;122;1302;3361;1337;3483
220173;202212;2494;6287;1979;5404;45;175;1571;4153;1616;4328
220177;202212;2858;6112;2712;5955;8;28;2670;5838;2678;5866
220180;202212;1427;2875;1158;2449;3;17;982;1928;985;1945
220190;202212;10093;19997;8578;18086;654;1169;6597;14256;7251;15425
220191;202212;1949;5129;1756;4817;142;429;1278;3395;1420;3824
220192;202212;2414;5690;1736;4544;39;130;1412;3607;1451;3737
220194;202212;2218;5291;1935;4843;42;164;1624;3866;1666;4030
220196;202212;2576;5777;2329;5419;20;87;2017;4577;2037;4664
220198;202212;1583;3526;1336;3225;15;36;1219;2951;1234;2987
220200;202212;5986;15659;5199;14589;148;544;4354;12072;4502;12616
220202;202212;2571;6244;2163;5604;30;122;1854;4695;1884;4817
220205;202212;3231;7546;2866;6938;83;247;2442;5730;2525;5977
220207;202212;907;2409;764;2175;78;195;484;1421;562;1616
220208;202212;2122;5869;1707;5116;287;903;883;2614;1170;3517
220209;202212;1856;4889;1530;4303;32;110;1167;3206;1199;3316
220210;202212;2319;4631;2014;4192;22;59;1780;3583;1802;3642
220211;202212;2061;4212;1877;3977;18;61;1656;3428;1674;3489
220213;202212;2148;5001;1805;4428;31;101;1473;3418;1504;3519
220217;202212;2881;6781;2653;6520;165;241;2342;5962;2507;6203
220220;202212;16375;32517;14110;29347;467;1048;11940;24157;12407;25205
220225;202212;1216;2694;987;2410;2;12;930;2244;932;2256
220230;202212;7060;15320;6071;13987;456;893;5044;11691;5500;12584
220240;202212;3835;9592;3091;8348;96;385;2510;6562;2606;6947
220245;202212;2490;4330;1923;3671;10;37;1794;3360;1804;3397
220250;202212;3654;8764;3181;8180;27;100;2974;7582;3001;7682
220253;202212;1970;4759;1650;4274;30;98;1408;3563;1438;3661
220255;202212;2363;4864;1984;4338;41;141;1710;3574;1751;3715
220260;202212;6125;15000;5286;13585;276;670;4237;10831;4513;11501
220265;202212;1833;4735;1656;4505;81;275;1393;3689;1474;3964
220270;202212;7300;20918;6782;19995;175;847;5762;16262;5937;17109
220271;202212;1812;3994;1581;3685;48;121;1366;3138;1414;3259
220272;202212;2018;5286;1741;4781;53;180;1326;3472;1379;3652
220273;202212;1501;3866;1238;3405;66;213;935;2529;1001;2742
220275;202212;3197;5969;2558;5109;73;101;2311;4587;2384;4688
220277;202212;2853;5900;2389;5263;91;180;2005;4323;2096;4503
220280;202212;2394;4332;2015;3870;27;52;1837;3456;1864;3508
220285;202212;2024;4016;1748;3691;11;47;1671;3468;1682;3515
220290;202212;8374;20447;6648;18099;598;1497;4655;13122;5253;14619
220300;202212;2334;6043;1811;5365;36;173;1471;4310;1507;4483
220310;202212;3860;8934;3035;7978;47;169;2652;6900;2699;7069
220320;202212;3679;9327;2778;7779;71;301;2196;5884;2267;6185
220323;202212;2049;5033;1568;4277;47;166;1319;3471;1366;3637
220325;202212;1429;3910;1177;3478;35;137;942;2722;977;2859
220327;202212;1988;4808;1720;4382;64;211;1449;3562;1513;3773
220330;202212;6530;12581;5624;11522;90;259;5170;10356;5260;10615
220335;202212;2236;5487;2028;5207;131;234;1697;4445;1828;4679
220340;202212;2107;5212;1575;4328;89;294;992;2610;1081;2904
220342;202212;1503;3712;1338;3483;124;222;1000;2711;1124;2933
220345;202212;3710;7372;2813;6164;19;57;2524;5417;2543;5474
220350;202212;3912;9053;3114;7883;225;521;2191;5497;2416;6018
220360;202212;1570;3538;1203;2954;15;48;985;2327;1000;2375
220370;202212;10872;26859;9762;25175;405;1082;8256;21021;8661;22103
220375;202212;2058;4792;1817;4501;15;24;1752;4355;1767;4379
220380;202212;1893;3760;1506;3219;30;48;1324;2811;1354;2859
220385;202212;1123;2225;912;1877;6;10;822;1649;828;1659
220390;202212;15469;32822;12357;28405;1988;4690;6936;15590;8924;20280
220400;202212;1800;3842;1367;3184;17;58;1071;2348;1088;2406
220410;202212;1437;3499;1136;2990;30;103;942;2417;972;2520
220415;202212;1004;2327;792;1965;23;45;617;1494;640;1539
220420;202212;2209;5764;1751;4889;78;258;1266;3436;1344;3694
220430;202212;3504;7435;3103;6920;41;98;2818;6165;2859;6263
220435;202212;2470;5248;2133;4741;28;88;1835;3925;1863;4013
220440;202212;3921;8883;3315;8029;56;254;2962;6868;3018;7122
220450;202212;3318;7323;2748;6617;56;193;2435;5740;2491;5933
220455;202212;1703;4168;1605;4047;21;62;1460;3695;1481;3757
220460;202212;1407;2790;1286;2623;27;66;1150;2261;1177;2327
220465;202212;2895;7831;2540;7295;182;517;1994;5739;2176;6256
220470;202212;4676;11047;4111;10171;218;434;3156;7741;3374;8175
220480;202212;3154;7445;2489;6434;240;444;1664;4325;1904;4769
220490;202212;2891;6435;2447;5882;27;129;2153;5036;2180;5165
220500;202212;3988;8526;3301;7498;133;242;2574;5722;2707;5964
220510;202212;3241;7631;2591;6547;108;264;2039;5182;2147;5446
220515;202212;2144;4409;1950;4138;71;92;1669;3528;1740;3620
220520;202212;6228;13810;5587;12914;103;223;4827;11060;4930;11283
220525;202212;1688;3623;1396;3271;40;83;1234;2908;1274;2991
220527;202212;1981;4205;1629;3686;63;132;1442;3264;1505;3396
220530;202212;2008;4037;1662;3600;170;350;1262;2820;1432;3170
220535;202212;1028;2442;943;2315;26;92;775;1809;801;1901
220540;202212;3836;10699;3487;10023;230;630;2785;7969;3015;8599
220545;202212;1768;4604;1596;4340;87;309;1343;3567;1430;3876
220550;202212;10450;29440;9107;26959;535;1731;6660;19142;7195;20873
220551;202212;1753;4144;1488;3708;26;83;1257;3053;1283;3136
220552;202212;1930;5034;1548;4384;25;123;1250;3384;1275;3507
220553;202212;2546;4984;2136;4456;26;49;1948;4007;1974;4056
220554;202212;1164;2558;895;2162;80;153;632;1502;712;1655
220555;202212;4743;8433;4204;7793;32;85;3814;6983;3846;7068
220556;202212;1566;3922;1314;3486;42;182;961;2374;1003;2556
220557;202212;1996;5458;1626;4696;98;370;1195;3287;1293;3657
220558;202212;1751;3997;1393;3510;24;93;1197;2908;1221;3001
220559;202212;2240;4721;1884;4184;53;86;1573;3456;1626;3542
220560;202212;2366;4416;1989;3968;19;35;1870;3688;1889;3723
220570;202212;9808;24898;8753;23365;688;1653;6815;18158;7503;19811
220580;202212;8109;19413;7279;18189;101;279;6479;16074;6580;16353
220585;202212;2481;6866;2026;6018;63;155;1629;4831;1692;4986
220590;202212;1991;4187;1649;3716;104;207;1342;2967;1446;3174
220595;202212;3337;7840;2963;7331;83;271;2544;6131;2627;6402
220600;202212;2238;3758;1939;3421;21;35;1833;3194;1854;3229
220605;202212;1746;4638;1467;4139;25;122;1174;3183;1199;3305
220610;202212;3548;8406;3301;8062;16;90;3128;7542;3144;7632
220620;202212;10826;25861;9842;24551;136;641;9060;22094;9196;22735
220630;202212;420;1124;321;951;28;90;198;550;226;640
220635;202212;2128;5595;1861;5086;65;196;1496;3973;1561;4169
220640;202212;2839;7038;2383;6370;88;297;1923;5047;2011;5344
220650;202212;2936;6520;2492;5869;75;164;2087;4883;2162;5047
220660;202212;3106;8597;2571;7720;79;351;2118;6173;2197;6524
220665;202212;1637;4087;1398;3713;32;141;1210;3104;1242;3245
220667;202212;1930;5065;1738;4746;85;266;1406;3780;1491;4046
220669;202212;1974;5104;1867;4950;37;151;1676;4319;1713;4470
220670;202212;2838;5968;2275;5197;32;87;2018;4524;2050;4611
220672;202212;4146;8961;3411;8084;99;344;3029;6981;3128;7325
220675;202212;1546;3804;1368;3498;89;261;1026;2564;1115;2825
220680;202212;3736;7826;3536;7579;221;337;3107;6752;3328;7089
220690;202212;1870;4405;1593;3987;108;298;1198;2928;1306;3226
220695;202212;1112;2763;995;2566;20;59;834;2111;854;2170
220700;202212;14935;28890;12209;25388;446;992;10080;20225;10526;21217
220710;202212;1045;2525;749;2029;25;84;574;1490;599;1574
220720;202212;2751;5430;2452;5053;27;75;2202;4425;2229;4500
220730;202212;1666;3899;1424;3528;15;61;1250;3000;1265;3061
220735;202212;1239;2469;947;2035;39;71;728;1524;767;1595
220740;202212;1643;3756;1302;3306;56;128;1060;2713;1116;2841
220750;202212;5319;10898;4686;10063;272;428;4143;8983;4415;9411
220755;202212;1820;3668;1511;3236;40;85;1268;2652;1308;2737
220760;202212;4291;9032;3742;8329;48;161;3511;7736;3559;7897
220770;202212;33743;84405;28933;76673;7397;21029;12767;33140;20164;54169
220775;202212;1692;3422;1510;3201;5;23;1477;3097;1482;3120
220777;202212;1882;4278;1473;3668;50;97;1030;2690;1080;2787
220779;202212;1461;3521;1243;3187;42;122;1028;2579;1070;2701
220780;202212;7104;15261;6337;14185;399;912;4944;10980;5343;11892
220785;202212;1749;3398;1529;3124;18;39;1445;2919;1463;2958
220790;202212;12657;30584;11269;28670;233;796;9706;24263;9939;25059
220793;202212;1187;2602;956;2229;16;35;816;1866;832;1901
220795;202212;1673;3797;1450;3485;30;82;1285;3065;1315;3147
220800;202212;26394;49170;22680;44409;983;1857;18698;35577;19681;37434
220810;202212;3736;8986;3117;7987;75;157;2547;6592;2622;6749
220820;202212;7352;15196;6459;13961;298;489;5444;11746;5742;12235
220830;202212;9375;20766;8261;19178;459;1025;6713;15248;7172;16273
220840;202212;16188;40842;13679;36346;1933;5021;8685;22488;10618;27509
220850;202212;3609;9811;3172;9265;54;252;2825;8226;2879;8478
220855;202212;1048;1965;916;1802;23;56;835;1623;858;1679
220860;202212;1450;2830;1242;2542;27;70;1150;2308;1177;2378
220865;202212;2694;6727;2041;5599;51;205;1523;3998;1574;4203
220870;202212;3998;8821;3288;7919;42;169;3001;7102;3043;7271
220880;202212;8135;14434;7008;13096;135;288;6454;11921;6589;12209
220885;202212;1825;4388;1518;3942;92;262;1209;3092;1301;3354
220887;202212;1979;3625;1667;3218;37;52;1548;2966;1585;3018
220890;202212;1699;4531;1438;4148;57;199;1157;3315;1214;3514
220900;202212;2642;5184;2222;4639;24;51;2010;4102;2034;4153
220910;202212;2157;4632;1836;4167;294;475;1304;3141;1598;3616
220915;202212;1088;2699;842;2273;9;31;639;1618;648;1649
220920;202212;1912;4882;1639;4524;109;295;1352;3754;1461;4049
220930;202212;2422;5072;2038;4570;21;56;1841;4192;1862;4248
220935;202212;1249;3310;967;2726;20;89;653;1718;673;1807
220937;202212;1731;4089;1448;3642;36;116;1158;2827;1194;2943
220940;202212;2277;4796;1862;4126;41;116;1597;3390;1638;3506
220945;202212;586;1781;459;1551;23;115;312;1029;335;1144
220950;202212;1616;3400;1073;2579;11;26;875;1993;886;2019
220955;202212;2025;4335;1666;3759;14;26;1470;3260;1484;3286
220960;202212;884;2100;637;1693;38;128;430;1052;468;1180
220965;202212;2197;5012;1904;4598;22;101;1687;3948;1709;4049
220970;202212;2619;5048;1953;4122;8;30;1729;3523;1737;3553
220975;202212;918;2097;770;1907;13;53;688;1634;701;1687
220980;202212;1550;3557;1375;3331;39;105;1198;2836;1237;2941
220985;202212;1764;3731;1513;3351;92;161;1184;2583;1276;2744
220987;202212;1810;4622;1594;4276;55;184;1332;3515;1387;3699
220990;202212;1960;4882;1698;4485;24;94;1432;3719;1456;3813
220995;202212;1708;3794;1401;3295;14;46;1211;2792;1225;2838
220997;202212;2913;7461;2618;6983;46;181;2333;6042;2379;6223
221000;202212;5894;13431;5101;12328;190;521;4279;10178;4469;10699
221005;202212;2014;4313;1825;4018;24;95;1591;3326;1615;3421
221010;202212;1564;2946;1236;2549;38;54;1093;2229;1131;2283
221020;202212;1786;4959;1592;4636;22;93;1253;3604;1275;3697
221030;202212;2059;4149;1755;3777;22;57;1578;3400;1600;3457
221035;202212;1923;4171;1608;3748;47;72;1400;3283;1447;3355
221037;202212;837;2020;694;1784;11;42;524;1259;535;1301
221038;202212;617;1552;477;1318;25;76;339;908;364;984
221039;202212;1001;2455;816;2166;31;115;655;1681;686;1796
221040;202212;5299;13530;4501;12222;243;640;3573;9676;3816;10316
221050;202212;5694;10989;5103;10264;70;193;4692;9301;4762;9494
221060;202212;11771;27803;9618;24351;512;1138;7680;19224;8192;20362
221062;202212;1622;4015;1383;3656;121;251;1074;2887;1195;3138
221063;202212;1480;3387;1285;3112;57;161;1068;2501;1125;2662
221065;202212;3542;7414;3055;6636;15;51;2778;5914;2793;5965
221070;202212;3986;11004;3172;9382;486;1406;1866;5603;2352;7009
221080;202212;4390;9396;3578;8208;52;180;3022;6634;3074;6814
221090;202212;1694;3688;1396;3245;19;45;1219;2768;1238;2813
221093;202212;2035;4491;1834;4167;184;353;1337;2976;1521;3329
221095;202212;1085;2488;892;2214;35;93;718;1757;753;1850
221097;202212;981;2249;726;1826;19;58;561;1330;580;1388
221100;202212;179012;396248;151797;353891;10314;27592;112325;247537;122639;275129
221110;202212;13856;32738;12596;31171;402;883;11075;27318;11477;28201
221120;202212;5921;15073;5236;14070;205;611;4474;11922;4679;12533
221130;202212;7251;15457;5688;12772;974;1928;3606;7864;4580;9792
221135;202212;2437;4995;2102;4573;88;160;1807;3991;1895;4151
221140;202212;1943;3528;1598;3114;54;88;1407;2709;1461;2797
221150;202212;1350;2991;1008;2437;25;108;806;1826;831;1934
221160;202212;886;1958;781;1825;39;50;614;1444;653;1494
221170;202212;1272;2931;1175;2771;6;17;1083;2498;1089;2515
230010;202212;3624;8591;2921;7408;69;185;2380;5844;2449;6029
230015;202212;4387;11451;3777;10256;222;645;2717;7246;2939;7891
230020;202212;18749;47178;17281;44926;955;2411;14249;37028;15204;39439
230030;202212;15753;34446;13101;30909;556;1149;10582;25281;11138;26430
230040;202212;5562;12043;4612;10606;45;184;3807;8816;3852;9000
230050;202212;3090;8808;2343;7147;304;1008;1178;3246;1482;4254
230060;202212;2973;7009;2290;5883;42;151;1840;4580;1882;4731
230070;202212;5367;11931;4234;10000;560;1242;2727;6437;3287;7679
230075;202212;12070;31833;10879;29857;528;1761;8870;23683;9398;25444
230080;202212;3756;6842;2869;5754;11;25;2682;5325;2693;5350
230090;202212;5676;11715;4710;10248;155;326;3968;8352;4123;8678
230100;202212;27427;58129;23745;53398;2158;4920;16841;37294;18999;42214
230110;202212;16732;44209;14011;39139;2167;6393;7849;20983;10016;27376
230120;202212;9942;22884;8471;20629;711;1737;6060;14628;6771;16365
230125;202212;3752;8695;3100;7682;64;242;2564;6065;2628;6307
230130;202212;6844;18479;5487;15698;360;1005;3826;10746;4186;11751
230140;202212;4332;11228;3568;9788;106;410;2804;7341;2910;7751
230150;202212;1946;5130;1585;4407;199;523;947;2631;1146;3154
230160;202212;9031;18047;7770;16269;244;458;6686;13683;6930;14141
230170;202212;7446;19276;5955;16370;443;1157;4113;11061;4556;12218
230180;202212;2008;4858;1610;4150;15;62;1316;3237;1331;3299
230185;202212;5680;13342;4655;11749;465;1164;3284;8321;3749;9485
230190;202212;17605;47523;14299;41360;1906;5636;8004;22484;9910;28120
230195;202212;7021;17650;6254;16409;345;907;4832;12591;5177;13498
230200;202212;5884;14709;4799;12763;328;854;3486;9040;3814;9894
230205;202212;5711;13231;4974;12210;485;982;3744;9246;4229;10228
230210;202212;13342;26837;11338;24230;472;990;9214;19146;9686;20136
230220;202212;19003;40509;16600;37194;962;2186;13570;29756;14532;31942
230230;202212;8793;21919;7870;20209;559;1308;5984;15208;6543;16516
230240;202212;16965;37775;14305;33566;901;1809;11108;25848;12009;27657
230250;202212;11400;27658;10539;26407;517;1330;7883;19120;8400;20450
230260;202212;18583;46726;15861;42185;2244;5751;9621;25273;11865;31024
230270;202212;8892;21250;6739;17504;892;2126;3879;10400;4771;12526
230280;202212;24810;56190;20362;49096;430;1649;16784;38109;17214;39758
230290;202212;6429;14451;5413;12676;233;524;4368;9876;4601;10400
230300;202212;6210;13891;5515;12943;80;210;4883;11394;4963;11604
230310;202212;5638;14450;4627;12633;170;592;3394;8906;3564;9498
230320;202212;9215;23763;7582;20972;252;949;5901;15770;6153;16719
230330;202212;5826;13964;4491;11545;149;479;3406;8409;3555;8888
230340;202212;4669;12930;3974;11559;264;818;2807;7904;3071;8722
230350;202212;23519;54054;20410;49699;998;2916;15100;35549;16098;38465
230360;202212;3759;8530;2903;7123;164;391;2133;5198;2297;5589
230365;202212;3731;7916;3080;7004;81;231;2706;6044;2787;6275
230370;202212;99447;210780;87378;194550;4852;12810;69870;147980;74722;160790
230380;202212;7511;18548;5846;15552;139;495;4442;11259;4581;11754
230390;202212;4112;10436;3495;9485;78;317;2796;7334;2874;7651
230393;202212;4129;10271;3278;8659;85;412;2647;6588;2732;7000
230395;202212;6840;16834;5754;15005;539;1395;3833;9766;4372;11161
230400;202212;6863;16294;5979;14934;88;403;4888;11558;4976;11961
230410;202212;16171;43157;13304;38185;1075;3170;9087;25822;10162;28992
230420;202212;37010;88568;30176;77377;2995;8086;19130;46786;22125;54872
230423;202212;5490;14564;4769;13262;314;933;3435;9266;3749;10199
230425;202212;7492;19707;6844;18508;720;1879;4778;12776;5498;14655
230426;202212;3264;7554;2342;5883;43;157;1792;4288;1835;4445
230427;202212;2132;5483;1484;4186;142;456;840;2129;982;2585
230428;202212;12182;29638;10408;27103;1488;3911;6142;15437;7630;19348
230430;202212;5886;15051;4534;12682;191;541;3423;9345;3614;9886
230435;202212;7796;17489;6300;15026;897;2055;3691;8674;4588;10729
230440;202212;608684;1244807;519185;1122486;34029;82278;389345;802697;423374;884975
230445;202212;4985;12350;4027;10741;251;675;2741;6966;2992;7641
230450;202212;4626;11276;3986;10350;196;688;3049;7480;3245;8168
230460;202212;2739;6325;2329;5690;65;222;1970;4673;2035;4895
230465;202212;5110;12366;4239;10787;144;415;3300;8058;3444;8473
230470;202212;14160;39864;12642;37141;816;2793;9389;26519;10205;29312
230480;202212;1862;4541;1529;3979;53;213;1184;2881;1237;3094
230490;202212;3334;8208;2743;7105;214;649;1850;4416;2064;5065
230495;202212;7448;18211;6470;16595;805;2179;4094;10139;4899;12318
230500;202212;11233;32153;9811;29667;430;1368;7765;23460;8195;24828
230510;202212;2146;5185;1670;4287;163;435;1072;2606;1235;3041
230520;202212;5852;13934;5004;12532;400;976;3664;8929;4064;9905
230523;202212;20048;53094;15511;44108;3526;9716;4200;12274;7726;21990
230526;202212;4814;11468;4011;10195;332;665;2839;7449;3171;8114
230530;202212;6591;18749;5462;16658;1174;3655;2991;9087;4165;12742
230533;202212;6077;11521;4838;9723;62;181;4194;8008;4256;8189
230535;202212;5985;15458;4988;13830;347;1059;3328;9067;3675;10126
230540;202212;18336;45564;15541;41386;279;994;12892;33652;13171;34646
230550;202212;28109;63372;23027;55342;1931;4727;15995;37014;17926;41741
230560;202212;9368;19531;7329;16475;179;343;6274;14010;6453;14353
230565;202212;3773;9153;3106;7978;94;290;2489;6180;2583;6470
230570;202212;4055;9281;3367;8317;77;230;2799;6749;2876;6979
230580;202212;14927;32180;12780;29169;506;1092;10796;24278;11302;25370
230590;202212;11652;28645;9623;25233;737;1843;6996;18038;7733;19881
230600;202212;4548;10100;3559;8501;144;351;2501;5914;2645;6265
230610;202212;8120;19459;7112;17825;478;1221;5596;13854;6074;15075
230620;202212;2494;5998;1915;4942;94;292;1285;3069;1379;3361
230625;202212;12337;29335;10538;26362;2067;5440;5044;11973;7111;17413
230630;202212;14314;35306;12475;32103;1495;3544;8096;20872;9591;24416
230640;202212;32586;88829;29306;83548;1458;4913;23363;65003;24821;69916
230650;202212;6300;14923;5251;13208;178;642;4299;10316;4477;10958
230655;202212;11954;33481;11208;32281;909;2376;8924;26092;9833;28468
230660;202212;7245;18960;5787;16447;174;722;4658;12878;4832;13600
230670;202212;7209;15297;5115;12076;156;419;4124;9377;4280;9796
230680;202212;3336;8030;2717;7006;165;329;1900;4874;2065;5203
230690;202212;8363;22213;6981;19614;532;1565;4397;12237;4929;13802
230700;202212;12949;27981;10271;23324;425;1034;8004;17448;8429;18482
230710;202212;7965;22702;6911;20586;658;1999;4599;13352;5257;15351
230720;202212;2297;6063;1885;5334;139;385;1262;3463;1401;3848
230725;202212;5727;14697;5120;13675;367;1156;3551;9008;3918;10164
230730;202212;74270;174581;58278;152053;12483;33113;23898;63353;36381;96466
230740;202212;7177;18084;5966;16172;177;505;4708;12653;4885;13158
230750;202212;10088;23983;8140;20866;138;480;6618;16320;6756;16800
230760;202212;14191;32869;12214;29971;487;1524;9426;22058;9913;23582
230763;202212;5805;13917;4722;12147;97;378;3783;9304;3880;9682
230765;202212;55879;131093;47327;118146;4846;13127;30593;72239;35439;85366
230770;202212;36132;71479;30753;64782;2012;4396;23970;48800;25982;53196
230780;202212;8005;24344;7131;22394;977;2881;4310;13657;5287;16538
230790;202212;3845;9323;3410;8652;129;428;2713;6527;2842;6955
230800;202212;10662;29117;9208;26359;1123;3378;5575;15168;6698;18546
230810;202212;12805;34936;11251;32402;561;1734;8662;24397;9223;26131
230820;202212;4197;12247;3440;10694;344;1258;2137;6276;2481;7534
230830;202212;9417;22062;7903;19649;339;734;6290;15292;6629;16026
230835;202212;5002;10574;3858;8861;120;281;3199;7107;3319;7388
230837;202212;4719;10638;4229;9858;76;288;3731;8301;3807;8589
230840;202212;11445;30047;9737;27179;790;2204;7106;19629;7896;21833
230850;202212;12432;30197;10447;26706;598;1444;7775;19605;8373;21049
230860;202212;7922;14883;6622;13106;239;368;5871;11462;6110;11830
230870;202212;22509;44382;19251;39362;755;1479;15917;31573;16672;33052
230880;202212;2406;6506;2172;6120;74;309;1698;4589;1772;4898
230890;202212;5504;15305;4931;14312;231;799;3672;10390;3903;11189
230900;202212;3929;9863;3274;8624;129;454;2414;6015;2543;6469
230910;202212;4218;9218;3277;7846;67;256;2755;6417;2822;6673
230920;202212;5650;14060;4472;12117;126;417;3462;9028;3588;9445
230930;202212;8329;20777;6774;18126;356;1044;4740;12288;5096;13332
230940;202212;10048;22027;8636;20007;204;449;7429;16960;7633;17409
230945;202212;7925;19850;6677;17608;338;999;4878;12338;5216;13337
230950;202212;7644;16641;6719;15407;143;334;5742;13098;5885;13432
230960;202212;15764;40740;13456;36530;2138;5914;6942;18049;9080;23963
230970;202212;19345;44681;16306;40151;1591;4094;10845;25710;12436;29804
230980;202212;4266;9131;3673;8188;332;720;2745;5974;3077;6694
230990;202212;2057;5096;1696;4430;65;243;1256;3075;1321;3318
231000;202212;3333;7655;2592;6302;71;215;2003;4593;2074;4808
231010;202212;4599;8965;3542;7320;33;121;3172;6295;3205;6416
231020;202212;10862;27737;9596;25528;1521;3692;5913;15949;7434;19641
231025;202212;10459;23576;9241;21742;633;1391;7255;16819;7888;18210
231030;202212;8643;23382;6501;19121;842;2441;3816;11062;4658;13503
231040;202212;3808;8852;3231;7877;88;245;2716;6354;2804;6599
231050;202212;14920;32599;11940;27672;474;1226;9580;21300;10054;22526
231060;202212;3522;8539;3102;7913;116;344;2476;6295;2592;6639
231070;202212;9874;25125;8466;22703;758;2029;5770;15175;6528;17204
231080;202212;4636;11709;3788;10322;228;654;2652;7131;2880;7785
231085;202212;9039;18910;7200;16699;240;564;5715;12948;5955;13512
231090;202212;5160;12196;3757;9587;123;437;2688;6429;2811;6866
231095;202212;2628;7230;2044;6008;189;556;1357;3921;1546;4477
231100;202212;3515;9157;2873;8007;141;453;2182;5882;2323;6335
231110;202212;4420;11672;4036;10996;339;1056;2851;7394;3190;8450
231120;202212;2918;7293;2432;6500;112;299;1819;4742;1931;5041
231123;202212;2331;5440;1789;4494;117;274;1278;3162;1395;3436
231126;202212;6668;16252;5316;13809;316;759;3951;10087;4267;10846
231130;202212;30698;62304;25636;55997;1263;3538;20325;42028;21588;45566
231135;202212;5069;12647;4168;10993;166;472;3046;7849;3212;8321
231140;202212;21421;51431;17368;44965;769;2535;13057;32176;13826;34711
231150;202212;7074;17384;4986;13379;816;2258;1895;4939;2711;7197
231160;202212;8565;21687;7583;19955;758;1979;5079;13090;5837;15069
231170;202212;5642;14271;4629;12447;298;852;3346;8571;3644;9423
231180;202212;19045;46748;15421;39835;2375;6121;8238;20567;10613;26688
231190;202212;4996;12230;3879;10288;101;333;3000;7668;3101;8001
231195;202212;5958;16157;4831;14022;310;995;3447;9906;3757;10901
231200;202212;10272;25183;8828;22543;146;647;7561;18317;7707;18964
231210;202212;5813;14973;4827;13349;140;573;3886;10336;4026;10909
231220;202212;16251;35108;12693;29001;625;1348;9557;20816;10182;22164
231230;202212;12001;33607;10507;30933;778;2415;7777;22595;8555;25010
231240;202212;14510;38320;12628;34958;1694;4575;7848;21386;9542;25961
231250;202212;2521;5508;1656;3795;67;155;1161;2474;1228;2629
231260;202212;4026;9588;3382;8599;338;750;2321;5962;2659;6712
231270;202212;7810;17653;6293;15237;154;543;4859;11124;5013;11667
231280;202212;2137;5901;1834;5377;171;486;1257;3682;1428;4168
231290;202212;44277;119146;36933;105857;5006;14365;19635;54063;24641;68428
231300;202212;5014;12285;3847;10065;171;539;2692;6677;2863;7216
231310;202212;10270;21747;8122;18128;576;1470;6051;12735;6627;14205
231320;202212;8405;21226;6415;17708;174;462;5012;13642;5186;14104
231325;202212;2898;6760;2254;5737;145;276;1623;4106;1768;4382
231330;202212;13438;33596;11075;29329;1409;3630;7178;18863;8587;22493
231335;202212;6767;15807;5614;14057;157;483;4787;11784;4944;12267
231340;202212;22612;61056;20104;57006;1558;4321;15044;42957;16602;47278
231350;202212;19517;46589;17633;43935;304;942;15811;38848;16115;39790
231355;202212;5296;13750;4645;12596;233;662;3630;9637;3863;10299
231360;202212;9586;25574;8203;23316;422;1303;6453;18035;6875;19338
231370;202212;2440;6141;1915;5219;43;126;1469;3939;1512;4065
231375;202212;4898;13421;4322;12471;168;497;3466;9999;3634;10496
231380;202212;7429;16771;6511;15567;211;421;5422;12891;5633;13312
231390;202212;4060;10643;3577;9860;116;469;2712;7160;2828;7629
231395;202212;5326;13341;4434;11932;323;835;3100;8176;3423;9011
231400;202212;12003;29850;9949;26227;294;1154;7760;19520;8054;20674
231410;202212;20046;49582;18034;46572;905;2175;14961;38423;15866;40598
240010;202212;3077;7262;2368;6052;360;931;1189;2907;1549;3838
240020;202212;17281;40361;14305;35428;846;2498;10186;23945;11032;26443
240030;202212;4744;8748;4273;8097;87;257;3887;7061;3974;7318
240040;202212;927;2454;762;2158;21;68;508;1370;529;1438
240050;202212;4181;9889;3253;8272;75;187;2502;6183;2577;6370
240060;202212;1789;4151;1387;3459;46;123;1091;2659;1137;2782
240070;202212;3216;7846;2829;7066;220;614;2035;4751;2255;5365
240080;202212;3509;8519;2727;7197;125;372;1922;4909;2047;5281
240090;202212;2828;5880;2312;5081;44;88;2004;4310;2048;4398
240100;202212;13553;28079;10818;23633;219;656;8877;18253;9096;18909
240110;202212;5922;14638;4889;12780;172;581;3755;9333;3927;9914
240120;202212;4049;10284;3368;9350;251;835;2403;6457;2654;7292
240130;202212;4859;8427;3952;7280;30;74;3618;6536;3648;6610
240140;202212;2153;5920;1787;5258;200;676;1117;3146;1317;3822
240145;202212;8272;20888;6574;18023;744;2091;4219;11355;4963;13446
240150;202212;1278;3004;1062;2609;51;160;835;1955;886;2115
240160;202212;1744;4547;1418;3959;42;185;1044;2775;1086;2960
240165;202212;1167;2804;961;2442;26;93;798;1951;824;2044
240170;202212;3446;7927;2878;6981;293;701;1894;4501;2187;5202
240180;202212;3643;9718;2912;8260;618;1732;1329;3883;1947;5615
240185;202212;1648;4449;1466;4141;47;179;1153;3114;1200;3293
240190;202212;1383;3310;1130;2924;31;106;909;2292;940;2398
240200;202212;15972;33928;12852;28997;1447;3386;7986;17095;9433;20481
240210;202212;4266;8614;3525;7462;37;144;3089;6219;3126;6363
240220;202212;8744;23691;7724;22133;517;1761;5885;16521;6402;18282
240230;202212;7084;15899;5528;13427;309;619;4045;9938;4354;10557
240240;202212;2103;5604;1431;4149;186;586;517;1260;703;1846
240250;202212;3803;8356;3256;7570;62;203;2737;6099;2799;6302
240260;202212;19768;50076;17057;45705;4948;12832;7162;21240;12110;34072
240270;202212;3006;7615;2450;6736;110;328;1697;4754;1807;5082
240280;202212;1950;4542;1608;3995;64;153;1264;3087;1328;3240
240290;202212;1380;3585;1107;3038;32;131;760;1883;792;2014
240300;202212;2670;6234;1931;4984;101;262;1211;3015;1312;3277
240310;202212;10352;24909;8125;21064;1126;2888;4152;10473;5278;13361
240320;202212;2256;5686;1537;4282;102;318;1047;2750;1149;3068
240325;202212;45618;103844;37413;90736;4386;12021;22988;51993;27374;64014
240330;202212;2150;5284;1661;4422;73;248;1142;2846;1215;3094
240340;202212;2528;4894;2027;4176;60;145;1694;3315;1754;3460
240350;202212;3032;6212;2683;5808;59;133;2449;5262;2508;5395
240360;202212;15403;36011;13674;33413;2138;4985;8698;21237;10836;26222
240370;202212;2653;5695;2034;4613;91;252;1537;3250;1628;3502
240375;202212;1145;2487;911;2118;43;135;658;1359;701;1494
240380;202212;2750;6929;2110;5639;211;537;1237;3201;1448;3738
240390;202212;1165;2599;790;1930;24;53;522;1178;546;1231
240400;202212;1736;3868;1284;3135;40;150;920;2089;960;2239
240410;202212;702;1906;560;1631;61;214;313;844;374;1058
240420;202212;6246;18172;5556;16834;455;1729;3858;11102;4313;12831
240430;202212;4277;9640;3567;8490;110;345;2803;6318;2913;6663
240440;202212;3388;6747;2866;6018;285;542;2179;4509;2464;5051
240450;202212;5300;13010;4128;10918;321;1021;2609;6306;2930;7327
240460;202212;4229;9713;3777;9019;310;670;2998;7189;3308;7859
240470;202212;4053;11333;3071;9349;655;1803;1411;4554;2066;6357
240480;202212;687;1699;417;1135;28;62;207;539;235;601
240485;202212;2522;6416;1989;5501;154;455;1275;3501;1429;3956
240490;202212;1956;4313;1487;3517;88;172;1082;2486;1170;2658
240500;202212;2606;6243;2228;5617;115;278;1800;4469;1915;4747
240510;202212;1991;4813;1699;4383;65;197;1378;3441;1443;3638
240520;202212;1946;3906;1481;3293;103;213;1174;2597;1277;2810
240530;202212;2877;6761;2526;6209;159;288;2048;5010;2207;5298
240540;202212;2803;6050;2492;5588;46;118;2239;4968;2285;5086
240550;202212;1076;2308;951;2106;13;50;854;1823;867;1873
240560;202212;4824;9851;4150;8980;164;284;3500;7519;3664;7803
240570;202212;3282;8042;2183;5754;291;786;855;1992;1146;2778
240580;202212;10548;26426;9276;24286;536;1523;7529;19354;8065;20877
240590;202212;1122;2166;959;1931;23;33;801;1557;824;1590
240600;202212;2102;5103;1516;3988;59;164;1062;2639;1121;2803
240610;202212;5529;12627;4698;11222;236;618;3459;7890;3695;8508
240615;202212;1563;3521;1240;2996;92;248;924;2104;1016;2352
240620;202212;2363;5625;2008;5047;68;208;1662;4041;1730;4249
240630;202212;2777;6196;2488;5750;211;345;1875;4412;2086;4757
240640;202212;1110;2624;859;2211;35;107;649;1602;684;1709
240650;202212;4804;12728;3958;11063;312;837;2672;7395;2984;8232
240660;202212;5205;9236;4747;8641;65;127;4469;8034;4534;8161
240670;202212;3079;7497;2407;6205;213;589;1580;3884;1793;4473
240680;202212;1934;4457;1536;3806;53;158;1204;2839;1257;2997
240690;202212;1453;3032;1122;2487;20;71;956;1987;976;2058
240700;202212;2836;7537;2258;6513;112;347;1663;4716;1775;5063
240710;202212;24396;50518;20859;45176;1731;3903;15706;32626;17437;36529
240720;202212;6262;14175;5209;12669;641;1609;3405;8083;4046;9692
240725;202212;1290;3353;969;2773;44;125;620;1710;664;1835
240730;202212;2726;6765;2119;5668;64;213;1623;4182;1687;4395
240740;202212;2260;5645;1794;4741;86;272;1267;3143;1353;3415
240750;202212;2753;7923;2296;6994;283;906;1341;3922;1624;4828
240760;202212;2075;4163;1496;3326;114;162;1112;2575;1226;2737
240770;202212;4024;9560;3386;8701;136;437;2806;7013;2942;7450
240780;202212;6472;15447;5387;13696;745;1905;3481;8636;4226;10541
240790;202212;1058;2636;858;2293;26;119;627;1565;653;1684
240800;202212;71854;145133;57767;124921;5276;12229;38511;77604;43787;89833
240810;202212;133177;287016;116159;261200;10727;24961;83942;181866;94669;206827
240820;202212;7691;20107;6702;18363;986;2747;4079;11127;5065;13874
240830;202212;10328;26219;8898;24126;328;1127;7088;18824;7416;19951
240840;202212;1298;2934;1020;2495;48;97;721;1710;769;1807
240850;202212;1652;4136;1112;3021;88;221;650;1671;738;1892
240860;202212;1782;3883;1351;3171;35;122;1114;2488;1149;2610
240870;202212;1243;2854;935;2355;159;386;473;1209;632;1595
240880;202212;1519;4389;1301;3962;105;400;917;2695;1022;3095
240890;202212;6556;14544;5159;12214;464;1285;3449;7384;3913;8669
240895;202212;3579;9543;3223;8982;406;1070;2339;6608;2745;7678
240910;202212;4159;10087;3411;8804;61;203;2765;6886;2826;7089
240920;202212;1278;2800;1023;2440;114;199;659;1617;773;1816
240930;202212;4373;8902;3511;7840;266;404;2321;5687;2587;6091
240933;202212;1929;4348;1601;3878;41;163;1346;3116;1387;3279
240940;202212;8902;18391;7089;15549;668;1443;4830;10054;5498;11497
240950;202212;1313;3512;1107;3103;33;133;873;2330;906;2463
240960;202212;860;2166;764;1971;15;53;601;1475;616;1528
240970;202212;2409;5135;1938;4408;64;190;1621;3545;1685;3735
240980;202212;4808;10961;4303;10177;67;275;3810;8661;3877;8936
240990;202212;3576;8196;3130;7435;232;675;2333;5157;2565;5832
241000;202212;1242;2698;957;2214;14;49;785;1706;799;1755
241010;202212;3826;9876;3447;9153;139;464;2810;7168;2949;7632
241020;202212;2530;6043;1896;4846;100;315;1362;3251;1462;3566
241025;202212;1920;5062;1529;4383;39;154;1097;3022;1136;3176
241030;202212;2949;8321;2343;7108;256;762;1550;4604;1806;5366
241040;202212;2583;7197;2191;6550;106;422;1664;4897;1770;5319
241050;202212;1716;4272;1351;3626;40;127;1016;2642;1056;2769
241060;202212;995;2417;831;2095;43;110;590;1398;633;1508
241070;202212;844;2010;697;1779;16;39;541;1317;557;1356
241080;202212;1354;3433;1034;2802;34;114;736;1903;770;2017
241090;202212;2486;6230;1959;5357;80;307;1462;3808;1542;4115
241100;202212;1384;3504;1036;2826;53;117;688;1829;741;1946
241105;202212;1286;3374;1033;2912;197;580;485;1300;682;1880
241110;202212;1081;2798;801;2227;50;145;505;1333;555;1478
241120;202212;9110;23245;7696;20908;806;2235;5031;13533;5837;15768
241140;202212;3962;9573;2994;7689;131;387;2169;5373;2300;5760
241142;202212;896;2212;674;1810;58;143;406;1013;464;1156
241150;202212;7088;16335;6157;14934;257;611;4857;11591;5114;12202
241160;202212;1396;3566;1048;2915;164;493;558;1445;722;1938
241170;202212;1591;3628;1336;3188;31;92;1111;2546;1142;2638
241180;202212;1238;2842;910;2274;88;231;512;1210;600;1441
241190;202212;1429;3233;1168;2765;20;67;882;1979;902;2046
241200;202212;31791;67264;28015;61589;2989;6969;19559;40601;22548;47570
241210;202212;1979;4486;1416;3487;108;291;905;2136;1013;2427
241220;202212;12247;30240;10733;27819;2433;6308;5258;13740;7691;20048
241230;202212;3505;8217;2990;7457;111;261;2470;6094;2581;6355
241240;202212;1431;3720;845;2469;100;312;294;802;394;1114
241250;202212;7506;17778;5983;15164;142;594;4744;11310;4886;11904
241255;202212;3236;8507;2716;7561;158;504;1988;5331;2146;5835
241260;202212;5953;13741;4729;11772;167;501;3634;8630;3801;9131
241270;202212;1913;5064;1573;4428;113;351;1106;3020;1219;3371
241280;202212;3131;6191;2719;5500;89;179;2360;4650;2449;4829
241290;202212;3857;8487;2794;6843;100;292;2236;5272;2336;5564
241300;202212;1888;4414;1528;3841;47;159;1088;2572;1135;2731
241310;202212;2859;5788;2454;5239;58;109;2134;4481;2192;4590
241320;202212;1135;3352;960;3021;102;343;579;1768;681;2111
241330;202212;2085;4719;1653;4149;29;81;1465;3638;1494;3719
241335;202212;4469;10881;3880;9870;128;431;3186;7784;3314;8215
241340;202212;2113;4988;1646;4127;201;615;946;2149;1147;2764
241350;202212;2624;6280;2256;5649;109;271;1736;4245;1845;4516
241355;202212;1636;3925;1296;3293;52;116;966;2405;1018;2521
241360;202212;2456;5659;1760;4346;55;165;1314;3057;1369;3222
241370;202212;1624;3878;1232;3143;60;176;909;2154;969;2330
241380;202212;844;1996;666;1703;72;180;389;975;461;1155
241390;202212;3270;8442;2860;7828;154;483;2198;5950;2352;6433
241400;202212;4375;10829;3822;9996;218;683;2938;7455;3156;8138
241410;202212;2964;7950;2366;6766;238;743;1525;4247;1763;4990
241415;202212;2305;5423;1942;4786;44;169;1612;3761;1656;3930
241420;202212;3790;9672;3387;9036;594;1666;2044;5423;2638;7089
241430;202212;845;1903;543;1346;19;55;376;856;395;911
241440;202212;10323;26994;9224;25191;276;918;7575;20201;7851;21119
241445;202212;1662;3379;1431;3078;30;65;1279;2723;1309;2788
241450;202212;3670;7531;2954;6465;221;444;2306;4962;2527;5406
241460;202212;4719;11385;3707;9416;328;895;2461;5908;2789;6803
241470;202212;1723;4063;1366;3545;44;151;1143;2894;1187;3045
241475;202212;1454;3548;1119;2946;20;74;849;2083;869;2157
241480;202212;3748;10287;3059;8898;854;2472;1091;3389;1945;5861
241490;202212;901;1812;639;1427;15;42;523;1127;538;1169
241500;202212;954;2289;847;2163;10;23;745;1900;755;1923
250010;202212;3276;8380;2634;7136;75;244;2006;5213;2081;5457
250020;202212;1913;4513;1397;3596;86;154;1052;2686;1138;2840
250030;202212;8552;20528;7425;18855;922;2425;5115;12840;6037;15265
250040;202212;5696;14459;4933;13156;759;1952;3002;7928;3761;9880
250050;202212;4484;10377;3967;9732;181;451;3260;8094;3441;8545
250053;202212;1551;3902;1400;3677;141;306;964;2540;1105;2846
250057;202212;899;2480;817;2363;11;43;745;2145;756;2188
250060;202212;7507;16595;6572;15298;474;1116;5072;11719;5546;12835
250070;202212;4834;11854;4011;10484;44;187;3221;8080;3265;8267
250073;202212;972;2252;760;1919;7;21;622;1534;629;1555
250077;202212;3244;6832;2501;5704;34;102;2140;4698;2174;4800
250080;202212;7318;14073;6093;12619;67;198;5587;11340;5654;11538
250090;202212;4775;8922;4194;8195;64;135;3751;7107;3815;7242
250100;202212;4117;11221;3671;10427;263;694;2754;7670;3017;8364
250110;202212;6076;14816;5490;14011;352;1026;4219;10493;4571;11519
250115;202212;923;1919;702;1604;12;42;566;1238;578;1280
250120;202212;2249;5838;1908;5302;25;122;1528;4099;1553;4221
250130;202212;7629;15923;6505;14435;51;218;5806;12470;5857;12688
250135;202212;1678;3834;1450;3453;60;135;1215;2853;1275;2988
250140;202212;2678;6973;2442;6689;179;518;1956;5431;2135;5949
250150;202212;5726;15893;5117;14905;199;700;4079;11554;4278;12254
250153;202212;1673;3971;1360;3512;77;165;1067;2719;1144;2884
250157;202212;2663;6076;2337;5568;51;161;1972;4534;2023;4695
250160;202212;4681;10118;3741;8862;79;203;3216;7507;3295;7710
250170;202212;2270;5256;2009;4878;41;139;1708;4024;1749;4163
250180;202212;30445;59467;26274;54280;1256;3164;21306;41959;22562;45123
250190;202212;5208;11895;4363;10708;437;1016;3076;7291;3513;8307
250200;202212;3236;5996;2776;5421;37;82;2510;4745;2547;4827
250205;202212;981;2802;820;2548;22;93;637;1956;659;2049
250210;202212;1719;4669;1509;4330;70;254;1157;3226;1227;3480
250215;202212;1927;4782;1616;4355;101;287;931;2523;1032;2810
250220;202212;821;2029;639;1743;33;119;451;1162;484;1281
250230;202212;1995;4058;1406;3220;23;56;1103;2440;1126;2496
250240;202212;3740;8132;3313;7463;38;154;2971;6482;3009;6636
250250;202212;5914;13805;5203;12840;443;726;4000;10445;4443;11171
250260;202212;1878;4848;1562;4293;69;179;1186;3269;1255;3448
250270;202212;1434;3865;1304;3707;101;298;924;2752;1025;3050
250280;202212;4908;10440;4337;9706;278;474;3391;7716;3669;8190
250290;202212;2257;4702;1887;4180;27;66;1582;3358;1609;3424
250300;202212;7467;15924;6679;14995;218;695;5625;12192;5843;12887
250310;202212;1461;3728;1179;3253;58;142;855;2322;913;2464
250320;202212;18114;33289;15897;30830;188;511;14692;27782;14880;28293
250330;202212;3264;7218;2771;6567;72;242;2418;5492;2490;5734
250340;202212;1521;3161;1304;2874;19;45;1176;2563;1195;2608
250350;202212;4603;11913;3957;10794;330;693;2959;8321;3289;9014
250355;202212;2714;6422;2391;6028;15;61;2221;5566;2236;5627
250360;202212;2181;5056;1932;4729;63;188;1614;3809;1677;3997
250370;202212;19869;40480;16884;36220;244;767;14960;30913;15204;31680
250375;202212;1585;3324;1269;2958;5;13;1164;2751;1169;2764
250380;202212;2203;4597;2021;4385;45;141;1810;3772;1855;3913
250390;202212;2379;5188;2000;4621;139;316;1547;3550;1686;3866
250400;202212;90176;203583;68660;171504;19761;52142;21299;52649;41060;104791
250403;202212;2952;5913;2617;5541;55;254;2264;4463;2319;4717
250407;202212;1880;3710;1332;2939;139;245;861;2009;1000;2254
250410;202212;858;1996;734;1795;21;57;608;1427;629;1484
250415;202212;2427;5678;2120;5229;30;108;1867;4496;1897;4604
250420;202212;1738;3594;1568;3368;13;29;1463;3095;1476;3124
250430;202212;9423;18396;8103;16700;277;564;6933;13794;7210;14358
250435;202212;1920;4894;1479;4151;27;100;1127;3042;1154;3142
250440;202212;5298;12829;4570;11884;104;254;3955;10169;4059;10423
250450;202212;2193;5044;1792;4504;93;174;1389;3583;1482;3757
250460;202212;9446;22571;8254;20910;584;1595;6377;15899;6961;17494
250470;202212;2155;4594;1769;4004;69;147;1443;3150;1512;3297
250480;202212;4629;11340;3868;10395;77;185;3283;8838;3360;9023
250485;202212;834;1738;620;1442;68;101;412;942;480;1043
250490;202212;7083;13609;6264;12686;108;312;5658;11121;5766;11433
250500;202212;2437;6017;2130;5509;50;148;1742;4414;1792;4562
250510;202212;7111;14729;6091;13371;247;337;5112;11354;5359;11691
250520;202212;2197;5352;1869;4923;84;259;1465;3755;1549;4014
250523;202212;2784;5772;2428;5296;195;467;1885;3971;2080;4438
250527;202212;2050;4450;1849;4225;20;64;1675;3793;1695;3857
250530;202212;801;1839;682;1669;18;49;555;1309;573;1358
250535;202212;1622;4214;1431;3876;26;115;1154;3009;1180;3124
250540;202212;4139;7495;3492;6791;450;499;2783;5750;3233;6249
250550;202212;901;2660;785;2444;51;168;540;1653;591;1821
250560;202212;2063;5038;1757;4603;48;182;1466;3707;1514;3889
250570;202212;3304;8589;2828;7764;167;487;2106;5733;2273;6220
250580;202212;1249;2948;1096;2742;59;203;888;2140;947;2343
250590;202212;1290;2633;1167;2468;27;71;1051;2147;1078;2218
250600;202212;9169;22327;7547;20092;286;811;5830;15170;6116;15981
250610;202212;3460;8837;3057;8244;132;413;2455;6567;2587;6980
250620;202212;1128;2379;942;2096;44;129;753;1584;797;1713
250625;202212;2784;7314;2456;6787;47;219;2098;5648;2145;5867
250630;202212;15295;33822;12861;29967;1163;2956;9223;20425;10386;23381
250640;202212;4566;10416;4046;9746;88;321;3514;8242;3602;8563
250650;202212;1296;2728;1015;2360;11;51;871;1973;882;2024
250660;202212;1877;4145;1470;3562;33;86;1231;2847;1264;2933
250670;202212;2926;7747;2639;7248;46;184;2297;6129;2343;6313
250680;202212;7449;14497;6687;13643;37;151;6270;12449;6307;12600
250690;202212;8823;17154;7387;15426;161;305;6426;13183;6587;13488
250700;202212;5566;14028;4835;12892;701;1909;3136;8202;3837;10111
250710;202212;5198;13545;4484;12551;383;1119;3202;8938;3585;10057
250720;202212;3409;8173;2983;7548;65;252;2592;6417;2657;6669
250730;202212;5474;12226;4792;11323;211;590;4069;9293;4280;9883
250740;202212;2514;5463;2053;4859;134;289;1551;3675;1685;3964
250750;202212;155161;327266;133524;297748;8924;22429;102394;218283;111318;240712
250760;202212;3679;6819;3297;6273;65;162;3021;5575;3086;5737
250770;202212;4917;13219;4351;12453;678;1669;2816;8469;3494;10138
250780;202212;2310;5211;1936;4582;60;174;1600;3647;1660;3821
250790;202212;3142;8041;2728;7443;99;386;2189;5735;2288;6121
250800;202212;2970;6913;2560;6274;109;214;2075;5020;2184;5234
250810;202212;1776;3843;1462;3413;163;240;1086;2690;1249;2930
250820;202212;2587;5856;2370;5607;46;156;2142;4978;2188;5134
250830;202212;7437;19762;6095;17175;227;827;4429;11818;4656;12645
250840;202212;882;2586;764;2369;38;138;558;1728;596;1866
250850;202212;2184;5587;1897;5099;28;125;1564;4069;1592;4194
250855;202212;1359;3277;1204;3055;41;118;996;2455;1037;2573
250860;202212;4214;10846;3479;9684;487;1413;2001;5398;2488;6811
250870;202212;1270;3002;1057;2674;65;148;809;2047;874;2195
250880;202212;1943;4461;1583;3934;125;302;1173;2873;1298;3175
250890;202212;14807;29908;13060;27740;264;1086;11495;23041;11759;24127
250900;202212;4022;9051;3498;8209;83;232;2999;6799;3082;7031
250905;202212;3025;7421;2772;7098;45;173;2513;6368;2558;6541
250910;202212;9257;17507;7930;16050;84;255;7224;14350;7308;14605
250915;202212;2642;5286;1920;4502;29;52;1695;3985;1724;4037
250920;202212;4773;10068;4278;9366;262;513;3562;7641;3824;8154
250930;202212;2854;6791;2526;6380;113;339;2055;5050;2168;5389
250933;202212;1496;3862;1289;3511;52;194;1006;2650;1058;2844
250937;202212;984;2299;813;2043;24;77;668;1657;692;1734
250939;202212;2505;5443;2183;5031;46;119;1841;4129;1887;4248
250940;202212;4779;11028;4129;10161;61;171;3625;8805;3686;8976
250950;202212;2022;4792;1616;4240;46;152;1279;3264;1325;3416
250960;202212;1370;3472;1193;3189;30;132;983;2510;1013;2642
250970;202212;10997;24212;9491;21817;353;774;7745;17395;8098;18169
250980;202212;2891;6717;2591;6308;21;92;2261;5320;2282;5412
250990;202212;2573;6815;2173;6140;110;368;1640;4490;1750;4858
251000;202212;2367;6044;1895;5259;47;164;1522;4170;1569;4334
251010;202212;3041;7415;2665;6863;33;146;2327;5853;2360;5999
251020;202212;1895;4671;1695;4366;32;141;1477;3690;1509;3831
251030;202212;1232;2962;1003;2565;72;162;677;1708;749;1870
251040;202212;2225;5451;1883;4902;25;107;1612;4121;1637;4228
251050;202212;1189;3105;980;2705;44;158;698;1813;742;1971
251060;202212;1354;2642;992;2173;38;82;738;1602;776;1684
251065;202212;557;1412;402;1120;13;38;285;752;298;790
251070;202212;921;2034;765;1815;14;43;641;1462;655;1505
251080;202212;26439;56778;21689;49926;3627;8337;12413;28796;16040;37133
251090;202212;3430;8788;2858;7840;72;201;2341;6281;2413;6482
251100;202212;944;2730;801;2450;32;104;594;1715;626;1819
251110;202212;2246;5149;1846;4443;124;281;1379;3239;1503;3520
251120;202212;9828;22558;8274;20646;548;1524;6220;15063;6768;16587
251130;202212;5965;10069;5250;9282;62;123;4929;8571;4991;8694
251140;202212;4844;12475;4239;11620;123;399;3364;9131;3487;9530
251150;202212;3402;8553;3091;8071;59;281;2663;6736;2722;7017
251160;202212;2967;6904;2567;6322;26;132;2317;5551;2343;5683
251170;202212;2257;4862;1994;4536;34;106;1803;3978;1837;4084
251180;202212;3395;7658;2801;6852;287;560;1904;4823;2191;5383
251190;202212;6755;13371;6078;12606;64;257;5477;10850;5541;11107
251200;202212;5631;13635;4921;12733;162;354;4126;10774;4288;11128
251203;202212;1174;3401;1037;3095;56;160;677;1955;733;2115
251207;202212;1334;3226;993;2677;21;91;680;1762;701;1853
251210;202212;9901;21737;8027;19167;645;1213;5660;13977;6305;15190
251220;202212;1644;3323;1205;2763;99;207;920;2106;1019;2313
251230;202212;5673;14204;4854;12784;121;415;3869;9778;3990;10193
251240;202212;4456;11402;3719;10155;316;763;2447;6744;2763;7507
251250;202212;14985;33596;13087;30527;790;1971;10123;22648;10913;24619
251260;202212;666;1550;587;1422;15;63;475;1080;490;1143
251270;202212;5549;14344;4923;13488;278;689;3866;10851;4144;11540
251272;202212;1749;3910;1603;3733;48;178;1415;3163;1463;3341
251274;202212;1014;2596;799;2220;68;179;493;1337;561;1516
251275;202212;1915;3987;1613;3521;71;176;1339;2795;1410;2971
251276;202212;1625;3945;1389;3622;37;145;1120;2802;1157;2947
251278;202212;813;1864;711;1710;30;84;572;1328;602;1412
251280;202212;3438;6989;3116;6556;51;165;2815;5707;2866;5872
251290;202212;10208;17735;9338;16734;301;586;8326;14574;8627;15160
251300;202212;1055;2697;917;2484;15;63;772;2054;787;2117
251310;202212;3449;8531;2950;7755;49;224;2482;6320;2531;6544
251315;202212;2214;6110;1974;5666;104;279;1532;4353;1636;4632
251320;202212;2025;4729;1527;3881;40;144;1172;2849;1212;2993
251330;202212;2623;5232;2093;4606;37;82;1827;3986;1864;4068
251335;202212;1329;3302;1181;3080;21;97;1058;2683;1079;2780
251340;202212;4734;9704;3760;8459;137;326;3006;6611;3143;6937
251350;202212;1299;3248;1170;3050;34;98;971;2487;1005;2585
251360;202212;2230;5395;1737;4680;28;82;1374;3620;1402;3702
251365;202212;953;2247;689;1750;22;56;537;1346;559;1402
251370;202212;33858;77470;29032;70871;4253;10144;17801;43585;22054;53729
251380;202212;1881;4022;1620;3635;52;128;1395;3063;1447;3191
251385;202212;950;2217;717;1818;29;81;502;1207;531;1288
251390;202212;9576;22029;8476;20407;693;1709;6239;14684;6932;16393
251392;202212;1264;3026;1043;2686;39;109;810;2063;849;2172
251394;202212;813;2052;657;1785;66;180;443;1153;509;1333
251396;202212;864;2115;718;1866;26;74;499;1223;525;1297
251398;202212;1215;2856;841;2194;22;81;610;1514;632;1595
251400;202212;1796;3436;1439;2972;52;107;1186;2326;1238;2433
251410;202212;1938;3892;1522;3299;15;51;1299;2662;1314;2713
251420;202212;2570;5700;2072;5119;52;173;1675;3995;1727;4168
251430;202212;1812;4856;1623;4531;58;197;1354;3704;1412;3901
251440;202212;1310;3197;1057;2762;71;157;777;2055;848;2212
251445;202212;2097;4836;1905;4581;28;97;1657;3855;1685;3952
251450;202212;5666;14027;5036;13076;58;226;4385;11133;4443;11359
251455;202212;1057;2788;943;2595;33;100;745;1994;778;2094
251460;202212;1169;2879;934;2497;75;202;673;1786;748;1988
251465;202212;598;1501;495;1320;14;62;378;948;392;1010
251470;202212;1387;3537;1024;2817;120;387;544;1341;664;1728
251480;202212;1219;2866;928;2372;18;61;693;1666;711;1727
251490;202212;2494;5658;2013;5004;140;269;1516;3755;1656;4024
251500;202212;2690;6006;2436;5670;72;188;2103;4727;2175;4915
251510;202212;3154;8624;2590;7537;124;409;1780;4973;1904;5382
251520;202212;1214;2862;900;2320;80;166;574;1442;654;1608
251530;202212;19317;38782;15870;34578;166;718;14193;29971;14359;30689
251540;202212;3608;9223;3184;8507;87;329;2614;6732;2701;7061
251550;202212;5399;10086;4403;8891;124;214;3768;7516;3892;7730
251560;202212;660;1823;585;1716;41;162;431;1186;472;1348
251570;202212;1116;2857;915;2464;21;104;718;1853;739;1957
251580;202212;2766;5354;2465;4923;25;96;2162;4076;2187;4172
251590;202212;2017;4231;1702;3856;61;137;1460;3208;1521;3345
251593;202212;1162;3101;1028;2876;89;305;701;1886;790;2191
251597;202212;2759;6266;2485;5913;15;68;2294;5350;2309;5418
251600;202212;7716;18809;6676;17228;273;788;5451;13767;5724;14555
251610;202212;4104;9861;3547;8920;296;713;2626;6480;2922;7193
251615;202212;1662;3496;1318;2998;21;62;1121;2448;1142;2510
251620;202212;24756;48005;19344;41494;226;463;16885;36050;17111;36513
251630;202212;6466;12694;5219;10977;284;627;4143;8284;4427;8911
251640;202212;2661;6327;2352;5879;21;90;2118;5185;2139;5275
251650;202212;5139;11390;4394;10432;136;327;3739;8700;3875;9027
251660;202212;4410;11242;3863;10325;56;251;3235;8334;3291;8585
251670;202212;5808;12556;5166;11723;56;223;4744;10485;4800;10708
251675;202212;1083;2249;974;2110;44;117;851;1799;895;1916
251680;202212;3196;7250;2678;6586;112;197;2168;5374;2280;5571
251690;202212;3929;9881;3308;8839;126;362;2508;6621;2634;6983
251700;202212;2775;6734;2292;6072;45;174;1914;4863;1959;5037
251710;202212;958;2222;684;1707;42;115;435;993;477;1108
251720;202212;1580;3990;1243;3423;21;97;968;2539;989;2636
251740;202212;801;1966;638;1692;33;103;477;1212;510;1315
260005;202212;38808;72718;32423;64772;1833;3801;26163;50455;27996;54256
260010;202212;12713;29560;10463;26042;632;1732;6745;16052;7377;17784
260020;202212;8595;16806;7054;14722;77;282;6076;12232;6153;12514
260030;202212;9920;19577;8440;17545;77;291;7484;14962;7561;15253
260040;202212;8988;20302;7528;18326;460;1189;5594;13521;6054;14710
260050;202212;18227;38087;15696;35248;255;672;14646;32635;14901;33307
260060;202212;5227;10988;4430;9797;395;660;3298;7537;3693;8197
260070;202212;14629;29331;12653;26630;201;682;11015;22197;11216;22879
260080;202212;8682;16156;7563;14762;132;312;6595;12449;6727;12761
260090;202212;6861;14459;6082;13456;436;858;4838;10711;5274;11569
260100;202212;4032;8634;3454;7838;34;154;3095;6801;3129;6955
260105;202212;6156;14487;5497;13621;104;383;4693;11263;4797;11646
260110;202212;26548;66788;23357;62173;1139;3466;18853;49073;19992;52539
260120;202212;19579;42967;16591;38780;1854;3962;11575;26942;13429;30904
260130;202212;4083;8716;3513;7949;88;197;2881;6267;2969;6464
260140;202212;17235;32103;14927;29385;412;903;13026;24945;13438;25848
260150;202212;4767;8947;4175;8233;113;221;3757;7336;3870;7557
260160;202212;9411;17972;8157;16474;135;270;7538;15128;7673;15398
260170;202212;27815;55365;23776;49994;1136;2510;19436;39755;20572;42265
260180;202212;4399;9958;3716;9002;81;295;3162;7500;3243;7795
260190;202212;26752;43732;22935;39374;177;358;21161;35392;21338;35750
260200;202212;13709;28879;11824;26475;492;955;10330;23053;10822;24008
260210;202212;13709;34153;11482;30660;404;1221;9161;24149;9565;25370
260220;202212;15409;28500;14267;27129;347;594;12771;23840;13118;24434
260230;202212;16363;30526;14296;27987;325;625;12385;23670;12710;24295
260240;202212;3394;8802;2906;7922;66;280;2333;6149;2399;6429
260250;202212;2958;6392;2505;5713;97;237;2021;4444;2118;4681
260260;202212;17503;38497;15485;35717;1146;2421;11829;27620;12975;30041
260270;202212;6380;11659;5687;10885;78;239;5174;9616;5252;9855
260280;202212;16391;39358;14867;37222;335;1277;13257;32126;13592;33403
260290;202212;53658;119596;46247;109342;4030;10020;33492;76821;37522;86841
260300;202212;13281;28337;11412;25736;280;806;9842;21584;10122;22390
260310;202212;8176;16222;7356;15234;399;667;6202;12866;6601;13533
260320;202212;8949;23487;7454;21068;153;560;6162;17159;6315;17719
260330;202212;2920;8066;2451;7141;65;226;1951;5515;2016;5741
260340;202212;2775;6103;2421;5598;33;122;2151;4780;2184;4902
260345;202212;36972;80643;31437;73031;2963;7466;21383;46897;24346;54363
260350;202212;7855;14196;6845;13084;27;93;6379;11921;6406;12014
260360;202212;2939;6832;2551;6135;101;284;1816;4196;1917;4480
260370;202212;6889;16541;5839;14822;163;578;4722;11394;4885;11972
260380;202212;6119;15656;5186;14156;242;573;3942;10721;4184;11294
260390;202212;5614;15058;4450;12806;214;600;2980;8351;3194;8951
260392;202212;4938;11980;4461;11376;55;317;3953;9879;4008;10196
260400;202212;27967;51900;24464;47432;337;998;21128;38594;21465;39592
260410;202212;102496;217507;82243;189801;14497;35856;41849;95139;56346;130995
260415;202212;5822;12488;5012;11320;34;134;4421;9680;4455;9814
260420;202212;17215;28666;14821;26074;78;240;14171;24525;14249;24765
260430;202212;3223;9180;2687;8147;188;596;1789;5331;1977;5927
260440;202212;5336;10687;4732;9912;32;118;4372;8973;4404;9091
260450;202212;6915;15407;6139;14393;377;681;5089;12104;5466;12785
260460;202212;6951;17022;5925;15329;439;1338;4161;10190;4600;11528
260470;202212;6295;13152;5287;12010;137;288;4645;10820;4782;11108
260480;202212;4668;10686;3909;9648;324;850;2798;6828;3122;7678
260490;202212;7058;13187;6207;12062;32;115;5773;10953;5805;11068
260500;202212;7550;16506;6440;14977;495;1110;4569;10562;5064;11672
260510;202212;14336;27627;12271;24847;139;440;11110;21824;11249;22264
260515;202212;5720;12915;4472;10716;103;296;3384;7528;3487;7824
260520;202212;20411;41477;17814;38219;1038;2242;14607;30616;15645;32858
260530;202212;12784;29624;10953;26992;103;468;9843;23620;9946;24088
260540;202212;9869;17386;8824;16134;122;255;8216;14767;8338;15022
260545;202212;155;408;101;297;18;63;36;83;54;146
260550;202212;3807;9242;3035;7983;194;650;2042;4965;2236;5615
260560;202212;6974;15763;5762;13984;144;459;4884;11494;5028;11953
260570;202212;11757;23474;10284;21612;213;582;9193;18774;9406;19356
260580;202212;6433;11912;5839;11155;26;64;5461;10271;5487;10335
260590;202212;10122;17327;8732;15813;100;235;8021;14214;8121;14449
260600;202212;43786;94355;36599;83965;1202;3406;29728;64897;30930;68303
260610;202212;9625;21878;8383;20231;392;1040;6486;15276;6878;16316
260620;202212;27487;54629;24515;50744;1161;3179;20273;39579;21434;42758
260630;202212;2873;6828;2345;6013;57;151;1937;4850;1994;5001
260640;202212;32684;59692;28087;54491;967;1909;24207;46064;25174;47973
260650;202212;7830;17299;6301;15415;497;902;5186;12787;5683;13689
260660;202212;9608;19885;8435;18443;278;749;7597;16285;7875;17034
260670;202212;2808;6384;2285;5547;77;210;1775;4100;1852;4310
260680;202212;39418;80349;33373;72204;2109;4869;25429;52531;27538;57400
260690;202212;4151;9564;3403;8441;90;311;2692;6477;2782;6788
260700;202212;9212;18766;8607;18112;54;193;8370;17533;8424;17726
260710;202212;1637;3808;1355;3384;56;184;1088;2644;1144;2828
260720;202212;38656;75350;33653;69354;1804;4132;27758;55557;29562;59689
260730;202212;10309;25001;8895;23046;202;723;7778;19634;7980;20357
260740;202212;1646;3973;1326;3454;25;101;1089;2792;1114;2893
260750;202212;9765;21136;7679;18622;218;387;6740;16747;6958;17134
260760;202212;8611;16408;7550;15186;124;340;6826;13416;6950;13756
260765;202212;10706;25879;9381;24097;644;1891;6851;17032;7495;18923
260770;202212;4736;10523;3847;9112;92;282;3132;7170;3224;7452
260775;202212;7514;16546;6581;15158;155;525;5434;11760;5589;12285
260780;202212;4668;11833;4103;10919;363;1171;2692;6594;3055;7765
260790;202212;187753;353109;159360;317303;19301;39490;112506;215791;131807;255281
260795;202212;4681;8790;4032;7990;147;317;3477;6752;3624;7069
260800;202212;8013;14300;7206;13238;258;431;6407;11522;6665;11953
260805;202212;4732;10879;4060;9806;140;446;3315;7636;3455;8082
260810;202212;8356;19169;7286;17272;299;798;5856;13243;6155;14041
260820;202212;6111;11421;5444;10681;75;216;4822;9335;4897;9551
260825;202212;3578;9389;3108;8608;120;378;2422;6585;2542;6963
260830;202212;5360;13464;4466;11965;536;1172;2989;8207;3525;9379
260840;202212;5853;11929;5199;11072;246;468;4538;9552;4784;10020
260845;202212;5710;12861;5030;11787;199;571;4035;8993;4234;9564
260850;202212;6214;14528;5167;12700;382;1012;3563;8207;3945;9219
260860;202212;4120;10488;3494;9394;148;442;2796;7304;2944;7746
260870;202212;5746;11211;4963;10271;132;256;4397;9018;4529;9274
260875;202212;10671;20747;8788;18170;702;1405;6411;13138;7113;14543
260880;202212;14306;31555;12534;28805;279;786;10869;24201;11148;24987
260890;202212;16891;36641;14510;33195;1143;2704;9978;22313;11121;25017
260900;202212;6950;17161;5730;15448;547;1474;3652;9767;4199;11241
260910;202212;4312;9582;3759;8791;146;352;3011;6897;3157;7249
260915;202212;7381;15342;6669;14486;28;111;6349;13599;6377;13710
260920;202212;4435;8382;3791;7704;114;193;3355;6756;3469;6949
260930;202212;5005;12769;4246;11519;166;562;3372;8817;3538;9379
260940;202212;19689;39449;17053;35860;1167;2583;13288;26995;14455;29578
260950;202212;9644;21404;7811;18500;365;1051;5565;12154;5930;13205
260960;202212;116665;210466;98758;188577;7496;15140;75429;137022;82925;152162
260970;202212;6966;15834;6018;14609;391;722;4546;11176;4937;11898
260980;202212;5919;14210;5143;13245;75;192;4689;12067;4764;12259
260990;202212;21043;51189;17641;46563;742;2271;14035;36127;14777;38398
261000;202212;21855;42185;18391;37901;554;1366;15483;30732;16037;32098
261010;202212;2763;6098;2360;5559;92;241;2028;4719;2120;4960
261020;202212;8610;18819;7525;17100;341;807;6183;13492;6524;14299
261030;202212;5063;12747;4424;11687;109;405;3605;9103;3714;9508
261040;202212;6711;16439;5472;14305;175;588;4338;10794;4513;11382
261050;202212;9843;21649;8855;20256;205;449;7506;16889;7711;17338
261060;202212;18836;39724;16416;36871;387;998;13993;30630;14380;31628
261070;202212;93600;179141;78650;159873;7397;14977;57576;113517;64973;128494
261080;202212;8738;17644;7855;16585;98;202;7399;15492;7497;15694
261090;202212;26301;50070;23405;46395;750;1401;20439;39836;21189;41237
261100;202212;11125;25556;9664;23506;618;1493;7380;17592;7998;19085
261110;202212;96595;227750;81588;202028;9921;26711;51603;122038;61524;148749
261120;202212;5013;9968;4370;9095;107;253;3845;7752;3952;8005
261130;202212;9768;19587;8559;17986;176;347;7556;15614;7732;15961
261140;202212;5011;9565;4411;8794;311;565;3439;6801;3750;7366
261150;202212;7211;14986;6343;13780;237;451;5400;11586;5637;12037
261153;202212;2310;6190;1881;5398;79;248;1328;3737;1407;3985
261160;202212;314946;629139;261002;558312;63289;137371;116295;251215;179584;388586
261170;202212;9783;18556;8526;16921;255;499;7513;14462;7768;14961
261180;202212;11920;25454;10453;23623;477;1020;8214;18294;8691;19314
261190;202212;6628;14925;5942;13903;136;566;5072;11279;5208;11845
261200;202212;4439;8497;3836;7713;134;281;3247;6360;3381;6641
261210;202212;2263;4904;1932;4452;116;196;1589;3645;1705;3841
261220;202212;18801;43481;15989;38914;1450;3697;11200;25847;12650;29544
261230;202212;4732;11740;3894;10659;44;159;3283;8962;3327;9121
261240;202212;8030;15300;7132;14053;206;424;6313;12114;6519;12538
261245;202212;4749;11163;3851;9686;65;285;3189;7593;3254;7878
261247;202212;3751;9814;3091;8666;346;937;1982;5595;2328;6532
261250;202212;37992;69541;33719;64685;3275;6643;26919;50793;30194;57436
261255;202212;4900;12692;3928;10895;174;573;2972;7986;3146;8559
261260;202212;20387;39488;18069;36606;228;822;16974;33420;17202;34242
261270;202212;6688;12340;5920;11439;213;398;5306;10045;5519;10443
261280;202212;3193;7663;2753;6973;100;333;2210;5339;2310;5672
261290;202212;3702;7960;3106;7303;87;264;2548;5981;2635;6245
261300;202212;17224;38331;14835;34701;378;1259;12166;26922;12544;28181
261310;202212;12600;26316;10856;24003;888;2014;8150;17467;9038;19481
261320;202212;7543;18232;6522;16665;92;300;5590;13956;5682;14256
261330;202212;8164;15765;7390;14787;181;447;6655;12970;6836;13417
261340;202212;7566;14991;6788;14060;94;303;6262;12607;6356;12910
261350;202212;10218;27178;8835;24852;304;821;6896;19233;7200;20054
261360;202212;11176;21864;9480;19533;411;870;7759;15451;8170;16321
261370;202212;30850;66995;26100;60810;2188;5338;18878;42658;21066;47996
261380;202212;5534;13158;4756;11921;479;1187;3348;8329;3827;9516
261390;202212;21248;53140;17665;47610;1215;3668;12311;32018;13526;35686
261400;202212;6324;15308;5489;13786;228;734;4396;10439;4624;11173
261410;202212;12471;26084;10314;22948;304;863;8748;18616;9052;19479
261420;202212;10696;25378;9644;24148;612;1840;7700;18853;8312;20693
261430;202212;5512;11044;4764;9975;38;137;4330;8732;4368;8869
261440;202212;1663;4518;1349;3928;50;217;987;2735;1037;2952
261450;202212;18995;42519;16710;39230;625;1478;13545;31393;14170;32871
261460;202212;9625;22380;8159;20203;268;698;6654;16259;6922;16957
261470;202212;4738;10486;4047;9526;56;216;3450;7902;3506;8118
261480;202212;6861;17486;5816;15788;243;878;4593;11933;4836;12811
261485;202212;7031;16778;6123;15442;428;1248;4648;11282;5076;12530
261500;202212;8585;18390;7460;16905;640;1189;5235;12272;5875;13461
261510;202212;2176;5775;1870;5289;67;246;1449;4047;1516;4293
261520;202212;2930;7549;2591;6911;133;377;1919;4960;2052;5337
261530;202212;15472;38261;12618;33565;716;2588;8083;19611;8799;22199
261540;202212;12199;29587;11158;28183;2781;6372;5518;15528;8299;21900
261550;202212;4680;10683;4051;9722;224;619;3072;7023;3296;7642
261560;202212;11885;26509;10454;24519;348;973;8799;20051;9147;21024
261570;202212;4424;10574;3450;8989;269;758;2378;5955;2647;6713
261580;202212;8999;19301;7879;17835;62;282;7355;16331;7417;16613
261590;202212;3522;7452;2854;6509;70;225;2344;5099;2414;5324
261600;202212;7798;14798;6721;13353;174;358;5742;10933;5916;11291
261610;202212;2728;7005;2166;6007;231;644;1266;3544;1497;4188
261618;202212;3630;6805;3211;6250;69;208;2840;5285;2909;5493
261620;202212;5969;13856;5478;13174;588;1280;4036;10034;4624;11314
261630;202212;7398;18817;6258;16681;490;1436;4077;10270;4567;11706
261640;202212;49856;93936;42580;85325;2255;3613;33890;68329;36145;71942
261650;202212;5535;11009;4698;10011;224;443;3863;8137;4087;8580
270010;202212;5102;15240;4368;14034;156;763;3474;10822;3630;11585
270020;202212;5171;10565;4517;9775;115;440;4006;8199;4121;8639
270030;202212;42502;104117;35834;93862;2454;6868;27369;70036;29823;76904
270040;202212;12547;29375;10581;27014;656;1798;8463;21421;9119;23219
270050;202212;6758;13626;5774;12528;148;358;5325;11446;5473;11804
270060;202212;2720;6250;2306;5754;148;390;1864;4571;2012;4961
270070;202212;6412;14227;5613;13150;85;356;5006;11269;5091;11625
270080;202212;1692;4106;1400;3648;85;213;1057;2694;1142;2907
270090;202212;2205;5735;1995;5375;31;138;1762;4630;1793;4768
270100;202212;8762;16355;7659;14923;161;380;6884;13038;7045;13418
270110;202212;4058;8509;3298;7631;213;346;2621;6339;2834;6685
270120;202212;3042;7554;2655;7032;87;266;2183;5683;2270;5949
270130;202212;6124;13885;5226;12820;146;462;4511;10887;4657;11349
270135;202212;2386;5054;2021;4655;25;115;1865;4240;1890;4355
270140;202212;10544;23417;8368;20466;326;1022;6502;15056;6828;16078
270150;202212;3783;8575;3491;8185;17;72;3349;7790;3366;7862
270160;202212;6309;15933;5406;14818;171;598;4841;13115;5012;13713
270170;202212;3836;10171;3180;9226;206;852;2296;6307;2502;7159
270180;202212;2790;7439;2505;7081;36;190;2230;6160;2266;6350
270190;202212;3020;5970;2763;5677;32;94;2609;5271;2641;5365
270200;202212;3151;8306;2702;7662;348;855;1803;5263;2151;6118
270210;202212;7281;14579;6258;13422;80;245;5840;12306;5920;12551
270220;202212;2080;4532;1691;4003;107;313;1296;2892;1403;3205
270230;202212;12196;29317;10271;26457;933;2611;7660;19201;8593;21812
270235;202212;7238;19906;6294;18422;260;826;5143;14851;5403;15677
270240;202212;14230;33563;11824;30337;966;2632;8925;22545;9891;25177
270250;202212;4150;8216;3745;7680;158;307;3319;6714;3477;7021
270255;202212;5247;13491;4132;11596;140;501;3249;8836;3389;9337
270260;202212;6436;17772;5809;16740;95;443;5045;14242;5140;14685
270270;202212;1206;2857;996;2600;119;289;735;1910;854;2199
270280;202212;4553;9681;3608;8532;266;560;2705;6559;2971;7119
270290;202212;9586;26723;8631;25265;169;738;7708;22266;7877;23004
270300;202212;4898;11490;3810;10296;165;394;3081;8444;3246;8838
270310;202212;8150;20464;6939;18688;165;575;5832;15479;5997;16054
270320;202212;6465;17343;5490;15563;236;815;4155;11197;4391;12012
270330;202212;5217;14256;4565;13319;185;801;3835;10941;4020;11742
270340;202212;1961;4601;1663;4198;76;151;1402;3532;1478;3683
270350;202212;2309;4652;1866;4133;153;284;1371;3103;1524;3387
270360;202212;4205;7914;3814;7480;46;120;3663;7116;3709;7236
270370;202212;1585;4430;1426;4149;34;159;1213;3468;1247;3627
270375;202212;4790;8571;4167;7892;17;50;4033;7580;4050;7630
270380;202212;6786;15852;5736;14596;626;1429;4246;11071;4872;12500
270390;202212;1487;3236;1177;2874;10;59;1007;2428;1017;2487
270400;202212;7845;18241;6507;16283;257;691;5083;12365;5340;13056
270410;202212;5880;14724;5112;13613;137;461;4384;11509;4521;11970
270420;202212;8301;19288;7566;18274;168;614;6804;15942;6972;16556
270430;202212;201300;413519;160912;362693;19815;46667;101105;219771;120920;266438
270440;202212;5623;13493;4904;12594;136;426;4298;10980;4434;11406
270450;202212;11130;23181;9887;21717;495;892;8343;18573;8838;19465
270460;202212;4717;9192;4013;8334;230;364;3569;7469;3799;7833
270470;202212;14446;34879;12533;32244;665;1985;10107;25426;10772;27411
270480;202212;3716;8490;3104;7655;174;508;2564;6121;2738;6629
270490;202212;1075;2682;932;2508;35;117;777;2037;812;2154
270500;202212;5955;15679;5275;14579;264;820;4274;11651;4538;12471
270510;202212;7853;16972;6606;15422;323;930;5348;11955;5671;12885
270520;202212;4926;12195;3892;10610;741;2122;1908;5163;2649;7285
270530;202212;1588;4155;1346;3776;93;233;933;2652;1026;2885
270540;202212;2730;6523;2292;5961;66;214;1994;5098;2060;5312
270550;202212;7872;18221;6191;16353;611;1487;4504;12168;5115;13655
270560;202212;3561;8027;2963;7241;163;495;2372;5595;2535;6090
270570;202212;6899;14204;6041;13041;493;1198;4997;10360;5490;11558
270580;202212;2909;6982;2621;6596;107;297;2289;5679;2396;5976
270590;202212;1733;4767;1592;4573;16;69;1491;4270;1507;4339
270600;202212;3296;8887;2985;8426;58;214;2646;7370;2704;7584
270610;202212;4388;10248;3827;9526;137;265;3384;8401;3521;8666
270620;202212;1437;3911;1302;3679;27;106;1124;3081;1151;3187
270630;202212;23576;48357;20522;44289;712;1954;17858;37270;18570;39224
270640;202212;6612;16485;5431;14603;141;544;4444;11667;4585;12211
270642;202212;3065;8666;2683;8051;205;664;1994;5860;2199;6524
270644;202212;4828;10521;4015;9502;265;624;3218;7518;3483;8142
270650;202212;4538;10502;3985;9802;262;795;3355;8053;3617;8848
270660;202212;2399;5296;2060;4844;89;206;1611;3700;1700;3906
270670;202212;23468;44879;19999;40718;676;1418;17388;34447;18064;35865
270680;202212;8018;14505;7279;13699;312;407;6708;12794;7020;13201
270690;202212;12548;26865;10482;24227;260;771;8831;19816;9091;20587
270700;202212;673;1791;577;1643;62;190;386;1062;448;1252
270710;202212;6883;18153;6010;16842;387;1122;4700;12995;5087;14117
270720;202212;4525;11106;4010;10280;97;315;3562;8929;3659;9244
270730;202212;9657;19156;8327;17758;1034;1322;6216;14573;7250;15895
270740;202212;2768;6691;2421;6288;79;242;2026;5190;2105;5432
270750;202212;6868;15617;6041;14571;100;395;5447;12835;5547;13230
270760;202212;4038;9825;3335;8868;52;234;2837;7382;2889;7616
270770;202212;28752;63248;23479;56625;3355;8178;15084;35959;18439;44137
270780;202212;2486;5343;2287;5087;48;156;2094;4560;2142;4716
270790;202212;2100;4894;1782;4483;138;336;1423;3539;1561;3875
270800;202212;14618;32554;13128;30514;586;1418;11013;25273;11599;26691
270810;202212;4061;9823;3207;8552;184;588;2428;6272;2612;6860
270820;202212;1930;5184;1631;4718;56;228;1327;3760;1383;3988
270830;202212;6297;13591;5113;12152;203;575;4190;9722;4393;10297
270840;202212;9861;26480;8531;24469;352;1488;6890;18998;7242;20486
270850;202212;10974;22184;9637;20663;662;1572;8174;17312;8836;18884
270860;202212;17692;35127;14212;31225;576;1406;11867;25431;12443;26837
270870;202212;2729;7004;2185;6110;205;573;1454;4027;1659;4600
270880;202212;9303;25313;8267;23740;204;816;6923;19396;7127;20212
270890;202212;4238;10279;3571;9327;456;1167;2144;5522;2600;6689
270895;202212;4658;10885;4159;10260;142;391;3679;8929;3821;9320
270900;202212;1896;4450;1458;3781;19;71;1211;3051;1230;3122
270910;202212;5182;12966;4490;11975;229;490;3711;9843;3940;10333
270915;202212;11461;28859;9247;25381;839;2746;6335;16522;7174;19268
270920;202212;7308;18214;6370;16894;124;481;5524;14275;5648;14756
270930;202212;22153;44976;17443;39615;2005;4035;12611;29442;14616;33477
270940;202212;7289;17385;6110;16039;180;752;4988;12616;5168;13368
280010;202212;701;1831;537;1499;21;80;379;962;400;1042
280020;202212;6551;13844;5510;12267;400;912;4265;9124;4665;10036
280030;202212;123501;240599;102837;212663;15857;33860;62315;124395;78172;158255
280040;202212;3754;8586;3248;7876;159;482;2541;5875;2700;6357
280050;202212;5112;13065;4247;11655;925;2517;2144;5836;3069;8353
280060;202212;9365;20068;7590;17508;1003;2604;4788;10591;5791;13195
280067;202212;9007;18395;7637;16375;631;1032;5647;12069;6278;13101
280070;202212;2061;5690;1878;5406;119;405;1478;4113;1597;4518
280100;202212;5338;11908;4491;10637;545;1142;2887;7079;3432;8221
280110;202212;1976;4131;1688;3727;25;75;1550;3341;1575;3416
280120;202212;9763;23491;8609;21726;1138;2515;6057;15629;7195;18144
280130;202212;10644;22249;9207;20285;618;1395;7306;15777;7924;17172
280140;202212;7706;14806;6802;13590;689;1128;5130;10462;5819;11590
280150;202212;4851;11025;4168;10069;486;1065;2960;7085;3446;8150
280160;202212;1610;3854;1366;3468;139;390;957;2277;1096;2667
280170;202212;7318;15039;6561;14102;214;491;5659;11871;5873;12362
280190;202212;2100;3409;1911;3171;38;103;1788;2879;1826;2982
280200;202212;1489;3528;1218;3134;75;231;897;2205;972;2436
280210;202212;22121;46474;19190;42461;2115;4661;13052;28054;15167;32715
280220;202212;2120;4785;1803;4378;111;253;1442;3515;1553;3768
280230;202212;5025;11409;4056;9972;273;535;2773;6822;3046;7357
280240;202212;3909;9190;3425;8496;35;176;2996;7193;3031;7369
280250;202212;1210;2355;1021;2097;60;133;799;1562;859;1695
280260;202212;3067;5913;2701;5461;40;94;2506;5002;2546;5096
280270;202212;2991;6967;2610;6424;116;361;2251;5373;2367;5734
280280;202212;4728;12407;4152;11572;583;1366;2841;8169;3424;9535
280290;202212;27454;58329;23550;53070;2197;5138;15204;34535;17401;39673
280300;202212;16683;31563;14509;29234;1200;1622;11413;24099;12613;25721
280310;202212;1657;3804;1362;3339;47;122;1082;2559;1129;2681
280320;202212;11538;26056;9965;23745;984;2429;7350;16700;8334;19129
280330;202212;5574;12319;4613;10973;342;788;3390;7874;3732;8662
280340;202212;6459;12001;5393;10814;197;297;4764;9574;4961;9871
280350;202212;40514;73146;35897;67192;1039;2357;31199;56108;32238;58465
280360;202212;6916;17158;5945;15631;660;1879;3791;9711;4451;11590
280370;202212;2908;5947;2319;5002;142;257;1759;3704;1901;3961
280380;202212;1269;2935;1064;2654;96;213;748;1869;844;2082
280390;202212;5196;10162;4377;8953;282;456;3576;7262;3858;7718
280400;202212;5109;10573;4436;9705;429;863;3347;7271;3776;8134
280410;202212;3415;7947;2849;7083;288;755;1868;4394;2156;5149
280420;202212;5485;12226;4906;11515;118;283;4446;10419;4564;10702
280430;202212;2906;5813;2575;5386;63;174;2270;4576;2333;4750
280440;202212;5526;12192;4871;11242;189;503;4172;9288;4361;9791
280445;202212;2653;6307;2381;5876;51;164;1916;4545;1967;4709
280450;202212;12008;26525;10324;24229;2298;5446;5132;12331;7430;17777
280460;202212;8853;17984;8004;16858;418;980;6822;13975;7240;14955
280470;202212;2001;5008;1652;4370;122;346;1213;3084;1335;3430
280480;202212;63633;128344;55215;117060;5295;12010;39561;80703;44856;92713
280490;202212;4219;11109;3510;9888;140;559;2643;7066;2783;7625
280500;202212;1292;2606;1056;2313;26;75;884;1926;910;2001
280510;202212;4428;7482;3928;6859;56;153;3616;6052;3672;6205
280520;202212;2346;4781;2048;4384;171;298;1558;3331;1729;3629
280530;202212;2825;6417;2446;5907;119;282;1935;4584;2054;4866
280540;202212;10246;24526;9184;23050;407;1016;7817;19496;8224;20512
280550;202212;8340;16735;6941;14813;122;451;5953;12081;6075;12532
280560;202212;9135;21387;8510;20497;124;409;7698;18162;7822;18571
280570;202212;8845;17747;7318;15886;314;735;5871;12337;6185;13072
280580;202212;7758;16232;6831;14958;459;900;5541;11931;6000;12831
280590;202212;3364;7053;2830;6421;163;419;2136;4603;2299;5022
280600;202212;5265;11190;4639;10305;152;364;3697;8012;3849;8376
280610;202212;3487;6875;3102;6394;129;297;2668;5300;2797;5597
280620;202212;7740;15633;6605;14207;570;847;4834;10804;5404;11651
280630;202212;5111;11435;4677;10882;418;842;3613;8549;4031;9391
280640;202212;2970;6577;2575;6134;104;218;2279;5449;2383;5667
280650;202212;1451;3423;1192;3050;109;272;849;2089;958;2361
280660;202212;4884;8989;4273;8282;127;220;3823;7292;3950;7512
280670;202212;25504;52171;21942;47601;3107;6533;14538;31357;17645;37890
280680;202212;3566;7491;3054;6771;293;538;2091;4791;2384;5329
280690;202212;1285;2600;1081;2344;51;133;909;1888;960;2021
280700;202212;1452;3027;1237;2724;32;77;1028;2196;1060;2273
280710;202212;19004;36590;16168;33393;1048;1566;13804;28820;14852;30386
280720;202212;3258;6415;2675;5738;54;124;2230;4765;2284;4889
280730;202212;1221;2847;1029;2555;78;212;738;1737;816;1949
280740;202212;21371;40048;18474;36038;987;2172;15117;28191;16104;30363
280750;202212;4103;10337;3493;9309;229;660;2520;6556;2749;7216
280760;202212;9159;19242;7797;17413;788;1583;5592;12489;6380;14072
290010;202212;3893;7084;2569;5145;21;53;2251;4302;2272;4355
290020;202212;7614;15278;6930;14465;532;823;5798;12326;6330;13149
290030;202212;5740;11254;4685;10058;343;625;3695;8136;4038;8761
290035;202212;6590;12116;5308;10479;262;430;4312;8403;4574;8833
290040;202212;7258;12220;6259;11062;312;423;5455;9633;5767;10056
290050;202212;2493;7203;2096;6401;145;475;1421;4210;1566;4685
290060;202212;1873;3655;1363;2969;165;389;963;2020;1128;2409
290070;202212;53170;99460;45703;90137;2928;5554;35978;69087;38906;74641
290080;202212;8259;19070;7146;17499;751;1827;5116;12515;5867;14342
290090;202212;2808;4490;2054;3688;27;58;1908;3373;1935;3431
290100;202212;12119;27711;9703;24218;1669;3906;5102;13138;6771;17044
290110;202212;6948;15699;5941;14130;810;1792;3621;8602;4431;10394
290115;202212;4876;12859;4115;11555;357;1038;3198;8877;3555;9915
290120;202212;8320;17498;6949;15628;208;549;5971;13064;6179;13613
290130;202212;5602;11716;4338;10060;291;565;3086;7394;3377;7959
290135;202212;5680;11402;4602;9671;166;414;3778;7484;3944;7898
290140;202212;5440;12372;4180;10716;224;521;3399;8763;3623;9284
290150;202212;4192;7671;3670;7080;160;395;3131;5816;3291;6211
290160;202212;4378;8435;3872;7751;200;353;3271;6455;3471;6808
290170;202212;4683;9285;4143;8705;141;282;3692;7759;3833;8041
290180;202212;3688;8663;3078;7716;70;246;2631;6399;2701;6645
290190;202212;6266;13148;5597;12293;118;339;4915;10548;5033;10887
290195;202212;3400;6754;2698;5885;176;317;2201;4810;2377;5127
290200;202212;4952;12321;3867;10505;267;599;2713;7412;2980;8011
290205;202212;4516;9704;3964;8896;176;442;3237;7075;3413;7517
290210;202212;18020;39668;15867;36529;1569;3015;12082;28217;13651;31232
290220;202212;4176;7720;3691;7149;92;223;3277;6151;3369;6374
290225;202212;4020;6932;3109;5998;44;120;2889;5431;2933;5551
290230;202212;3922;7455;3582;7073;175;241;2966;6006;3141;6247
290240;202212;5309;10375;4342;9225;80;249;3862;8000;3942;8249
290250;202212;4958;12078;4022;10751;158;378;3330;9031;3488;9409
290260;202212;6671;14104;5629;12605;259;655;4763;10318;5022;10973
290265;202212;3976;10646;3174;9190;295;897;2071;5845;2366;6742
290270;202212;13084;39360;11867;37291;860;2795;9087;28562;9947;31357
290280;202212;7370;20208;6277;18098;551;1813;4278;11862;4829;13675
290290;202212;11694;31035;9236;26661;986;3054;5801;16348;6787;19402
290300;202212;5091;12260;3687;9712;203;590;2620;6648;2823;7238
290310;202212;2849;4924;2341;4342;23;78;2195;3972;2218;4050
290320;202212;36559;81326;29686;71444;4951;12238;17506;41260;22457;53498
290323;202212;4658;11235;3928;10084;108;295;3101;7883;3209;8178
290327;202212;5109;12841;4243;11227;407;975;2853;7447;3260;8422
290330;202212;3083;5064;2492;4438;23;29;2323;4133;2346;4162
290340;202212;7941;16202;6210;14169;507;1099;4922;11184;5429;12283
290350;202212;5681;14384;4679;12694;250;759;3419;9069;3669;9828
290360;202212;6790;13934;5896;12745;104;269;5265;11177;5369;11446
290370;202212;5771;12642;4167;10517;168;414;2984;7442;3152;7856
290380;202212;7237;15459;6007;13828;192;309;5085;11804;5277;12113
290390;202212;18909;46981;15505;41561;1462;3936;10750;28471;12212;32407
290395;202212;3569;8782;2804;7517;70;261;2206;5744;2276;6005
290400;202212;4574;11102;3622;9578;182;558;2734;6969;2916;7527
290405;202212;5404;13959;4522;12459;472;1255;2973;8353;3445;9608
290410;202212;6669;16067;5057;13607;180;661;3839;9957;4019;10618
290420;202212;3753;9071;3019;7946;105;280;2362;6174;2467;6454
290430;202212;4518;9613;3746;8514;164;484;3027;6509;3191;6993
290440;202212;3452;7659;2487;6174;175;383;1770;4406;1945;4789
290450;202212;5328;9982;4286;8557;89;222;3822;7317;3911;7539
290460;202212;15437;39633;12639;34513;2675;7490;5116;13704;7791;21194
290470;202212;6169;12061;4686;10121;419;940;3206;6649;3625;7589
290475;202212;7988;19991;6592;17690;97;446;5547;14513;5644;14959
290480;202212;2285;4931;1850;4314;70;223;1422;3112;1492;3335
290485;202212;5672;14248;4922;13190;224;663;3961;10578;4185;11241
290490;202212;12076;23487;10922;21981;459;943;9154;18223;9613;19166
290500;202212;5030;13619;3830;11211;696;2171;1552;4313;2248;6484
290510;202212;4518;9245;3774;8306;104;230;3311;7307;3415;7537
290515;202212;4191;10390;3608;9576;27;86;3276;8727;3303;8813
290520;202212;15090;37430;11530;30748;517;1709;7851;19386;8368;21095
290530;202212;5857;15055;4871;13489;96;380;4130;11262;4226;11642
290540;202212;4674;10503;4263;10047;174;464;3774;8859;3948;9323
290550;202212;5196;11512;4515;10715;48;107;4139;9883;4187;9990
290560;202212;7817;17841;5969;15172;559;1595;3858;9245;4417;10840
290570;202212;71174;149407;63721;139972;4296;10157;51457;109975;55753;120132
290580;202212;11356;25948;9852;23902;972;2040;7242;18001;8214;20041
290590;202212;8308;23095;6905;20688;161;555;5695;17060;5856;17615
290600;202212;22874;56894;19656;51801;1072;2947;15575;40381;16647;43328
290610;202212;2930;8310;2264;7010;98;320;1600;4878;1698;5198
290620;202212;7290;18913;6236;17206;441;1134;4981;13756;5422;14890
290630;202212;13077;25043;10783;22190;799;1618;8627;17612;9426;19230
290640;202212;3392;7387;2615;6306;277;514;1788;4553;2065;5067
290650;202212;23048;43448;21097;41303;971;2215;18883;36174;19854;38389
290660;202212;4586;10655;3581;9029;178;500;2557;6402;2735;6902
290670;202212;10702;21120;9343;19235;222;582;8260;16558;8482;17140
290680;202212;13620;32047;11171;28559;233;910;9332;23226;9565;24136
290682;202212;6825;13728;5908;12539;503;686;4382;10079;4885;10765
290685;202212;4337;8745;3122;7028;492;1020;1760;4122;2252;5142
290687;202212;10150;21534;8429;18943;1183;2496;5358;12222;6541;14718
290689;202212;3385;8340;2522;6859;322;891;1615;4365;1937;5256
290690;202212;7107;16096;5800;14271;392;978;4259;10251;4651;11229
290700;202212;3958;7861;3507;7322;66;176;3150;6440;3216;6616
290710;202212;11342;25461;9575;23101;225;737;8438;19952;8663;20689
290720;202212;25907;57768;23070;53573;1665;3389;18097;41362;19762;44751
290730;202212;8652;18236;7260;16604;491;913;5231;12304;5722;13217
290740;202212;1309;2995;990;2503;22;45;869;2170;891;2215
290750;202212;17281;33884;14776;30237;337;903;12431;23893;12768;24796
290755;202212;2385;6187;1902;5342;108;284;1326;3725;1434;4009
290760;202212;4573;11843;3763;10432;227;520;2674;7515;2901;8035
290770;202212;3780;8741;3492;8409;81;201;3114;7463;3195;7664
290780;202212;9466;21360;8023;19439;333;654;6201;15126;6534;15780
290790;202212;6292;14842;5370;13536;281;688;4415;11131;4696;11819
290800;202212;8635;15153;6236;12416;403;646;4629;9359;5032;10005
290810;202212;7093;15034;5715;13092;235;538;4463;10154;4698;10692
290820;202212;6511;14545;5613;13206;324;681;4041;9326;4365;10007
290830;202212;5229;11546;4566;10503;103;325;3685;7932;3788;8257
290840;202212;22409;52066;18810;46575;2088;4349;12318;32020;14406;36369
290850;202212;11416;20455;9871;18782;478;709;8327;15678;8805;16387
290860;202212;7912;18686;6888;17505;385;861;5774;14956;6159;15817
290870;202212;5825;14226;4391;11597;350;844;2949;7679;3299;8523
290880;202212;1699;3698;1336;3243;206;447;757;1990;963;2437
290890;202212;12098;20926;10638;19295;364;607;9567;17272;9931;17879
290900;202212;2756;6692;2086;5539;189;484;1278;3328;1467;3812
290910;202212;6250;12923;4770;10757;48;119;4157;9228;4205;9347
290920;202212;6465;13775;5561;12700;161;230;4734;11385;4895;11615
290930;202212;8743;22279;6890;19084;277;947;5163;13842;5440;14789
290940;202212;4106;10537;3353;9404;161;540;2617;7195;2778;7735
290950;202212;1713;3867;1363;3349;120;283;881;2183;1001;2466
290960;202212;7469;15930;6604;14881;315;582;5519;12395;5834;12977
290970;202212;3680;10213;2965;8882;123;424;2254;6661;2377;7085
290980;202212;17805;36321;15451;32920;833;2006;11207;22499;12040;24505
290990;202212;12088;27711;10690;25598;339;1105;9032;20797;9371;21902
291000;202212;4011;9056;3070;7901;168;431;2447;6359;2615;6790
291005;202212;21641;45708;19055;42480;1003;2268;15757;34455;16760;36723
291010;202212;3524;10007;2732;8305;149;499;1771;5200;1920;5699
291020;202212;1549;3471;1246;2976;33;96;902;1994;935;2090
291030;202212;3083;6522;2252;5212;206;425;1429;3205;1635;3630
291040;202212;6376;15451;5148;13736;264;769;3968;10599;4232;11368
291050;202212;14474;28046;12796;25816;1506;2950;9413;18664;10919;21614
291060;202212;10827;23720;9476;21997;945;2031;7127;16507;8072;18538
291070;202212;22425;48405;18992;43226;350;1141;16550;36396;16900;37537
291072;202212;35824;76330;27264;63137;3973;9321;15740;34964;19713;44285
291075;202212;6432;14277;5739;13218;100;286;4778;10539;4878;10825
291077;202212;2011;4741;1549;3963;91;172;1089;2776;1180;2948
291080;202212;168599;350974;136575;308454;28091;64050;67466;148989;95557;213039
291085;202212;6688;15122;5368;13102;218;593;4386;10431;4604;11024
291090;202212;2629;4325;1950;3586;48;89;1688;3012;1736;3101
291100;202212;4078;7446;2884;6051;125;244;2290;4745;2415;4989
291110;202212;7054;19243;5873;17296;360;1259;4421;12621;4781;13880
291120;202212;10599;21045;9105;19226;575;1170;7184;15027;7759;16197
291125;202212;2897;4399;2209;3637;102;138;1916;3122;2018;3260
291130;202212;3785;9663;2803;7829;85;326;2192;5850;2277;6176
291140;202212;5853;13849;4182;10911;687;1577;2425;6343;3112;7920
291150;202212;3498;5945;2771;5156;47;69;2597;4802;2644;4871
291160;202212;6126;15056;4997;13419;563;1541;3180;8307;3743;9848
291165;202212;2454;6249;1747;4900;26;117;1202;3222;1228;3339
291170;202212;27201;61446;22571;53944;1657;4019;14886;33771;16543;37790
291180;202212;9978;16994;7846;14315;254;504;6942;12303;7196;12807
291185;202212;4346;9163;3851;8443;216;450;3097;6726;3313;7176
291190;202212;9432;20192;7785;18143;310;711;6062;14334;6372;15045
291200;202212;3249;8143;2357;6495;91;328;1590;4079;1681;4407
291210;202212;9487;16938;7042;14186;392;685;5437;10896;5829;11581
291220;202212;6087;14076;5387;13063;521;1200;3682;8812;4203;10012
291230;202212;6173;10493;4916;9129;64;97;4592;8476;4656;8573
291240;202212;5022;11600;4238;10328;83;236;3671;8762;3754;8998
291250;202212;3851;10407;2940;8774;191;547;1790;5417;1981;5964
291260;202212;1775;3620;1442;3194;42;84;1183;2646;1225;2730
291270;202212;6842;15036;5345;13000;524;1162;3801;9430;4325;10592
291280;202212;3470;7468;2561;6154;175;436;1792;4093;1967;4529
291290;202212;6843;16180;5173;13622;508;1404;3443;8806;3951;10210
291300;202212;4776;11239;3774;9607;202;489;2807;7036;3009;7525
291310;202212;6408;14767;5473;13199;128;378;4743;11147;4871;11525
291320;202212;8025;19171;6202;16133;1304;3259;3257;8643;4561;11902
291330;202212;2245;5146;1820;4446;68;185;1385;3269;1453;3454
291340;202212;5097;11724;4023;10006;222;421;2719;6714;2941;7135
291345;202212;3646;9021;3243;8422;205;543;2583;6697;2788;7240
291350;202212;8847;18295;6950;15981;191;472;5859;13248;6050;13720
291360;202212;55193;104519;44344;92012;5331;10797;29522;61734;34853;72531
291370;202212;10074;23988;8838;22122;656;1869;6660;15898;7316;17767
291380;202212;5839;11428;5213;10614;117;313;4671;9263;4788;9576
291390;202212;16870;30814;13055;26619;634;1136;11073;22318;11707;23454
291400;202212;20555;41576;17179;36731;1645;3308;12061;25764;13706;29072
291410;202212;3569;8417;2766;7073;61;199;2064;5081;2125;5280
291420;202212;2275;4914;1764;4276;21;70;1557;3704;1578;3774
291430;202212;3141;7832;2645;7012;96;338;2097;5350;2193;5688
291440;202212;8029;19889;6834;18059;540;1336;4953;13344;5493;14680
291450;202212;13720;25015;11379;22349;316;444;10195;20210;10511;20654
291460;202212;22581;48379;19711;44299;1795;3732;14463;31891;16258;35623
291465;202212;10873;23315;8600;20709;266;902;7355;17201;7621;18103
291470;202212;25895;46608;22104;42323;1171;2082;17714;33573;18885;35655
291480;202212;59914;114337;45862;95983;5164;10822;27701;55755;32865;66577
291490;202212;9209;17553;8211;16453;254;568;7483;14817;7737;15385
291500;202212;6848;12982;5778;11649;188;418;5283;10561;5471;10979
291510;202212;5935;11421;4543;9667;77;215;4000;8332;4077;8547
291520;202212;5592;11289;4269;9627;278;633;3429;7632;3707;8265
291530;202212;2892;5812;2102;4804;232;518;1430;3296;1662;3814
291535;202212;4682;11334;3907;10030;213;474;3095;8001;3308;8475
291540;202212;2717;5153;1917;4203;58;140;1642;3562;1700;3702
291550;202212;8371;15137;6586;12980;538;924;4886;9492;5424;10416
291560;202212;22482;47956;16750;40563;3649;8489;7909;19890;11558;28379
291570;202212;2972;5816;2294;5043;74;170;2022;4434;2096;4604
291580;202212;7829;17415;6143;15245;322;916;4699;11235;5021;12151
291590;202212;3472;6311;3077;5864;77;188;2819;5233;2896;5421
291600;202212;6880;13950;5273;11616;498;1191;3557;7591;4055;8782
291610;202212;8774;16750;7799;15670;728;993;6130;12851;6858;13844
291620;202212;3699;7217;2803;6234;226;400;2073;4742;2299;5142
291630;202212;4353;8004;3331;6763;570;842;2345;5019;2915;5861
291640;202212;22712;45800;17613;38913;1541;3553;11196;23414;12737;26967
291650;202212;12876;25520;11389;23801;929;1307;9295;20108;10224;21415
291660;202212;2432;5296;1779;4326;116;355;1234;2761;1350;3116
291670;202212;2416;5758;1971;5117;203;458;1329;3558;1532;4016
291680;202212;5016;10826;4053;9517;552;1293;2506;5947;3058;7240
291685;202212;5690;12667;4507;11030;189;392;3490;8505;3679;8897
291690;202212;5583;9882;4007;7791;139;295;3514;6630;3653;6925
291700;202212;11848;27551;10410;25289;336;1043;8958;21051;9294;22094
291710;202212;6869;13549;5236;11377;352;786;3967;8288;4319;9074
291720;202212;5273;14374;4312;12557;867;2609;2266;6470;3133;9079
291730;202212;9945;18404;8575;16688;416;816;7304;14059;7720;14875
291733;202212;3573;8018;2929;7152;122;229;2156;5478;2278;5707
291735;202212;3165;8004;2403;6658;87;208;1685;4681;1772;4889
291740;202212;4669;11082;3207;8404;119;255;2258;5850;2377;6105
291750;202212;27575;56010;22846;49168;3046;5834;15137;32770;18183;38604
291760;202212;13864;34497;10783;29859;3288;10588;2856;7329;6144;17917
291770;202212;9296;21791;7677;19050;376;1178;5901;13817;6277;14995
291780;202212;6449;14596;5783;13714;162;447;4984;11573;5146;12020
291790;202212;3792;8199;3451;7791;389;604;2555;6059;2944;6663
291800;202212;44702;92631;35740;80350;4254;10273;22734;48347;26988;58620
291810;202212;13422;27493;11420;25115;468;885;9556;21099;10024;21984
291820;202212;4872;11042;4200;10177;145;367;3429;8208;3574;8575
291830;202212;6030;11472;4923;10057;369;518;3840;7949;4209;8467
291835;202212;7821;21101;6188;18175;683;2040;4018;11842;4701;13882
291840;202212;64656;150691;56150;138044;5942;15489;40078;96481;46020;111970
291845;202212;4255;8126;3531;7261;271;421;2850;6039;3121;6460
291850;202212;5490;12912;4604;11565;138;346;3943;9834;4081;10180
291855;202212;2968;4739;2398;4124;41;74;2259;3855;2300;3929
291860;202212;2519;6222;1705;4668;46;119;1156;3056;1202;3175
291870;202212;1503;3496;995;2615;54;164;664;1685;718;1849
291875;202212;3434;9510;2904;8440;68;275;2147;5988;2215;6263
291880;202212;6699;16364;5592;14601;345;826;4228;11151;4573;11977
291890;202212;2109;3837;1397;3012;199;426;895;1882;1094;2308
291900;202212;1645;3409;1257;2843;40;88;1003;2177;1043;2265
291905;202212;2743;6460;2202;5616;109;330;1668;4058;1777;4388
291910;202212;4500;8399;3865;7656;84;173;3450;6782;3534;6955
291915;202212;8937;22388;7151;19456;277;706;5237;14593;5514;15299
291920;202212;44049;93639;38614;86636;1983;5465;31139;66721;33122;72186
291930;202212;3412;7471;2876;6740;304;662;2083;4953;2387;5615
291940;202212;4511;10355;3012;7945;272;677;1822;4714;2094;5391
291950;202212;10981;30643;9100;27240;517;1583;6063;18017;6580;19600
291955;202212;24949;52848;22284;49480;1462;3494;17875;39039;19337;42533
291960;202212;4717;9386;3955;8425;309;486;3160;6928;3469;7414
291970;202212;6200;12625;5231;11477;201;478;4230;9111;4431;9589
291980;202212;12330;30868;9945;27025;922;2350;6680;18309;7602;20659
291990;202212;2750;6220;2290;5665;32;113;2109;5156;2141;5269
291992;202212;5861;11572;4967;10450;222;480;4154;8459;4376;8939
291995;202212;2840;6261;2339;5518;81;253;1942;4404;2023;4657
292000;202212;3362;6714;2772;6019;90;230;2335;4976;2425;5206
292010;202212;7129;14248;5799;12360;106;367;4989;10243;5095;10610
292020;202212;5842;13998;4926;12514;143;527;4065;9870;4208;10397
292030;202212;2538;6556;2182;5945;146;426;1453;3826;1599;4252
292040;202212;5816;12244;4630;10582;171;416;3851;8660;4022;9076
292045;202212;5761;11083;4588;9435;24;72;4318;8816;4342;8888
292050;202212;7788;19268;6232;16676;277;870;4286;11075;4563;11945
292060;202212;16399;30776;15155;29291;522;894;13529;25662;14051;26556
292070;202212;8660;17154;7616;15935;535;1061;6452;13419;6987;14480
292080;202212;4695;8785;3895;7800;45;146;3623;7125;3668;7271
292090;202212;5283;10185;3754;8326;222;533;2959;6525;3181;7058
292100;202212;16194;34074;13833;31150;2082;4638;8471;19204;10553;23842
292105;202212;4016;9247;3470;8511;48;160;2926;7095;2974;7255
292110;202212;8385;16468;6064;13318;722;1731;4028;8540;4750;10271
292120;202212;8783;19584;7170;16983;743;1534;4991;11762;5734;13296
292130;202212;4141;8736;3345;7742;208;520;2481;5619;2689;6139
292140;202212;7174;13757;6065;12234;186;384;5389;10661;5575;11045
292145;202212;3204;7605;2653;6732;149;279;2010;5207;2159;5486
292150;202212;19655;42799;16909;38529;393;1023;14530;32089;14923;33112
292160;202212;3554;7524;2696;6455;35;105;2114;5327;2149;5432
292170;202212;10764;25428;8869;22425;516;1518;6703;16392;7219;17910
292180;202212;3474;8688;2577;7063;193;547;1619;4268;1812;4815
292190;202212;3731;8412;3130;7561;277;719;2197;5248;2474;5967
292200;202212;11688;25481;8779;21424;1827;4552;4233;10462;6060;15014
292205;202212;4715;11252;4047;10261;114;310;3500;8828;3614;9138
292210;202212;8324;15831;6911;14096;84;285;6442;12873;6526;13158
292220;202212;2762;5579;2336;4951;183;377;1726;3497;1909;3874
292225;202212;3817;9822;3299;9069;68;272;2851;7690;2919;7962
292230;202212;10791;22469;9427;20708;309;826;7928;16966;8237;17792
292240;202212;6130;15450;5207;13784;315;787;3735;9810;4050;10597
292250;202212;7764;16878;6880;15638;314;795;5557;12214;5871;13009
292260;202212;4113;9521;3609;8895;62;186;3208;7846;3270;8032
292265;202212;4516;10342;3721;9132;64;249;3173;7524;3237;7773
292270;202212;6215;11224;5088;9904;196;305;4292;8256;4488;8561
292273;202212;3452;6562;2738;5696;164;267;1972;4323;2136;4590
292275;202212;2374;5119;1935;4554;52;159;1621;3725;1673;3884
292280;202212;3394;6807;2705;6016;121;205;2289;5187;2410;5392
292285;202212;3186;6550;2492;5648;108;195;2028;4656;2136;4851
292290;202212;9259;20588;7379;17982;205;512;6210;14908;6415;15420
292300;202212;13009;28844;10217;25055;1458;3573;6260;15448;7718;19021
292303;202212;4192;9278;3630;8442;59;139;3260;7446;3319;7585
292305;202212;2794;6679;2529;6322;54;174;2267;5582;2321;5756
292310;202212;8632;18237;7435;16773;147;445;6540;14391;6687;14836
292320;202212;7032;16883;5570;14413;175;532;4360;10961;4535;11493
292330;202212;4049;6725;3400;6012;158;231;2878;5123;3036;5354
292335;202212;6194;14122;5421;12986;258;585;4516;10840;4774;11425
292340;202212;6099;15805;4970;13647;371;932;3498;9548;3869;10480
292350;202212;3377;7728;2830;7011;144;393;2344;5731;2488;6124
292360;202212;6069;14251;5016;12568;274;734;3680;9012;3954;9746
292370;202212;13752;27126;11829;24643;88;338;11204;22909;11292;23247
292380;202212;8414;20550;7414;18837;445;1186;5812;14395;6257;15581
292390;202212;6166;9664;4743;8063;112;190;4314;7280;4426;7470
292400;202212;28618;69746;24527;63632;2324;5925;17218;44228;19542;50153
292405;202212;5583;11827;4618;10367;141;328;3632;8261;3773;8589
292410;202212;3075;5682;2647;5169;93;159;2357;4595;2450;4754
292420;202212;6223;11914;5583;11067;123;254;5077;9816;5200;10070
292430;202212;5962;15960;4436;13173;339;1086;2981;8670;3320;9756
292440;202212;11470;29319;10493;27927;126;604;9535;24967;9661;25571
292450;202212;4895;12389;3660;10095;96;301;2858;7732;2954;8033
292460;202212;7921;16079;6712;14316;159;447;5871;12078;6030;12525
292465;202212;3142;7018;2619;6352;131;268;1759;4548;1890;4816
292467;202212;2678;6140;2375;5748;334;675;1644;4208;1978;4883
292470;202212;3409;8025;2552;6704;150;346;1809;4783;1959;5129
292480;202212;8461;15518;6985;13776;167;330;6331;12363;6498;12693
292490;202212;3457;6578;2852;5804;83;167;2305;4688;2388;4855
292500;202212;9022;19939;7180;17116;422;899;5308;12362;5730;13261
292510;202212;17625;39407;13835;33672;1083;2554;9776;23573;10859;26127
292520;202212;9290;20501;8164;18882;416;1129;6597;14815;7013;15944
292525;202212;8244;16138;6810;14509;136;318;6152;13029;6288;13347
292530;202212;44800;100660;35731;86694;6934;17956;18521;43295;25455;61251
292540;202212;5460;8827;4349;7656;137;214;3960;6969;4097;7183
292550;202212;10430;24784;8081;21929;653;1636;5542;15781;6195;17417
292560;202212;5553;12234;4599;10925;173;510;3549;8064;3722;8574
292570;202212;4584;10388;3805;9078;53;189;3262;7478;3315;7667
292575;202212;8210;21221;7435;20156;884;2294;5365;14809;6249;17103
292580;202212;10006;20390;8281;17974;538;759;6822;14918;7360;15677
292590;202212;8834;20966;7384;18442;315;1024;6097;14669;6412;15693
292593;202212;3551;7819;2785;6556;80;194;2320;5347;2400;5541
292595;202212;7054;15835;6096;14664;329;668;4993;12230;5322;12898
292600;202212;13931;32473;11949;29632;662;1493;9437;23403;10099;24896
292610;202212;5630;12133;4722;10697;159;356;3851;8516;4010;8872
292620;202212;8516;18814;7039;17036;121;283;6463;15627;6584;15910
292630;202212;11557;23953;9269;20452;956;2325;6423;13497;7379;15822
292640;202212;9704;24932;8064;22247;487;1337;5526;15246;6013;16583
292650;202212;5122;11460;4511;10660;64;200;4137;9633;4201;9833
292660;202212;13075;32701;11067;29723;644;1578;8334;22598;8978;24176
292665;202212;2446;6449;2040;5901;123;292;1588;4717;1711;5009
292670;202212;4097;10434;3146;8686;255;819;2044;5379;2299;6198
292680;202212;4783;11215;3773;9514;107;276;2937;7146;3044;7422
292690;202212;3000;7180;2041;5648;221;558;1256;3562;1477;4120
292700;202212;12975;29677;11113;26917;667;1445;8357;19980;9024;21425
292710;202212;4173;8856;3903;8532;77;154;3703;8066;3780;8220
292720;202212;10865;22180;9108;20159;487;916;6979;15924;7466;16840
292730;202212;6887;13032;6181;12049;363;586;5219;10105;5582;10691
292740;202212;507552;1011969;451129;935692;47907;102624;325929;652736;373836;755360
292750;202212;8713;18246;7619;16825;310;626;6484;14194;6794;14820
292760;202212;4777;11933;4095;10798;198;577;3118;8030;3316;8607
292770;202212;9675;20698;7969;18409;984;2310;5557;12891;6541;15201
292780;202212;2633;4455;1952;3661;44;107;1682;2972;1726;3079
292790;202212;4699;8694;3571;7482;317;573;2780;5931;3097;6504
292800;202212;14966;31410;12778;28188;935;1828;9951;21996;10886;23824
292805;202212;4690;9332;3738;8158;143;345;3152;6728;3295;7073
292810;202212;16950;32562;13942;28232;479;1260;11830;22631;12309;23891
292820;202212;8237;21083;5961;17261;486;1571;4082;11534;4568;13105
292830;202212;3636;7410;3107;6793;151;307;2537;5642;2688;5949
292840;202212;12634;25474;10846;23146;159;470;9895;20577;10054;21047
292850;202212;3176;7320;2673;6628;240;560;1865;4556;2105;5116
292860;202212;23263;42952;20794;39991;416;1007;18498;34510;18914;35517
292870;202212;28884;59000;24908;53517;1714;3617;17968;37045;19682;40662
292880;202212;13591;33901;11260;30252;437;1529;8183;20839;8620;22368
292890;202212;10819;23224;9576;21517;214;658;8431;18387;8645;19045
292895;202212;4260;7605;3306;6244;248;387;2652;5005;2900;5392
292900;202212;3735;8054;3354;7534;57;201;2848;6134;2905;6335
292905;202212;5477;12232;4332;10546;150;414;3391;7931;3541;8345
292910;202212;6903;15102;6050;13994;181;390;4942;11142;5123;11532
292920;202212;12317;28885;11274;27438;328;1010;9732;23109;10060;24119
292925;202212;6296;16284;5113;14082;453;1030;3465;9573;3918;10603
292930;202212;8542;21769;7320;19600;962;2638;4233;10955;5195;13593
292935;202212;3486;6358;2823;5633;20;58;2603;5153;2623;5211
292937;202212;3386;7735;2773;6892;388;716;1457;4281;1845;4997
292940;202212;3687;8137;2932;7018;494;1043;1775;4395;2269;5438
292950;202212;11186;26134;9681;23981;560;1353;7289;17663;7849;19016
292960;202212;6757;14088;5657;12583;215;386;4574;10050;4789;10436
292970;202212;4881;11893;4280;11058;120;329;3541;9207;3661;9536
292975;202212;5376;10337;4779;9662;102;230;4394;8794;4496;9024
292980;202212;4863;9097;4068;8014;65;190;3658;7002;3723;7192
292990;202212;13954;34328;11527;30255;410;1282;9059;22900;9469;24182
293000;202212;3316;7093;2774;6261;167;317;2090;4746;2257;5063
293010;202212;23465;51538;18947;44942;2394;5917;12192;28412;14586;34329
293015;202212;10467;28175;8146;23871;696;2078;5504;16093;6200;18171
293020;202212;12886;30264;11651;28550;168;595;10623;25743;10791;26338
293030;202212;6224;14688;4805;12537;421;764;3139;8626;3560;9390
293040;202212;5307;11985;4257;10554;132;346;3585;8799;3717;9145
293050;202212;32064;62372;28131;56853;1961;3840;21738;42625;23699;46465
293060;202212;4641;10890;3688;9168;231;590;2705;6455;2936;7045
293070;202212;42088;79831;37543;74212;2288;4771;30420;58114;32708;62885
293075;202212;4383;11761;3771;10796;69;350;3245;9215;3314;9565
293076;202212;4211;8999;3802;8529;114;210;3355;7588;3469;7798
293077;202212;8006;18942;6418;16514;924;2157;3699;10108;4623;12265
293080;202212;5495;14376;4600;12846;90;366;3783;10299;3873;10665
293090;202212;3679;9930;2801;8424;196;611;1946;5762;2142;6373
293100;202212;7110;16746;5684;14333;338;720;4333;10903;4671;11623
293105;202212;4584;13074;3851;11620;244;754;2662;7994;2906;8748
293110;202212;3193;6480;2678;5765;132;282;2139;4523;2271;4805
293120;202212;6610;13518;6012;12691;526;723;4842;10624;5368;11347
293130;202212;4475;10552;3844;9749;128;409;3318;8241;3446;8650
293135;202212;39563;84748;29087;70607;5419;14419;11897;27963;17316;42382
293140;202212;3649;6053;3206;5540;105;143;2862;4874;2967;5017
293150;202212;6220;16474;5072;14394;412;1262;3462;9495;3874;10757
293160;202212;5227;10463;4606;9764;564;755;3550;8172;4114;8927
293170;202212;6851;11102;5841;9946;109;241;5176;8587;5285;8828
293180;202212;5630;13564;4639;11853;102;345;3789;9365;3891;9710
293190;202212;20806;42208;18366;38886;129;515;16900;34849;17029;35364
293200;202212;11835;23086;9731;19985;580;896;7995;16364;8575;17260
293210;202212;6701;14732;5630;13195;568;1176;4077;9699;4645;10875
293220;202212;7583;15185;5728;12321;758;1595;3836;7912;4594;9507
293230;202212;6039;11730;4592;9939;370;699;3466;7555;3836;8254
293240;202212;5556;12472;4442;10778;210;376;3284;8322;3494;8698
293245;202212;4976;11513;4479;10815;280;651;3671;8730;3951;9381
293250;202212;7138;15137;5706;13186;406;977;4321;9809;4727;10786
293260;202212;5973;13281;4826;11584;181;354;3528;8500;3709;8854
293270;202212;9550;17727;7617;15676;633;784;6100;13336;6733;14120
293280;202212;5615;12509;4868;11480;306;652;3883;9102;4189;9754
293290;202212;21166;50680;18560;46691;1718;4440;13442;33156;15160;37596
293300;202212;8477;16771;7250;15011;560;1139;5569;11154;6129;12293
293305;202212;5432;10903;4576;9824;40;109;4200;8944;4240;9053
293310;202212;2707;6016;2271;5350;32;115;1890;4301;1922;4416
293315;202212;5815;11086;4824;9721;472;671;3818;7839;4290;8510
293317;202212;3516;7124;3109;6547;314;472;2267;4872;2581;5344
293320;202212;17629;33837;15713;31725;224;548;14410;28499;14634;29047
293325;202212;2283;4899;1771;4259;199;466;1170;2798;1369;3264
293330;202212;97715;221932;80727;194632;9560;26058;49467;110262;59027;136320
293340;202212;2597;6526;2094;5656;162;448;1426;3785;1588;4233
293345;202212;4746;10788;3789;9386;494;901;2436;6678;2930;7579
293350;202212;7132;17707;6054;16350;156;437;5278;14283;5434;14720
293360;202212;19513;40490;16783;36975;574;1208;14541;32237;15115;33445
310010;202212;1211;2511;833;2023;101;279;363;766;464;1045
310020;202212;3907;9299;2937;7636;512;1431;1228;2895;1740;4326
310030;202212;2433;6141;1896;5217;266;784;1227;3243;1493;4027
310040;202212;1008;2383;778;1995;68;228;450;1000;518;1228
310050;202212;2016;5038;1687;4538;146;481;1148;2954;1294;3435
310060;202212;3883;9417;3244;8568;145;463;2423;6462;2568;6925
310070;202212;434;937;326;787;13;43;248;575;261;618
310080;202212;926;2325;676;1889;95;290;335;885;430;1175
310090;202212;6606;13935;5456;12198;209;598;4434;9480;4643;10078
310100;202212;4608;10375;3832;9220;104;369;3259;7559;3363;7928
310110;202212;5970;14034;4661;11872;612;1792;2819;6703;3431;8495
310120;202212;833;1876;548;1459;92;313;277;616;369;929
310130;202212;539;1201;463;1088;28;93;364;795;392;888
310140;202212;424;1084;321;938;66;214;168;433;234;647
310150;202212;7926;17659;6001;14389;525;1549;3611;7737;4136;9286
310160;202212;12913;28374;9905;23773;1560;4346;4966;10821;6526;15167
310163;202212;1436;3920;1096;3253;243;820;310;770;553;1590
310170;202212;12292;26714;9985;23289;957;2254;7101;16189;8058;18443
310180;202212;2535;5431;1831;4352;196;534;1188;2670;1384;3204
310190;202212;3298;8680;2621;7520;597;1847;544;1417;1141;3264
310200;202212;2468;6349;1854;5286;372;1249;819;2051;1191;3300
310205;202212;1422;3506;1136;3072;153;433;733;1992;886;2425
310210;202212;2943;7203;2375;6201;127;315;1665;4204;1792;4519
310220;202212;1404;3533;1034;2839;87;282;646;1668;733;1950
310230;202212;2918;6842;2381;5909;281;832;1502;3433;1783;4265
310240;202212;1253;3222;1051;2893;59;203;720;1871;779;2074
310250;202212;1520;3219;1262;2840;38;106;1024;2213;1062;2319
310260;202212;4638;11131;3127;8366;755;2343;1093;2334;1848;4677
310270;202212;3660;7020;2963;6117;101;232;2490;5093;2591;5325
310280;202212;3576;6927;2799;5906;137;369;2135;4154;2272;4523
310285;202212;2252;6328;1824;5558;184;618;1121;3370;1305;3988
310290;202212;1988;4696;1673;4129;200;581;1053;2342;1253;2923
310300;202212;2055;5154;1576;4311;166;559;854;2055;1020;2614
310310;202212;411;881;277;667;46;121;146;318;192;439
310320;202212;588;1367;399;1055;24;73;220;548;244;621
310330;202212;602;1343;347;887;56;149;143;327;199;476
310340;202212;10212;23358;7868;19442;939;2347;4201;10065;5140;12412
310350;202212;17105;38146;12213;30363;1794;5035;6542;14926;8336;19961
310360;202212;753;1480;618;1311;28;69;418;844;446;913
310370;202212;1474;4274;1258;3905;243;839;419;1335;662;2174
310375;202212;1087;2459;752;1972;226;581;238;599;464;1180
310380;202212;455;997;259;693;24;67;143;354;167;421
310390;202212;737;2007;592;1730;104;339;255;662;359;1001
310400;202212;15682;34905;11820;29163;876;2610;7965;18395;8841;21005
310410;202212;1304;3469;780;2363;89;304;334;868;423;1172
310420;202212;6272;15021;4655;12188;559;1643;2456;5817;3015;7460
310430;202212;2133;5361;1498;4226;254;748;652;1560;906;2308
310440;202212;798;1877;537;1420;90;229;247;616;337;845
310445;202212;1636;4160;1228;3385;83;217;869;2314;952;2531
310450;202212;5970;12568;4557;10432;271;800;3490;7500;3761;8300
310460;202212;2148;5339;1555;4253;199;594;480;1105;679;1699
310470;202212;4162;8662;3196;7396;451;960;1998;4703;2449;5663
310480;202212;1237;2893;928;2389;108;354;554;1271;662;1625
310490;202212;3754;9028;2940;7714;388;1182;1630;3868;2018;5050
310500;202212;1920;4469;1514;3834;200;536;966;2319;1166;2855
310510;202212;3005;6960;2201;5541;389;1057;989;2334;1378;3391
310520;202212;1367;3250;956;2506;141;404;457;1152;598;1556
310530;202212;1034;2470;761;2021;113;348;309;669;422;1017
310540;202212;3644;9620;2942;8290;527;1627;1324;3387;1851;5014
310550;202212;1572;3458;1126;2726;80;245;733;1582;813;1827
310560;202212;21236;50201;15586;40136;1758;5304;8175;18129;9933;23433
310570;202212;1531;3255;1206;2824;57;177;1006;2263;1063;2440
310590;202212;5331;12449;4229;10464;275;800;2601;5859;2876;6659
310600;202212;1735;4511;1414;3875;172;521;758;1894;930;2415
310610;202212;600;1533;361;1108;92;304;71;196;163;500
310620;202212;290485;651825;221895;531652;22089;63916;133932;284087;156021;348003
310630;202212;5773;14333;4377;11651;547;1498;2563;6475;3110;7973
310640;202212;1917;4381;1553;3789;115;371;1107;2426;1222;2797
310650;202212;2890;7091;2108;5670;140;445;1265;3186;1405;3631
310660;202212;1793;4068;1464;3623;24;63;1284;3126;1308;3189
310665;202212;1737;3765;1446;3386;48;149;1167;2685;1215;2834
310670;202212;84683;189076;70732;166490;6317;17235;49507;108354;55824;125589
310680;202212;977;2037;805;1790;19;71;672;1420;691;1491
310690;202212;3165;6617;2353;5444;233;567;1610;3465;1843;4032
310700;202212;664;1224;518;1045;11;28;436;845;447;873
310710;202212;7750;19851;5618;16601;1265;4258;927;2384;2192;6642
310720;202212;1439;2916;1140;2531;41;123;867;1844;908;1967
310730;202212;12866;29503;10891;26542;510;1562;8155;18755;8665;20317
310740;202212;8650;21127;6576;17268;775;2439;3383;7761;4158;10200
310750;202212;1680;3560;1274;2977;125;332;772;1610;897;1942
310760;202212;889;1992;637;1608;70;137;389;1000;459;1137
310770;202212;1318;3269;915;2631;121;409;444;1099;565;1508
310780;202212;5176;10697;4152;9280;304;729;2965;6491;3269;7220
310790;202212;2292;6590;1950;5889;415;1442;475;1161;890;2603
310800;202212;2822;7890;2036;6309;455;1568;132;337;587;1905
310810;202212;1873;3940;1552;3447;74;209;1193;2473;1267;2682
310820;202212;1462;3390;863;2388;160;439;246;639;406;1078
310825;202212;3287;8117;2610;7082;46;223;2168;5603;2214;5826
310830;202212;2650;6468;2013;5363;369;1090;1007;2396;1376;3486
310840;202212;2787;6937;2106;5796;439;1366;691;1611;1130;2977
310850;202212;1621;4016;1320;3571;55;208;934;2387;989;2595
310855;202212;4070;9454;3204;8139;227;617;2343;5736;2570;6353
310860;202212;8371;21537;6763;18647;823;2056;4026;11220;4849;13276
310870;202212;1117;2487;882;2161;55;141;630;1476;685;1617
310880;202212;1084;2975;812;2403;99;315;456;1296;555;1611
310890;202212;2746;7325;1778;5393;344;1104;279;731;623;1835
310900;202212;5276;13523;3891;10737;726;2268;1690;4084;2416;6352
310910;202212;2687;6066;1847;4741;266;740;511;1153;777;1893
310920;202212;2321;5396;1746;4554;215;636;1106;2732;1321;3368
310925;202212;1343;3005;1052;2569;50;154;792;1813;842;1967
310930;202212;6696;15656;4632;12458;880;2460;2197;6036;3077;8496
310940;202212;8685;17578;7011;15278;267;741;5582;11563;5849;12304
310945;202212;1655;3806;1270;3187;156;436;746;1716;902;2152
310950;202212;2251;6211;1415;4345;239;840;384;910;623;1750
310960;202212;861;2180;498;1443;80;243;135;360;215;603
310970;202212;1414;3973;996;3103;252;812;188;556;440;1368
310980;202212;409;889;229;586;21;61;117;273;138;334
310990;202212;1869;4393;1511;3815;173;508;923;2106;1096;2614
311000;202212;5365;13080;4054;10949;691;2108;2243;5513;2934;7621
311010;202212;1231;2939;1002;2553;221;587;517;1288;738;1875
311020;202212;1433;3333;933;2471;71;223;520;1286;591;1509
311030;202212;2316;5285;1678;4243;406;1173;694;1590;1100;2763
311040;202212;354;1020;270;834;78;268;64;172;142;440
311050;202212;3855;8766;2916;7360;445;1308;1493;3414;1938;4722
311060;202212;4484;10339;3311;8287;414;1199;1554;3410;1968;4609
311070;202212;3115;6849;2232;5526;311;952;1172;2598;1483;3550
311080;202212;1410;2804;1109;2365;38;113;878;1745;916;1858
311090;202212;2835;8004;2308;7067;521;1704;719;2125;1240;3829
311100;202212;3058;7908;1982;5856;379;1267;560;1374;939;2641
311110;202212;4591;9047;2427;5863;553;1323;473;1083;1026;2406
311115;202212;1795;3350;1491;2969;41;92;1294;2496;1335;2588
311120;202212;8953;21395;6808;17637;1037;3022;2931;6411;3968;9433
311130;202212;2319;5609;1782;4864;170;580;1037;2640;1207;3220
311140;202212;1936;4421;1496;3830;161;468;959;2388;1120;2856
311150;202212;1761;5119;1387;4407;191;667;737;2194;928;2861
311160;202212;5116;13172;3753;10764;651;2136;1571;4082;2222;6218
311170;202212;1146;2691;939;2426;56;162;586;1586;642;1748
311180;202212;1893;3875;1270;2985;190;439;698;1553;888;1992
311190;202212;1048;2762;777;2216;115;363;329;791;444;1154
311200;202212;2782;6786;2081;5505;371;1116;910;2002;1281;3118
311205;202212;1125;2938;895;2519;36;120;590;1546;626;1666
311210;202212;1261;3339;1109;3129;140;354;762;2242;902;2596
311220;202212;1095;2438;952;2192;26;84;753;1586;779;1670
311230;202212;9684;26390;7135;21222;1393;4302;2570;7523;3963;11825
311240;202212;1410;3182;1114;2767;164;478;633;1423;797;1901
311250;202212;1654;4145;1268;3481;242;721;508;1233;750;1954
311260;202212;3274;7431;2141;5538;279;827;1051;2334;1330;3161
311265;202212;1693;3633;1209;2890;50;150;925;2088;975;2238
311270;202212;3723;9807;3167;8932;203;766;2176;5797;2379;6563
311280;202212;1491;3681;892;2542;206;638;225;539;431;1177
311290;202212;2155;6028;1921;5575;122;382;1266;3587;1388;3969
311300;202212;5477;13345;4508;11771;188;609;3663;9289;3851;9898
311310;202212;672;1702;560;1510;46;124;351;899;397;1023
311320;202212;3845;10576;3272;9350;305;1029;1747;4392;2052;5421
311330;202212;7762;16770;6043;14202;650;1660;3225;7485;3875;9145
311340;202212;13410;33715;10589;28845;2290;6665;3482;8722;5772;15387
311350;202212;2837;6383;2037;4992;252;687;995;2094;1247;2781
311360;202212;1394;3099;998;2553;267;739;434;1082;701;1821
311370;202212;5740;12719;4174;10280;491;1409;2331;5270;2822;6679
311380;202212;486;1371;363;1126;57;186;182;539;239;725
311390;202212;2124;5913;1692;5317;663;2282;418;1109;1081;3391
311400;202212;2011;4988;1432;3922;240;707;465;1004;705;1711
311410;202212;2325;6261;1850;5460;281;939;909;2479;1190;3418
311420;202212;2016;5325;1500;4393;315;1004;481;1143;796;2147
311430;202212;5639;13560;3765;10008;538;1523;1560;3825;2098;5348
311440;202212;3803;9590;2889;8053;896;2873;581;1310;1477;4183
311450;202212;2965;7982;1854;5636;460;1608;424;972;884;2580
311455;202212;1341;2808;953;2259;100;245;576;1306;676;1551
311460;202212;723;2004;464;1449;92;327;107;261;199;588
311470;202212;591;1686;398;1277;98;368;60;158;158;526
311480;202212;1423;2936;1171;2569;84;200;939;2011;1023;2211
311490;202212;334;913;255;757;42;152;116;292;158;444
311500;202212;621;1409;489;1214;55;162;298;690;353;852
311510;202212;4360;9706;3123;7729;335;975;1716;3725;2051;4700
311520;202212;806;1971;696;1771;54;166;447;1102;501;1268
311530;202212;11587;24537;8102;19256;1735;4784;2927;6169;4662;10953
311535;202212;1094;2684;780;2072;125;374;377;920;502;1294
311540;202212;656;1736;565;1584;80;240;390;1071;470;1311
311545;202212;2371;6124;2043;5624;100;309;1576;4245;1676;4554
311547;202212;2195;4220;1916;3841;36;77;1676;3245;1712;3322
311550;202212;3667;8952;2968;7773;422;1287;1381;3199;1803;4486
311560;202212;370;730;221;496;33;78;86;165;119;243
311570;202212;1744;3783;1215;3057;58;156;879;2256;937;2412
311580;202212;2799;4911;1970;3923;181;342;1375;2643;1556;2985
311590;202212;773;1787;645;1612;63;192;425;1006;488;1198
311600;202212;1841;4100;1482;3619;177;521;1032;2405;1209;2926
311610;202212;2779;7469;2199;6429;160;540;1401;3875;1561;4415
311615;202212;4449;10165;3575;8789;139;430;2897;6844;3036;7274
311620;202212;701;1741;526;1449;69;211;311;808;380;1019
311630;202212;1544;3930;1219;3274;108;320;740;1923;848;2243
311640;202212;960;2316;759;1998;109;317;422;1020;531;1337
311650;202212;2297;5122;1832;4434;223;575;1107;2522;1330;3097
311660;202212;3819;9980;2787;7966;385;1283;816;1755;1201;3038
311670;202212;2000;4521;1476;3638;161;460;775;1792;936;2252
311680;202212;2821;6710;2165;5623;155;388;1522;3952;1677;4340
311690;202212;764;1441;553;1174;41;95;382;812;423;907
311700;202212;2457;5312;1869;4474;25;101;1564;3583;1589;3684
311710;202212;1916;5098;1419;4267;377;1245;444;1238;821;2483
311720;202212;516;1408;418;1228;49;170;235;662;284;832
311730;202212;5674;12789;4025;9824;826;2284;1970;4259;2796;6543
311740;202212;1170;2821;950;2508;71;140;735;1984;806;2124
311750;202212;4891;12944;3911;11204;326;1149;2554;6739;2880;7888
311760;202212;900;2268;695;1885;113;398;287;573;400;971
311770;202212;2706;6950;2108;5920;442;1343;800;2031;1242;3374
311780;202212;1856;4749;1377;3891;272;819;491;1207;763;2026
311783;202212;2857;6513;2332;5692;51;203;1923;4459;1974;4662
311787;202212;967;2570;729;2062;120;379;291;677;411;1056
311790;202212;1877;4827;1266;3688;253;846;323;799;576;1645
311800;202212;6192;16912;4834;14088;1041;3131;870;1982;1911;5113
311810;202212;1251;3058;1024;2680;57;178;781;1918;838;2096
311820;202212;1226;2580;934;2159;73;182;649;1408;722;1590
311830;202212;11137;28780;8044;22489;2205;6469;1583;4116;3788;10585
311840;202212;4861;10750;3869;9369;293;754;2794;6719;3087;7473
311850;202212;425;980;330;821;13;51;233;534;246;585
311860;202212;95444;210258;75424;177202;7864;21401;48667;105041;56531;126442
311870;202212;2253;5508;1583;4389;252;834;694;1675;946;2509
311880;202212;7653;17793;6341;15960;444;1073;4658;11788;5102;12861
311890;202212;2356;4700;1883;4069;48;170;1530;3067;1578;3237
311900;202212;800;1855;599;1590;106;265;315;847;421;1112
311910;202212;5332;12020;4149;10460;698;1885;2277;5446;2975;7331
311920;202212;2735;6065;2203;5310;136;319;1554;3673;1690;3992
311930;202212;6062;12105;4606;10182;749;1971;2682;5228;3431;7199
311940;202212;19365;46206;13856;36161;1942;5526;6215;14706;8157;20232
311950;202212;2896;6750;2147;5478;180;511;1323;3319;1503;3830
311960;202212;588;1371;450;1154;55;166;211;473;266;639
311970;202212;499;1514;371;1205;69;250;92;249;161;499
311980;202212;559;1380;299;881;34;104;119;315;153;419
311990;202212;637;1424;410;1079;63;212;180;389;243;601
311995;202212;1140;3043;585;1790;39;139;94;179;133;318
312000;202212;979;2045;743;1713;32;78;566;1266;598;1344
312010;202212;1385;3119;1104;2713;72;186;765;1807;837;1993
312015;202212;1598;4020;1381;3678;63;251;1109;2834;1172;3085
312020;202212;2206;6117;1498;4518;265;875;358;912;623;1787
312030;202212;2680;5229;2264;4757;78;215;2042;4201;2120;4416
312040;202212;1018;2772;728;2201;116;355;323;897;439;1252
312050;202212;1461;4088;1189;3594;222;832;426;1118;648;1950
312060;202212;1219;2722;771;2108;183;525;299;772;482;1297
312070;202212;1095;2869;745;2115;35;133;470;1222;505;1355
312080;202212;3624;7951;2823;6782;141;404;1976;4321;2117;4725
312083;202212;1364;2822;1070;2394;59;182;862;1818;921;2000
312087;202212;3077;6782;2493;5927;87;230;2015;4707;2102;4937
312090;202212;14543;33643;11479;28859;1174;3553;6940;15925;8114;19478
312100;202212;2017;4975;1561;4214;109;363;964;2354;1073;2717
312110;202212;1211;3450;990;2990;168;623;475;1256;643;1879
312120;202212;1288;3261;881;2549;219;749;283;659;502;1408
312125;202212;2462;5398;2087;4882;95;265;1715;3857;1810;4122
312130;202212;1466;3089;1080;2475;74;225;653;1277;727;1502
312140;202212;905;2418;736;2085;187;561;307;784;494;1345
312150;202212;626;1495;532;1329;34;95;371;853;405;948
312160;202212;11991;28102;9239;23436;975;2980;5050;11415;6025;14395
312170;202212;1079;2490;823;2027;52;149;555;1305;607;1454
312180;202212;1702;4038;1376;3492;146;416;812;1913;958;2329
312190;202212;1013;2392;786;2007;68;225;465;1055;533;1280
312200;202212;5817;14068;4519;12035;538;1477;2746;7023;3284;8500
312210;202212;1795;3351;1373;2785;60;131;1124;2194;1184;2325
312220;202212;2033;5540;1724;4997;188;570;1104;3187;1292;3757
312230;202212;25209;57578;18272;45638;3538;10101;6721;13679;10259;23780
312235;202212;2703;5580;2199;4905;129;334;1723;3637;1852;3971
312240;202212;971;2823;745;2368;156;525;225;673;381;1198
312245;202212;4082;7514;3495;6710;41;101;3238;6073;3279;6174
312247;202212;1274;2650;879;2064;113;283;538;1179;651;1462
312250;202212;1120;2758;704;1973;97;298;258;668;355;966
312260;202212;1258;2897;1017;2527;75;205;785;1856;860;2061
312270;202212;891;2227;675;1797;30;112;412;963;442;1075
312280;202212;529;1458;426;1282;99;331;159;422;258;753
312290;202212;1171;3039;977;2724;161;518;386;958;547;1476
312300;202212;1427;3901;1032;2980;232;729;249;559;481;1288
312310;202212;1247;3350;953;2750;122;426;494;1305;616;1731
312320;202212;2570;5960;1824;4685;351;884;543;1270;894;2154
312330;202212;1125;2899;917;2516;127;406;529;1344;656;1750
312340;202212;297;687;206;546;29;102;115;261;144;363
312350;202212;306;592;224;500;13;37;157;309;170;346
312352;202212;1802;5184;1574;4762;282;914;744;2407;1026;3321
312360;202212;4346;11131;3245;9099;669;2041;1328;3291;1997;5332
312370;202212;2579;5814;2046;5008;244;695;1281;2917;1525;3612
312380;202212;2645;5289;2168;4681;21;52;1868;3890;1889;3942
312385;202212;1529;3731;1183;3141;392;1068;293;813;685;1881
312390;202212;2292;5924;1711;4839;264;825;496;1176;760;2001
312400;202212;3755;9790;3179;8877;1040;3157;713;1949;1753;5106
312410;202212;19041;44041;15624;38675;1836;4904;10189;23850;12025;28754
312420;202212;4942;11963;3974;10410;789;2362;1931;4681;2720;7043
312430;202212;11162;24051;9178;20795;277;832;7217;15391;7494;16223
312440;202212;1271;3646;1061;3236;518;1670;201;572;719;2242
312450;202212;1671;4442;1266;3710;330;1048;490;1413;820;2461
312460;202212;609;1315;444;1086;24;65;303;709;327;774
312470;202212;559;1303;339;918;51;147;101;221;152;368
312480;202212;1313;3002;947;2465;84;260;525;1263;609;1523
312490;202212;3232;6444;2559;5528;203;496;1604;3248;1807;3744
312500;202212;1342;2821;1133;2549;52;156;893;1945;945;2101
312510;202212;6207;15149;4131;11200;808;2192;1184;2897;1992;5089
312520;202212;450;1019;351;869;65;196;215;491;280;687
312530;202212;882;1808;739;1640;42;99;562;1228;604;1327
312540;202212;1882;4636;1266;3484;148;398;696;1810;844;2208
312550;202212;1000;2326;714;1798;31;92;465;1062;496;1154
312560;202212;2170;5171;1647;4358;109;319;1157;2989;1266;3308
312570;202212;3330;7009;2497;5962;412;1004;1294;3035;1706;4039
312580;202212;785;1952;527;1430;50;166;271;647;321;813
312590;202212;1837;4799;1398;3932;164;545;784;1992;948;2537
312595;202212;2608;6640;2133;5920;306;786;1186;3537;1492;4323
312600;202212;1700;3867;1104;2636;164;478;381;862;545;1340
312610;202212;8601;20351;5832;15325;951;2822;2009;4442;2960;7264
312620;202212;3061;6814;2339;5819;62;249;1932;4691;1994;4940
312630;202212;404;1038;292;841;50;175;130;324;180;499
312640;202212;659;1669;490;1400;61;202;245;635;306;837
312650;202212;2526;5596;1742;4210;51;171;1319;2923;1370;3094
312660;202212;1604;3481;1231;2879;87;209;864;1889;951;2098
312670;202212;7525;15626;6294;13763;128;516;5207;10564;5335;11080
312675;202212;1451;3323;1181;2945;60;173;940;2270;1000;2443
312680;202212;1952;4233;1756;3953;40;149;1588;3453;1628;3602
312690;202212;3665;6820;2754;5694;110;227;2227;4501;2337;4728
312695;202212;1255;2884;1054;2570;50;89;878;2113;928;2202
312700;202212;2461;6112;1752;4854;196;636;939;2386;1135;3022
312705;202212;2052;3785;1789;3439;13;45;1699;3224;1712;3269
312707;202212;1635;4197;1147;3347;55;228;753;2006;808;2234
312710;202212;9214;19833;5991;14919;1540;3829;1826;4627;3366;8456
312720;202212;1329;3157;1042;2713;103;304;683;1658;786;1962
312730;202212;1933;4220;1383;3477;122;311;886;2155;1008;2466
312733;202212;1556;3815;1156;3096;47;159;773;1902;820;2061
312735;202212;959;2247;722;1810;51;146;481;1097;532;1243
312737;202212;1013;2029;731;1632;71;174;507;1079;578;1253
312738;202212;993;2238;709;1755;62;187;465;1032;527;1219
312740;202212;526;1280;328;939;69;220;87;180;156;400
312750;202212;1740;4518;1255;3625;149;496;577;1519;726;2015
312760;202212;2231;6008;1596;4751;239;738;623;1729;862;2467
312770;202212;56583;125944;36698;92368;6139;17324;15096;34473;21235;51797
312780;202212;3214;8138;2681;7254;335;903;1632;4322;1967;5225
312790;202212;282;636;137;393;4;14;31;51;35;65
312800;202212;7145;17194;5697;14630;538;1722;3555;8319;4093;10041
312810;202212;1976;4972;1294;3829;367;1188;383;997;750;2185
312820;202212;2133;5071;1704;4357;113;291;1198;3015;1311;3306
312825;202212;1901;3597;1592;3207;38;82;1379;2717;1417;2799
312830;202212;3387;8617;2226;6397;529;1625;709;1768;1238;3393
312840;202212;1806;4221;1400;3566;155;449;739;1721;894;2170
312850;202212;1399;2693;1051;2220;20;74;794;1490;814;1564
312860;202212;1285;3078;879;2434;233;685;269;648;502;1333
312870;202212;7284;18217;4627;13241;807;2470;1370;3457;2177;5927
312880;202212;1846;4089;1430;3433;234;524;714;1717;948;2241
312890;202212;2857;6259;2099;5065;131;312;1268;2878;1399;3190
312900;202212;1571;3647;1274;3251;162;448;758;1934;920;2382
312910;202212;1794;3172;1079;2259;151;305;594;1204;745;1509
312920;202212;1144;2842;806;2301;127;428;292;689;419;1117
312930;202212;2964;6526;2157;5331;363;950;1073;2634;1436;3584
312940;202212;1209;2972;947;2603;93;304;505;1276;598;1580
312950;202212;4195;9110;3026;7345;445;1277;1718;3749;2163;5026
312960;202212;2079;4969;1713;4418;110;261;1228;3265;1338;3526
312965;202212;2000;4841;1604;4215;164;408;1029;2709;1193;3117
312970;202212;1983;4981;1585;4372;157;548;939;2364;1096;2912
312980;202212;32225;80113;25836;68831;4892;13794;11636;28776;16528;42570
312990;202212;631;1448;423;1109;78;233;196;462;274;695
313000;202212;581;1500;439;1254;30;126;274;699;304;825
313005;202212;2935;7653;2418;6815;121;365;1752;4754;1873;5119
313010;202212;7336;17786;5881;15460;923;2761;3494;8653;4417;11414
313020;202212;1219;3432;949;2900;184;609;200;505;384;1114
313030;202212;1484;3054;1048;2452;73;209;763;1674;836;1883
313040;202212;1087;2987;909;2652;38;154;571;1554;609;1708
313050;202212;2222;5627;1547;4596;249;840;422;1074;671;1914
313055;202212;2293;5521;1947;4991;641;1843;961;2287;1602;4130
313060;202212;1309;2947;945;2325;204;598;228;494;432;1092
313065;202212;2071;5068;1820;4660;31;130;1556;3827;1587;3957
313070;202212;1059;2621;824;2235;92;276;420;1065;512;1341
313080;202212;486;1230;356;999;59;204;145;329;204;533
313090;202212;6803;15447;5624;13631;256;720;4067;9531;4323;10251
313100;202212;1625;3809;1288;3330;63;219;931;2277;994;2496
313110;202212;1832;4453;1288;3491;133;406;653;1582;786;1988
313115;202212;3546;8904;2814;7551;270;872;1673;4004;1943;4876
313120;202212;4544;10026;3289;8355;241;604;2193;5578;2434;6182
313130;202212;40487;93900;30607;76642;3097;8886;18170;41589;21267;50475
313140;202212;973;1857;655;1460;43;106;491;1064;534;1170
313150;202212;1709;4488;1220;3596;348;1160;198;464;546;1624
313160;202212;1747;3882;1311;3241;28;86;1009;2364;1037;2450
313170;202212;14389;37062;10608;29885;1725;5295;4223;10418;5948;15713
313180;202212;3143;7330;2369;5794;168;448;1627;3756;1795;4204
313190;202212;5702;14666;4190;11731;722;2233;1745;4301;2467;6534
313200;202212;1393;3231;1175;2858;30;92;965;2255;995;2347
313210;202212;5159;12056;4256;10671;446;1264;2830;6655;3276;7919
313220;202212;2399;5768;1589;4206;208;615;761;1711;969;2326
313230;202212;3427;8357;2759;7507;62;218;2261;6123;2323;6341
313240;202212;14255;31537;10162;25211;1003;3125;5953;13224;6956;16349
313250;202212;7606;20210;5777;16418;1084;3261;2667;7020;3751;10281
313260;202212;978;2214;689;1767;66;238;399;874;465;1112
313270;202212;8749;16713;7381;14959;456;897;6151;12341;6607;13238
313280;202212;557;1381;367;1023;46;149;174;448;220;597
313290;202212;1248;3704;970;3190;248;923;331;1004;579;1927
313300;202212;2282;5673;1732;4724;370;1086;609;1476;979;2562
313310;202212;1825;4929;1459;4169;253;807;488;1097;741;1904
313320;202212;2464;5987;1783;4915;396;1177;625;1711;1021;2888
313330;202212;5147;11816;3842;9899;277;806;2522;6316;2799;7122
313340;202212;2110;4273;1642;3639;108;278;1220;2572;1328;2850
313350;202212;3663;9252;2480;6754;287;924;1145;2602;1432;3526
313360;202212;2092;4662;1436;3614;240;722;760;1669;1000;2391
313370;202212;2047;5049;1556;4124;314;899;612;1404;926;2303
313375;202212;2311;5613;1470;4080;273;873;418;968;691;1841
313380;202212;8687;19908;6327;15678;944;2741;3195;6802;4139;9543
313390;202212;963;2696;820;2441;50;208;563;1580;613;1788
313400;202212;4605;10051;3450;8361;148;421;2605;6078;2753;6499
313410;202212;1742;4028;1298;3297;338;863;682;1651;1020;2514
313420;202212;19326;40569;10963;27085;2565;7122;2874;6175;5439;13297
313430;202212;1552;3477;1299;3032;66;252;1019;2163;1085;2415
313440;202212;9052;16779;6656;13874;193;498;5338;10636;5531;11134
313450;202212;885;2184;618;1693;106;328;218;468;324;796
313460;202212;2937;7498;2337;6527;412;1286;1096;2928;1508;4214
313470;202212;3417;7709;2737;6732;152;427;2113;5071;2265;5498
313480;202212;1409;3708;877;2589;90;305;384;992;474;1297
313490;202212;3843;9167;2095;5961;394;1229;555;1390;949;2619
313500;202212;688;1625;457;1187;69;166;208;496;277;662
313505;202212;13081;29613;11098;26907;494;1254;8919;21230;9413;22484
313507;202212;1672;3821;1317;3280;50;159;1011;2411;1061;2570
313510;202212;19200;45335;15011;37553;1353;3704;8835;20069;10188;23773
313520;202212;19586;45186;15855;39210;709;2147;12389;29215;13098;31362
313530;202212;708;1951;509;1527;73;266;218;555;291;821
313535;202212;2775;7098;2191;5979;248;658;1321;3513;1569;4171
313540;202212;1076;2780;828;2237;111;343;391;906;502;1249
313545;202212;1366;4058;1138;3642;173;572;520;1597;693;2169
313550;202212;2556;6627;2108;5647;243;691;1385;3611;1628;4302
313560;202212;3781;6015;2869;4951;42;68;2573;4362;2615;4430
313570;202212;1224;3170;963;2717;190;571;445;1147;635;1718
313580;202212;7709;16142;6108;13637;343;945;4500;9414;4843;10359
313590;202212;1421;3380;1140;2987;233;642;605;1612;838;2254
313600;202212;5548;11596;4720;10393;90;303;4244;9035;4334;9338
313610;202212;1216;2781;987;2395;80;229;646;1431;726;1660
313620;202212;7104;17128;5769;14807;550;1706;3779;9107;4329;10813
313630;202212;11148;24710;8054;20136;818;2455;4931;11576;5749;14031
313640;202212;1645;3038;1135;2395;91;219;842;1721;933;1940
313650;202212;1995;5498;1545;4731;135;452;928;2847;1063;3299
313652;202212;1097;2753;957;2501;62;202;704;1719;766;1921
313655;202212;1464;3133;1147;2741;79;199;855;1999;934;2198
313657;202212;1352;3208;1041;2711;40;162;747;1772;787;1934
313660;202212;1445;3329;1196;2928;73;261;901;2028;974;2289
313665;202212;7195;16672;5694;14098;479;1458;3809;8628;4288;10086
313670;202212;70751;158433;48895;122500;6326;17538;25140;57762;31466;75300
313680;202212;1307;3008;1049;2607;43;111;706;1647;749;1758
313690;202212;1208;3352;878;2700;163;564;197;527;360;1091
313695;202212;2163;5198;1590;4262;116;293;1051;2854;1167;3147
313700;202212;3464;9612;2973;8985;239;753;2364;7177;2603;7930
313710;202212;1776;3693;1255;3009;112;330;821;1870;933;2200
313720;202212;7997;19912;5843;15627;758;2262;2849;6718;3607;8980
313730;202212;1729;3323;1292;2764;76;145;867;1817;943;1962
313740;202212;2022;6728;1686;5925;371;1466;435;1307;806;2773
313750;202212;2927;6739;2359;5833;337;999;1439;3201;1776;4200
313753;202212;2558;5851;1705;4498;327;946;647;1616;974;2562
313760;202212;7581;19008;6004;16112;905;2776;3005;7216;3910;9992
313770;202212;4945;12761;3916;11169;200;546;2967;8586;3167;9132
313780;202212;4982;11801;3674;9810;584;1536;1257;3266;1841;4802
313790;202212;729;1887;615;1668;72;228;385;973;457;1201
313800;202212;1660;3429;1195;2783;112;310;709;1509;821;1819
313810;202212;2256;4738;1809;4106;72;230;1457;3135;1529;3365
313820;202212;21483;50887;14134;35961;2328;6189;4451;10098;6779;16287
313830;202212;485;1330;358;1070;73;251;133;346;206;597
313835;202212;1157;2886;858;2412;81;276;452;1137;533;1413
313840;202212;10116;23878;7949;20523;1820;4954;2311;5652;4131;10606
313850;202212;1229;2645;976;2294;161;413;530;1115;691;1528
313860;202212;3530;8322;2667;6846;367;1009;1336;3092;1703;4101
313862;202212;1457;3005;760;1980;48;145;385;959;433;1104
313865;202212;3196;7324;2630;6466;73;230;2041;4754;2114;4984
313867;202212;1650;4724;1292;4007;275;875;598;1896;873;2771
313868;202212;2047;5535;1606;4720;62;240;1213;3375;1275;3615
313870;202212;1317;3081;875;2299;120;339;388;897;508;1236
313880;202212;2752;6382;2091;5273;282;858;1135;2455;1417;3313
313890;202212;2992;5278;2205;4286;64;139;1762;3278;1826;3417
313900;202212;6653;16923;4668;13039;1186;3535;1407;3323;2593;6858
313910;202212;942;2538;709;2086;136;413;180;511;316;924
313920;202212;3464;9231;2839;8022;517;1505;1455;4073;1972;5578
313925;202212;2043;4598;1558;3764;200;429;959;2250;1159;2679
313930;202212;6241;15259;4966;13166;421;1078;3288;8637;3709;9715
313940;202212;12505;33210;9581;28399;2039;6574;2286;7184;4325;13758
313950;202212;7018;13459;5435;11507;269;642;4022;8226;4291;8868
313960;202212;7196;15730;4857;11930;716;2062;2154;4571;2870;6633
313970;202212;1986;4597;1659;4071;54;138;1161;2668;1215;2806
313980;202212;1838;4368;1293;3545;229;696;556;1403;785;2099
313990;202212;2702;7109;2101;5936;315;1104;1226;2992;1541;4096
314000;202212;13245;29689;10500;25107;708;2096;6851;15697;7559;17793
314010;202212;1655;3561;1286;3060;71;216;951;2130;1022;2346
314015;202212;3023;7318;2391;6232;263;832;1456;3402;1719;4234
314020;202212;622;1544;409;1188;141;497;35;91;176;588
314030;202212;1004;2584;746;2102;103;292;323;866;426;1158
314040;202212;773;1962;644;1735;86;282;362;915;448;1197
314050;202212;2498;5819;1858;4708;111;348;1202;2745;1313;3093
314053;202212;2559;6548;2029;5565;317;817;1189;3347;1506;4164
314055;202212;2850;6266;2389;5623;75;214;1981;4646;2056;4860
314060;202212;1555;3703;1149;3058;39;116;821;2115;860;2231
314070;202212;6288;14967;5081;12902;725;1953;2865;6803;3590;8756
314080;202212;2350;5742;1761;4725;155;485;893;2116;1048;2601
314085;202212;2896;6908;2286;6027;235;664;1471;3820;1706;4484
314090;202212;6190;14449;5262;13145;493;1279;3400;8602;3893;9881
314100;202212;3644;8056;2779;6867;84;212;2053;5022;2137;5234
314110;202212;6200;15731;5021;13558;635;1892;2681;6521;3316;8413
314120;202212;834;1841;400;1076;74;230;150;355;224;585
314130;202212;862;2035;614;1579;24;88;430;1021;454;1109
314140;202212;5658;13685;4438;11533;469;1329;2525;6193;2994;7522
314150;202212;1733;4010;1231;3157;125;359;754;1854;879;2213
314160;202212;2935;6667;2056;5209;206;526;879;2128;1085;2654
314170;202212;1154;2821;903;2350;48;174;622;1445;670;1619
314180;202212;6761;16513;5225;14067;618;1673;2713;7192;3331;8865
314190;202212;778;1755;583;1472;68;226;348;775;416;1001
314200;202212;3653;9150;2990;8087;291;773;1917;5073;2208;5846
314210;202212;2406;5740;1837;4732;305;825;648;1531;953;2356
314220;202212;2083;5126;1650;4447;257;809;763;1843;1020;2652
314225;202212;1260;3329;977;2794;104;329;608;1645;712;1974
314230;202212;1080;2549;844;2210;107;312;501;1247;608;1559
314240;202212;1318;3308;1030;2883;226;652;423;1177;649;1829
314250;202212;506;1368;318;963;43;144;126;329;169;473
314260;202212;1352;3177;1062;2791;355;959;349;829;704;1788
314270;202212;4047;9923;3313;8765;88;277;2546;6545;2634;6822
314280;202212;4404;9462;3053;7505;318;899;1819;4134;2137;5033
314290;202212;5656;12763;4761;11271;253;668;3560;8028;3813;8696
314300;202212;2419;6319;1539;4459;337;1056;473;1163;810;2219
314310;202212;4723;11627;3261;9182;879;2806;495;1178;1374;3984
314315;202212;1207;3334;950;2809;61;233;649;1801;710;2034
314320;202212;4134;10006;2807;7571;421;1342;1206;2860;1627;4202
314330;202212;69298;178936;52764;149878;12454;36294;14826;40408;27280;76702
314340;202212;3317;7718;2253;5869;428;1361;883;1844;1311;3205
314345;202212;2000;4816;1608;4148;120;311;1162;2867;1282;3178
314350;202212;1148;2955;750;2194;127;389;159;326;286;715
314360;202212;656;1747;430;1277;69;200;126;323;195;523
314370;202212;927;2118;747;1859;74;204;507;1192;581;1396
314380;202212;1523;3808;1070;3028;243;769;344;896;587;1665
314390;202212;19469;43710;13690;34082;1900;5464;6201;13205;8101;18669
314400;202212;4860;13432;3718;11231;1184;3808;1103;3396;2287;7204
314410;202212;3682;9652;2512;7337;546;1817;566;1493;1112;3310
314420;202212;933;2112;672;1707;26;92;445;1061;471;1153
314430;202212;9880;21298;7036;16836;992;2489;3476;7796;4468;10285
314435;202212;2262;5511;1747;4708;299;835;919;2339;1218;3174
314437;202212;1092;2467;803;2017;69;188;517;1233;586;1421
314440;202212;727;1956;520;1553;128;441;145;337;273;778
314450;202212;1822;4314;1471;3732;182;524;830;1889;1012;2413
314460;202212;4298;11631;3265;9570;757;2466;1260;3185;2017;5651
314465;202212;2824;7025;2261;6000;48;179;1757;4406;1805;4585
314467;202212;1197;2775;972;2414;100;293;646;1534;746;1827
314470;202212;2824;7267;2317;6328;415;1234;1108;2756;1523;3990
314480;202212;11047;27421;8317;21951;1199;3545;3918;8998;5117;12543
314490;202212;1284;3007;918;2327;78;226;586;1403;664;1629
314500;202212;2325;5129;1643;4216;457;1162;448;1150;905;2312
314505;202212;2850;5611;2323;4907;150;269;1813;3730;1963;3999
314510;202212;2613;6387;1908;5367;566;1838;635;1629;1201;3467
314520;202212;9437;25643;7455;21835;1583;4946;1808;4733;3391;9679
314530;202212;6785;18147;5965;16697;353;1235;4435;11852;4788;13087
314535;202212;3530;7524;2829;6523;160;407;2266;5136;2426;5543
314537;202212;1478;3695;1116;3112;77;201;741;2000;818;2201
314540;202212;520;1188;372;954;19;56;215;495;234;551
314545;202212;2344;4863;2067;4539;64;173;1667;3653;1731;3826
314550;202212;918;2029;601;1507;49;155;320;693;369;848
314560;202212;6069;15840;4562;12763;602;2005;2153;5124;2755;7129
314570;202212;383;995;276;808;29;94;143;404;172;498
314580;202212;589;1581;462;1332;103;306;159;436;262;742
314585;202212;904;2450;669;1973;57;208;327;877;384;1085
314587;202212;2773;6670;2157;5715;590;1563;1071;2754;1661;4317
314590;202212;5519;13356;4165;10973;492;1475;2111;5041;2603;6516
314600;202212;2221;5702;1426;4225;329;1085;176;454;505;1539
314610;202212;11989;27385;9250;23147;1072;3229;4633;11392;5705;14621
314620;202212;3091;6032;2478;5276;165;275;1951;4227;2116;4502
314625;202212;1969;4385;1668;3974;44;192;1441;3289;1485;3481
314630;202212;6144;13907;4892;12191;198;568;3865;9455;4063;10023
314640;202212;1037;2013;798;1658;33;94;617;1175;650;1269
314650;202212;1040;2276;692;1733;68;204;411;917;479;1121
314655;202212;1790;4487;1250;3570;148;404;681;1922;829;2326
314660;202212;439;841;329;671;10;22;255;484;265;506
314670;202212;1960;3990;1353;3152;30;82;957;2106;987;2188
314675;202212;2066;4721;1736;4198;105;250;1340;3178;1445;3428
314690;202212;2549;6360;1940;5439;509;1479;737;1983;1246;3462
314700;202212;14594;36171;10052;28017;1581;4860;4539;11604;6120;16464
314710;202212;10314;26527;7616;20979;1151;3471;3015;7169;4166;10640
314720;202212;2913;7972;2029;6156;398;1326;418;1032;816;2358
314730;202212;3073;7429;2142;5756;388;1172;745;1691;1133;2863
314740;202212;4013;10131;3131;8596;536;1616;1602;4043;2138;5659
314750;202212;370;884;287;719;28;97;175;371;203;468
314760;202212;2242;6090;1441;4304;218;785;438;960;656;1745
314770;202212;1242;3394;720;2176;127;378;175;481;302;859
314780;202212;442;1022;306;806;33;105;176;426;209;531
314790;202212;14817;36137;10633;28705;1841;5539;4525;11277;6366;16816
314795;202212;1818;4197;1523;3714;66;199;1186;2746;1252;2945
314800;202212;14639;34802;9883;26347;1667;4894;3706;8500;5373;13394
314810;202212;13273;31649;10010;26264;2457;6870;3922;9499;6379;16369
314820;202212;1556;3441;1207;2926;82;250;781;1785;863;2035
314830;202212;2140;5374;1752;4725;164;461;1086;2746;1250;3207
314840;202212;1087;2958;849;2534;86;326;564;1559;650;1885
314850;202212;3350;5688;2776;5002;36;77;2578;4564;2614;4641
314860;202212;4110;10197;3409;9010;144;513;2535;6400;2679;6913
314870;202212;8616;16823;6631;14452;294;627;5075;11159;5369;11786
314875;202212;2208;6003;1920;5582;189;501;1407;4111;1596;4612
314880;202212;945;2144;722;1800;43;128;450;1063;493;1191
314890;202212;632;1754;464;1384;64;221;236;615;300;836
314900;202212;1119;2442;859;2035;100;272;483;1062;583;1334
314910;202212;2034;5351;1512;4502;276;997;678;1809;954;2806
314915;202212;2555;6726;2054;5876;192;547;1274;3612;1466;4159
314920;202212;709;1585;512;1313;22;66;374;943;396;1009
314930;202212;7949;20041;6156;16721;984;3039;2829;6754;3813;9793
314940;202212;517;1097;425;958;43;105;277;586;320;691
314950;202212;816;1864;552;1447;55;197;304;712;359;909
314960;202212;1175;2496;921;2092;73;165;636;1403;709;1568
314970;202212;1377;3773;1061;3155;192;638;451;1184;643;1822
314980;202212;2578;5902;2078;5184;208;566;1428;3459;1636;4025
314990;202212;3353;8973;2395;6875;398;1188;676;1650;1074;2838
314995;202212;2071;5145;1597;4312;62;215;1027;2562;1089;2777
315000;202212;1319;3062;937;2471;85;256;605;1524;690;1780
315010;202212;496;1212;397;1064;38;131;251;620;289;751
315015;202212;3108;7536;2706;6899;255;803;1923;4649;2178;5452
315020;202212;960;2557;679;2010;58;210;333;885;391;1095
315030;202212;829;1966;571;1521;190;470;134;322;324;792
315040;202212;1214;2851;1012;2540;158;450;650;1509;808;1959
315050;202212;1413;3315;1028;2726;86;266;501;1222;587;1488
315053;202212;1512;3430;1108;2755;129;328;639;1497;768;1825
315057;202212;2212;5652;1736;4869;152;365;1112;3305;1264;3670
315060;202212;862;2344;618;1838;115;376;176;480;291;856
315070;202212;1087;2126;837;1774;76;214;612;1155;688;1369
315080;202212;4037;9581;3017;7761;148;447;2174;5266;2322;5713
315090;202212;1001;2684;755;2251;107;355;345;924;452;1279
315100;202212;1766;4750;1177;3484;151;515;493;1258;644;1773
315110;202212;2770;5881;2017;4780;164;377;1172;2696;1336;3073
315120;202212;15866;33286;11583;26966;1173;2759;6951;15752;8124;18511
315130;202212;2202;5404;1877;4861;197;604;1011;2318;1208;2922
315140;202212;4061;10097;3257;8720;583;1715;1763;4377;2346;6092
315150;202212;5564;13106;4011;10569;668;1970;1867;4639;2535;6609
315160;202212;2442;5335;1704;4199;247;651;963;2245;1210;2896
315170;202212;1751;5128;1206;3851;232;784;352;1045;584;1829
315180;202212;22199;50884;13099;34596;1787;5378;4981;11165;6768;16543
315190;202212;2760;5577;2098;4713;202;446;1559;3502;1761;3948
315200;202212;5769;14219;4342;11897;1231;3674;1512;3649;2743;7323
315210;202212;10791;25906;7569;19568;800;2319;3748;8366;4548;10685
315213;202212;1255;3055;1090;2823;22;83;896;2245;918;2328
315217;202212;3268;8386;2410;6956;92;388;1701;4648;1793;5036
315220;202212;10432;25802;8077;21892;631;1515;4524;12328;5155;13843
315230;202212;3699;7281;3036;6423;175;311;2201;4620;2376;4931
315240;202212;3077;7895;2497;6911;613;1804;1122;2987;1735;4791
315250;202212;18878;46154;14098;37428;2154;6400;6567;15549;8721;21949
315260;202212;1184;2952;710;2011;140;402;132;290;272;692
315270;202212;1203;3103;915;2586;120;415;432;1012;552;1427
315280;202212;3985;9280;2658;6957;712;1964;713;1727;1425;3691
315290;202212;1495;3387;948;2540;203;602;383;929;586;1531
315300;202212;825;1833;608;1517;35;101;434;1048;469;1149
315310;202212;1601;3602;1202;2942;79;248;824;1798;903;2046
315320;202212;776;2080;546;1622;77;244;205;560;282;804
315330;202212;894;2633;535;1750;67;248;224;625;291;873
315340;202212;3452;7873;2371;6233;544;1463;919;2303;1463;3766
315350;202212;2364;5275;1986;4720;143;405;1520;3431;1663;3836
315360;202212;2088;5492;1627;4602;217;651;790;2052;1007;2703
315370;202212;692;1740;564;1515;74;208;255;611;329;819
315380;202212;297;773;196;560;38;106;28;54;66;160
315390;202212;1562;3969;1268;3467;123;421;743;1789;866;2210
315400;202212;5150;12311;4079;10504;496;1406;2406;5802;2902;7208
315410;202212;2904;6024;2072;4818;377;1037;606;1259;983;2296
315415;202212;1813;4573;1461;4013;425;1381;297;682;722;2063
315420;202212;1851;4766;1313;3801;311;985;346;828;657;1813
315430;202212;4365;9857;3036;7909;494;1438;1453;3563;1947;5001
315440;202212;1265;2944;980;2509;102;296;610;1433;712;1729
315445;202212;2823;5465;2078;4464;123;256;1624;3436;1747;3692
315450;202212;2678;6577;2152;5724;209;600;1427;3606;1636;4206
315460;202212;58794;139898;49485;124247;4837;14688;32784;75322;37621;90010
315470;202212;812;2094;572;1545;52;157;287;690;339;847
315480;202212;1836;4624;1310;3545;185;543;612;1471;797;2014
315490;202212;3504;8053;2439;6379;369;1063;964;2286;1333;3349
315500;202212;627;1548;385;1060;26;80;223;543;249;623
315510;202212;1698;3682;1390;3253;17;71;1200;2669;1217;2740
315520;202212;1363;3075;1142;2752;41;109;957;2221;998;2330
315530;202212;983;2185;825;1921;60;191;646;1380;706;1571
315540;202212;2068;4950;1359;3661;118;388;614;1477;732;1865
315550;202212;2239;5652;1536;4370;270;902;494;1350;764;2252
315560;202212;8067;21016;6932;19070;434;1132;5052;13718;5486;14850
315570;202212;3061;7066;2169;5496;303;931;1155;2469;1458;3400
315580;202212;4038;8442;3167;7144;419;1066;1458;2975;1877;4041
315590;202212;1584;2993;1316;2610;40;157;1093;1949;1133;2106
315600;202212;2982;8199;2086;6488;495;1491;842;2772;1337;4263
315610;202212;1190;2745;892;2239;117;378;462;962;579;1340
315620;202212;641;1563;476;1310;36;109;250;681;286;790
315630;202212;1474;3597;1116;2925;169;464;542;1271;711;1735
315640;202212;497;1096;388;961;32;84;253;585;285;669
315645;202212;1186;2860;826;2298;131;390;229;583;360;973
315650;202212;2213;4451;1796;3878;57;146;1474;3068;1531;3214
315660;202212;2482;5931;1866;4847;196;505;1090;2740;1286;3245
315670;202212;20587;49078;16017;41013;2709;7458;8197;19343;10906;26801
315680;202212;3852;9688;2870;7954;385;1173;1508;3934;1893;5107
315690;202212;4699;10785;2846;7638;582;1517;809;2255;1391;3772
315700;202212;10729;26002;8151;21080;759;2239;4743;11170;5502;13409
315710;202212;2180;4765;1536;3834;75;224;1033;2406;1108;2630
315720;202212;5493;13399;4490;11685;215;795;3228;7836;3443;8631
315725;202212;2800;6378;2199;5474;209;497;1464;3767;1673;4264
315727;202212;755;1758;551;1423;65;210;289;671;354;881
315730;202212;736;2020;615;1781;127;390;225;577;352;967
315733;202212;1859;4211;1423;3532;221;595;670;1502;891;2097
315737;202212;1418;3491;1038;2776;32;116;733;1839;765;1955
315740;202212;1037;2633;849;2265;73;239;569;1380;642;1619
315750;202212;1606;3669;1212;3095;90;228;789;2031;879;2259
315760;202212;1518;3016;1248;2661;27;94;1064;2158;1091;2252
315765;202212;2540;5365;2088;4802;27;96;1891;4325;1918;4421
315770;202212;1482;3781;1189;3379;416;1267;296;815;712;2082
315780;202212;39066;95709;32495;84143;2096;6626;21854;52539;23950;59165
315790;202212;4260;11972;3575;10718;325;971;2102;6615;2427;7586
315800;202212;1644;4818;1254;3942;161;612;555;1478;716;2090
315810;202212;1700;3643;1409;3191;55;161;1135;2448;1190;2609
315820;202212;3632;7886;2948;6997;271;617;2091;4908;2362;5525
315830;202212;1531;4184;1024;3078;112;371;294;695;406;1066
315840;202212;1050;2332;752;1843;62;165;400;877;462;1042
315850;202212;1444;3777;1124;3243;159;502;612;1654;771;2156
315860;202212;701;1774;524;1472;102;318;184;416;286;734
315870;202212;548;1384;431;1202;21;69;307;812;328;881
315880;202212;1389;3130;1017;2522;116;349;489;1007;605;1356
315890;202212;2206;5599;1799;5048;537;1659;691;1903;1228;3562
315895;202212;7863;19526;5779;15621;660;2028;2785;6728;3445;8756
315900;202212;1043;2505;867;2263;123;367;500;1219;623;1586
315910;202212;776;1744;670;1597;46;137;536;1242;582;1379
315920;202212;1743;4098;1015;2761;160;553;374;840;534;1393
315930;202212;1415;2851;983;2261;82;213;567;1224;649;1437
315935;202212;1370;3621;1092;3121;204;602;496;1371;700;1973
315940;202212;746;1808;584;1569;83;246;312;776;395;1022
315950;202212;1551;3731;1305;3359;126;363;975;2485;1101;2848
315960;202212;6693;17300;4578;13076;1086;3349;1012;2076;2098;5425
315970;202212;690;1715;556;1535;70;221;363;986;433;1207
315980;202212;5362;10792;3161;7281;555;1377;1590;3244;2145;4621
315990;202212;4238;10029;3309;8453;435;1179;1747;4143;2182;5322
316000;202212;963;2026;756;1733;65;189;489;1027;554;1216
316010;202212;872;2285;644;1873;81;253;274;654;355;907
316020;202212;1128;2862;898;2443;91;308;562;1417;653;1725
316030;202212;3344;8163;2526;6762;374;1033;1491;4010;1865;5043
316040;202212;3254;8771;2257;6895;386;1332;589;1488;975;2820
316045;202212;2800;5672;2565;5379;156;224;2236;4781;2392;5005
316050;202212;507;1228;382;1031;27;80;240;568;267;648
316060;202212;894;1885;649;1562;31;92;471;1069;502;1161
316070;202212;7415;18072;6009;15477;944;2442;3030;7321;3974;9763
316080;202212;978;2710;773;2309;168;558;262;659;430;1217
316090;202212;639;1552;530;1354;47;148;343;774;390;922
316095;202212;1521;4317;1133;3389;251;816;413;1121;664;1937
316100;202212;2983;7744;2171;6085;322;1062;955;2351;1277;3413
316105;202212;858;2059;666;1752;50;129;428;1146;478;1275
316110;202212;18320;42617;15168;37627;910;2788;11339;26567;12249;29355
316120;202212;1499;3759;963;2652;154;489;345;753;499;1242
316130;202212;1580;3250;1046;2407;89;243;630;1314;719;1557
316140;202212;1310;3272;791;2290;139;406;280;766;419;1172
316150;202212;2728;5652;2149;4787;152;430;1283;2611;1435;3041
316160;202212;1210;2893;964;2476;40;143;704;1734;744;1877
316165;202212;1082;2340;852;2018;84;215;563;1262;647;1477
316170;202212;1745;3514;1370;2993;71;219;1024;2039;1095;2258
316180;202212;1962;5057;1367;3926;273;833;409;1002;682;1835
316190;202212;3269;8627;1861;5387;227;716;815;1982;1042;2698
316200;202212;4619;11411;3691;9906;597;1843;1830;4440;2427;6283
316210;202212;6875;18473;4856;13949;1511;4726;503;1216;2014;5942
316220;202212;874;2430;600;1904;122;413;132;392;254;805
316225;202212;1985;4019;1498;3291;57;202;1172;2322;1229;2524
316230;202212;613;1460;476;1241;105;305;240;584;345;889
316240;202212;6954;17684;6011;16038;445;1310;4409;11345;4854;12655
316245;202212;3872;10694;3432;9988;194;846;2537;6884;2731;7730
316250;202212;14066;30974;10641;25464;1910;4960;4518;10259;6428;15219
316255;202212;3576;9241;3068;8415;175;487;2230;6110;2405;6597
316257;202212;1908;3916;1428;3177;134;284;1002;2142;1136;2426
316260;202212;3340;6567;2600;5474;269;521;1720;3551;1989;4072
316265;202212;1317;3255;1027;2761;30;87;744;1905;774;1992
316270;202212;4619;12630;3893;11137;489;1516;2174;5746;2663;7262
316280;202212;3708;8979;3062;7866;382;1036;1714;4217;2096;5253
316290;202212;4991;12038;3815;9882;472;1305;1627;3802;2099;5107
316292;202212;7583;18151;6114;15846;675;1979;4049;9859;4724;11838
316294;202212;1140;3136;868;2682;182;644;262;701;444;1345
316295;202212;4481;11219;3669;9883;302;956;2380;5952;2682;6908
316300;202212;1368;3224;1085;2804;55;163;812;1996;867;2159
316310;202212;976;2448;677;1924;142;469;215;551;357;1020
316320;202212;819;2118;609;1784;119;378;130;326;249;704
316330;202212;1258;2928;959;2436;56;160;731;1798;787;1958
316340;202212;1284;3029;998;2551;74;264;669;1553;743;1817
316350;202212;1742;4118;1474;3680;155;412;1064;2544;1219;2956
316360;202212;787;1889;661;1697;62;151;502;1322;564;1473
316370;202212;7412;16967;5672;14082;623;1944;3152;6679;3775;8623
316380;202212;2147;4512;1705;3901;97;197;1255;2816;1352;3013
316390;202212;916;2305;682;1917;250;807;148;347;398;1154
316400;202212;1474;3855;929;2778;104;343;340;865;444;1208
316410;202212;1528;3445;1278;3065;37;120;1076;2475;1113;2595
316420;202212;2337;5658;1950;5101;31;127;1582;3966;1613;4093
316430;202212;1100;2669;761;2091;119;374;307;735;426;1109
316440;202212;1046;2997;835;2629;153;553;237;668;390;1221
316443;202212;691;1755;489;1380;102;343;165;416;267;759
316447;202212;2739;5975;2336;5386;34;99;2077;4661;2111;4760
316450;202212;2576;6789;1923;5517;230;700;1150;3174;1380;3874
316460;202212;1663;3996;1354;3490;125;359;875;2093;1000;2452
316470;202212;9233;23854;6892;19289;941;3017;3171;7743;4112;10760
316480;202212;272;633;228;577;34;97;132;305;166;402
316490;202212;412;1075;289;840;52;184;96;224;148;408
316500;202212;1610;4519;1103;3361;195;616;312;829;507;1445
316510;202212;969;2844;781;2486;134;424;374;1176;508;1600
316520;202212;1693;3783;1260;3031;199;538;534;1099;733;1637
316530;202212;1396;3211;1047;2616;97;349;615;1316;712;1665
316540;202212;1325;2989;1054;2614;179;502;495;1102;674;1604
316550;202212;1808;4401;1520;3914;56;187;1261;3156;1317;3343
316553;202212;6035;15855;4419;12272;570;1797;2088;4932;2658;6729
316555;202212;3333;8603;2877;8017;87;329;2427;6648;2514;6977
316556;202212;679;1457;500;1158;40;106;294;571;334;677
316557;202212;1521;4107;1313;3783;439;1413;531;1399;970;2812
316560;202212;498;1388;357;1108;59;216;124;335;183;551
316570;202212;1749;4468;1451;3952;362;900;469;1386;831;2286
316580;202212;496;983;337;739;34;84;190;381;224;465
316590;202212;1588;3639;1087;2727;146;344;628;1475;774;1819
316600;202212;1209;3121;1039;2806;141;430;653;1633;794;2063
316610;202212;761;2011;607;1759;61;202;370;1009;431;1211
316620;202212;2778;6208;2422;5687;169;368;1924;4460;2093;4828
316630;202212;1885;5143;1576;4574;436;1217;611;2023;1047;3240
316640;202212;207;521;162;445;31;95;66;154;97;249
316650;202212;1381;3484;1121;3097;81;226;758;2010;839;2236
316660;202212;220;506;108;285;11;31;39;84;50;115
316670;202212;1985;4611;1487;3867;391;1054;472;1092;863;2146
316680;202212;2868;6738;2136;5398;174;490;1446;3501;1620;3991
316690;202212;1642;4352;1176;3482;214;682;223;491;437;1173
316695;202212;1144;3077;916;2671;23;88;614;1719;637;1807
316700;202212;620;1058;530;960;15;30;473;824;488;854
316710;202212;4342;11853;3479;10197;404;1425;2020;5342;2424;6767
316720;202212;28382;69488;22003;57875;3238;9406;11459;27372;14697;36778
316730;202212;665;1441;530;1228;55;145;311;638;366;783
316740;202212;1079;2650;946;2459;152;435;640;1629;792;2064
316750;202212;496;1269;367;1052;69;222;158;402;227;624
316760;202212;4917;13653;4175;12309;1370;4568;1599;4523;2969;9091
316770;202212;1910;3866;1416;3218;48;127;1115;2537;1163;2664
316780;202212;747;1991;607;1743;208;680;129;263;337;943
316790;202212;883;2187;654;1759;109;318;179;452;288;770
316800;202212;8225;20596;6529;17725;857;2517;3361;8602;4218;11119
316805;202212;1497;2676;1221;2360;30;81;1057;1977;1087;2058
316810;202212;926;2256;708;1875;78;226;496;1285;574;1511
316820;202212;483;947;294;656;18;62;195;376;213;438
316830;202212;1117;2567;850;2133;96;248;526;1268;622;1516
316840;202212;3721;8234;2999;7123;162;485;2344;5288;2506;5773
316850;202212;2828;6232;2154;5142;174;510;1408;3031;1582;3541
316860;202212;29037;64466;22265;54447;2837;8339;12247;27591;15084;35930
316870;202212;11104;26520;8391;21612;948;2874;4668;10608;5616;13482
316880;202212;1419;3278;1195;2972;144;428;754;1717;898;2145
316890;202212;1407;3005;885;2323;104;346;556;1349;660;1695
316900;202212;3251;7710;2587;6549;419;1148;1226;2735;1645;3883
316905;202212;592;1618;475;1397;217;649;112;345;329;994
316910;202212;1269;3043;870;2379;215;628;228;570;443;1198
316920;202212;2447;5034;1859;4199;186;549;1311;2652;1497;3201
316930;202212;11917;30042;9407;25829;1831;5567;3973;9698;5804;15265
316935;202212;5469;13046;4060;10529;673;1964;1915;4422;2588;6386
316940;202212;7631;20378;6032;17322;993;3118;2720;6931;3713;10049
316950;202212;2501;4976;1934;4231;75;151;1638;3519;1713;3670
316960;202212;6624;13164;4836;10852;384;961;3453;7486;3837;8447
316970;202212;5190;12562;4371;11204;562;1613;2308;5305;2870;6918
316980;202212;1084;2777;833;2383;231;733;325;854;556;1587
316990;202212;16282;39471;12264;31864;2877;7974;2878;6397;5755;14371
317000;202212;3225;7937;2820;7407;187;413;2239;5911;2426;6324
317005;202212;3216;8152;2489;6735;389;1182;1313;3304;1702;4486
317010;202212;36691;80069;25962;63842;3928;10773;14297;33003;18225;43776
317020;202212;93436;207406;59595;149886;11260;30989;22230;49413;33490;80402
317030;202212;815;1980;651;1750;17;64;491;1277;508;1341
317040;202212;14362;33593;9791;25978;2353;6735;2795;7429;5148;14164
317043;202212;1137;2214;841;1827;37;86;681;1442;718;1528
317047;202212;1396;2968;970;2302;48;139;694;1551;742;1690
317050;202212;1485;4322;1052;3327;165;583;380;958;545;1541
317052;202212;3088;7194;2451;6224;215;606;1686;4059;1901;4665
317057;202212;2768;5154;2154;4279;32;98;1780;3295;1812;3393
317060;202212;596;1507;352;1010;54;177;141;350;195;527
317065;202212;1350;3552;1103;3073;78;263;709;1777;787;2040
317070;202212;10109;26172;7995;22241;1201;3903;3848;9526;5049;13429
317075;202212;1382;3110;1075;2627;136;351;662;1487;798;1838
317080;202212;8294;17676;6269;14477;1132;2793;3132;6910;4264;9703
317090;202212;5774;14628;5013;13447;377;917;3669;9797;4046;10714
317100;202212;3212;7124;2180;5471;424;1134;968;2246;1392;3380
317103;202212;3075;6405;2611;5762;142;414;2143;4481;2285;4895
317107;202212;1851;4237;1379;3391;50;160;933;1965;983;2125
317110;202212;830;1813;472;1254;78;235;183;457;261;692
317115;202212;1353;3515;1106;3076;140;410;652;1775;792;2185
317120;202212;24336;56764;19925;49845;1375;4276;13442;30986;14817;35262
317130;202212;14339;30902;9945;23762;1373;3621;4036;9253;5409;12874
317140;202212;1183;2564;895;2123;69;171;625;1445;694;1616
317150;202212;1304;2658;1001;2263;31;106;863;1862;894;1968
317160;202212;4178;9337;2703;6977;283;687;1346;3673;1629;4360
317170;202212;2540;5755;1961;4746;90;277;1345;2884;1435;3161
317180;202212;2273;6499;1621;5014;320;1040;362;1031;682;2071
317190;202212;1326;3331;971;2740;183;560;452;1185;635;1745
317200;202212;7995;19585;5913;15599;1290;3556;1469;3412;2759;6968
317210;202212;1519;3204;1172;2751;44;153;845;1939;889;2092
317220;202212;402;1026;349;937;63;192;206;498;269;690
320010;202212;5927;16106;4474;13140;704;2270;2185;6105;2889;8375
320013;202212;2594;6452;1825;5005;309;908;832;2289;1141;3197
320016;202212;3538;8372;2688;7055;215;595;1805;4614;2020;5209
320020;202212;6137;13938;4699;11519;653;1902;2581;5875;3234;7777
320030;202212;2182;5508;1408;3971;196;624;645;1608;841;2232
320035;202212;2416;5810;1997;5140;337;1010;1176;2869;1513;3879
320040;202212;5665;14359;4662;12593;642;1856;2593;6537;3235;8393
320050;202212;2354;4795;2022;4328;211;600;1371;2649;1582;3249
320060;202212;18363;45766;13589;36529;2338;6751;6172;15059;8510;21810
320070;202212;2456;5806;1853;4703;205;678;1055;2304;1260;2982
320080;202212;7059;16502;4945;12489;850;2314;2150;4872;3000;7186
320090;202212;10430;25920;7001;19183;1473;4438;2524;6084;3997;10522
320100;202212;4268;9938;3478;8617;453;1256;2118;4976;2571;6232
320110;202212;2991;6121;2191;4941;254;681;1384;2796;1638;3477
320115;202212;2718;7779;2310;7109;736;2345;917;2907;1653;5252
320120;202212;33505;76973;24263;61093;3221;8913;12542;28606;15763;37519
320130;202212;74039;175979;60879;153581;7505;20722;37615;89259;45120;109981
320140;202212;5170;12669;3781;10017;540;1688;1904;4537;2444;6225
320150;202212;18478;43950;13226;34601;3106;9167;2350;4782;5456;13949
320160;202212;8148;20257;6043;16514;779;2365;3087;7945;3866;10310
320170;202212;2284;5886;1611;4613;420;1227;534;1580;954;2807
320180;202212;920;2683;709;2251;215;764;161;442;376;1206
320190;202212;3914;11258;2862;9014;604;2148;597;1613;1201;3761
320200;202212;1640;4172;1101;3184;222;699;299;842;521;1541
320210;202212;5846;13449;4512;11232;703;1905;2491;5715;3194;7620
320220;202212;4563;10498;3428;8657;709;1870;1506;3541;2215;5411
320225;202212;1905;5362;1288;3997;362;1253;285;849;647;2102
320230;202212;7063;17090;5321;14232;1254;3541;1498;4108;2752;7649
320240;202212;22521;52312;16871;43561;4234;11992;5208;12546;9442;24538
320245;202212;4103;11181;2913;8628;801;2543;403;1064;1204;3607
320250;202212;3570;8499;2440;6119;384;1067;1180;2536;1564;3603
320255;202212;2691;7211;2325;6571;375;1151;1510;4241;1885;5392
320260;202212;1797;4694;1145;3350;280;849;295;721;575;1570
320265;202212;2861;8185;2126;6683;807;2763;270;757;1077;3520
320270;202212;2821;7208;2107;5869;531;1685;658;1722;1189;3407
320280;202212;10938;25038;9001;21958;1033;3019;6036;13650;7069;16669
320290;202212;1636;4557;1049;3223;279;948;283;794;562;1742
320300;202212;5605;14878;4468;12752;1183;3756;1508;4083;2691;7839
320305;202212;6763;17110;5078;14009;921;2842;2404;6162;3325;9004
320310;202212;2590;6472;1846;4960;329;981;831;1940;1160;2921
320313;202212;3159;7140;2144;5323;409;1141;813;1675;1222;2816
320316;202212;1915;5023;1455;4250;220;645;797;2329;1017;2974
320320;202212;27697;67721;20176;55120;4853;14032;7010;18522;11863;32554
320330;202212;3700;8968;2879;7606;460;1243;1623;4258;2083;5501
320332;202212;10890;25843;8738;22180;1601;4471;4717;11243;6318;15714
320334;202212;2418;6267;1645;4757;296;1027;411;897;707;1924
320335;202212;2302;6090;1523;4407;307;1031;470;1192;777;2223
320340;202212;7185;15022;6035;13414;439;1116;4257;9153;4696;10269
320350;202212;6701;14740;4676;11296;497;1375;2640;5758;3137;7133
320360;202212;1711;4059;1200;3117;131;368;599;1422;730;1790
320370;202212;3624;9882;2792;8158;773;2555;1016;2695;1789;5250
320380;202212;3885;8547;3250;7514;248;765;2364;4993;2612;5758
320390;202212;10122;24215;7426;19060;1482;4048;3061;7178;4543;11226
320400;202212;4109;10736;3027;8504;814;2535;1121;2877;1935;5412
320405;202212;6741;15651;5064;12874;719;1963;2773;6636;3492;8599
320410;202212;5999;14392;4511;12050;773;2090;2206;5868;2979;7958
320420;202212;5270;11832;4038;9939;870;2309;1651;3800;2521;6109
320425;202212;2733;5812;2081;4786;144;359;1447;3101;1591;3460
320430;202212;3924;9138;3105;7759;428;1143;1912;4544;2340;5687
320435;202212;2996;8521;2375;7262;750;2516;803;2471;1553;4987
320440;202212;1893;4791;1419;3905;235;720;636;1543;871;2263
320450;202212;2737;6614;2195;5670;320;1045;1284;2904;1604;3949
320455;202212;5573;15746;3780;11714;865;3010;901;2321;1766;5331
320460;202212;2652;7323;1927;5861;543;1851;532;1414;1075;3265
320465;202212;1980;5104;1411;4022;339;1075;565;1570;904;2645
320470;202212;5401;13041;3948;10289;735;2173;1450;3271;2185;5444
320480;202212;3074;6644;2487;5697;274;644;1723;3773;1997;4417
320490;202212;33372;76032;24788;61798;4493;11393;11196;27245;15689;38638
320495;202212;1800;4491;1293;3528;300;952;239;476;539;1428
320500;202212;86917;203344;69833;174753;8171;23215;43742;101245;51913;124460
320501;202212;6279;16397;4568;13270;1274;4055;1145;3126;2419;7181
320503;202212;3222;8490;2184;6405;617;1992;579;1526;1196;3518
320506;202212;3450;9401;2567;7547;721;2361;559;1336;1280;3697
320510;202212;15559;37056;12423;31805;1707;4538;6999;17116;8706;21654
320515;202212;2279;5794;1666;4553;476;1397;524;1336;1000;2733
320517;202212;2827;7569;2257;6444;639;1987;869;2367;1508;4354
320520;202212;60942;139511;47599;117615;6944;19119;24161;55180;31105;74299
320530;202212;46692;107015;37333;91499;2729;8325;25268;56399;27997;64724
330010;202212;36767;81052;30784;71719;2344;6325;23040;50955;25384;57280
330015;202212;2269;4720;1761;3935;220;618;1141;2315;1361;2933
330020;202212;30052;64902;25466;58349;2663;6935;18615;40989;21278;47924
330022;202212;2556;6314;1955;5340;377;1089;846;2232;1223;3321
330023;202212;9524;20024;7602;17154;1026;2593;4922;10379;5948;12972
330025;202212;10108;20564;6944;15583;1122;2800;3283;6604;4405;9404
330030;202212;15541;34831;12262;29750;900;2757;8647;19255;9547;22012
330040;202212;24807;55388;20709;48837;905;2793;16091;35381;16996;38174
330045;202212;148097;278585;126741;252219;5391;12164;109032;210700;114423;222864
330050;202212;4660;10375;3752;8965;573;1715;2360;4943;2933;6658
330060;202212;7840;17722;6023;14701;1083;3051;2554;5575;3637;8626
330070;202212;42902;90101;36145;80842;4323;10463;24615;53411;28938;63874
330080;202212;14485;29757;12298;26775;1491;3352;8503;18150;9994;21502
330090;202212;4552;8424;3343;6832;293;512;2292;4741;2585;5253
330093;202212;4043;8343;3096;7075;185;493;2502;5510;2687;6003
330095;202212;1938;4723;1508;3974;152;456;915;2210;1067;2666
330100;202212;105612;230749;92373;212327;4078;11640;75256;166814;79334;178454
330110;202212;3262;7592;2692;6690;270;810;1860;4260;2130;5070
330115;202212;3722;7965;2681;6371;420;1150;1555;3337;1975;4487
330120;202212;4820;9149;3742;7822;173;457;3010;5939;3183;6396
330130;202212;7397;17222;6138;15375;819;2131;3937;9525;4756;11656
330140;202212;6031;11953;5040;10667;192;596;4282;8583;4474;9179
330150;202212;3492;7968;2773;6849;460;1265;1572;3634;2032;4899
330160;202212;2176;5034;1707;4258;293;861;1006;2212;1299;3073
330170;202212;223581;431047;191953;389968;20679;44932;144492;285007;165171;329939
330180;202212;3061;5995;2520;5268;102;298;2051;4039;2153;4337
330185;202212;17130;33512;14708;30403;488;1388;12795;25388;13283;26776
330187;202212;8031;16794;6338;14219;765;2029;4215;8678;4980;10707
330190;202212;66252;128283;57728;116899;2473;6077;48541;94567;51014;100644
330200;202212;27395;57084;22847;51428;2808;6589;16485;36404;19293;42993
330205;202212;2973;6608;2256;5466;147;428;1561;3468;1708;3896
330210;202212;4384;9548;3269;7786;412;1083;1892;4103;2304;5186
330220;202212;20134;43041;15182;35205;2280;6084;7948;16342;10228;22426
330225;202212;6026;13243;4714;11322;345;952;3278;7485;3623;8437
330227;202212;28944;57229;25412;52964;536;1525;23026;46558;23562;48083
330230;202212;2467;5198;1657;4085;148;394;789;1916;937;2310
330240;202212;39430;85674;33595;76939;2814;7490;25015;54478;27829;61968
330245;202212;2189;4983;1360;3551;268;753;595;1371;863;2124
330250;202212;66783;136930;57185;123616;6208;14551;41919;87666;48127;102217
330260;202212;8957;17964;7272;15771;388;1019;5865;12197;6253;13216
330270;202212;46675;99146;30165;72463;3769;10162;16092;35378;19861;45540
330280;202212;3899;8283;3093;7034;184;542;2214;4586;2398;5128
330285;202212;44313;84847;37038;74890;1381;3707;31380;60173;32761;63880
330290;202212;6749;12895;5540;11344;305;884;4570;8733;4875;9617
330300;202212;8265;16498;6153;13588;422;1069;4640;9722;5062;10791
330310;202212;3815;7837;2890;6436;142;367;2193;4625;2335;4992
330320;202212;25981;51979;20835;45597;2291;4659;15610;33653;17901;38312
330330;202212;73758;140107;60862;123320;4246;9591;48155;93654;52401;103245
330340;202212;27532;57500;21080;47946;2715;7444;12579;25645;15294;33089
330350;202212;244534;457216;210243;416430;7950;17693;186009;359615;193959;377308
330360;202212;10957;21868;9568;20197;354;731;8438;17506;8792;18237
330370;202212;7963;18874;6326;16233;1111;3221;3319;7946;4430;11167
330380;202212;10249;22075;8362;18976;596;1750;6240;13115;6836;14865
330385;202212;6078;14319;4968;12702;803;2341;2722;6545;3525;8886
330390;202212;50625;110871;39715;92980;3728;10827;27355;58260;31083;69087
330395;202212;4943;10209;4112;9175;144;443;3324;7028;3468;7471
330400;202212;5036;11364;4217;10080;200;657;3275;7232;3475;7889
330410;202212;4716;10249;3581;8445;428;1287;2452;5212;2880;6499
330411;202212;3899;9409;3133;8096;187;617;2197;5240;2384;5857
330412;202212;2395;5604;1977;4952;150;455;1405;3250;1555;3705
330414;202212;35590;76334;29710;68424;1882;4972;23346;51840;25228;56812
330415;202212;6291;15091;4643;12280;444;1284;2772;6913;3216;8197
330420;202212;17973;39899;13505;32847;1386;3946;8247;18208;9633;22154
330430;202212;16030;30269;13755;27306;470;1177;11690;22220;12160;23397
330440;202212;4037;9110;3134;7636;312;939;2194;4889;2506;5828
330450;202212;2015;4851;1600;4182;128;376;1024;2489;1152;2865
330452;202212;28862;62267;23929;55063;1947;5561;17943;38720;19890;44281
330455;202212;1042508;2010074;876407;1784894;84370;187248;654435;1282665;738805;1469913
330460;202212;1696;3980;1322;3438;213;590;717;1806;930;2396
330470;202212;8105;17279;6007;14224;1316;3487;2512;5533;3828;9020
330475;202212;13396;29191;10937;26030;1407;3877;7392;16833;8799;20710
330480;202212;7921;17873;6722;16133;546;1400;4756;10793;5302;12193
330490;202212;169497;336872;141631;300329;11715;26624;108312;222417;120027;249041
330500;202212;11806;24899;9971;22464;589;1534;7851;17066;8440;18600
330510;202212;70092;146308;56507;127920;5131;13085;42459;91861;47590;104946
330513;202212;1784;3962;1440;3500;201;543;868;2047;1069;2590
330515;202212;4047;9253;3284;8175;427;1232;1919;4376;2346;5608
330520;202212;20777;45089;17631;40513;1507;4142;12780;27722;14287;31864
330530;202212;2263;4903;1617;3934;292;775;786;1846;1078;2621
330540;202212;4295;9867;3317;8241;701;1847;1601;3732;2302;5579
330550;202212;22548;44962;17438;37858;2290;5715;11560;23471;13850;29186
330555;202212;30942;53381;26344;47974;971;2030;22694;40610;23665;42640
330560;202212;5486;12268;4452;10678;629;1561;2905;6645;3534;8206
330570;202212;4388;9766;3846;9018;524;1447;2720;6147;3244;7594
330575;202212;9130;19161;7983;17261;304;857;6803;13862;7107;14719
330580;202212;32868;72230;27523;63349;3806;9396;17304;36795;21110;46191
330590;202212;2236;4887;1871;4434;234;543;1240;2951;1474;3494
330600;202212;18712;41092;15532;36187;835;2487;11528;24997;12363;27484
330610;202212;14165;31062;11689;27287;1035;2847;8251;18067;9286;20914
330615;202212;2986;6843;2465;6162;434;970;1591;4102;2025;5072
330620;202212;6211;14840;5053;12975;760;2238;2935;6948;3695;9186
330630;202212;43710;92206;34326;77673;1414;4351;26593;56099;28007;60450
350010;202212;2992;7222;1850;4951;335;980;494;1012;829;1992
350020;202212;878;2125;530;1465;74;219;188;450;262;669
350030;202212;4790;11912;3746;10162;768;2364;1885;4659;2653;7023
350040;202212;967;2570;584;1775;82;304;187;432;269;736
350050;202212;1932;4389;1327;3402;208;629;484;964;692;1593
350055;202212;1221;2727;963;2329;142;396;563;1201;705;1597
350060;202212;407;894;218;528;39;103;95;202;134;305
350070;202212;4701;11212;3249;8659;470;1386;1466;3378;1936;4764
350075;202212;863;2261;642;1859;206;599;122;362;328;961
350080;202212;843;2063;563;1532;48;155;298;700;346;855
350090;202212;825;1656;540;1240;71;201;335;683;406;884
350100;202212;3412;7909;2489;6418;153;527;1674;3898;1827;4425
350110;202212;644;1392;483;1126;17;48;353;773;370;821
350115;202212;1475;3985;1206;3460;196;633;586;1495;782;2128
350120;202212;822;1817;486;1255;44;135;266;629;310;764
350130;202212;4415;10491;3498;8860;427;1243;2047;4543;2474;5786
350140;202212;882;2237;625;1770;46;162;364;926;410;1088
350150;202212;582;1647;471;1431;90;304;157;401;247;705
350160;202212;16402;38492;11794;30063;1606;4550;6970;16331;8576;20881
350170;202212;3663;9101;3056;7830;472;1307;1715;3986;2187;5293
350180;202212;1265;2829;775;1979;96;264;427;989;523;1253
350190;202212;4838;12406;3571;9585;452;1506;2037;4585;2489;6091
350200;202212;707;1622;538;1328;39;104;349;778;388;882
350210;202212;8628;17949;6190;14184;451;1308;4413;9297;4864;10605
350220;202212;4038;10158;2882;7969;508;1506;1248;3040;1756;4546
350230;202212;1407;3200;1125;2820;155;462;659;1545;814;2007
350240;202212;750;1978;455;1305;76;218;129;305;205;523
350250;202212;4625;11466;3528;9700;911;2611;1109;2908;2020;5519
350260;202212;1093;2322;691;1664;80;222;414;892;494;1114
350270;202212;5712;13626;4554;11526;582;1658;2693;6204;3275;7862
350275;202212;3830;8952;3185;8009;218;718;2436;5728;2654;6446
350280;202212;24834;52945;16476;39653;2286;6000;8631;18872;10917;24872
350290;202212;4528;11390;3265;8916;545;1692;1493;3556;2038;5248
350300;202212;904;2069;696;1700;81;228;458;1004;539;1232
350310;202212;1238;3147;946;2609;135;429;460;1126;595;1555
350315;202212;771;1727;547;1385;27;100;334;726;361;826
350320;202212;22270;52715;17121;43769;2845;8226;8594;19614;11439;27840
350330;202212;18410;41232;13820;32976;1202;3345;9440;20774;10642;24119
350335;202212;459;1205;331;953;35;107;151;417;186;524
350340;202212;1721;4131;1072;2912;151;475;496;1170;647;1645
350350;202212;924;2107;732;1900;121;307;431;1122;552;1429
350360;202212;1523;3967;1231;3391;220;641;541;1404;761;2045
350370;202212;921;2069;668;1614;188;442;250;553;438;995
350380;202212;6222;15914;4540;12443;1004;2900;1624;4046;2628;6946
350390;202212;14934;35125;11703;29830;1480;4174;7155;16825;8635;20999
350395;202212;530;1250;262;748;27;83;98;238;125;321
350400;202212;11252;25702;8012;20357;2029;5584;2515;5922;4544;11506
350410;202212;14369;36549;10822;29982;2058;6292;4605;11638;6663;17930
350420;202212;1444;3421;1005;2614;181;474;362;787;543;1261
350430;202212;832;1996;648;1713;97;315;355;813;452;1128
350440;202212;2778;6127;2203;5254;120;368;1536;3351;1656;3719
350450;202212;9395;23512;7378;20051;1455;4502;3582;8713;5037;13215
350460;202212;2893;6864;1854;4924;288;841;873;2043;1161;2884
350470;202212;323;729;247;611;8;21;186;438;194;459
350480;202212;1205;2860;782;2114;179;551;182;419;361;970
350490;202212;2566;5868;1879;4820;298;883;926;2030;1224;2913
350500;202212;779;1940;549;1537;73;215;217;563;290;778
350510;202212;1552;3543;1185;2915;112;306;742;1673;854;1979
350520;202212;3078;8285;2415;7069;347;1117;1149;3031;1496;4148
350530;202212;4111;9504;3139;7721;247;722;1986;4396;2233;5118
350535;202212;1915;4617;1594;4155;233;669;1004;2487;1237;3156
350540;202212;2575;5123;1982;4293;193;513;1460;2893;1653;3406
350550;202212;12243;27649;8711;21815;825;2474;5335;11971;6160;14445
350560;202212;6000;13656;5041;12178;240;776;3940;8900;4180;9676
350570;202212;40617;100332;33266;87273;5147;14907;18319;44469;23466;59376
350580;202212;2847;6935;1850;5047;522;1620;547;1118;1069;2738
350590;202212;6717;16488;5073;13024;613;1800;3153;7331;3766;9131
350600;202212;43608;95988;28364;70252;4244;12104;13757;30177;18001;42281
350610;202212;9598;23562;7084;18798;818;2527;4131;9931;4949;12458
350620;202212;508;1240;334;962;38;119;191;509;229;628
350630;202212;2289;4844;1665;3838;105;311;1208;2520;1313;2831
350635;202212;14784;31638;11445;26603;1197;3106;8006;17474;9203;20580
350640;202212;1149;2874;619;1763;101;293;193;459;294;752
350650;202212;11273;27872;8237;22067;1399;4136;3671;8780;5070;12916
350660;202212;6575;14957;5144;12724;596;1466;3297;7879;3893;9345
350670;202212;2343;5806;1744;4773;287;840;887;2326;1174;3166
350680;202212;1459;3588;981;2720;153;444;428;1057;581;1501
350690;202212;1868;4557;1378;3713;238;682;724;1872;962;2554
350700;202212;6680;15230;5184;12942;1002;2939;2857;6415;3859;9354
350710;202212;4033;9537;3368;8455;585;1712;1876;4262;2461;5974
350715;202212;918;2443;766;2177;158;527;368;888;526;1415
350720;202212;207;483;148;396;18;60;48;102;66;162
350730;202212;791;2127;589;1733;54;186;328;840;382;1026
350740;202212;2095;5099;1414;3726;236;681;506;1175;742;1856
350745;202212;783;1897;457;1274;41;141;226;565;267;706
350750;202212;15212;36066;12175;31018;1989;5911;6212;14145;8201;20056
350760;202212;24009;52213;18321;42816;2305;6600;11307;23158;13612;29758
350770;202212;1340;2997;868;2206;86;242;543;1268;629;1510
350775;202212;917;1931;610;1474;85;210;336;754;421;964
350780;202212;3047;6815;2236;5711;574;1360;861;2396;1435;3756
350790;202212;2741;6826;1738;4988;377;1085;458;1075;835;2160
350800;202212;4576;11553;3888;10415;370;1170;2588;6437;2958;7607
350810;202212;3739;8213;2779;6800;631;1605;1274;2914;1905;4519
350820;202212;1180;2531;728;1737;51;148;453;973;504;1121
350830;202212;1077;2673;628;1742;107;335;222;474;329;809
350840;202212;4672;12556;3614;10608;678;2236;1629;4258;2307;6494
350850;202212;10940;27070;8563;22911;1381;4069;4778;11800;6159;15869
350860;202212;5168;11863;4472;10910;397;1064;3173;7550;3570;8614
350870;202212;3534;8739;2574;7235;403;1187;1325;3544;1728;4731
350880;202212;2074;5115;1706;4426;430;1187;704;1585;1134;2772
350890;202212;641;1560;417;1109;69;188;137;309;206;497
350900;202212;12737;30398;9327;23717;1340;3880;5263;11900;6603;15780
350910;202212;1221;2589;1017;2298;90;218;774;1700;864;1918
350920;202212;16844;37898;14161;33662;610;1798;11344;25558;11954;27356
350925;202212;5665;13594;4180;11123;666;2028;2263;5277;2929;7305
350930;202212;1840;4482;1256;3376;97;282;683;1748;780;2030
350940;202212;3551;8004;2854;6907;233;679;2117;4739;2350;5418
350945;202212;1219;3076;884;2428;160;432;373;931;533;1363
350950;202212;129554;299780;100891;248263;12223;33341;62882;143738;75105;177079
350960;202212;9384;22752;7245;18737;1075;3148;3798;8917;4873;12065
350970;202212;5066;12893;3748;10464;954;3054;1256;2721;2210;5775
350980;202212;989;2265;818;1984;123;348;509;1115;632;1463
350990;202212;2741;6487;2139;5541;486;1459;1016;2341;1502;3800
350995;202212;1111;3046;1005;2847;70;262;702;1853;772;2115
351000;202212;3993;9980;2560;7112;546;1590;776;2019;1322;3609
351010;202212;504;1184;311;829;46;148;157;383;203;531
351015;202212;1271;3432;1034;2964;193;604;447;1089;640;1693
351020;202212;10863;26197;8256;21680;1505;4301;4307;10242;5812;14543
351030;202212;3995;10515;3184;8958;509;1647;1688;4380;2197;6027
351040;202212;7538;16027;6282;14145;236;662;5184;11099;5420;11761
351050;202212;23424;52809;17979;44618;2928;7945;10075;23485;13003;31430
351060;202212;65836;149741;50969;125143;4343;12322;35614;82588;39957;94910
351070;202212;1864;4320;1109;3059;286;859;223;513;509;1372
351080;202212;3703;8071;2805;6976;341;986;1805;4176;2146;5162
351090;202212;429;1078;325;895;63;173;124;324;187;497
351100;202212;3738;9181;2403;6544;467;1411;853;2131;1320;3542
351110;202212;7504;18248;5483;14612;851;2604;2937;7127;3788;9731
351120;202212;939;2243;642;1698;112;310;234;542;346;852
351130;202212;1444;3741;673;1982;121;392;158;369;279;761
351140;202212;2942;7413;2221;6115;460;1429;956;2279;1416;3708
351150;202212;3805;9747;2679;7510;409;1317;1087;2668;1496;3985
351160;202212;1783;5021;1243;3824;244;805;267;676;511;1481
351170;202212;2114;5046;1806;4496;137;435;1303;2964;1440;3399
351190;202212;1254;3264;856;2473;200;581;253;685;453;1266
351200;202212;2008;4563;1483;3789;143;412;978;2313;1121;2725
351210;202212;1951;4378;1286;3243;85;270;809;1836;894;2106
351220;202212;4963;11689;4230;10520;453;1097;2825;6779;3278;7876
351230;202212;2897;6758;2229;5645;402;1143;1044;2281;1446;3424
351240;202212;2939;7208;1852;5018;481;1312;453;1045;934;2357
351250;202212;1288;3263;766;2192;103;306;266;705;369;1011
351260;202212;1054;2438;732;1873;151;380;283;674;434;1054
351270;202212;669;1687;473;1299;50;146;233;517;283;663
351280;202212;5130;12597;3876;10316;860;2390;1550;3757;2410;6147
351290;202212;1929;4204;1307;3161;117;329;934;2130;1051;2459
351300;202212;29176;70994;21581;57243;3868;11211;10648;25906;14516;37117
351310;202212;4933;10849;3816;9033;172;553;2887;6372;3059;6925
351320;202212;1008;2744;701;2145;118;377;193;508;311;885
351330;202212;455;1072;323;815;19;63;200;418;219;481
351340;202212;10729;24207;9053;21335;1499;4212;5754;11960;7253;16172
351350;202212;17535;39412;14513;34467;1028;2938;11219;25022;12247;27960
351360;202212;5217;12083;4273;10715;746;2187;2281;5122;3027;7309
351370;202212;2582;6701;1686;4869;386;1199;394;910;780;2109
351380;202212;62647;136963;45390;108448;4641;12368;29597;66135;34238;78503
351385;202212;467;1165;204;591;31;88;90;245;121;333
351390;202212;1814;4005;1279;3264;64;203;1029;2527;1093;2730
351400;202212;1489;3709;1190;3132;185;475;627;1575;812;2050
351410;202212;3433;8629;2567;7036;452;1337;1150;2882;1602;4219
351420;202212;630;1413;387;1007;45;118;238;562;283;680
351430;202212;1341;3083;1105;2711;73;207;835;1935;908;2142
351440;202212;4617;11119;3120;8214;555;1559;1000;2168;1555;3727
351450;202212;2155;5292;1486;4113;299;991;416;872;715;1863
351460;202212;1314;3077;1080;2719;155;415;668;1598;823;2013
351470;202212;1560;3649;1212;3076;81;246;798;1886;879;2132
351480;202212;3205;8167;2537;7123;405;1347;1299;3245;1704;4592
351490;202212;2924;7272;2516;6555;80;301;2024;5046;2104;5347
351492;202212;460;1071;390;938;8;26;310;706;318;732
351495;202212;285;695;227;587;27;57;125;307;152;364
351500;202212;58407;125570;45737;105696;5585;14429;30837;66349;36422;80778
351510;202212;17993;38856;13533;31696;1451;3843;8957;19723;10408;23566
351512;202212;591;1477;410;1095;84;231;131;318;215;549
351515;202212;4225;9172;2645;6499;518;1326;650;1624;1168;2950
351518;202212;2601;6300;1724;4712;286;886;718;1652;1004;2538
351519;202212;768;1970;465;1379;103;332;106;258;209;590
351520;202212;1503;3522;733;2046;80;271;346;839;426;1110
351530;202212;442;1088;269;745;48;129;114;257;162;386
351535;202212;2152;4920;1489;3773;233;633;672;1569;905;2202
351540;202212;3374;7524;2304;5699;229;690;1237;2643;1466;3333
351550;202212;9706;22177;6787;17102;777;2186;3824;8691;4601;10877
351560;202212;655;1750;503;1444;96;300;178;467;274;767
351565;202212;350;872;263;728;37;129;109;248;146;377
351570;202212;30186;71682;23852;59963;1896;5561;16487;38764;18383;44325
351580;202212;272;676;162;475;22;59;64;200;86;259
351590;202212;556;1235;293;771;23;68;158;371;181;439
351600;202212;1693;4198;1287;3411;211;603;601;1415;812;2018
351610;202212;843;1853;529;1318;53;150;294;665;347;815
351620;202212;31354;76950;23240;63632;3424;10852;11224;27678;14648;38530
351630;202212;38237;88290;31130;76969;2616;7590;22390;51937;25006;59527
351640;202212;26614;60147;21521;51716;1393;4097;15930;35786;17323;39883
351650;202212;473;1236;212;632;40;126;48;120;88;246
351660;202212;786;2079;532;1542;89;282;149;355;238;637
351670;202212;7885;19736;5182;13939;1089;2889;2214;5360;3303;8249
351680;202212;512;1336;344;994;74;208;102;253;176;461
351685;202212;593;1529;466;1327;87;249;190;466;277;715
351690;202212;1503;3554;870;2362;96;315;380;913;476;1228
351700;202212;1722;3919;1272;3163;229;644;680;1508;909;2152
351710;202212;984;2337;737;1909;60;190;424;964;484;1154
351720;202212;1958;4667;1382;3682;247;663;644;1572;891;2235
351730;202212;1296;2956;1048;2577;72;202;666;1497;738;1699
351740;202212;4285;9932;3465;8509;453;1265;2058;4580;2511;5845
351750;202212;2326;5629;1459;4028;195;574;724;1826;919;2400
351760;202212;4233;10598;3226;8724;550;1745;1591;3793;2141;5538
351770;202212;2641;6400;2162;5556;567;1415;1119;2742;1686;4157
351780;202212;1414;3347;820;2223;102;309;341;841;443;1150
351790;202212;1983;4259;1515;3587;248;576;914;2088;1162;2664
351800;202212;556;1230;282;736;35;98;110;238;145;336
351810;202212;1438;3413;1177;3037;272;785;554;1296;826;2081
351820;202212;4021;9801;3000;7905;620;1797;1171;2682;1791;4479
351830;202212;6537;15011;5000;12513;390;1188;3411;7828;3801;9016
351840;202212;12316;30504;9659;25800;958;2910;6162;15031;7120;17941
351850;202212;1897;4943;1221;3593;206;679;388;889;594;1568
351860;202212;3487;9115;2719;7773;620;2003;1355;3550;1975;5553
351870;202212;35323;82078;27459;69325;5678;15043;13199;32175;18877;47218
351880;202212;222530;489730;176133;414508;24785;69721;112654;240784;137439;310505
351885;202212;1342;3054;1095;2684;52;170;822;1882;874;2052
351890;202212;1044;2527;668;1908;122;388;162;381;284;769
351900;202212;1592;3885;1213;3323;102;288;797;2111;899;2399
351905;202212;779;2038;581;1642;70;214;256;614;326;828
351907;202212;30065;71636;23646;60581;2546;7475;15352;36582;17898;44057
351910;202212;2197;5054;1602;3938;154;436;967;2044;1121;2480
351920;202212;1130;2753;860;2257;130;376;374;868;504;1244
351925;202212;1259;3046;991;2596;97;312;582;1382;679;1694
351930;202212;5726;12661;5202;11789;490;1341;4201;9089;4691;10430
351940;202212;1392;3339;1001;2647;183;525;417;1079;600;1604
351950;202212;2102;4133;1605;3454;81;217;1183;2385;1264;2602
351960;202212;7112;16448;5370;13510;1286;3447;2301;5164;3587;8611
351970;202212;13934;33054;11643;29384;1358;4270;7933;18345;9291;22615
351980;202212;1367;3043;891;2275;127;370;447;1027;574;1397
351990;202212;1817;3963;1335;3278;58;202;747;1604;805;1806
352000;202212;3536;8730;3022;7709;262;807;2101;4939;2363;5746
352010;202212;2981;7176;2363;6190;688;1819;659;1734;1347;3553
352020;202212;2214;5182;1738;4379;240;725;1001;2253;1241;2978
352030;202212;8116;18334;6569;15935;761;2232;4398;9888;5159;12120
352040;202212;5660;13232;4079;10365;675;1891;1614;3577;2289;5468
352042;202212;4835;10333;3395;8154;372;1018;2254;5188;2626;6206
352044;202212;2588;6385;1543;4435;239;777;380;862;619;1639
352050;202212;17077;41989;11673;31593;3332;9672;2697;5812;6029;15484
352060;202212;978;2365;731;1935;139;386;346;834;485;1220
352070;202212;1219;2394;817;1857;69;170;466;966;535;1136
352080;202212;567;1378;349;966;45;117;112;267;157;384
352090;202212;1973;5232;1623;4597;191;630;832;2082;1023;2712
352100;202212;4919;12577;3777;10438;637;2036;1742;4426;2379;6462
352110;202212;935;2382;690;1911;144;404;290;701;434;1105
352115;202212;635;1581;525;1434;129;408;267;636;396;1044
352120;202212;1064;2770;828;2307;78;226;520;1327;598;1553
352130;202212;2451;6424;1547;4244;210;605;724;1764;934;2369
352140;202212;1723;4276;1256;3341;252;678;515;1306;767;1984
352150;202212;1080;2605;790;2117;100;305;487;1217;587;1522
352160;202212;1199;2721;860;2170;93;259;429;1011;522;1270
352170;202212;3749;9317;2886;7608;452;1392;1414;3255;1866;4647
352180;202212;3534;8858;2707;7415;554;1616;1090;2730;1644;4346
352190;202212;2139;4851;1708;4199;307;802;908;2170;1215;2972
352200;202212;420;1234;304;984;46;163;109;318;155;481
352210;202212;31103;62390;24974;54169;1356;3405;20192;42069;21548;45474
352215;202212;783;1911;596;1583;96;276;316;792;412;1068
352220;202212;36668;78577;28099;64643;3623;9676;17971;37214;21594;46890
352230;202212;20445;52700;16030;44770;3983;12286;6247;15202;10230;27488
352240;202212;13955;32615;10834;27599;1951;5564;5768;13153;7719;18717
352250;202212;32239;82642;26608;73300;3377;10260;17531;46136;20908;56396
352260;202212;6570;15233;4654;11568;732;2076;2594;5612;3326;7688
352265;202212;1106;2908;975;2720;162;490;556;1475;718;1965
352270;202212;2696;6974;2113;5812;396;1205;909;2227;1305;3432
352280;202212;3089;6863;2358;5783;311;870;1350;2984;1661;3854
352290;202212;1980;5000;1594;4273;190;568;913;2175;1103;2743
352300;202212;1222;2901;777;2009;84;226;412;961;496;1187
352310;202212;52781;127688;40962;108650;6385;18076;24781;63140;31166;81216
352320;202212;8992;20466;7104;17196;857;2497;4457;9438;5314;11935
352330;202212;3464;7689;2749;6704;266;845;1866;4127;2132;4972
352340;202212;9848;23803;7466;19431;1190;3468;3957;9183;5147;12651
352350;202212;3290;8010;2669;6764;141;431;1965;4710;2106;5141
352360;202212;1986;4649;1582;3958;147;381;1078;2518;1225;2899
352370;202212;1327;3383;1114;3026;47;148;843;2201;890;2349
352380;202212;1231;2898;916;2369;193;530;319;746;512;1276
352390;202212;18155;41800;13171;32872;1980;5693;7811;17674;9791;23367
352400;202212;4701;12308;3627;10240;881;2696;1254;3090;2135;5786
352410;202212;4915;11104;3818;9321;434;1134;2392;5462;2826;6596
352420;202212;1063;2496;714;1916;131;382;257;618;388;1000
352430;202212;11655;25079;8790;20404;1171;3077;5114;10911;6285;13988
352440;202212;25472;63336;19432;52134;4359;12310;7241;18297;11600;30607
352450;202212;987;2332;550;1559;85;273;224;545;309;818
352460;202212;3430;8633;2530;7051;458;1418;1146;2886;1604;4304
352470;202212;3931;9565;3107;8245;258;827;2011;4864;2269;5691
352480;202212;5814;12711;3968;9549;518;1518;2093;4329;2611;5847
352490;202212;1072;2708;846;2318;173;518;357;911;530;1429
352500;202212;14542;34694;10111;26768;3646;11280;2215;3661;5861;14941
352510;202212;5761;13857;4594;11838;464;1404;3171;7587;3635;8991
352520;202212;3847;9372;2947;7865;517;1585;1605;3792;2122;5377
352530;202212;15388;36016;10844;27811;2124;6215;4129;8632;6253;14847
352540;202212;699;1801;516;1435;70;196;253;627;323;823
352550;202212;1268;3147;848;2416;163;558;329;794;492;1352
352560;202212;834;2003;692;1752;46;157;498;1156;544;1313
352570;202212;2645;6897;1742;5138;415;1434;267;420;682;1854
352580;202212;971;2173;813;1913;115;308;531;1150;646;1458
352585;202212;474;1209;342;976;39;139;180;444;219;583
352590;202212;16872;41627;12501;33728;2342;7209;6840;16647;9182;23856
352600;202212;2524;6036;2066;5256;203;587;1404;3284;1607;3871
352610;202212;3748;9061;2855;7610;446;1391;1419;3435;1865;4826
352620;202212;7741;17152;5936;14598;1344;3484;2824;6688;4168;10172
352630;202212;1074;2425;810;2066;143;408;403;946;546;1354
352640;202212;4268;9858;3128;7826;298;847;1960;4460;2258;5307
352650;202212;699;1829;458;1327;75;227;179;466;254;693
352660;202212;1417;3649;1149;3152;103;356;775;1929;878;2285
352670;202212;14268;33968;10350;26623;1816;5186;4914;11160;6730;16346
352680;202212;4195;11215;3105;8818;595;2043;1517;3481;2112;5524
352690;202212;34380;79978;27241;68396;1208;3813;20255;48008;21463;51821
352700;202212;1006;2382;755;1952;112;306;381;920;493;1226
352710;202212;7066;16786;5209;13544;1287;3821;2207;5016;3494;8837
352720;202212;13240;30184;10765;25908;1638;4460;6218;13648;7856;18108
352725;202212;652;1439;375;973;18;50;227;530;245;580
352730;202212;5539;15629;5027;14483;632;2058;2449;5893;3081;7951
352740;202212;3013;6780;2274;5704;297;849;1179;2708;1476;3557
352750;202212;507;1195;328;899;37;110;152;368;189;478
352760;202212;2035;5122;1578;4291;202;551;854;2193;1056;2744
352770;202212;1190;2879;838;2240;118;330;429;1050;547;1380
352780;202212;799;2105;562;1626;138;383;161;451;299;834
352790;202212;503;1225;372;967;49;123;159;358;208;481
352800;202212;1724;4732;1198;3587;245;758;226;477;471;1235
352810;202212;1476;3336;990;2482;178;443;515;1237;693;1680
352820;202212;557;1474;413;1226;92;279;97;247;189;526
352830;202212;689;1649;340;948;25;73;125;295;150;368
352840;202212;4978;12918;4031;11244;941;2843;1781;4682;2722;7525
352850;202212;17249;36935;12837;30172;2347;6266;7075;14819;9422;21085
352860;202212;1471;3750;1099;3085;194;592;417;1069;611;1661
352870;202212;1049;2528;719;1870;81;235;434;1058;515;1293
352880;202212;2147;4786;1515;3679;244;628;624;1320;868;1948
352885;202212;456;1114;352;932;46;142;221;542;267;684
352890;202212;880;1916;605;1390;52;137;407;824;459;961
352900;202212;24981;59677;17097;44759;2809;7700;7138;17167;9947;24867
352910;202212;451;1120;248;717;20;60;99;247;119;307
352920;202212;3563;8290;2746;6930;142;448;2011;4758;2153;5206
352930;202212;7407;17933;5768;14701;878;2624;2905;6366;3783;8990
352940;202212;35345;85449;28374;71864;4140;11658;17288;40581;21428;52239
352950;202212;667;1685;423;1229;89;289;120;281;209;570
352960;202212;910;2268;531;1481;60;188;180;381;240;569
352965;202212;302;796;205;607;44;124;58;158;102;282
352970;202212;5083;9498;4205;8224;110;287;3663;6806;3773;7093
352980;202212;1871;4225;1457;3643;336;895;801;1902;1137;2797
352990;202212;5755;13456;4391;11272;748;2126;2418;5865;3166;7991
353000;202212;559;1418;318;902;43;138;117;276;160;414
353010;202212;3359;7675;2360;5874;428;1200;1126;2491;1554;3691
353020;202212;4132;9965;2538;6849;393;1219;1004;2404;1397;3623
353030;202212;6037;14314;4187;11178;998;2876;1247;3026;2245;5902
353040;202212;957;1997;710;1629;75;200;484;1009;559;1209
353050;202212;6702;17379;4805;13584;811;2546;2501;6557;3312;9103
353060;202212;65794;149738;54505;132290;3255;9968;41807;95556;45062;105524
353070;202212;14391;36628;10712;29038;1741;5311;5214;12481;6955;17792
353080;202212;6596;16031;4607;12300;942;2841;1920;4284;2862;7125
353090;202212;737;2007;584;1718;56;179;343;961;399;1140
353100;202212;368;893;158;451;33;107;51;106;84;213
353110;202212;10634;24577;8563;21707;1969;4987;4235;11112;6204;16099
353120;202212;615;1455;469;1208;61;207;251;544;312;751
353130;202212;3873;8466;2637;6333;616;1648;1195;2460;1811;4108
353140;202212;3917;8544;2981;7061;269;797;1986;4343;2255;5140
353150;202212;1986;4605;1442;3744;299;845;617;1462;916;2307
353160;202212;787;1882;546;1473;71;226;253;567;324;793
353170;202212;805;1901;609;1611;82;238;335;832;417;1070
353180;202212;12285;28425;9652;24010;2261;6215;4392;9840;6653;16055
353190;202212;4447;10861;3425;8883;403;1184;1983;4638;2386;5822
353200;202212;2181;5482;1389;3958;191;642;550;1358;741;2000
353205;202212;593;1555;490;1335;42;142;284;675;326;817
353210;202212;1202;2366;789;1704;27;77;608;1212;635;1289
353215;202212;500;1228;394;1048;50;155;180;414;230;569
353220;202212;939;2430;640;1826;116;315;194;480;310;795
353230;202212;1009;2590;782;2226;199;645;209;529;408;1174
353240;202212;3262;7748;2720;6918;383;1104;1629;3861;2012;4965
353250;202212;1738;3549;1203;2724;164;398;716;1548;880;1946
353260;202212;1396;3046;795;2085;168;489;328;766;496;1255
353270;202212;1030;2367;845;2057;98;297;532;1161;630;1458
353280;202212;910;2224;661;1823;138;399;241;633;379;1032
353282;202212;2135;5482;1757;4808;149;482;1092;2757;1241;3239
353284;202212;446;1019;255;673;21;62;103;218;124;280
353286;202212;205;508;124;366;23;75;34;66;57;141
353290;202212;1540;3810;893;2507;163;434;253;654;416;1088
353300;202212;2764;6743;2022;5374;321;975;945;2104;1266;3079
353310;202212;507;1129;381;929;28;92;247;530;275;622
353320;202212;833;2023;683;1792;40;140;441;1050;481;1190
353325;202212;998;2576;705;1984;118;345;321;824;439;1169
353330;202212;802;1846;520;1353;70;204;261;587;331;791
353340;202212;4362;10937;3398;9117;526;1669;1888;4536;2414;6205
353350;202212;5580;12549;4108;9989;973;2523;1292;2732;2265;5255
353360;202212;869;2230;710;1941;75;264;445;1121;520;1385
353370;202212;743;1947;604;1717;47;151;391;1067;438;1218
353380;202212;396;1012;319;877;40;139;175;418;215;557
353390;202212;8318;19160;6210;15755;526;1552;3847;8987;4373;10539
353400;202212;707;1723;540;1432;93;286;234;471;327;757
353410;202212;672;1608;495;1284;125;359;240;544;365;903
353420;202212;597;1421;403;1045;67;183;102;211;169;394
353430;202212;2997;7540;2386;6449;454;1296;1115;2801;1569;4097
353440;202212;99836;240342;75717;193904;9827;28772;46634;108423;56461;137195
353450;202212;489;1121;344;887;52;164;171;381;223;545
353460;202212;4197;10492;3038;8312;620;1935;741;1659;1361;3594
353470;202212;11915;28445;8815;22828;1449;4257;4177;9482;5626;13739
353475;202212;2049;4732;1395;3540;145;422;751;1672;896;2094
353480;202212;2063;4784;1697;4237;112;345;1224;2842;1336;3187
353490;202212;1342;3252;988;2625;128;355;494;1189;622;1544
353500;202212;1548;3455;1120;2770;245;662;575;1295;820;1957
353510;202212;1260;3310;914;2556;166;484;335;768;501;1252
353520;202212;1366;3297;883;2441;122;373;387;903;509;1276
353530;202212;3283;7591;2653;6521;307;891;1635;3615;1942;4506
353540;202212;2722;6620;2213;5851;367;1055;1276;3186;1643;4241
353550;202212;8064;18144;6461;15565;1001;2575;3911;8711;4912;11286
353560;202212;2997;7322;2351;6365;667;1941;850;1995;1517;3936
353570;202212;796;2001;507;1443;89;283;192;458;281;741
353580;202212;3130;7474;2469;6291;450;1139;1362;3314;1812;4453
353590;202212;937;2187;694;1796;86;223;400;973;486;1196
353600;202212;1947;4632;1410;3703;179;513;711;1770;890;2283
353610;202212;1006;2633;762;2158;115;347;357;905;472;1252
353620;202212;3787;8958;2732;7253;592;1665;889;2015;1481;3680
353625;202212;775;1785;451;1205;52;170;245;595;297;765
353630;202212;1995;5316;1678;4705;238;736;943;2382;1181;3118
353640;202212;1786;4221;1370;3508;185;475;868;2095;1053;2570
353650;202212;9338;23421;7248;19701;962;2885;4104;10234;5066;13119
353657;202212;453;1134;344;963;32;105;156;407;188;512
353660;202212;1722;3293;1218;2622;164;393;831;1696;995;2089
353670;202212;5638;14055;4387;11740;806;2489;2130;5017;2936;7506
353680;202212;932;2177;693;1838;105;305;404;990;509;1295
353690;202212;546;1402;248;735;29;81;69;176;98;257
353700;202212;2784;6463;2274;5676;211;565;1536;3648;1747;4213
353710;202212;6192;13204;3908;9179;595;1399;2167;4425;2762;5824
353715;202212;523;1317;302;859;24;80;133;328;157;408
353720;202212;2547;6072;1957;5154;371;1079;932;2343;1303;3422
353730;202212;6495;15265;5131;12962;669;2000;3122;7174;3791;9174
353740;202212;2730;6554;1984;5242;372;1069;887;2102;1259;3171
353750;202212;1165;3237;859;2665;207;649;227;669;434;1318
353760;202212;19486;38836;15196;33321;2714;6528;8831;18471;11545;24999
353770;202212;790;2116;445;1393;60;227;62;150;122;377
353780;202212;8977;21055;7396;18312;1213;3356;4295;9885;5508;13241
353790;202212;3684;10075;2746;8198;632;2102;631;1516;1263;3618
353800;202212;24163;57416;19591;50344;2817;7578;11670;28545;14487;36123
353810;202212;1509;3653;1057;2768;183;502;441;1076;624;1578
353820;202212;2320;5674;1609;4354;428;1181;445;1029;873;2210
353830;202212;772;1778;580;1488;81;243;311;718;392;961
353850;202212;2050;5052;1573;4206;290;801;705;1726;995;2527
353860;202212;3545;8593;2718;7237;631;1977;1293;2927;1924;4904
353870;202212;38546;92591;27978;72937;3935;11336;14259;33070;18194;44406
353880;202212;3878;9616;3119;8221;236;776;2029;4878;2265;5654
353890;202212;4122;7905;2897;6099;176;468;2067;3876;2243;4344
353900;202212;903;2353;669;1910;85;286;278;695;363;981
353910;202212;4083;9548;3485;8655;249;726;2564;6125;2813;6851
353920;202212;2549;6378;1854;5128;527;1602;451;931;978;2533
353930;202212;7029;16751;5028;12975;935;2682;2244;5052;3179;7734
353940;202212;1668;4439;1195;3509;187;612;469;1199;656;1811
353950;202212;4493;10884;3443;9017;889;2565;1164;2637;2053;5202
353960;202212;956;2344;658;1814;161;417;163;433;324;850
353970;202212;833;1767;652;1508;61;171;481;1046;542;1217
353980;202212;22237;49663;17331;41670;769;2386;13374;30057;14143;32443
353990;202212;1220;2690;851;2091;171;443;466;1052;637;1495
354000;202212;3241;7388;1899;4899;349;946;659;1501;1008;2447
354010;202212;422;1019;314;843;53;171;180;446;233;617
354020;202212;5175;12276;4119;10321;784;2189;2000;4375;2784;6564
354025;202212;919;2348;605;1742;94;306;184;452;278;758
354030;202212;656;1383;357;894;57;144;172;400;229;544
354040;202212;1001;2113;679;1634;39;118;480;1058;519;1176
354050;202212;1341;3497;948;2833;174;608;397;1092;571;1700
354060;202212;5297;13291;3898;10394;622;1880;2028;4685;2650;6565
354070;202212;5257;12255;3659;9231;580;1647;1760;3832;2340;5479
354075;202212;3711;9274;3011;8101;476;1432;1800;4423;2276;5855
354080;202212;1858;4791;1289;3703;188;579;585;1484;773;2063
354085;202212;523;974;404;828;1;4;304;567;305;571
354090;202212;2222;5533;1892;4864;103;300;1470;3593;1573;3893
354100;202212;31130;76714;22778;62834;4365;13217;11111;28467;15476;41684
354105;202212;1612;3754;1175;3028;165;515;582;1326;747;1841
354110;202212;589;1533;451;1282;82;266;191;496;273;762
354120;202212;1823;4575;1222;3303;241;712;437;980;678;1692
354130;202212;7546;18051;5203;13646;1470;3983;1098;2328;2568;6311
354140;202212;24357;56742;17861;44815;2496;7075;9565;21251;12061;28326
354150;202212;3626;8066;2858;6900;714;1780;934;2195;1648;3975
354160;202212;3595;9342;2895;8090;676;2039;1232;3144;1908;5183
354165;202212;921;2439;731;2079;91;343;442;1099;533;1442
354170;202212;2536;6343;2063;5504;260;808;1082;2508;1342;3316
354180;202212;566;1442;440;1188;38;118;262;642;300;760
354190;202212;1944;5036;1382;3909;101;345;748;1933;849;2278
354200;202212;1169;2626;872;2150;84;249;563;1252;647;1501
354210;202212;1334;3180;1047;2709;99;289;669;1568;768;1857
354220;202212;3991;9649;2977;7785;533;1509;1421;3421;1954;4930
354230;202212;1031;2326;841;2089;41;122;634;1518;675;1640
354240;202212;2368;6089;1614;4525;292;855;619;1493;911;2348
354250;202212;800;1856;538;1421;121;320;193;453;314;773
354260;202212;11575;26431;9010;22244;1325;3564;4702;10834;6027;14398
354270;202212;1273;3387;1038;2960;157;481;501;1262;658;1743
354280;202212;1054;2315;874;2044;39;120;656;1385;695;1505
354290;202212;1203;3417;983;2965;144;469;539;1548;683;2017
354300;202212;4283;11384;3593;10131;901;2568;1666;4495;2567;7063
354310;202212;1005;2594;858;2345;144;445;496;1243;640;1688
354320;202212;1211;2710;799;2048;121;328;386;833;507;1161
354323;202212;583;1289;369;911;42;113;190;405;232;518
354325;202212;1707;4815;1050;3249;197;609;176;476;373;1085
354330;202212;12933;29633;9315;22740;1045;2950;5816;12900;6861;15850
354340;202212;51982;119302;38543;96836;5214;14648;22705;53378;27919;68026
354350;202212;1481;3357;1183;2882;134;429;783;1679;917;2108
354360;202212;799;1780;503;1329;108;300;174;400;282;700
354370;202212;1256;3217;1025;2855;159;475;608;1596;767;2071
354380;202212;673;1635;500;1367;69;243;203;458;272;701
354390;202212;19809;43923;13825;33726;2026;5460;7595;16778;9621;22238
354400;202212;2110;6130;1644;5118;282;960;567;1635;849;2595
354410;202212;9150;20954;7171;17497;1059;2957;4185;9239;5244;12196
354420;202212;1828;4378;1293;3394;161;477;698;1619;859;2096
354425;202212;3659;8080;2681;6453;506;1272;1403;3183;1909;4455
354430;202212;2163;5076;1697;4347;136;410;1109;2608;1245;3018
354440;202212;738;1755;480;1258;57;169;251;568;308;737
354450;202212;614;1543;331;991;52;169;108;252;160;421
354460;202212;1009;2444;683;1874;158;479;228;563;386;1042
354470;202212;513;1254;332;892;30;103;122;244;152;347
354480;202212;1697;3574;1135;2671;91;254;735;1574;826;1828
354490;202212;1021;2746;752;2175;147;430;344;901;491;1331
354500;202212;2905;7302;2318;6352;628;1854;792;1975;1420;3829
354510;202212;956;2423;747;2048;69;221;428;1032;497;1253
354515;202212;562;1494;386;1134;64;197;130;348;194;545
354520;202212;10585;26041;7804;20463;984;3011;4517;10607;5501;13618
354530;202212;6620;16385;5248;13863;1367;3627;1978;4917;3345;8544
354540;202212;1607;3909;1164;3138;199;580;528;1319;727;1899
354550;202212;720;1843;570;1570;77;240;297;734;374;974
354560;202212;2688;6011;1468;3789;157;439;871;2015;1028;2454
354570;202212;1184;2817;530;1474;103;290;86;221;189;511
354580;202212;11093;27780;7714;21367;1121;3499;4126;10487;5247;13986
354600;202212;2619;6374;2026;5294;308;810;1171;2892;1479;3702
354610;202212;560;1399;306;885;31;98;149;401;180;499
354620;202212;620;1605;384;1149;36;119;183;490;219;609
354625;202212;399;1159;239;839;23;78;93;361;116;439
354630;202212;3092;7997;2567;7035;748;2105;720;1769;1468;3874
354640;202212;5038;12632;3936;10551;478;1547;2125;5034;2603;6581
354650;202212;1095;2630;875;2268;187;452;441;1096;628;1548
354660;202212;4498;9886;2612;6899;322;1010;1167;2738;1489;3748
354670;202212;1451;3703;1018;2836;208;635;335;791;543;1426
354680;202212;8159;18501;6491;15886;1024;2757;3891;9017;4915;11774
354690;202212;667;1883;478;1480;74;234;193;541;267;775
354700;202212;1117;2711;793;2102;94;287;442;1038;536;1325
354710;202212;596;1463;389;1061;42;121;180;421;222;542
354720;202212;385;865;190;506;57;143;57;145;114;288
354730;202212;14528;37902;11470;32184;1584;4922;6841;17976;8425;22898
354740;202212;404;1043;175;516;34;106;29;65;63;171
354750;202212;3047;7348;2075;5484;322;966;901;2038;1223;3004
354760;202212;2832;6869;2064;5528;423;1229;755;1758;1178;2987
354765;202212;431;1090;194;572;18;68;68;156;86;224
354770;202212;3180;7266;2330;5732;445;1192;1069;2370;1514;3562
354780;202212;83357;185071;65154;151360;4458;12684;47100;99940;51558;112624
354790;202212;1167;2959;910;2551;78;246;572;1522;650;1768
354800;202212;3518;8313;2608;6811;569;1612;1049;2401;1618;4013
354805;202212;1805;3867;1329;3183;108;285;898;1932;1006;2217
354810;202212;708;1965;428;1382;73;272;127;344;200;616
354820;202212;1202;3168;859;2539;165;528;296;714;461;1242
354830;202212;678;1522;383;994;77;215;144;308;221;523
354840;202212;1066;2590;635;1679;52;156;357;836;409;992
354850;202212;29512;67210;21721;54166;1910;5806;14814;33852;16724;39658
354860;202212;2140;5401;1393;3962;204;632;547;1374;751;2006
354870;202212;88020;199622;69275;166583;5389;15340;47963;105914;53352;121254
354880;202212;7983;18581;4452;11347;538;1579;2114;4279;2652;5858
354890;202212;23856;53946;18955;45609;2418;6756;11176;24975;13594;31731
354900;202212;466;1106;305;816;74;217;111;247;185;464
354910;202212;7762;18963;4840;13770;1098;3339;1383;3389;2481;6728
354920;202212;604;1533;304;922;40;130;79;187;119;317
354925;202212;356;962;199;623;22;68;46;126;68;194
354930;202212;448;1041;304;779;36;96;158;359;194;455
354940;202212;3299;8870;2510;7215;715;2206;926;2267;1641;4473
354950;202212;2001;4509;1646;4054;104;343;1201;2747;1305;3090
354960;202212;1056;2586;742;2074;89;311;339;821;428;1132
354970;202212;5628;14042;4484;12190;363;1249;3121;7948;3484;9197
354980;202212;46034;101284;32743;79038;3430;10037;21442;46925;24872;56962
354990;202212;102767;230572;75588;183156;4963;14972;52864;116798;57827;131770
354995;202212;4367;8206;3432;7023;151;375;2811;5499;2962;5874
355000;202212;1979;4485;1497;3773;234;710;779;1741;1013;2451
355010;202212;5238;13041;3518;9505;1144;3001;809;2092;1953;5093
355020;202212;4112;10901;3262;9464;745;2389;1349;3536;2094;5925
355030;202212;1779023;4043470;1337091;3232653;179225;483991;760359;1667560;939584;2151551
355040;202212;4605;9929;3638;8651;343;899;2724;6254;3067;7153
355050;202212;1415;2993;1039;2469;250;604;424;944;674;1548
355060;202212;8777;21466;6641;17670;1048;3186;3679;8851;4727;12037
355070;202212;14040;31872;11681;28202;1286;3662;7817;17419;9103;21081
355080;202212;1234;3269;785;2460;182;600;137;358;319;958
355090;202212;1762;4356;1413;3769;247;728;746;1791;993;2519
355100;202212;38963;88705;32458;79088;3396;9486;23318;53653;26714;63139
355110;202212;1229;3107;871;2568;169;521;66;155;235;676
355120;202212;934;2254;658;1845;80;257;337;863;417;1120
355130;202212;1053;2136;608;1355;25;66;442;884;467;950
355140;202212;2936;5411;2514;4842;77;197;2238;4161;2315;4358
355150;202212;6359;14782;5161;12782;580;1582;3386;7917;3966;9499
355160;202212;3010;7527;2152;6064;490;1513;612;1524;1102;3037
355170;202212;15845;36157;12570;30809;2026;5571;7253;16563;9279;22134
355180;202212;3664;8466;2740;7076;518;1551;1396;3242;1914;4793
355190;202212;2373;5812;1870;5017;713;1977;562;1597;1275;3574
355200;202212;1103;3068;931;2792;269;911;319;886;588;1797
355210;202212;4127;10200;3148;8219;740;1988;1318;3206;2058;5194
355220;202212;69786;164601;56787;140813;7631;21647;33496;74804;41127;96451
355230;202212;1517;3636;815;2240;150;441;313;709;463;1150
355240;202212;32142;78611;23263;61867;2478;7398;14300;35190;16778;42588
355250;202212;53198;127570;41085;105133;8519;23552;20535;48017;29054;71569
355255;202212;787;1863;411;1183;52;141;129;344;181;485
355260;202212;2026;4281;1498;3487;115;349;1064;2252;1179;2601
355270;202212;1549;4133;1220;3499;281;814;507;1347;788;2161
355280;202212;43060;98777;31997;79314;3842;10538;18779;42837;22621;53375
355290;202212;1199;2910;939;2498;183;485;463;1137;646;1622
355300;202212;1784;4688;1471;4123;241;727;671;1663;912;2390
355310;202212;1167;2905;866;2375;113;344;495;1287;608;1631
355320;202212;718;1770;524;1403;114;356;208;444;322;800
355330;202212;3910;9005;3059;7547;136;440;2346;5396;2482;5836
355340;202212;5281;10944;4046;9366;768;1810;1970;4664;2738;6474
355350;202212;1807;4587;1375;3785;248;787;625;1527;873;2314
355360;202212;1639;3780;1273;3220;155;411;726;1667;881;2078
355365;202212;450;1054;241;698;40;121;78;192;118;313
355370;202212;7255;16843;5696;14434;1236;2829;2696;7051;3932;9880
355380;202212;3789;9180;2904;7628;576;1663;1117;2492;1693;4155
355385;202212;1777;4212;1441;3715;110;348;936;2193;1046;2541
355390;202212;1011;2584;733;2016;108;335;359;853;467;1188
355395;202212;2259;6009;1623;4728;264;872;672;1678;936;2550
355400;202212;12332;32150;9964;27661;2140;6771;4278;10391;6418;17162
355410;202212;32241;81234;21771;60435;4200;12885;8370;21138;12570;34023
355420;202212;769;2256;630;1996;131;473;207;598;338;1071
355430;202212;4800;11091;3721;9234;618;1680;2011;4705;2629;6385
355440;202212;918;2303;587;1664;98;279;132;304;230;583
355450;202212;4634;11015;3203;8333;459;1341;1592;3580;2051;4921
355460;202212;604;1411;402;1068;39;118;181;441;220;559
355465;202212;547;1291;435;1115;61;152;278;695;339;847
355470;202212;1493;3517;877;2339;231;680;307;722;538;1402
355475;202212;430;925;349;821;18;45;255;569;273;614
355480;202212;5453;13790;4329;12035;609;1957;2728;7221;3337;9178
355490;202212;1131;2868;644;1899;73;235;297;792;370;1027
355495;202212;1188;2915;876;2394;117;400;411;952;528;1352
355500;202212;9041;21202;6022;15634;800;2403;2870;6459;3670;8862
355510;202212;1714;3977;1159;3049;197;535;501;1169;698;1704
355520;202212;384;875;189;535;38;118;46;114;84;232
355530;202212;379;825;170;435;9;32;97;216;106;248
355535;202212;663;1668;530;1452;108;348;265;616;373;964
355540;202212;17388;37764;14611;33947;1534;3972;10586;23487;12120;27459
355550;202212;821;2206;696;1973;82;268;401;1016;483;1284
355560;202212;1385;3405;785;2241;169;530;33;104;202;634
355570;202212;360;883;198;548;48;142;55;133;103;275
355580;202212;1513;3479;874;2315;165;482;228;528;393;1010
355590;202212;212;516;157;427;16;45;84;218;100;263
355600;202212;1767;4142;1121;2989;170;505;302;717;472;1222
355610;202212;2554;5840;1740;4435;272;758;956;2175;1228;2933
355620;202212;6570;16085;5054;13270;546;1745;3011;7052;3557;8797
355630;202212;3346;8134;2416;6429;268;796;1456;3494;1724;4290
355635;202212;1249;3332;896;2626;136;420;326;858;462;1278
355640;202212;4441;11318;2948;8433;721;2044;538;1502;1259;3546
355645;202212;4850;12540;3523;10180;513;1636;1917;5208;2430;6844
355650;202212;10059;24390;8121;21006;1600;4375;4121;9725;5721;14100
355660;202212;1709;4191;1112;3130;203;516;218;540;421;1056
355670;202212;5624;13726;4061;10496;515;1634;2136;4670;2651;6304
355680;202212;3446;8924;1740;5173;473;1512;129;340;602;1852
355690;202212;901;2462;605;1909;183;604;11;20;194;624
355695;202212;327;839;193;562;18;57;42;86;60;143
355700;202212;10902;27558;9179;24077;1111;3341;5712;13849;6823;17190
355710;202212;13069;28729;9046;21475;1234;3490;4883;9854;6117;13344
355715;202212;573;1481;320;918;87;249;61;162;148;411
355720;202212;1877;4688;1476;4006;239;724;812;1985;1051;2709
355730;202212;1327;3279;1051;2807;107;343;609;1483;716;1826
410010;202212;1519;3968;1138;3185;249;731;276;692;525;1423
410020;202212;1363;3608;998;2847;294;828;259;667;553;1495
410030;202212;2129;5154;1757;4579;258;688;909;2339;1167;3027
410040;202212;18562;46682;13673;37774;2886;8506;4520;11254;7406;19760
410045;202212;901;2310;663;1822;139;415;189;435;328;850
410050;202212;2691;6501;1888;5126;309;938;679;1658;988;2596
410060;202212;2535;6629;2024;5707;505;1557;572;1451;1077;3008
410070;202212;2424;5709;1748;4509;337;978;692;1539;1029;2517
410080;202212;1655;4153;1190;3364;267;771;252;643;519;1414
410090;202212;1416;3111;1143;2729;152;327;547;1422;699;1749
410100;202212;2586;6862;1750;5028;314;986;162;416;476;1402
410105;202212;679;1545;436;1092;27;84;251;540;278;624
410110;202212;4056;9269;2900;7295;356;1029;1554;3492;1910;4521
410115;202212;671;1643;479;1307;61;190;188;435;249;625
410120;202212;4043;9461;3540;8720;586;1391;2279;5517;2865;6908
410130;202212;1627;3904;1424;3554;203;536;849;2041;1052;2577
410140;202212;21782;49688;14516;37082;2684;7500;4825;10907;7509;18407
410150;202212;20349;45888;11122;28492;1865;5272;3750;8077;5615;13349
410160;202212;3649;9601;2950;8377;636;2057;1086;2819;1722;4876
410165;202212;750;1925;584;1583;79;246;293;728;372;974
410170;202212;3579;8689;2187;5815;402;1166;354;769;756;1935
410180;202212;21829;55651;16910;46055;2764;8348;8419;20311;11183;28659
410185;202212;554;1495;412;1158;78;236;145;344;223;580
410190;202212;2712;6413;1934;5038;389;1044;511;1119;900;2163
410200;202212;7112;15245;3961;10021;782;2142;780;1691;1562;3833
410210;202212;3842;9163;2376;6581;368;1146;803;1858;1171;3004
410220;202212;656;1603;444;1218;96;276;148;356;244;632
410230;202212;2435;6059;1840;4885;283;860;781;1728;1064;2588
410240;202212;6187;15424;4275;11876;855;2766;707;1642;1562;4408
410250;202212;2803;6380;2045;5179;247;646;937;2252;1184;2898
410260;202212;2471;5581;1577;3980;302;778;782;1779;1084;2557
410270;202212;598;1482;425;1174;57;187;171;394;228;581
410275;202212;730;1888;497;1399;77;252;209;510;286;762
410280;202212;2889;7111;1970;5401;250;792;886;2119;1136;2911
410290;202212;3939;10186;2714;7721;892;2478;681;1881;1573;4359
410300;202212;850;1952;673;1685;69;207;358;775;427;982
410302;202212;407;973;247;692;29;95;108;279;137;374
410304;202212;1839;3980;1555;3510;163;398;1009;2226;1172;2624
410305;202212;2111;4678;1484;3773;159;450;965;2300;1124;2750
410310;202212;3852;8961;3170;7813;252;824;2152;4871;2404;5695
410315;202212;907;1914;566;1386;163;407;176;410;339;817
410320;202212;1168;3111;746;2253;94;307;120;305;214;612
410322;202212;779;1993;392;1127;52;152;132;309;184;461
410330;202212;1816;4162;1257;3155;205;521;434;973;639;1494
410335;202212;1024;2550;763;2080;135;388;270;661;405;1049
410337;202212;963;2289;658;1714;91;254;237;529;328;783
410340;202212;559;1483;373;1044;30;101;162;358;192;459
410345;202212;3356;8214;2075;5587;465;1265;784;1865;1249;3130
410347;202212;932;2261;683;1837;93;255;193;491;286;746
410350;202212;2034;4620;1456;3716;141;424;836;1877;977;2301
410360;202212;4838;11553;3535;9284;625;1707;1120;2754;1745;4461
410370;202212;17648;44321;11579;30684;1358;4106;5047;10979;6405;15085
410380;202212;2156;4897;1495;3775;211;613;545;1208;756;1821
410390;202212;3573;7941;2400;6053;492;1513;979;2039;1471;3552
410395;202212;1100;2916;853;2441;179;512;311;907;490;1419
410400;202212;9890;22641;7550;18531;856;2422;4746;10495;5602;12917
410405;202212;1098;2397;758;1898;114;322;376;848;490;1170
410410;202212;1958;4582;1717;4204;127;366;1181;2818;1308;3184
410420;202212;15390;37856;11609;30725;1906;5516;5320;12415;7226;17931
410425;202212;4616;11678;3190;8852;570;1690;1194;2905;1764;4595
410430;202212;16578;38567;11707;30018;1782;5100;4786;10820;6568;15920
410440;202212;2985;7741;2566;6985;406;1241;1430;3656;1836;4897
410442;202212;3062;8326;2416;7008;684;2059;605;1642;1289;3701
410445;202212;2754;7272;1861;5545;397;1297;252;790;649;2087
410450;202212;1882;4361;1386;3613;237;644;480;1146;717;1790
410460;202212;2986;6853;2138;5407;315;910;1055;2335;1370;3245
410465;202212;3676;9744;2778;8086;564;1659;899;2242;1463;3901
410470;202212;2967;7556;2093;6061;648;2126;192;529;840;2655
410480;202212;50168;113803;28882;77429;4220;12763;8860;19601;13080;32364
410490;202212;14733;37166;10716;29227;1764;5246;4918;11871;6682;17117
410500;202212;2240;5410;1452;3944;282;787;313;666;595;1453
410510;202212;2248;5241;1560;4069;343;862;480;1227;823;2089
410520;202212;3737;10574;3276;9716;1040;3286;1216;3502;2256;6788
410530;202212;1883;4416;894;2415;122;375;248;516;370;891
410540;202212;3465;8668;2398;6611;404;1279;1042;2540;1446;3819
410550;202212;9567;23972;6513;17698;1089;3319;2007;4457;3096;7776
410560;202212;1903;4620;1380;3611;302;873;393;822;695;1695
410570;202212;3335;8184;2335;6468;803;2585;230;564;1033;3149
410580;202212;36520;86143;27524;70314;4097;11823;14495;33522;18592;45345
410590;202212;2095;5397;1425;3899;191;554;445;967;636;1521
410600;202212;2247;5389;1741;4455;362;928;658;1595;1020;2523
410610;202212;851;2020;631;1633;57;171;323;735;380;906
410620;202212;3502;8723;2482;6604;621;1786;689;1569;1310;3355
410630;202212;3133;7536;2065;5502;402;1275;495;988;897;2263
410640;202212;6299;13814;4288;10393;935;2504;703;1670;1638;4174
410645;202212;1715;3925;1437;3586;137;383;1132;2764;1269;3147
410650;202212;3092;7769;2110;5827;417;1260;878;2116;1295;3376
410655;202212;1037;2375;711;1822;87;266;292;625;379;891
410657;202212;731;1867;454;1284;64;194;196;449;260;643
410660;202212;4601;10668;2788;7048;434;1180;1037;2231;1471;3411
410670;202212;1208;2866;734;1965;116;319;278;628;394;947
410680;202212;2888;8079;1912;5739;446;1367;358;1032;804;2399
410685;202212;636;1534;458;1219;102;308;193;460;295;768
410690;202212;180358;408865;125795;311480;19345;54662;56128;119408;75473;174070
410700;202212;3001;7147;2435;6287;567;1518;921;2178;1488;3696
410710;202212;1088;2595;691;1863;179;517;264;613;443;1130
410712;202212;825;2103;683;1842;102;287;372;954;474;1241
410715;202212;1058;2827;655;1965;73;248;279;761;352;1009
410720;202212;4735;10889;3881;9504;529;1605;1479;3313;2008;4918
410725;202212;1447;3323;878;2328;202;590;188;388;390;978
410730;202212;1007;2426;698;1865;99;319;160;407;259;726
410740;202212;1028;2704;777;2243;60;209;406;1134;466;1343
410750;202212;2414;5448;1869;4501;317;808;893;1973;1210;2781
410752;202212;478;1095;253;682;84;213;67;161;151;374
410753;202212;414;1124;289;867;32;109;90;231;122;340
410754;202212;1396;3250;1143;2882;83;213;823;2095;906;2308
410755;202212;684;1642;494;1312;58;160;236;555;294;715
410760;202212;4430;10859;3130;8562;759;2488;838;2075;1597;4563
410765;202212;22579;56345;17801;47649;3586;10679;6006;13472;9592;24151
410770;202212;1242;2794;849;2154;81;182;423;1052;504;1234
410773;202212;1620;3837;1370;3430;186;534;862;1991;1048;2525
410775;202212;2046;4242;1789;3889;43;112;1392;2849;1435;2961
410780;202212;758;1772;505;1311;93;261;162;372;255;633
410785;202212;978;2219;706;1796;103;308;313;743;416;1051
410790;202212;1312;3551;1068;3099;232;735;163;362;395;1097
410800;202212;4244;8411;3380;7215;67;192;2354;4715;2421;4907
410810;202212;554;1377;409;1111;45;163;214;490;259;653
410820;202212;1247;3280;685;1879;154;443;147;308;301;751
410830;202212;56544;123225;40657;97336;6325;17595;20352;43419;26677;61014
410832;202212;1361;3337;1101;2891;97;313;689;1619;786;1932
410840;202212;11293;26596;6611;17794;1303;3991;1917;3998;3220;7989
410845;202212;1481;3178;1169;2740;134;362;720;1535;854;1897
410850;202212;2632;6766;2259;6123;426;1313;1070;2649;1496;3962
410855;202212;857;2033;537;1420;66;202;267;590;333;792
410860;202212;6040;13052;4785;11042;216;679;3399;7145;3615;7824
410865;202212;1761;4605;1486;4115;217;649;778;2230;995;2879
410870;202212;1447;3591;1138;3064;147;435;631;1616;778;2051
410880;202212;5838;14515;3938;11103;690;1981;704;1968;1394;3949
410890;202212;1424;3561;1129;3024;217;576;514;1287;731;1863
410895;202212;1219;3549;996;3068;326;1127;254;659;580;1786
410900;202212;1027;2597;681;1979;108;330;149;319;257;649
410910;202212;533;1154;329;785;17;45;194;403;211;448
410920;202212;1128;2470;835;2022;104;288;466;1037;570;1325
410930;202212;2124;5099;1449;3974;371;1135;247;577;618;1712
410940;202212;31109;77215;22826;62754;4392;13556;9268;22995;13660;36551
410950;202212;2452;6233;2173;5798;201;507;1631;4287;1832;4794
410960;202212;10847;24090;7626;19010;2063;6011;3006;6612;5069;12623
410965;202212;1366;3309;857;2363;113;355;380;928;493;1283
410970;202212;5281;13265;3686;10183;916;2989;675;1399;1591;4388
410975;202212;1819;4023;1317;3219;195;533;581;1310;776;1843
410980;202212;9348;21564;6108;15907;645;1913;3029;6932;3674;8845
410990;202212;1845;4017;1273;3173;222;628;604;1419;826;2047
411000;202212;825;2114;564;1635;104;334;172;414;276;748
411005;202212;573;1339;354;917;45;124;145;308;190;432
411007;202212;3127;7674;2270;6172;458;1380;824;2006;1282;3386
411010;202212;5656;15124;4271;12393;1201;3579;751;1858;1952;5437
411020;202212;2887;7431;2347;6545;603;1781;730;1910;1333;3691
411030;202212;865;2044;588;1504;75;220;266;569;341;789
411040;202212;1236;2964;649;1751;129;340;177;401;306;741
411050;202212;2426;7056;1889;5930;400;1404;333;833;733;2237
411060;202212;2764;6848;1761;4820;325;933;534;1197;859;2130
411065;202212;463;1116;277;746;28;92;111;263;139;355
411070;202212;9724;22234;7675;18956;1047;3042;4223;9468;5270;12510
411080;202212;2453;5986;1956;5137;467;1418;592;1374;1059;2792
411090;202212;951;2447;578;1704;82;267;140;335;222;602
411095;202212;2966;6686;1701;4483;229;632;302;647;531;1279
411100;202212;1488;3593;984;2674;121;400;357;879;478;1279
411110;202212;786;1982;359;1070;38;104;31;56;69;160
411120;202212;2017;4872;1653;4306;283;915;815;1865;1098;2780
411125;202212;6671;17687;5819;16187;1558;4502;2236;6182;3794;10684
411130;202212;903;2226;624;1695;172;456;168;456;340;912
411140;202212;2659;7586;2131;6490;523;1662;600;1822;1123;3484
411150;202212;4972;11793;3251;8446;673;1888;330;652;1003;2540
411155;202212;1337;3052;902;2283;113;347;470;974;583;1321
411160;202212;464;989;296;723;33;91;90;217;123;308
411170;202212;997;2653;752;2156;169;539;316;841;485;1380
411180;202212;6645;15612;5393;13441;757;2157;3014;6712;3771;8869
411190;202212;2625;6290;1990;5205;267;784;913;2058;1180;2842
411200;202212;6264;15427;4718;12696;964;3022;1592;3435;2556;6457
411210;202212;4388;9219;3096;7129;394;1064;1458;2990;1852;4054
411220;202212;1198;2811;814;2133;166;456;281;654;447;1110
411230;202212;1035;2585;757;2066;168;491;240;592;408;1083
411240;202212;1914;4259;1329;3296;235;623;512;1163;747;1786
411250;202212;2795;6816;1984;5402;421;1267;564;1353;985;2620
411260;202212;381;929;246;667;36;125;106;239;142;364
411270;202212;2459;6107;1778;4801;284;835;838;1988;1122;2823
411275;202212;2012;4103;1427;3206;143;414;901;1781;1044;2195
411280;202212;1829;4546;1314;3581;299;886;419;978;718;1864
411290;202212;1036;2484;673;1790;74;243;356;860;430;1103
411295;202212;1552;3721;1131;2961;193;518;494;1167;687;1685
411300;202212;1215;2897;753;2026;87;256;284;595;371;851
411310;202212;1165;2386;903;2050;154;393;482;989;636;1382
411320;202212;7262;16742;5442;13622;785;2231;2731;5840;3516;8071
411325;202212;1822;4602;1450;3926;285;783;703;1948;988;2731
411330;202212;3982;9950;2920;8096;708;2184;866;2206;1574;4390
411340;202212;995;2573;592;1714;88;271;179;428;267;699
411342;202212;1285;2949;693;1790;126;379;260;537;386;916
411345;202212;1499;3478;1078;2762;72;212;712;1744;784;1956
411350;202212;3632;9124;2346;6600;609;1830;363;864;972;2694
411360;202212;961;2080;719;1708;75;228;393;790;468;1018
411370;202212;73208;169601;53488;136752;4203;12900;31884;73580;36087;86480
411373;202212;1760;4074;1371;3501;160;431;661;1680;821;2111
411375;202212;1350;3200;907;2364;109;310;354;807;463;1117
411380;202212;1412;3034;945;2193;38;104;639;1343;677;1447
411390;202212;1912;4740;1462;3817;228;688;631;1333;859;2021
411400;202212;2908;6544;2184;5299;232;658;1228;2693;1460;3351
411410;202212;3617;9494;2647;7486;615;1940;675;1627;1290;3567
411420;202212;5146;11967;2728;7497;382;1170;530;1027;912;2197
411430;202212;4996;11990;3762;9782;724;2106;1328;2909;2052;5015
411435;202212;540;1361;299;871;43;131;68;155;111;286
411440;202212;3251;8217;2432;6690;499;1482;690;1657;1189;3139
411450;202212;3190;7726;2390;6416;350;923;1331;3544;1681;4467
411460;202212;5578;13577;3514;9684;519;1639;899;1965;1418;3604
411470;202212;1091;2513;839;2096;104;331;461;999;565;1330
411480;202212;6666;16214;4810;12869;939;2976;1525;3391;2464;6367
411490;202212;2077;4830;1564;4047;197;585;722;1661;919;2246
411500;202212;1692;4183;1178;3135;201;584;273;539;474;1123
411510;202212;2831;6397;2195;5406;339;1004;678;1588;1017;2592
411520;202212;44606;103054;26633;68563;3132;9633;11999;26262;15131;35895
411530;202212;1142;2745;613;1745;89;291;125;311;214;602
411535;202212;628;1731;414;1264;46;149;125;336;171;485
411540;202212;3293;7424;2305;5691;137;356;1409;3293;1546;3649
411545;202212;1090;2896;910;2571;74;234;587;1614;661;1848
411550;202212;851;1985;642;1612;93;251;221;471;314;722
411560;202212;2382;6249;1262;3799;191;601;99;207;290;808
411570;202212;9565;20637;6692;16351;1540;4095;2233;4918;3773;9013
411573;202212;961;2384;771;2059;123;389;415;982;538;1371
411575;202212;2488;6133;1797;4834;328;944;587;1425;915;2369
411580;202212;5431;12463;3213;8741;458;1421;570;1148;1028;2569
411585;202212;725;2043;357;1135;63;194;52;145;115;339
411590;202212;574;1433;423;1139;44;142;230;550;274;692
411600;202212;424;985;268;725;42;111;111;262;153;373
411605;202212;1948;4170;1252;3107;155;443;605;1511;760;1954
411610;202212;3612;7327;2615;5663;65;210;1978;3874;2043;4084
411620;202212;3727;8739;3057;7729;546;1438;1471;3651;2017;5089
411630;202212;1039;2479;680;1854;106;360;271;607;377;967
411640;202212;559;1393;368;987;46;129;132;291;178;420
411650;202212;236;638;147;450;27;87;39;99;66;186
411660;202212;1058;2492;728;1872;101;269;297;662;398;931
411670;202212;1890;4160;1253;3045;122;321;725;1583;847;1904
411680;202212;1735;4322;1275;3433;243;736;458;1095;701;1831
411690;202212;4908;11552;3584;9287;781;2013;1105;2855;1886;4868
411695;202212;775;2144;526;1540;48;151;232;610;280;761
411700;202212;1978;4869;1344;3681;318;911;303;744;621;1655
411705;202212;2988;7512;2502;6713;396;1110;1557;4178;1953;5288
411710;202212;2601;6177;1775;4669;376;1039;532;1203;908;2242
411720;202212;1272;2942;889;2260;133;345;311;708;444;1053
411721;202212;1196;2831;868;2241;150;393;266;619;416;1012
411722;202212;1152;3007;677;1941;120;360;246;564;366;924
411725;202212;1565;4156;991;3015;232;769;234;621;466;1390
411727;202212;1715;4474;1115;3242;220;655;135;274;355;929
411729;202212;707;1709;408;1129;60;193;107;224;167;417
411730;202212;6826;16415;5196;13341;1069;3115;2187;5174;3256;8289
411740;202212;589;1472;319;905;76;196;69;154;145;350
411745;202212;948;2558;650;1897;95;310;158;342;253;652
411750;202212;7878;19041;5805;15249;755;2179;2942;7167;3697;9346
411760;202212;9253;22127;6919;18415;2074;5793;1465;3902;3539;9695
411770;202212;3996;10700;2926;8457;641;1978;666;1671;1307;3649
411780;202212;3229;8274;2709;7398;716;1982;925;2611;1641;4593
411790;202212;3881;8683;2394;6120;326;995;960;2015;1286;3010
411800;202212;1420;3807;1019;2859;192;601;254;551;446;1152
411810;202212;1880;4536;1361;3555;216;609;512;1148;728;1757
411820;202212;20947;49825;17603;44335;3989;10315;9263;22358;13252;32673
411830;202212;590;1437;426;1136;103;234;61;163;164;397
411840;202212;15627;38407;10889;29071;1653;4873;4146;9442;5799;14315
411845;202212;786;2073;480;1402;74;252;140;350;214;602
411850;202212;9986;23522;6871;18206;1830;5206;1379;3035;3209;8241
411860;202212;914;2398;671;1905;112;343;144;384;256;727
411870;202212;730;1971;530;1539;135;455;100;214;235;669
411880;202212;3000;6597;2155;5266;321;866;973;2148;1294;3014
411885;202212;1294;3216;902;2487;123;384;243;535;366;919
411890;202212;1828;4560;1308;3671;235;714;141;365;376;1079
411900;202212;1033;2619;630;1780;174;511;78;198;252;709
411910;202212;1335;3701;944;2907;190;682;304;816;494;1498
411915;202212;20382;46709;14036;35394;2101;5914;6198;13667;8299;19581
411920;202212;1448;3808;1174;3316;278;876;441;1096;719;1972
411925;202212;589;1416;397;1066;73;201;185;447;258;648
411930;202212;6276;17076;5273;15313;2593;7914;572;1785;3165;9699
411940;202212;4124;10915;3209;9115;736;2158;1156;2901;1892;5059
411950;202212;19888;48223;16451;42710;1907;5769;10441;25245;12348;31014
411960;202212;7295;17873;5691;14879;1041;3066;2295;5253;3336;8319
411965;202212;608;1553;436;1211;62;184;208;508;270;692
411970;202212;1426;2903;1101;2482;221;422;492;1301;713;1723
411980;202212;2063;4476;1505;3637;290;719;725;1612;1015;2331
411990;202212;50480;122030;33935;92909;6010;18204;14239;35390;20249;53594
411995;202212;6245;13972;4769;11729;1302;3608;1488;3333;2790;6941
412000;202212;2401;5015;1723;3900;40;121;1314;2730;1354;2851
412010;202212;738;2046;472;1460;58;206;117;261;175;467
412015;202212;632;1655;503;1413;81;239;259;713;340;952
412020;202212;566;1522;336;1044;51;182;107;291;158;473
412030;202212;768;2009;581;1674;77;241;271;699;348;940
412033;202212;1127;2771;773;2111;91;254;322;760;413;1014
412035;202212;841;2153;532;1585;94;298;245;688;339;986
412040;202212;862;2154;531;1497;84;252;137;298;221;550
412050;202212;1744;4116;1198;3158;296;871;242;603;538;1474
412060;202212;9009;23777;7249;20328;1923;6127;2008;5072;3931;11199
412065;202212;764;1917;545;1499;96;288;145;359;241;647
412070;202212;1609;3789;1237;3108;143;412;592;1241;735;1653
412080;202212;3319;7927;2439;6287;309;905;1269;2736;1578;3641
412085;202212;401;938;153;437;10;38;43;86;53;124
412090;202212;8009;18531;5890;14984;1255;3525;2554;6210;3809;9735
412100;202212;2283;5582;1662;4519;500;1482;401;1098;901;2580
412110;202212;1161;2868;703;1955;77;233;221;499;298;732
412120;202212;2853;7272;2204;6141;460;1467;686;1601;1146;3068
412125;202212;947;2462;555;1641;92;260;127;348;219;608
412130;202212;953;2254;620;1641;115;309;141;349;256;658
412135;202212;695;1762;342;994;43;152;134;321;177;473
412140;202212;2446;5530;1722;4303;293;791;444;1045;737;1836
412150;202212;3400;8094;2797;7036;519;1495;1421;3133;1940;4628
412160;202212;1059;3162;555;1792;40;127;48;104;88;231
412170;202212;5693;13929;4720;12408;872;2509;2271;5313;3143;7822
412175;202212;1610;4282;1303;3726;310;917;436;1202;746;2119
412180;202212;2091;5368;1534;4363;217;708;605;1543;822;2251
412190;202212;3948;9329;2789;7282;352;1054;1174;2755;1526;3809
412200;202212;2350;6222;1517;4380;391;1242;304;746;695;1988
412210;202212;792;1796;481;1290;66;199;222;534;288;733
412215;202212;4110;10171;2899;7816;635;1810;1290;3418;1925;5228
412217;202212;1233;2860;1000;2463;16;55;764;1734;780;1789
412220;202212;7369;19881;5817;16984;1347;3950;1550;4352;2897;8302
412230;202212;3407;9142;2606;7652;380;1305;480;1167;860;2472
412240;202212;9883;24190;6463;17725;1154;3434;2063;4806;3217;8240
412250;202212;2368;5772;1699;4541;418;1207;341;732;759;1939
412260;202212;1659;3970;1241;3175;221;572;420;961;641;1533
412265;202212;1264;2978;1010;2586;124;360;640;1498;764;1858
412270;202212;1304;3380;864;2467;115;363;356;872;471;1235
412280;202212;503;1303;374;1069;80;230;88;214;168;444
412290;202212;1303;3031;951;2440;167;464;363;855;530;1319
412300;202212;2201;5240;1609;4246;278;778;529;1213;807;1991
412310;202212;791;2176;563;1709;96;353;153;375;249;728
412320;202212;895;2183;554;1503;52;192;184;454;236;646
412330;202212;1954;4777;1267;3537;257;784;331;852;588;1636
412340;202212;1458;3704;1018;2846;157;485;140;354;297;839
412350;202212;3878;9620;2507;6982;449;1360;688;1597;1137;2957
412360;202212;351;836;266;679;6;21;189;456;195;477
412370;202212;1379;3475;950;2670;193;564;231;598;424;1162
412380;202212;1825;4798;1302;3787;315;976;76;236;391;1212
412382;202212;613;1413;396;1044;45;158;210;451;255;609
412385;202212;2893;6927;2275;5811;637;1588;818;2142;1455;3730
412390;202212;3036;6876;2354;5784;439;1155;755;1749;1194;2904
412395;202212;917;2310;642;1740;87;237;317;791;404;1028
412400;202212;1150;2782;790;2105;138;400;255;573;393;973
412402;202212;2963;6824;2030;5316;453;1166;580;1509;1033;2675
412405;202212;3697;9321;2411;6986;672;1933;360;956;1032;2889
412410;202212;7987;19444;5845;15999;1053;3327;1911;4696;2964;8023
412420;202212;634;1490;397;1033;40;121;154;356;194;477
412430;202212;653;1589;352;969;51;133;137;355;188;488
412440;202212;3650;8805;2542;6911;581;1619;769;1969;1350;3588
412450;202212;645;1769;406;1199;52;162;42;77;94;239
412460;202212;1422;3226;1085;2685;205;548;489;1145;694;1693
412470;202212;1953;5563;1593;4794;385;1316;451;1198;836;2514
412480;202212;1646;3806;1108;2785;190;521;449;970;639;1491
412490;202212;1629;3674;1243;3034;81;235;741;1623;822;1858
412500;202212;2512;5833;1835;4647;310;860;611;1334;921;2194
412510;202212;2361;6612;1677;4998;447;1434;294;662;741;2096
412520;202212;1694;4055;1028;2766;203;535;153;362;356;897
412530;202212;828;2090;594;1647;105;300;137;341;242;641
412535;202212;968;2455;557;1611;82;254;68;136;150;390
412540;202212;1289;3148;909;2494;169;585;216;553;385;1138
412545;202212;878;2143;572;1549;102;293;190;483;292;776
412550;202212;46536;113494;33939;89675;4921;14396;16410;38132;21331;52528
412555;202212;355;854;231;594;26;86;81;149;107;235
412560;202212;6600;17099;4870;13410;1179;3615;1113;2594;2292;6209
412570;202212;5232;12169;3140;8343;540;1630;617;1292;1157;2922
412575;202212;1395;3142;1096;2657;245;579;524;1152;769;1731
412580;202212;1946;4528;1383;3545;120;342;790;1811;910;2153
412590;202212;547;1362;290;820;57;179;38;72;95;251
412600;202212;2098;4936;1652;4116;98;320;1092;2459;1190;2779
412610;202212;1013;2546;729;1963;99;274;337;774;436;1048
412620;202212;1547;3696;1191;3144;230;665;505;1203;735;1868
412625;202212;11622;29149;7680;21547;1536;4612;1137;2590;2673;7202
412627;202212;1399;3644;956;2787;237;772;199;520;436;1292
412630;202212;3358;9259;2299;7010;384;1294;551;1439;935;2733
412635;202212;560;1393;341;971;54;165;102;229;156;394
412640;202212;1193;2998;677;1921;103;295;124;270;227;565
412650;202212;2068;5289;1603;4354;269;819;626;1480;895;2299
412660;202212;3498;8214;2455;6300;287;820;962;2133;1249;2953
412665;202212;509;1199;384;983;77;212;155;362;232;574
412667;202212;2051;5140;1473;4015;225;684;625;1595;850;2279
412670;202212;1153;2461;780;1878;138;393;327;639;465;1032
412680;202212;2543;6376;1714;4862;193;631;515;1180;708;1811
412690;202212;1407;3374;971;2552;183;527;352;794;535;1321
412700;202212;2279;5500;1868;4852;388;1112;877;2077;1265;3189
412710;202212;6856;18447;5043;14760;875;2805;1403;3298;2278;6103
412720;202212;1587;4221;1273;3594;189;592;410;882;599;1474
412730;202212;3345;8003;2454;6366;411;1230;1070;2397;1481;3627
412740;202212;2495;6486;1673;4911;313;1033;287;754;600;1787
412750;202212;4846;11874;3871;10350;483;1439;2190;5435;2673;6874
412760;202212;3887;9429;3193;8279;619;1871;1750;4159;2369;6030
412770;202212;14985;36869;8360;24045;1114;3446;2107;4885;3221;8331
412780;202212;1550;3734;1122;3000;266;797;368;855;634;1652
412785;202212;2711;5817;1876;4485;248;632;1218;2757;1466;3389
412788;202212;1693;4454;1355;3868;355;1040;506;1337;861;2377
412790;202212;1677;4091;1055;2938;167;524;424;961;591;1485
412795;202212;1475;3560;851;2371;134;407;214;517;348;924
412796;202212;2728;7271;2265;6471;509;1559;720;1843;1229;3402
412800;202212;5190;11249;3741;8733;374;1101;2124;4240;2498;5341
412810;202212;16411;38933;10964;28471;1254;3743;4807;10722;6061;14465
412820;202212;7818;20003;5492;15449;1364;4081;1495;3933;2859;8014
412830;202212;413;1092;309;886;36;101;87;222;123;323
412840;202212;2416;5251;1728;4006;138;403;1098;2216;1236;2619
412850;202212;3380;8197;2516;6798;280;903;1296;3131;1576;4034
412853;202212;2011;4538;1678;3977;205;577;975;1966;1180;2543
412855;202212;1657;4027;874;2411;120;357;202;429;322;786
412860;202212;904;2172;584;1638;106;326;227;552;333;878
412862;202212;790;1892;529;1458;97;260;214;543;311;803
412863;202212;1549;4187;1352;3826;289;920;659;1660;948;2580
412865;202212;822;2101;591;1638;153;444;152;385;305;829
412870;202212;1185;2839;840;2291;243;750;228;591;471;1341
412880;202212;1146;2917;833;2341;178;542;303;759;481;1301
420005;202212;545;1512;315;953;29;77;152;450;181;527
420010;202212;3936;8896;2601;6640;167;474;1904;4797;2071;5271
420020;202212;528;1551;371;1172;71;262;128;307;199;569
420030;202212;151;505;109;397;29;115;28;97;57;212
420040;202212;725;2110;443;1475;81;312;35;94;116;406
420050;202212;942;2148;648;1588;106;304;382;808;488;1112
420055;202212;207;592;119;376;20;79;48;130;68;209
420060;202212;235;620;171;480;24;71;83;213;107;284
420070;202212;1088;2968;848;2493;168;546;447;1216;615;1762
420075;202212;104;274;55;166;9;29;20;41;29;70
420080;202212;517;1416;352;1008;69;211;101;250;170;461
420090;202212;555;1623;356;1163;76;273;85;222;161;495
420100;202212;1861;4164;1516;3624;104;253;1123;2655;1227;2908
420110;202212;368;1086;311;964;46;163;173;510;219;673
420120;202212;792;2035;548;1522;73;236;278;692;351;928
420125;202212;457;1320;319;1004;66;207;100;290;166;497
420127;202212;401;1037;177;526;31;107;67;180;98;287
420130;202212;5939;15427;4509;12906;879;2876;1855;4521;2734;7397
420140;202212;5846;14633;4476;12258;1233;3777;1166;2800;2399;6577
420150;202212;867;2102;639;1735;53;166;360;931;413;1097
420160;202212;257;614;110;318;19;72;35;87;54;159
420165;202212;220;636;134;433;31;110;38;97;69;207
420170;202212;404;1134;311;919;52;169;139;345;191;514
420180;202212;192;595;106;384;16;73;28;89;44;162
420190;202212;262;742;155;475;30;92;49;136;79;228
420195;202212;2492;6053;1943;5164;472;1440;890;2108;1362;3548
420200;202212;9762;21785;6463;15826;813;2303;3216;6507;4029;8810
420205;202212;2746;6781;1856;5001;265;783;978;2449;1243;3232
420207;202212;2811;6766;1846;4967;336;1027;783;1851;1119;2878
420208;202212;435;1198;261;834;89;291;53;128;142;419
420209;202212;209;628;127;399;14;51;63;172;77;223
420210;202212;5476;13203;3962;10572;623;1881;2054;5007;2677;6888
420213;202212;1016;2802;809;2356;158;497;323;889;481;1386
420215;202212;300;844;204;631;53;169;61;177;114;346
420220;202212;431;1237;295;947;49;188;115;312;164;500
420230;202212;7704;18969;6031;15905;727;2224;3479;8342;4206;10566
420240;202212;20071;52690;13190;36994;1656;5427;6150;14339;7806;19766
420243;202212;598;1415;485;1209;79;226;315;748;394;974
420245;202212;2580;6024;1970;4976;164;486;1248;2906;1412;3392
420250;202212;799;1774;699;1634;47;152;560;1226;607;1378
420253;202212;590;1355;420;1103;38;99;256;658;294;757
420257;202212;209;511;143;395;26;83;67;179;93;262
420260;202212;1552;3595;1188;3107;94;301;887;2239;981;2540
420270;202212;719;1773;364;962;40;113;164;381;204;494
420280;202212;1955;5243;1537;4358;200;668;738;1880;938;2548
420285;202212;197;541;114;333;18;67;35;69;53;136
420287;202212;591;1279;418;1037;77;202;177;415;254;617
420290;202212;7150;18847;5647;15681;802;2602;3281;8201;4083;10803
420300;202212;9961;26540;5719;16724;1071;3381;1780;4433;2851;7814
420310;202212;1057;2245;624;1528;67;184;327;714;394;898
420315;202212;1165;2992;739;2134;91;287;384;1013;475;1300
420320;202212;8028;20201;6075;17047;1718;5168;1890;4844;3608;10012
420325;202212;417;1121;290;862;41;142;114;286;155;428
420330;202212;1334;3700;836;2576;162;545;271;723;433;1268
420340;202212;1548;3693;1189;3064;275;755;479;1068;754;1823
420350;202212;1748;3857;1332;3154;148;389;904;2036;1052;2425
420360;202212;3735;9761;2031;6133;356;1170;179;481;535;1651
420370;202212;1739;4174;1399;3586;116;384;980;2311;1096;2695
420380;202212;5777;14169;3999;10925;742;2316;1794;4382;2536;6698
420390;202212;1380;3355;980;2572;185;550;346;609;531;1159
420395;202212;1584;4164;1123;3294;164;533;222;470;386;1003
420400;202212;1493;3713;1059;2891;129;397;585;1461;714;1858
420410;202212;737;1822;539;1415;70;193;309;784;379;977
420415;202212;442;1190;314;895;61;192;137;372;198;564
420417;202212;787;2211;607;1822;142;411;277;862;419;1273
420419;202212;188;614;131;454;43;161;13;52;56;213
420420;202212;18664;45973;13016;35305;3238;9952;4485;10566;7723;20518
420425;202212;795;2092;551;1574;54;181;285;759;339;940
420430;202212;4245;10711;2708;7466;453;1424;1142;2660;1595;4084
420435;202212;438;1089;256;744;55;169;121;336;176;505
420440;202212;1078;2623;723;1894;246;602;240;610;486;1212
420445;202212;295;683;182;473;29;82;60;119;89;201
420450;202212;1091;2996;797;2344;147;524;328;808;475;1332
420455;202212;2685;5997;1972;4901;484;1205;786;1959;1270;3164
420460;202212;12670;31201;9861;26137;1341;4132;5625;13582;6966;17714
420470;202212;816;2059;450;1241;77;242;121;259;198;501
420475;202212;86;227;38;120;6;23;9;26;15;49
420480;202212;7251;16973;4722;12595;849;2401;2051;5153;2900;7554
420490;202212;487;1281;332;933;53;176;149;371;202;547
420500;202212;1719;4418;1145;3372;198;696;537;1427;735;2123
420510;202212;190;496;114;336;18;67;36;78;54;145
420515;202212;162;448;115;337;16;59;42;92;58;151
420517;202212;903;2178;747;1891;87;230;441;1097;528;1327
420519;202212;387;956;270;758;33;100;129;350;162;450
420520;202212;365;960;199;635;30;106;7;10;37;116
420530;202212;979;2810;669;2112;126;461;212;541;338;1002
420535;202212;264;733;100;323;11;37;28;69;39;106
420540;202212;52852;119630;36996;93145;4958;14504;16200;34459;21158;48963
420543;202212;298;822;227;658;29;103;95;235;124;338
420545;202212;1914;5501;1434;4415;292;951;546;1508;838;2459
420550;202212;5492;13365;3544;9815;581;1730;1482;3814;2063;5544
420555;202212;429;1163;291;875;37;133;150;403;187;536
420560;202212;540;1200;386;981;55;150;214;530;269;680
420570;202212;3889;9318;2927;7577;474;1424;1568;3677;2042;5101
420580;202212;2235;5906;1557;4715;364;1202;474;1293;838;2495
420590;202212;3900;10047;2485;7007;398;1280;740;1648;1138;2928
420600;202212;1639;4167;1333;3603;110;407;874;2161;984;2568
420610;202212;707;1846;478;1388;108;307;224;626;332;933
420620;202212;1067;2599;737;2027;134;402;297;774;431;1176
420630;202212;1324;3782;939;2851;152;519;422;1151;574;1670
420640;202212;606;1633;316;1014;79;256;18;45;97;301
420650;202212;4593;11344;3116;8360;448;1401;1419;3096;1867;4497
420660;202212;554;1351;339;888;59;165;67;139;126;304
420665;202212;910;2210;607;1676;99;304;277;655;376;959
420670;202212;1534;4169;883;2693;90;314;188;424;278;738
420675;202212;263;651;169;487;15;57;103;266;118;323
420680;202212;356;758;200;541;23;87;116;278;139;365
420690;202212;1194;3221;790;2279;113;357;266;624;379;981
420700;202212;4054;10003;3178;8446;268;823;2138;5349;2406;6172
420710;202212;1384;3740;1126;3198;150;502;628;1544;778;2046
420720;202212;1707;4352;1291;3597;201;621;762;1947;963;2568
420730;202212;4751;11530;3678;9743;628;1895;1906;4566;2534;6461
420740;202212;600;1652;345;1083;79;272;61;155;140;427
420750;202212;2774;7617;1840;5488;299;1083;713;1828;1012;2911
420757;202212;139;348;67;207;8;26;33;99;41;125
420760;202212;487;1334;258;741;41;122;83;194;124;316
420765;202212;707;1940;371;1097;60;203;194;553;254;756
420768;202212;1729;4380;1458;3904;176;465;1029;2711;1205;3176
420770;202212;403;1077;168;583;17;71;30;80;47;151
420775;202212;371;972;221;669;40;136;82;216;122;352
420780;202212;1226;3279;743;2183;141;400;127;341;268;741
420785;202212;281;689;204;540;17;50;93;184;110;234
420790;202212;1473;3924;1123;3182;217;753;631;1559;848;2312
420800;202212;965;2174;603;1512;147;386;311;718;458;1104
420810;202212;1914;5343;1571;4656;383;1355;736;1838;1119;3193
420820;202212;18236;43458;13547;35863;1960;5702;7076;17215;9036;22917
420830;202212;6447;15800;4823;12916;838;2561;2148;5260;2986;7821
420840;202212;746;2247;384;1329;75;284;35;112;110;396
420845;202212;3905;9447;2730;7413;530;1722;1215;2984;1745;4706
420850;202212;1333;3919;948;2979;176;604;288;767;464;1371
420860;202212;481;1240;288;880;78;246;77;203;155;449
420870;202212;1044;2766;702;2067;154;482;245;658;399;1140
420880;202212;1532;4271;1206;3617;253;833;498;1351;751;2184
420890;202212;9936;25761;6220;17960;917;2934;2166;5253;3083;8187
420895;202212;238;669;149;445;25;81;65;171;90;252
420900;202212;2061;4884;1272;3472;163;550;578;1292;741;1842
420910;202212;45762;114214;31409;87468;4766;15250;14194;33828;18960;49078
420915;202212;571;1930;458;1652;74;297;220;773;294;1070
420917;202212;606;1456;296;731;48;99;165;397;213;496
420920;202212;110;278;45;131;3;7;10;24;13;31
420930;202212;23427;55137;17424;44706;2418;7172;9718;22407;12136;29579
420940;202212;4557;10573;2959;7864;597;1828;876;1764;1473;3592
420945;202212;241;702;139;411;26;87;56;140;82;227
420950;202212;509;1354;333;970;58;199;99;234;157;433
420960;202212;1389;3285;1001;2637;160;492;443;999;603;1491
420970;202212;2934;7391;2018;5703;413;1217;643;1814;1056;3031
420980;202212;324;1069;262;915;88;325;55;183;143;508
420985;202212;478;1255;270;833;51;173;73;198;124;371
420990;202212;453;1295;281;890;50;163;60;151;110;314
421000;202212;726;2100;492;1569;109;360;94;236;203;596
421003;202212;544;1305;190;542;15;41;15;33;30;74
421005;202212;131;371;90;279;14;43;37;116;51;159
421010;202212;4773;11981;3458;9522;590;1925;1335;2957;1925;4882
421020;202212;506;1487;395;1260;57;224;208;605;265;829
421030;202212;1328;3487;1010;2846;217;677;395;1004;612;1681
421040;202212;860;1974;510;1393;56;170;315;808;371;978
421050;202212;1531;3930;1015;2778;163;516;382;838;545;1354
421055;202212;208;565;123;376;20;71;53;135;73;206
421060;202212;931;2477;668;1909;119;389;307;740;426;1129
421070;202212;825;2274;503;1485;95;312;223;564;318;876
421080;202212;664;1831;521;1538;84;298;227;606;311;904
421085;202212;424;1169;186;607;23;76;33;90;56;166
421090;202212;373;933;210;562;21;77;87;181;108;258
421100;202212;1086;2302;505;1357;84;240;140;321;224;561
421105;202212;1981;4981;1420;3936;264;774;598;1521;862;2295
421110;202212;1659;3900;1381;3496;122;375;904;2204;1026;2579
421120;202212;1380;3935;971;3033;134;467;322;841;456;1308
421125;202212;480;1156;346;866;89;238;145;332;234;570
421130;202212;7979;21057;6574;18249;1215;3755;3507;8957;4722;12712
421140;202212;446;1167;301;876;72;205;107;275;179;480
421145;202212;517;1324;345;969;92;291;103;235;195;526
421150;202212;965;2568;653;1902;120;398;269;652;389;1050
421160;202212;812;2088;631;1720;88;292;397;978;485;1270
421165;202212;292;821;180;535;33;99;58;137;91;236
421170;202212;1520;3743;1303;3400;119;327;965;2474;1084;2801
421175;202212;1343;3367;806;2396;156;538;326;891;482;1429
421180;202212;505;1231;285;790;34;112;147;343;181;455
421185;202212;406;992;287;759;43;126;138;315;181;441
421187;202212;328;971;198;643;41;126;72;228;113;354
421189;202212;507;1366;384;1119;57;191;161;410;218;601
421190;202212;17966;45305;13455;36598;2262;7054;6266;14941;8528;21995
421200;202212;995;2555;762;2098;100;325;421;1084;521;1409
421205;202212;297;756;226;629;48;144;87;228;135;372
421210;202212;1405;3402;791;2308;173;494;262;714;435;1208
421220;202212;1806;4928;1417;4134;376;1171;484;1250;860;2421
421223;202212;500;1220;341;943;68;206;189;486;257;692
421225;202212;1348;3520;1169;3235;133;453;779;2077;912;2530
421227;202212;896;2378;572;1691;119;377;229;656;348;1033
421230;202212;795;1987;542;1519;107;328;199;518;306;846
421240;202212;330;937;150;510;22;98;33;85;55;183
421250;202212;3277;7833;2454;6486;405;1065;1431;3588;1836;4653
421260;202212;325;998;87;271;16;52;11;26;27;78
421265;202212;1206;2694;1036;2456;89;203;845;1978;934;2181
421270;202212;480;1254;246;772;60;204;87;250;147;454
421280;202212;3266;8048;2479;6707;397;1215;1275;3191;1672;4406
421290;202212;1410;3655;670;1901;110;331;141;339;251;670
421300;202212;410;1071;200;618;29;95;35;94;64;189
421310;202212;302;809;204;602;65;196;78;206;143;402
421315;202212;378;947;232;640;49;144;79;193;128;337
421320;202212;795;2414;433;1394;39;122;62;103;101;225
421330;202212;764;2133;502;1543;104;337;145;399;249;736
421335;202212;502;1436;401;1242;62;213;197;573;259;786
421340;202212;1815;4802;1257;3775;204;679;525;1440;729;2119
421350;202212;2174;5161;1448;3945;284;816;536;1402;820;2218
421360;202212;2811;7104;1700;4881;432;1449;551;1179;983;2628
421370;202212;964;2921;606;1974;104;381;195;510;299;891
421380;202212;1102;2582;963;2370;86;263;672;1556;758;1819
421390;202212;196;528;84;286;25;85;20;59;45;144
421400;202212;804;2055;547;1554;95;307;251;630;346;937
421410;202212;236;657;127;424;36;103;31;135;67;238
421415;202212;250;649;175;468;20;60;67;158;87;218
421420;202212;773;2038;553;1545;68;212;275;695;343;907
421430;202212;119;347;76;238;11;34;14;30;25;64
421440;202212;852;2220;522;1560;105;313;208;586;313;899
421450;202212;554;1585;355;1127;45;152;42;135;87;287
421460;202212;432;1285;232;816;14;46;18;48;32;94
421470;202212;461;1238;322;970;46;144;108;322;154;466
421480;202212;4073;10273;2825;7737;376;1219;1283;3096;1659;4315
421490;202212;146;452;91;308;13;52;22;63;35;115
421500;202212;3046;8233;2135;6316;444;1510;646;1532;1090;3042
421505;202212;400;996;330;888;33;108;206;534;239;642
421507;202212;538;1377;322;913;51;158;142;354;193;512
421510;202212;524;1379;343;971;45;152;154;340;199;492
421520;202212;561;1463;317;881;49;132;109;252;158;384
421530;202212;419;1224;242;817;34;152;51;118;85;270
421535;202212;554;1388;338;924;48;144;186;462;234;606
421540;202212;443;992;259;697;24;79;104;252;128;331
421545;202212;854;2373;641;1965;126;444;298;821;424;1265
421550;202212;2871;7196;2189;5962;356;1055;1156;2958;1512;4013
421555;202212;274;750;76;232;12;40;15;25;27;65
421560;202212;125;394;74;253;14;55;24;62;38;117
421565;202212;1268;3093;918;2514;215;654;371;912;586;1566
421567;202212;630;1827;460;1372;132;426;122;350;254;776
421568;202212;389;1102;204;639;40;149;63;175;103;324
421569;202212;196;538;85;248;11;40;46;116;57;156
421570;202212;1988;5206;1424;4008;267;840;586;1386;853;2226
421575;202212;401;1095;288;794;38;132;151;361;189;493
421580;202212;6224;15893;4007;11187;575;1854;1707;3966;2282;5820
421590;202212;232;620;178;510;40;127;78;206;118;333
421600;202212;748;1858;493;1324;82;252;188;412;270;664
421605;202212;871;2192;626;1778;109;299;256;724;365;1023
421610;202212;1266;3191;874;2454;174;550;338;855;512;1405
421620;202212;5045;12527;3465;9700;662;2137;1475;3631;2137;5768
421625;202212;158;442;84;253;12;33;24;59;36;92
421630;202212;3647;9094;2383;6645;405;1284;827;1954;1232;3238
421635;202212;560;1426;379;1057;31;111;224;528;255;639
421640;202212;900;2229;648;1835;160;452;314;846;474;1298
421650;202212;3469;8710;2340;6683;476;1568;792;1940;1268;3508
421660;202212;15945;40952;11823;32960;1648;5336;6053;14930;7701;20266
421670;202212;1161;3064;796;2183;151;462;344;815;495;1277
421680;202212;2261;4476;1878;3896;117;319;1515;2917;1632;3236
421690;202212;1899;5173;1299;3903;249;804;358;984;607;1788
421700;202212;788;2210;500;1514;87;288;147;354;234;642
421710;202212;269;815;147;467;17;57;65;185;82;242
421715;202212;206;511;152;380;26;79;93;204;119;283
421720;202212;2667;6921;1587;4606;340;1099;470;1126;810;2225
421725;202212;370;882;200;555;30;90;92;210;122;300
421730;202212;685;1911;446;1260;75;218;207;523;282;741
421740;202212;1078;2871;739;2165;130;412;290;706;420;1118
421750;202212;1221;2834;665;1820;143;420;217;539;360;959
421755;202212;215;580;117;344;20;67;43;103;63;170
421760;202212;1364;3356;874;2456;163;519;324;778;487;1297
421770;202212;3217;7913;2290;6283;420;1175;896;2319;1316;3494
421775;202212;261;676;152;443;16;52;49;107;65;159
421780;202212;1190;3151;798;2344;139;441;349;893;488;1334
421790;202212;1145;2946;615;1875;131;414;182;488;313;902
421795;202212;247;687;172;515;26;81;55;141;81;222
421800;202212;4242;10730;3147;8684;503;1531;1566;3939;2069;5470
421810;202212;742;1916;502;1470;60;179;249;708;309;887
421820;202212;1431;3912;953;2801;175;606;310;745;485;1351
421825;202212;2035;4589;1698;4069;121;323;1239;2887;1360;3210
421830;202212;2440;6694;1797;5360;384;1236;418;1135;802;2371
421835;202212;324;744;227;578;31;86;133;323;164;409
421840;202212;438;1312;343;1087;73;266;98;277;171;543
421850;202212;488;1367;276;927;50;172;53;133;103;305
421860;202212;313;800;173;522;24;85;61;134;85;219
421870;202212;6677;15636;5102;12690;577;1801;3123;6756;3700;8557
421875;202212;396;1154;161;498;24;76;37;97;61;173
421880;202212;839;2265;547;1614;110;305;143;388;253;693
421885;202212;356;944;213;612;30;88;95;242;125;330
421890;202212;1311;3382;965;2722;142;500;579;1486;721;1986
421895;202212;531;1281;457;1163;52;112;292;766;344;878
421900;202212;1388;3486;1000;2627;124;393;482;1040;606;1433
421910;202212;416;1227;223;744;32;138;44;110;76;248
421915;202212;493;1330;292;847;69;218;59;127;128;345
421917;202212;794;1751;446;1236;110;323;107;296;217;619
421920;202212;523;1502;359;1142;110;362;102;317;212;679
421930;202212;4127;9873;2413;6666;450;1352;843;1971;1293;3323
421935;202212;539;1501;435;1292;106;296;235;700;341;996
421940;202212;443;1250;209;628;35;110;67;168;102;278
421950;202212;4163;10158;2462;6881;460;1410;723;1652;1183;3062
421960;202212;194;471;108;314;14;38;37;90;51;128
421970;202212;2593;6398;1622;4368;298;927;682;1554;980;2481
421985;202212;403;1059;272;784;30;97;135;354;165;451
422000;202212;2549;5944;2010;5151;165;517;1391;3447;1556;3964
430003;202212;751;1869;528;1483;90;276;264;713;354;989
430005;202212;433;1000;319;812;15;47;227;523;242;570
430010;202212;2308;4904;1702;3989;332;752;909;2132;1241;2884
430020;202212;697;1510;510;1241;58;170;325;728;383;898
430030;202212;1310;2895;757;1894;111;292;424;972;535;1264
430040;202212;12341;27090;7896;19795;2059;5538;2195;4941;4254;10479
430045;202212;683;1504;498;1194;28;84;374;854;402;938
430047;202212;296;636;117;305;19;49;40;102;59;151
430050;202212;1029;2397;629;1645;118;323;293;707;411;1030
430055;202212;326;744;155;401;14;40;81;179;95;219
430057;202212;115;253;55;147;18;46;13;36;31;82
430060;202212;27209;64557;21736;56139;3635;10221;11846;29157;15481;39378
430063;202212;914;2340;758;2047;145;386;431;1148;576;1534
430064;202212;1434;3537;1035;2805;185;534;549;1421;734;1955
430066;202212;133;286;102;235;9;28;82;177;91;205
430070;202212;780;1957;175;530;30;98;28;68;58;166
430080;202212;1152;2717;667;1752;96;308;362;811;458;1119
430085;202212;1158;2288;691;1584;106;276;322;693;428;969
430087;202212;1152;2588;939;2305;82;247;625;1461;707;1708
430090;202212;548;1366;212;671;38;130;47;123;85;253
430100;202212;1303;2950;756;1942;125;355;282;604;407;959
430105;202212;1812;4227;1273;3332;180;561;674;1619;854;2180
430107;202212;201;549;102;291;15;39;30;73;45;112
430110;202212;2739;6237;2063;5222;332;934;1007;2392;1339;3326
430120;202212;1591;4142;1094;2974;189;506;497;1249;686;1755
430130;202212;4397;9143;3261;7599;1124;2604;678;1866;1802;4470
430140;202212;1284;3079;903;2406;145;424;443;1103;588;1527
430150;202212;683;1676;372;1059;76;242;108;264;184;506
430155;202212;285;680;127;364;20;60;23;44;43;104
430160;202212;27436;56006;22122;48786;1716;4475;15834;33007;17550;37482
430163;202212;4383;8738;3132;6964;71;237;2555;5402;2626;5639
430165;202212;392;961;139;423;12;34;24;55;36;89
430170;202212;1129;2806;384;1241;81;312;61;142;142;454
430175;202212;1059;2427;907;2147;164;387;522;1195;686;1582
430180;202212;837;1955;599;1527;122;306;257;637;379;943
430185;202212;775;1891;384;1077;97;292;77;174;174;466
430187;202212;1055;2022;784;1704;90;187;545;1166;635;1353
430190;202212;1839;4231;1423;3589;265;685;677;1583;942;2268
430192;202212;138;357;58;164;12;34;19;43;31;77
430195;202212;523;1440;83;261;9;29;16;38;25;67
430200;202212;1403;3664;1096;3119;309;910;263;778;572;1688
430205;202212;674;1321;626;1233;10;30;588;1126;598;1156
430210;202212;8839;21527;5272;13938;743;2141;1546;3104;2289;5245
430215;202212;415;953;256;651;39;110;113;265;152;375
430220;202212;706;1678;237;704;28;94;80;184;108;278
430222;202212;294;747;199;565;36;104;72;188;108;292
430223;202212;338;813;256;677;26;76;155;384;181;460
430225;202212;34;70;25;55;2;3;16;32;18;35
430230;202212;2552;6086;2138;5504;113;330;1721;4352;1834;4682
430235;202212;545;1385;346;985;53;158;94;214;147;372
430237;202212;662;1359;500;1113;25;71;400;847;425;918
430240;202212;1673;3711;932;2411;119;361;444;998;563;1359
430245;202212;934;2238;745;1901;141;343;435;1135;576;1478
430250;202212;1268;2846;912;2268;303;812;228;487;531;1299
430258;202212;157;392;117;315;12;35;55;143;67;178
430260;202212;868;2027;582;1512;66;200;332;827;398;1027
430265;202212;287;781;196;616;25;86;75;233;100;319
430270;202212;4209;8692;3401;7519;376;986;2457;5073;2833;6059
430280;202212;6404;13495;4612;10611;751;1806;2410;5192;3161;6998
430290;202212;2736;5610;2223;4993;173;439;1694;3632;1867;4071
430300;202212;13420;29659;10308;24620;1270;3527;6293;13856;7563;17383
430310;202212;17186;39108;12551;30928;1553;4252;7277;16445;8830;20697
430320;202212;1125;2664;640;1740;61;170;356;926;417;1096
430330;202212;795;1830;461;1183;83;221;164;368;247;589
430340;202212;776;1654;532;1274;75;182;344;782;419;964
430350;202212;10820;24037;8355;20003;1069;2792;5093;11423;6162;14215
430355;202212;408;1068;162;501;32;93;18;45;50;138
430360;202212;1077;2438;650;1710;150;439;198;451;348;890
430367;202212;427;871;269;621;36;115;167;337;203;452
430370;202212;582;1516;238;696;51;153;60;134;111;287
430380;202212;770;1806;391;1132;78;236;94;239;172;475
430390;202212;4365;10037;2879;7428;588;1617;377;729;965;2346
430400;202212;1305;2516;957;2048;137;351;553;1065;690;1416
430410;202212;678;1446;494;1167;46;124;363;822;409;946
430420;202212;3832;8766;2968;7100;377;1079;1876;3988;2253;5067
430430;202212;620;1489;271;788;49;157;47;121;96;278
430435;202212;2216;4996;1626;3993;270;710;819;1919;1089;2629
430440;202212;5824;13676;4743;11938;508;1447;3125;7466;3633;8913
430450;202212;9570;20391;7783;17484;1259;3279;4456;9180;5715;12459
430460;202212;50040;113084;36681;91492;5002;13861;20618;48094;25620;61955
430461;202212;255;651;98;283;20;67;38;90;58;157
430462;202212;382;935;195;558;36;105;55;133;91;238
430463;202212;9146;21924;6758;17649;1324;3904;3136;7555;4460;11459
430465;202212;706;1601;469;1175;77;216;262;626;339;842
430466;202212;6080;13636;4902;11897;811;2158;2846;6347;3657;8505
430467;202212;633;1419;465;1164;47;137;287;659;334;796
430468;202212;1809;3993;1473;3518;100;314;1129;2556;1229;2870
430469;202212;720;1939;135;408;16;46;43;98;59;144
430470;202212;7223;17169;4822;13019;1250;3844;1269;2931;2519;6775
430471;202212;950;2270;811;2037;102;311;554;1272;656;1583
430480;202212;759;1986;478;1385;73;233;148;329;221;562
430485;202212;203;498;97;258;22;48;23;60;45;108
430490;202212;537;1282;311;836;37;106;154;346;191;452
430495;202212;469;1221;316;931;49;157;154;426;203;583
430500;202212;1205;2886;843;2298;274;843;235;540;509;1383
430510;202212;34931;84307;25382;66611;4441;13092;11471;26582;15912;39674
430511;202212;394;1056;150;462;21;58;22;52;43;110
430512;202212;1269;2609;1015;2245;225;535;430;923;655;1458
430513;202212;952;2133;476;1185;62;183;272;587;334;770
430515;202212;468;1186;333;921;38;119;158;401;196;520
430517;202212;1717;4316;1304;3469;214;560;738;1923;952;2483
430520;202212;1612;3845;892;2370;139;388;232;542;371;930
430530;202212;1136;2694;476;1342;77;220;134;344;211;564
430535;202212;4530;10604;3238;8374;467;1271;1660;4023;2127;5294
430537;202212;676;1489;597;1343;61;120;457;1007;518;1127
430540;202212;702;1612;419;1144;64;180;230;597;294;777
430543;202212;1318;2225;821;1648;198;370;226;509;424;879
430544;202212;827;2198;544;1593;137;433;180;507;317;940
430545;202212;3214;7395;2437;6258;402;1073;1357;3370;1759;4443
430550;202212;450;1163;326;916;92;248;92;244;184;492
430558;202212;182;397;76;191;3;7;39;89;42;96
430560;202212;352;782;179;509;25;81;61;144;86;225
430570;202212;1037;2328;724;1794;144;448;338;660;482;1108
430580;202212;989;2398;719;1993;170;450;278;867;448;1317
430583;202212;211;516;48;135;4;13;13;24;17;37
430585;202212;248;567;131;339;28;83;42;87;70;170
430587;202212;242;621;180;519;21;67;80;224;101;291
430590;202212;1652;3694;1297;3138;141;360;871;2043;1012;2403
430593;202212;36;100;28;73;6;20;14;29;20;49
430595;202212;489;1195;125;365;19;50;23;41;42;91
430597;202212;540;1285;274;752;24;61;85;174;109;235
430600;202212;2347;5844;1009;2774;154;438;217;518;371;956
430605;202212;1634;3885;1186;3119;175;479;531;1325;706;1804
430607;202212;831;1752;546;1264;39;101;355;773;394;874
430610;202212;7811;16647;5634;13457;1380;3910;2203;4503;3583;8413
430613;202212;305;681;87;242;9;26;25;55;34;81
430620;202212;980;2163;734;1736;144;399;378;749;522;1148
430630;202212;519;1357;163;464;27;78;52;124;79;202
430632;202212;514;1284;216;595;37;103;80;197;117;300
430635;202212;705;1450;515;1129;51;103;369;800;420;903
430637;202212;621;1387;458;1134;42;122;300;691;342;813
430640;202212;1363;3517;913;2614;139;423;345;863;484;1286
430642;202212;438;1159;268;758;42;135;108;272;150;407
430645;202212;196;441;100;245;12;33;34;62;46;95
430650;202212;2267;5540;1670;4596;509;1328;630;1916;1139;3244
430655;202212;378;857;230;572;27;84;133;276;160;360
430660;202212;6609;15050;5023;12527;840;2337;2644;6155;3484;8492
430670;202212;735;1655;518;1279;93;220;232;545;325;765
430673;202212;616;1327;282;747;63;164;104;249;167;413
430675;202212;281;790;66;219;11;39;9;31;20;70
430676;202212;7311;16512;5824;14204;921;2324;3518;8222;4439;10546
430680;202212;1471;3509;959;2537;297;846;334;673;631;1519
430690;202212;4046;9385;3200;7950;964;2488;1268;3057;2232;5545
430692;202212;246;686;198;607;11;32;154;470;165;502
430693;202212;1149;2851;692;1967;154;481;193;504;347;985
430695;202212;467;1053;282;692;50;127;130;284;180;411
430697;202212;624;1408;488;1221;73;195;306;760;379;955
430700;202212;10030;22887;6414;16503;1356;3861;1662;3532;3018;7393
430705;202212;433;959;215;575;24;68;89;209;113;277
430710;202212;2357;4195;1599;3215;81;220;1265;2381;1346;2601
430720;202212;960;2202;503;1393;59;179;273;688;332;867
430730;202212;1141;2894;779;2190;113;322;337;878;450;1200
430740;202212;822;2078;429;1249;76;255;132;334;208;589
430745;202212;600;1319;434;1017;53;181;267;499;320;680
430750;202212;2061;4654;1343;3391;345;889;535;1255;880;2144
430755;202212;559;1298;403;998;34;105;245;538;279;643
430760;202212;3111;7007;2431;5984;498;1317;1185;2696;1683;4013
430770;202212;9430;21003;7499;18149;830;2309;4933;11329;5763;13638
430780;202212;2631;6064;1761;4624;302;851;875;2165;1177;3016
430781;202212;748;1757;494;1215;165;437;182;363;347;800
430783;202212;423;904;273;674;57;157;136;315;193;472
430786;202212;41;121;26;89;5;15;4;9;9;24
430790;202212;6107;13742;4518;11068;453;1394;2829;6232;3282;7626
430800;202212;1064;2086;812;1747;52;130;621;1261;673;1391
430805;202212;502;1105;349;817;11;37;273;591;284;628
430807;202212;722;1655;429;1112;63;197;182;380;245;577
430810;202212;921;2079;458;1203;67;200;186;404;253;604
430820;202212;1641;4280;952;2815;156;473;290;754;446;1227
430825;202212;304;700;123;298;18;43;47;96;65;139
430830;202212;2492;5630;2060;4871;127;324;1568;3514;1695;3838
430840;202212;1479;3199;1011;2461;138;330;628;1472;766;1802
430843;202212;216;506;96;262;9;22;37;90;46;112
430845;202212;636;1345;424;994;52;142;270;558;322;700
430850;202212;2926;7158;2004;5482;561;1623;540;1389;1101;3012
430860;202212;1392;3221;713;1912;115;368;309;691;424;1059
430865;202212;687;1621;417;1135;101;311;121;246;222;557
430870;202212;635;1626;270;817;53;167;53;136;106;303
430880;202212;1866;3800;1325;2955;153;415;891;1847;1044;2262
430885;202212;212;538;132;378;13;32;88;251;101;283
430890;202212;1339;3148;858;2331;159;526;104;216;263;742
430900;202212;4024;7657;2834;6032;132;396;2103;4105;2235;4501
430905;202212;1158;2691;778;2011;143;394;315;733;458;1127
430910;202212;2757;6915;2069;5526;319;1013;978;2192;1297;3205
430912;202212;623;1637;399;1165;59;163;223;655;282;818
430915;202212;645;1714;408;1206;116;369;104;301;220;670
430920;202212;34446;77980;27587;67027;3223;8791;17984;41388;21207;50179
430925;202212;106;222;53;134;7;19;26;64;33;83
430930;202212;15301;32179;11256;26238;1294;3350;7094;15418;8388;18768
430940;202212;1540;3680;1039;2732;228;639;408;922;636;1561
430950;202212;1087;2124;724;1551;52;151;533;1031;585;1182
430955;202212;504;1252;138;376;24;66;39;88;63;154
430957;202212;241;691;211;625;40;119;116;347;156;466
430960;202212;1712;3847;1000;2606;241;661;341;789;582;1450
430965;202212;1920;4053;1530;3479;69;162;1196;2705;1265;2867
430970;202212;460;1061;263;704;40;113;124;307;164;420
430975;202212;604;1594;457;1278;75;248;176;430;251;678
430980;202212;525;1143;296;754;41;117;147;320;188;437
430990;202212;763;1909;527;1429;77;233;256;651;333;884
430995;202212;687;1551;491;1240;77;200;277;649;354;849
431000;202212;1672;3779;706;1954;117;329;69;150;186;479
431010;202212;3298;7985;2336;6335;418;1294;883;2002;1301;3296
431020;202212;10756;22160;6418;15381;1000;2859;3089;6300;4089;9159
431030;202212;396;1041;197;620;41;145;27;78;68;223
431033;202212;5180;11292;3515;8679;756;1895;1355;3188;2111;5083
431036;202212;356;767;78;228;4;8;27;62;31;70
431040;202212;1100;2514;713;1884;79;271;416;982;495;1253
431041;202212;512;1112;349;849;61;165;163;339;224;504
431043;202212;516;1218;325;848;30;109;199;447;229;556
431046;202212;124;308;51;143;8;22;11;23;19;45
431050;202212;1569;3428;1128;2747;191;449;625;1501;816;1950
431053;202212;849;2037;454;1292;90;270;151;334;241;604
431055;202212;722;1619;558;1355;55;143;382;930;437;1073
431057;202212;254;712;154;480;31;107;58;159;89;266
431060;202212;7074;15974;4910;12494;1138;3186;1896;4306;3034;7492
431065;202212;578;1319;378;990;53;153;200;499;253;652
431070;202212;507;1272;302;840;60;184;87;229;147;413
431075;202212;338;835;192;517;35;121;91;191;126;312
431080;202212;776;2024;538;1533;84;254;179;439;263;693
431085;202212;947;2280;508;1330;58;173;226;564;284;737
431087;202212;504;1261;401;1059;53;144;245;624;298;768
431090;202212;487;1094;195;562;32;88;41;114;73;202
431100;202212;5436;10405;3966;8556;346;861;2772;5595;3118;6456
431110;202212;1810;3834;1275;2915;176;456;679;1375;855;1831
431112;202212;793;1869;657;1632;78;227;441;1043;519;1270
431113;202212;627;1476;490;1224;113;292;274;643;387;935
431115;202212;1267;3159;978;2642;112;382;663;1664;775;2046
431120;202212;3354;7834;2275;5860;508;1438;875;1978;1383;3416
431123;202212;426;1037;280;753;48;128;140;360;188;488
431125;202212;1444;3387;1020;2617;285;735;513;1305;798;2040
431127;202212;244;636;72;218;8;29;14;31;22;60
431130;202212;4097;9226;3177;7827;521;1404;1668;3855;2189;5259
431140;202212;7300;16471;4459;11221;562;1593;2076;4357;2638;5950
431142;202212;798;1735;598;1425;82;226;398;906;480;1132
431150;202212;1248;3023;902;2422;132;389;484;1215;616;1604
431160;202212;809;2010;534;1470;134;394;170;419;304;813
431162;202212;683;1606;471;1228;43;146;282;658;325;804
431164;202212;202;460;55;164;5;14;11;25;16;39
431170;202212;565;1410;416;1118;114;296;94;229;208;525
431171;202212;1124;2210;945;1992;172;351;679;1414;851;1765
431173;202212;560;1337;396;1102;118;390;127;295;245;685
431175;202212;1590;3477;975;2424;143;342;446;1041;589;1383
431177;202212;1164;2722;872;2270;167;482;484;1201;651;1683
431179;202212;383;832;127;362;26;75;39;104;65;179
431180;202212;2917;7081;1784;4872;399;1088;393;898;792;1986
431190;202212;703;1691;291;818;28;89;65;128;93;217
431198;202212;494;1329;402;1155;90;264;164;473;254;737
431200;202212;389;953;117;316;23;57;17;44;40;101
431205;202212;290;717;162;450;48;131;49;128;97;259
431210;202212;793;1703;630;1459;130;307;317;746;447;1053
431213;202212;333;805;250;650;22;63;129;302;151;365
431215;202212;726;1680;369;1033;41;129;178;457;219;586
431217;202212;210;500;142;370;29;85;60;137;89;222
431220;202212;725;1678;461;1206;95;261;233;543;328;804
431225;202212;1943;4015;1494;3329;160;384;1026;2219;1186;2603
431230;202212;886;2244;657;1739;132;405;325;718;457;1123
431235;202212;203;554;27;92;0;0;6;20;6;20
431237;202212;446;1252;337;1025;48;166;173;500;221;666
431238;202212;46;149;38;131;10;41;16;44;26;85
431240;202212;6679;14716;5388;12679;568;1651;3539;7648;4107;9299
431242;202212;384;853;310;714;42;111;192;411;234;522
431244;202212;474;1088;254;635;40;103;113;248;153;351
431245;202212;1591;3470;1040;2532;105;259;528;1189;633;1448
431247;202212;338;772;216;547;31;91;102;216;133;307
431250;202212;2385;5274;1821;4499;415;988;916;2312;1331;3300
431260;202212;388;999;236;691;25;93;96;253;121;346
431261;202212;338;925;276;817;27;101;158;421;185;522
431262;202212;326;888;171;543;29;105;86;259;115;364
431265;202212;1867;4234;736;2004;126;387;216;472;342;859
431267;202212;300;709;194;508;24;72;119;284;143;356
431270;202212;3506;7201;1884;4513;436;1137;666;1465;1102;2602
431275;202212;187;472;124;330;21;68;70;160;91;228
431280;202212;335;912;153;479;28;88;34;95;62;183
431290;202212;440;1253;284;884;52;173;50;135;102;308
431295;202212;90;222;37;105;10;31;11;27;21;58
431300;202212;353;898;99;282;12;44;33;72;45;116
431301;202212;308;838;83;258;13;42;10;25;23;67
431303;202212;799;1875;472;1244;34;106;209;463;243;569
431306;202212;2806;6270;1728;4438;227;655;748;1634;975;2289
431308;202212;48;135;38;109;14;40;15;41;29;81
431310;202212;648;1573;435;1143;72;182;212;517;284;699
431320;202212;849;2202;507;1500;83;264;166;414;249;678
431330;202212;2323;5170;1298;3376;156;460;669;1526;825;1986
431333;202212;249;637;138;396;22;67;42;109;64;176
431335;202212;42;115;24;78;9;29;1;4;10;33
431337;202212;5073;10531;4258;9357;219;707;3535;7286;3754;7993
431339;202212;549;1292;369;979;95;240;139;371;234;611
431340;202212;23734;53876;17086;42847;2383;6781;9149;20939;11532;27720
431342;202212;486;1051;359;850;49;124;241;556;290;680
431344;202212;425;1032;234;657;37;99;129;343;166;442
431346;202212;250;596;88;266;18;57;19;42;37;99
431349;202212;1184;2500;789;1749;123;302;473;964;596;1266
431350;202212;6076;13769;4726;11649;608;1697;2903;6648;3511;8345
431360;202212;690;1555;349;913;99;286;105;237;204;523
431365;202212;2979;5861;2349;5033;123;334;1943;3973;2066;4307
431370;202212;6286;13529;4675;11072;855;2258;2581;5724;3436;7982
431380;202212;1133;2774;906;2413;190;532;503;1312;693;1844
431390;202212;3346;7703;2157;5671;221;700;1193;2711;1414;3411
431395;202212;2197;4477;1700;3764;166;398;1202;2522;1368;2920
431400;202212;385;1017;216;635;42;124;46;110;88;234
431402;202212;1109;2248;819;1824;96;237;554;1163;650;1400
431403;202212;237;634;179;522;44;151;64;160;108;311
431405;202212;7101;16823;5538;14254;919;2722;2783;6470;3702;9192
431406;202212;698;1757;454;1242;117;295;151;447;268;742
431407;202212;644;1619;410;1133;68;175;191;499;259;674
431410;202212;24111;54373;17237;43068;2271;6653;10270;23088;12541;29741
431413;202212;292;793;70;216;7;21;25;60;32;81
431415;202212;893;2075;593;1563;111;340;255;576;366;916
431417;202212;657;1341;420;971;65;175;234;511;299;686
431420;202212;2096;4232;1587;3564;118;320;1082;2274;1200;2594
431430;202212;680;1634;347;986;52;156;114;286;166;442
431440;202212;47582;98633;36353;82191;5551;14498;20385;40775;25936;55273
431442;202212;192;522;89;284;13;44;12;36;25;80
431445;202212;415;1137;124;394;13;44;24;62;37;106
431446;202212;356;951;277;795;30;96;152;416;182;512
431447;202212;916;2212;504;1400;85;232;165;451;250;683
431449;202212;967;2238;641;1643;97;262;332;765;429;1027
431450;202212;3140;5504;2454;4583;205;323;1919;3472;2124;3795
431454;202212;53;167;42;141;9;34;22;68;31;102
431455;202212;659;1478;339;853;33;77;178;403;211;480
431460;202212;3857;8165;2506;5878;517;1295;1046;2276;1563;3571
431470;202212;1695;4269;1219;3336;238;698;462;1177;700;1875
431475;202212;305;802;57;189;3;12;7;13;10;25
431477;202212;572;1351;314;850;80;191;103;259;183;450
431478;202212;254;680;55;171;10;27;6;14;16;41
431480;202212;4195;9973;3297;8547;795;2110;1329;3359;2124;5469
431490;202212;167004;347355;130529;292667;7419;21148;99916;209611;107335;230759
431500;202212;584;1370;437;1111;64;164;224;537;288;701
431505;202212;310;691;211;538;21;50;147;377;168;427
431507;202212;358;829;141;401;39;120;21;48;60;168
431510;202212;2096;4955;1419;3663;465;1209;378;970;843;2179
431513;202212;260;553;136;344;29;91;43;71;72;162
431514;202212;156;369;128;322;4;13;86;192;90;205
431515;202212;673;1445;507;1163;115;279;273;590;388;869
431517;202212;82;230;63;192;8;30;28;81;36;111
431520;202212;446;1053;188;524;27;97;84;184;111;281
431530;202212;6546;13501;3959;9552;862;2184;1711;3860;2573;6044
431531;202212;265;600;155;399;31;77;56;137;87;214
431532;202212;737;1541;422;997;70;177;205;463;275;640
431535;202212;348;876;158;455;28;80;34;86;62;166
431540;202212;2204;6044;1994;5765;103;319;1531;4469;1634;4788
431545;202212;419;979;100;241;16;32;38;84;54;116
431550;202212;2650;6176;1859;4734;246;721;1019;2395;1265;3116
431555;202212;845;1766;498;1186;44;115;288;672;332;787
431560;202212;32285;72050;22266;56530;4202;10438;9145;23147;13347;33585
431570;202212;6998;13501;6026;12152;379;966;5007;9491;5386;10457
431575;202212;479;1040;406;919;76;164;249;525;325;689
431580;202212;821;1954;548;1433;67;222;319;732;386;954
431590;202212;927;2355;658;1796;154;449;241;573;395;1022
431595;202212;443;1108;279;778;57;166;99;248;156;414
431600;202212;2268;5122;1609;4096;288;817;699;1598;987;2415
431610;202212;1783;3950;1157;2861;207;501;469;1249;676;1750
431620;202212;561;1331;300;777;58;186;160;334;218;520
431630;202212;1573;3678;726;2004;167;512;227;542;394;1054
431640;202212;8801;17813;7345;15919;871;2137;4973;10311;5844;12448
431642;202212;798;1681;487;1141;93;209;234;501;327;710
431643;202212;433;1012;209;565;21;52;78;188;99;240
431645;202212;3047;5331;2424;4552;38;96;2138;3876;2176;3972
431647;202212;365;834;121;337;14;36;29;69;43;105
431650;202212;178;471;129;388;18;61;58;142;76;203
431660;202212;1105;2734;539;1582;88;315;138;333;226;648
431670;202212;1495;3371;893;2292;138;380;435;992;573;1372
431673;202212;256;657;100;324;12;43;32;88;44;131
431675;202212;429;1059;114;375;14;49;19;41;33;90
431680;202212;12434;27497;9310;22080;1774;4790;4845;10280;6619;15070
431690;202212;34262;75866;24894;59843;3719;10485;14201;31110;17920;41595
431695;202212;279;632;166;423;25;99;97;202;122;301
431697;202212;562;1214;430;1016;79;185;243;567;322;752
431700;202212;1830;4037;1425;3357;233;488;751;1792;984;2280
431710;202212;19039;38850;14103;32151;1689;4341;9062;19618;10751;23959
431720;202212;8637;19376;5218;13380;1295;3524;1164;2452;2459;5976
431725;202212;42;104;30;82;9;31;14;32;23;63
431730;202212;5715;12236;3830;9422;703;1922;1938;4380;2641;6302
431740;202212;6544;14562;4396;11084;1001;2839;1379;3026;2380;5865
431750;202212;10664;24846;7650;19993;1816;5053;2717;6709;4533;11762
431755;202212;377;993;98;310;11;40;25;68;36;108
431760;202212;6677;14011;4634;10758;503;1422;2836;5932;3339;7354
431770;202212;2566;5260;1936;4418;343;744;1224;2791;1567;3535
431775;202212;262;634;143;403;34;107;36;82;70;189
431780;202212;2622;5895;1708;4291;288;776;599;1410;887;2186
431790;202212;927;2317;633;1744;135;383;275;719;410;1102
431795;202212;319;763;152;426;25;71;45;111;70;182
431800;202212;10457;23003;6734;17255;1879;5676;853;1795;2732;7471
431805;202212;314;783;65;231;3;5;2;3;5;8
431810;202212;4042;8445;2605;5970;386;996;1481;3065;1867;4061
431820;202212;2726;6479;2064;5475;474;1428;919;2274;1393;3702
431830;202212;10910;22612;7873;18486;2321;6177;1274;2990;3595;9167
431840;202212;3619;8063;2888;6951;440;1163;1750;4082;2190;5245
431842;202212;589;1395;204;587;40;127;46;112;86;239
431843;202212;367;941;243;674;55;172;106;261;161;433
431844;202212;206;551;76;247;16;50;16;52;32;102
431845;202212;593;1416;386;1016;35;101;235;595;270;696
431846;202212;373;811;324;742;13;35;290;650;303;685
431848;202212;190;472;102;287;11;36;28;61;39;97
431849;202212;433;1038;80;225;11;32;14;30;25;62
431850;202212;5406;13214;4095;10795;1015;2895;1270;3082;2285;5977
431860;202212;801;1758;459;1131;63;180;283;653;346;833
431861;202212;126;318;79;215;18;54;24;53;42;107
431862;202212;607;1780;494;1582;98;366;228;674;326;1040
431870;202212;29949;67175;23984;58205;2298;6491;15926;36138;18224;42629
431880;202212;5060;11773;3694;9461;471;1426;2060;4850;2531;6276
431890;202212;6226;14294;3963;10090;1112;2929;1044;2520;2156;5449
431900;202212;1308;3062;854;2273;145;441;409;949;554;1390
431910;202212;919;2068;356;923;54;152;102;204;156;356
431912;202212;678;1513;550;1309;78;196;361;835;439;1031
431915;202212;1435;2969;1153;2548;70;179;920;1950;990;2129
431920;202212;1630;3156;1336;2797;34;81;1182;2420;1216;2501
431930;202212;910;2137;620;1630;214;561;198;505;412;1066
431935;202212;103;257;73;204;10;27;14;29;24;56
431936;202212;377;955;213;574;40;113;113;289;153;402
431937;202212;194;481;127;356;31;77;43;113;74;190
431940;202212;3728;7978;2426;5752;167;470;1587;3492;1754;3962
431950;202212;2780;6391;2163;5413;520;1368;912;2150;1432;3518
431960;202212;3741;8361;2787;6724;796;2016;739;1704;1535;3720
431970;202212;512;1238;247;656;48;149;75;162;123;311
431971;202212;97;242;49;147;12;36;13;35;25;71
431973;202212;712;1961;486;1502;47;153;340;1048;387;1201
431975;202212;131;261;40;101;9;27;12;22;21;49
431980;202212;1559;3333;1223;2831;131;400;836;1718;967;2118
431990;202212;8648;18580;6119;15086;412;1250;4050;9478;4462;10728
432000;202212;19658;41109;14924;34065;1773;4738;9854;20717;11627;25455
432010;202212;3421;7392;2310;5664;536;1334;789;1778;1325;3112
432020;202212;1945;4844;1208;3348;369;1065;238;616;607;1681
432023;202212;642;1422;312;806;40;101;143;318;183;419
432026;202212;1256;3072;964;2520;283;749;351;953;634;1702
432030;202212;537;1198;313;816;24;63;184;441;208;504
432032;202212;408;983;270;705;24;72;143;324;167;396
432035;202212;871;2217;724;1966;177;454;333;926;510;1380
432040;202212;1138;2679;515;1448;54;178;240;571;294;749
432045;202212;222;564;132;382;19;65;58;151;77;216
432050;202212;688;1567;502;1253;63;193;259;615;322;808
432055;202212;856;1994;573;1488;176;437;155;415;331;852
432057;202212;183;458;154;391;10;27;105;239;115;266
432060;202212;514;1191;150;447;18;60;41;112;59;172
432065;202212;277;690;211;559;50;149;102;248;152;397
432067;202212;1014;2521;840;2159;91;244;561;1401;652;1645
432070;202212;2056;4704;1501;3737;229;641;777;1735;1006;2376
432080;202212;6361;13289;4720;10871;787;2178;2337;4825;3124;7003
432085;202212;499;1230;387;1057;81;244;195;485;276;729
432090;202212;3403;7924;2044;5388;475;1157;829;2028;1304;3185
432100;202212;1140;2720;557;1622;93;277;105;238;198;515
432110;202212;2773;6442;2018;5163;452;1276;579;1234;1031;2510
432120;202212;4575;11169;3692;9731;614;1866;1877;4487;2491;6353
432130;202212;3512;7796;2889;6916;510;1232;1467;3500;1977;4732
432132;202212;318;795;173;482;25;83;82;192;107;275
432135;202212;1265;2621;872;1987;101;224;555;1281;656;1505
432140;202212;2400;5897;1910;5009;232;695;1267;3160;1499;3855
432143;202212;1920;4569;1423;3790;120;357;888;2282;1008;2639
432145;202212;2196;5437;1432;3929;235;714;467;1020;702;1734
432146;202212;166;424;132;382;46;147;36;95;82;242
432147;202212;675;1743;361;1054;118;357;62;179;180;536
432149;202212;593;1342;272;707;31;77;117;272;148;349
432150;202212;5178;11644;3916;9621;755;2165;2028;4365;2783;6530
432160;202212;8260;18699;6282;15757;1537;4128;2447;5844;3984;9972
432162;202212;229;503;37;104;7;21;9;14;16;35
432163;202212;202;484;41;115;2;6;7;9;9;15
432166;202212;807;2046;649;1752;117;360;244;562;361;922
432170;202212;1917;4814;1308;3706;233;716;524;1311;757;2027
432180;202212;3579;7924;1850;4758;272;802;850;1854;1122;2656
432183;202212;480;1255;365;1008;71;246;176;438;247;684
432185;202212;1070;2510;650;1726;133;399;304;723;437;1122
432190;202212;2789;6068;2022;4900;185;554;1364;3004;1549;3558
432195;202212;1226;2952;749;2062;138;393;254;677;392;1070
432200;202212;4714;10364;3614;8727;270;717;2605;6007;2875;6724
432210;202212;521;1218;355;919;47;134;199;452;246;586
432215;202212;790;1972;663;1754;80;189;388;1032;468;1221
432218;202212;270;619;121;319;17;50;42;85;59;135
432220;202212;4530;9698;3247;7630;541;1332;1832;4056;2373;5388
432225;202212;200;496;138;379;21;54;60;165;81;219
432230;202212;925;2107;439;1188;62;205;170;371;232;576
432232;202212;602;1391;376;1006;73;209;171;408;244;617
432234;202212;347;826;176;490;34;82;45;108;79;190
432235;202212;61;152;33;81;6;18;16;31;22;49
432237;202212;373;884;322;800;11;28;269;650;280;678
432240;202212;21948;47018;16334;39645;1548;3697;11193;26717;12741;30414
432250;202212;8667;21225;6518;17108;1175;3456;3530;8525;4705;11981
432252;202212;576;1284;371;902;49;139;191;416;240;555
432253;202212;1140;2994;789;2154;224;668;202;474;426;1142
432254;202212;743;1687;222;629;28;87;43;90;71;177
432255;202212;127;310;76;205;10;30;42;100;52;130
432260;202212;7371;16690;5512;13430;1053;2906;2825;6100;3878;9006
432270;202212;2832;6765;2264;5767;686;1794;775;1905;1461;3699
432280;202212;1541;3689;810;2292;132;425;260;590;392;1015
432285;202212;157;471;30;86;3;9;9;25;12;34
432290;202212;428;1061;273;739;60;185;91;196;151;381
432300;202212;39862;87454;30950;73834;2644;7814;21828;48489;24472;56303
432310;202212;1315;2794;1009;2296;125;259;771;1769;896;2028
432320;202212;243;538;115;308;15;43;43;89;58;132
432330;202212;250;542;83;250;17;51;15;46;32;97
432335;202212;193;552;72;250;9;27;10;27;19;54
432340;202212;379;926;175;528;28;95;68;191;96;286
432345;202212;1053;1951;903;1776;11;25;799;1532;810;1557
432350;202212;386;911;197;557;40;126;58;133;98;259
432360;202212;262;754;54;180;4;13;17;51;21;64
432370;202212;427;962;239;643;26;77;128;330;154;407
432375;202212;632;1448;431;1069;129;342;139;342;268;684
432377;202212;190;561;44;155;3;11;10;25;13;36
432380;202212;2470;6324;1723;4951;281;891;860;2346;1141;3237
500020;202212;4343;9659;3018;7627;305;942;2022;4865;2327;5807
500025;202212;1394;3223;887;2304;110;294;497;1230;607;1524
500060;202212;10407;26135;7384;20076;923;2746;4292;11317;5215;14063
500070;202212;6327;14368;4543;11483;824;2264;2223;5407;3047;7671
500080;202212;1911;4385;1168;3061;196;585;460;1048;656;1633
500085;202212;2511;5806;1746;4474;440;1229;664;1523;1104;2752
500090;202212;2542;6146;1718;4779;275;819;511;1513;786;2332
500100;202212;4824;11261;3595;9324;592;1676;1450;3462;2042;5138
500110;202212;13256;29624;9113;23215;1757;4847;4382;10795;6139;15642
500124;202212;2772;7012;2225;6174;345;927;1363;3817;1708;4744
500150;202212;1937;3997;1354;3218;226;612;745;1598;971;2210
500190;202212;6304;15101;4098;10985;862;2404;1413;3423;2275;5827
500200;202212;3378;7178;2245;5358;198;500;1405;3147;1603;3647
500210;202212;6436;13520;4618;11198;1236;3154;2308;5381;3544;8535
500215;202212;1764;4458;1288;3628;143;435;711;1963;854;2398
500220;202212;4231;10348;3114;8499;439;1256;1657;4171;2096;5427
500230;202212;2623;5619;2003;4757;272;707;1271;2859;1543;3566
500240;202212;5207;13940;3771;11039;528;1677;1581;4577;2109;6254
500260;202212;4058;8093;2593;6086;275;723;1573;3437;1848;4160
500270;202212;188947;412495;122819;306664;16610;47520;58287;128993;74897;176513
500280;202212;1712;3964;1124;3080;173;468;625;1707;798;2175
500290;202212;4623;10507;2807;7467;430;1340;1055;2452;1485;3792
500295;202212;5170;11521;3436;8595;571;1635;1506;3231;2077;4866
500310;202212;1301;2413;855;1860;114;194;489;1059;603;1253
500315;202212;6170;13092;5105;11680;306;798;4257;9432;4563;10230
500320;202212;25849;62710;17958;49959;4411;12203;7272;21016;11683;33219
500325;202212;7609;15416;5391;12450;630;1618;3402;7424;4032;9042
500330;202212;8598;18115;5692;13940;551;1429;3254;7867;3805;9296
500345;202212;2743;6299;1842;4834;320;891;681;1638;1001;2529
500348;202212;2959;6806;2246;5649;179;513;1552;3785;1731;4298
500350;202212;1474;3806;849;2513;102;332;298;797;400;1129
500370;202212;35303;85056;25809;69741;3453;10632;12820;32855;16273;43487
500375;202212;3211;7878;2006;5486;266;794;769;1809;1035;2603
500380;202212;4443;10346;3092;8145;872;2311;512;1361;1384;3672
500390;202212;846;1640;515;1245;78;215;319;767;397;982
500400;202212;1985;4769;1317;3493;221;658;498;1157;719;1815
500410;202212;2994;6513;2087;5216;242;591;1145;2966;1387;3557
500430;202212;3519;8093;2385;6405;383;1026;943;2725;1326;3751
500440;202212;2011;4507;1108;2970;195;543;427;1142;622;1685
500450;202212;2416;5628;1496;4092;299;828;374;961;673;1789
500460;202212;4784;11688;2915;8150;516;1594;663;1678;1179;3272
500470;202212;3476;8760;2292;6401;547;1690;665;1535;1212;3225
500480;202212;2391;6905;1946;6198;214;723;1360;4357;1574;5080
500490;202212;1450;3198;862;2290;167;517;222;580;389;1097
500500;202212;5093;12557;3367;9884;1051;3523;362;1093;1413;4616
500510;202212;892;2101;593;1560;43;146;382;896;425;1042
500515;202212;2050;4880;1548;4112;221;640;833;2159;1054;2799
500520;202212;4299;11199;3264;9444;721;2076;1589;4701;2310;6777
500525;202212;1241;3311;982;2912;139;440;577;1646;716;2086
500540;202212;6546;16056;3933;11415;1076;3502;648;1550;1724;5052
500560;202212;7054;16768;5670;15025;252;770;4669;12325;4921;13095
500568;202212;5851;11908;3654;8618;744;1827;1585;3344;2329;5171
500570;202212;11102;23773;7671;18267;1012;2846;4397;9377;5409;12223
500580;202212;3901;9301;2791;7401;697;1899;1174;3042;1871;4941
500600;202212;4614;10787;3307;8706;768;2135;954;2405;1722;4540
500620;202212;10317;24802;7170;19029;1054;3010;3659;8954;4713;11964
500625;202212;697;1748;479;1328;73;230;212;523;285;753
500627;202212;968;2468;596;1802;100;318;176;480;276;798
500630;202212;9723;20416;5774;14210;1204;3250;1875;4202;3079;7452
500635;202212;3272;9801;2409;8573;288;926;1569;6109;1857;7035
500640;202212;2211;4423;1476;3463;67;169;1029;2290;1096;2459
500660;202212;26386;60059;18116;48226;5356;14787;6241;16486;11597;31273
500690;202212;3396;8006;2310;6301;727;2167;821;2116;1548;4283
500710;202212;4171;10200;2960;8111;699;2116;869;2223;1568;4339
500720;202212;6310;15187;4173;11614;816;2472;1365;3551;2181;6023
500730;202212;1299;2961;720;1940;144;371;229;603;373;974
500740;202212;5797;12949;3703;9738;831;2276;1464;3681;2295;5957
500750;202212;1423;3260;999;2564;133;388;465;1045;598;1433
500755;202212;1403;3390;875;2412;149;454;256;605;405;1059
500769;202212;6478;15043;3602;9863;915;2544;478;1161;1393;3705
500770;202212;1744;4354;1202;3466;231;704;411;1127;642;1831
500780;202212;1584;3707;1007;2698;176;537;256;543;432;1080
500790;202212;9353;23226;6679;18459;1322;4003;2415;6426;3737;10429
500793;202212;2638;6188;1880;4893;362;1033;768;1772;1130;2805
500795;202212;3801;7948;3074;7013;183;415;2547;5822;2730;6237
500797;202212;1001;2347;669;1746;205;588;203;487;408;1075
500800;202212;4392;9373;2748;6922;698;1994;672;1653;1370;3647
500830;202212;26366;60464;17453;44715;3712;10159;6409;14994;10121;25153
500840;202212;1778;4028;1113;2777;125;336;555;1240;680;1576
510010;202212;2220;4486;1579;3680;197;451;1064;2461;1261;2912
510020;202212;5108;12275;2771;7799;487;1397;741;1838;1228;3235
510025;202212;9397;21143;6104;16010;663;1898;3430;8433;4093;10331
510030;202212;3889;7950;2534;5888;255;651;1293;2901;1548;3552
510035;202212;1366;3442;871;2640;243;744;302;994;545;1738
510040;202212;3015;6186;2276;5273;286;603;1424;3400;1710;4003
510050;202212;2835;5335;1987;4276;219;565;1434;2929;1653;3494
510060;202212;1937;4608;1318;3490;307;869;285;582;592;1451
510080;202212;1935;4643;1267;3566;210;665;530;1362;740;2027
510100;202212;869;1825;626;1471;71;193;385;827;456;1020
510120;202212;331;564;195;407;10;19;155;310;165;329
510125;202212;2569;6126;1941;5132;240;753;932;2213;1172;2966
510130;202212;2052;4696;1445;3761;298;861;712;1716;1010;2577
510140;202212;3767;9287;2568;7700;1001;3260;755;2318;1756;5578
510160;202212;2464;5186;1931;4514;46;132;1754;4049;1800;4181
510170;202212;6343;15011;4799;12590;894;2587;2315;5760;3209;8347
510180;202212;18963;38668;12900;30305;2008;5162;6655;15544;8663;20706
510185;202212;2169;5309;1416;4218;535;1669;385;1327;920;2996
510190;202212;3012;7764;1877;5891;473;1622;405;1267;878;2889
510250;202212;22227;50594;16491;42187;2461;6883;9377;23612;11838;30495
510260;202212;2244;9025;1865;8374;279;1213;1100;5591;1379;6804
510263;202212;4794;12496;3162;9304;559;1794;757;1875;1316;3669
510267;202212;7075;19090;4115;12510;710;2277;807;2058;1517;4335
510268;202212;1596;3927;1099;3075;313;932;243;547;556;1479
510269;202212;1249;3144;805;2345;149;485;337;901;486;1386
510270;202212;3702;9824;2558;7855;391;1340;1077;3166;1468;4506
510279;202212;2239;5457;1287;3739;188;597;392;994;580;1591
510285;202212;1298;3193;827;2363;216;691;265;652;481;1343
510300;202212;5171;11401;3910;9756;269;709;2905;7173;3174;7882
510305;202212;1847;4710;1224;3598;263;789;381;1105;644;1894
510310;202212;1305;3015;919;2416;242;609;346;945;588;1554
510320;202212;5091;11501;3450;8871;769;2220;1071;2390;1840;4610
510325;202212;5519;15116;3715;11589;858;2843;820;2489;1678;5332
510330;202212;3256;8554;2151;6707;531;1807;827;2541;1358;4348
510335;202212;6139;16127;4639;13713;864;2772;2402;6978;3266;9750
510336;202212;639;1661;459;1390;71;198;247;805;318;1003
510337;202212;1860;4953;1207;3800;423;1460;304;879;727;2339
510340;202212;124702;260691;86060;206411;17211;47614;38277;82615;55488;130229
510343;202212;1546;3454;1033;2629;134;397;565;1332;699;1729
510345;202212;1662;4072;1254;3336;233;663;655;1546;888;2209
510350;202212;3993;9377;2669;7291;767;2163;644;1694;1411;3857
510360;202212;2456;4533;1474;3403;62;120;1079;2588;1141;2708
510370;202212;2211;5774;1671;4935;279;803;990;3006;1269;3809
510380;202212;674;1535;390;1062;51;165;163;420;214;585
510385;202212;1517;4679;1131;3986;108;444;769;2774;877;3218
510390;202212;1803;3976;1248;3337;242;685;758;1994;1000;2679
510395;202212;866;1749;579;1346;33;70;424;989;457;1059
510410;202212;6607;16092;4912;13329;701;1975;3113;8389;3814;10364
510420;202212;3281;5948;2288;4674;70;159;1828;3631;1898;3790
510450;202212;657;1493;386;1038;87;228;131;330;218;558
510452;202212;1131;2948;831;2379;124;377;458;1276;582;1653
510454;202212;1503;3637;1035;2857;180;467;585;1737;765;2204
510455;202212;1136;2853;735;2102;148;475;282;721;430;1196
510460;202212;2459;5780;1731;4678;618;1945;510;962;1128;2907
510480;202212;6056;13787;3935;9934;702;1971;1723;3880;2425;5851
510490;202212;2150;4894;1612;4215;262;699;1004;2645;1266;3344
510500;202212;1825;4206;1098;3063;266;803;277;737;543;1540
510510;202212;4947;12745;3437;10231;1028;3338;1015;2947;2043;6285
510515;202212;6813;16519;4674;12837;889;2641;1788;4496;2677;7137
510517;202212;1954;4677;1358;3806;510;1592;355;849;865;2441
510520;202212;2821;5484;1532;3813;161;436;675;1725;836;2161
510523;202212;1457;3196;1023;2542;145;383;618;1456;763;1839
510525;202212;10294;26472;7454;20994;1398;4242;2841;7271;4239;11513
510530;202212;692;1632;520;1397;45;129;358;956;403;1085
510550;202212;3233;8535;2429;7187;494;1564;1203;3434;1697;4998
510558;202212;2778;7007;2018;5841;267;734;1046;3212;1313;3946
510560;202212;2330;6183;1480;4532;360;1159;297;943;657;2102
510562;202212;7562;16541;5607;13337;874;2183;2975;6614;3849;8797
510590;202212;4015;9020;2925;7655;275;767;2091;5451;2366;6218
510600;202212;1517;3013;1095;2440;125;340;704;1425;829;1765
510610;202212;3461;7570;2406;6170;334;1006;1445;3522;1779;4528
510615;202212;3554;8211;2461;6516;362;1007;1440;3758;1802;4765
510617;202212;1307;3540;1042;3152;134;433;733;2287;867;2720
510618;202212;1611;3889;1145;3168;213;692;599;1555;812;2247
510619;202212;910;2207;516;1479;106;317;107;235;213;552
510620;202212;1631;3505;808;2190;311;940;67;130;378;1070
510621;202212;1949;4904;1161;3437;259;800;317;812;576;1612
510622;202212;6922;17791;4346;12536;1274;3961;616;1497;1890;5458
510623;202212;3458;7887;2467;6370;517;1460;978;2425;1495;3885
510624;202212;2032;5055;1065;3266;117;398;216;576;333;974
510625;202212;4434;10021;2714;7071;511;1450;926;2348;1437;3798
510626;202212;1716;4058;1146;3170;277;856;289;773;566;1629
510627;202212;777;1889;432;1246;112;337;119;354;231;691
510628;202212;1833;3811;1158;2964;369;1069;427;979;796;2048
510629;202212;2167;5596;1394;4156;309;1022;359;1010;668;2032
510630;202212;4215;10803;2657;8032;614;1919;658;2112;1272;4031
510631;202212;733;1577;557;1330;21;40;435;1052;456;1092
510637;202212;4519;9838;3175;7955;805;2279;1144;2685;1949;4964
510642;202212;7367;18533;5682;16113;986;3216;3335;9086;4321;12302
510645;202212;1243;2302;751;1685;176;388;339;767;515;1155
510650;202212;9361;20475;7396;18335;986;1576;5324;14589;6310;16165
510665;202212;2096;4308;1321;3128;287;612;530;1357;817;1969
510670;202212;523;1066;315;789;33;80;166;413;199;493
510675;202212;8242;21098;5542;16096;1362;4431;1104;2812;2466;7243
510677;202212;2781;6635;1974;5443;352;1073;1082;2909;1434;3982
510680;202212;870;2091;489;1418;90;280;134;327;224;607
510682;202212;2165;5662;1608;4779;523;1737;541;1512;1064;3249
510685;202212;660;1721;480;1385;50;135;279;810;329;945
510700;202212;5414;11758;3743;9441;362;1061;2574;6251;2936;7312
510704;202212;14149;31367;9493;23763;2254;6049;2945;6548;5199;12597
510706;202212;3028;8232;2072;6622;383;1258;825;2830;1208;4088
510710;202212;3691;8493;2293;5957;588;1508;605;1449;1193;2957
510715;202212;792;1543;518;1183;53;155;318;666;371;821
510718;202212;2811;6157;1709;4670;361;1010;779;2364;1140;3374
510719;202212;584;1172;334;816;37;111;168;351;205;462
510720;202212;1129;2417;744;1879;164;474;314;709;478;1183
510724;202212;1092;2915;725;2202;105;365;324;887;429;1252
510726;202212;1111;2003;650;1455;71;158;366;795;437;953
510729;202212;721;1590;325;863;35;112;104;269;139;381
510730;202212;3666;8267;2506;6526;355;1084;1356;3218;1711;4302
510735;202212;1583;4059;1270;3613;108;273;1017;2923;1125;3196
510740;202212;1206;2700;822;2050;84;250;513;1136;597;1386
510757;202212;647;1939;508;1707;138;524;213;655;351;1179
510760;202212;56880;117561;35275;85836;6950;19376;13748;29299;20698;48675
510770;202212;5227;10556;3683;8623;258;552;2569;6150;2827;6702
510774;202212;494;1197;343;966;65;181;186;546;251;727
510775;202212;825;1975;500;1450;115;356;139;370;254;726
510776;202212;882;2112;598;1569;112;322;282;716;394;1038
510777;202212;1750;4382;1264;3756;238;845;753;2081;991;2926
510779;202212;989;2482;724;2041;81;209;461;1359;542;1568
510780;202212;5430;12262;3888;10034;726;1779;1977;5436;2703;7215
510785;202212;2553;6215;1472;4288;333;1029;412;1183;745;2212
510787;202212;4249;11163;2845;8424;1028;3154;292;760;1320;3914
510788;202212;659;1435;433;1106;67;162;191;554;258;716
510790;202212;24494;59919;15204;43512;3138;9818;1564;3835;4702;13653
510792;202212;13207;34483;8407;25311;1985;6516;1795;4594;3780;11110
510794;202212;1604;4116;1133;3351;342;1160;210;496;552;1656
510795;202212;13478;31926;9462;25089;2085;6182;3292;7807;5377;13989
510800;202212;1817;4618;1230;3639;342;1118;159;337;501;1455
510805;202212;1868;4826;1174;3548;233;764;452;1238;685;2002
510810;202212;836;1598;541;1213;167;331;263;623;430;954
510820;202212;960;1746;553;1245;26;64;372;800;398;864
510830;202212;1086;2382;822;2044;85;212;550;1401;635;1613
510835;202212;761;1644;486;1260;58;171;300;735;358;906
510840;202212;78776;152602;57085;126351;9067;19669;34585;76758;43652;96427
510850;202212;2199;5305;1425;4106;494;1636;87;124;581;1760
510860;202212;3271;7999;2140;6236;740;2343;401;1174;1141;3517
510880;202212;899;2400;643;1948;169;512;162;484;331;996
510885;202212;753;1781;481;1341;91;235;117;321;208;556
510890;202212;1035;2702;719;2131;221;711;197;547;418;1258
510895;202212;1855;4358;1231;3310;206;658;583;1379;789;2037
520005;202212;4615;10985;3698;9782;1106;2554;1490;4725;2596;7279
520010;202212;3583;8766;2667;7082;567;1669;1074;2437;1641;4106
520013;202212;4382;10273;2821;7469;722;1920;774;2149;1496;4069
520015;202212;635;1491;458;1226;104;275;159;451;263;726
520017;202212;1493;3482;1025;2738;186;565;438;1033;624;1598
520020;202212;693;1247;535;1065;54;109;406;788;460;897
520025;202212;49265;119499;41934;109191;6073;16630;26818;68464;32891;85094
520030;202212;8891;18750;7379;16729;587;1298;5617;12524;6204;13822
520050;202212;493;1131;276;720;54;129;119;309;173;438
520055;202212;2095;4887;1271;3230;194;481;563;1334;757;1815
520060;202212;2373;5620;1575;4243;288;862;400;1047;688;1909
520080;202212;2328;5417;1776;4684;357;900;875;2406;1232;3306
520082;202212;1004;2392;703;1882;123;347;302;845;425;1192
520085;202212;1259;2900;996;2532;236;605;470;1158;706;1763
520090;202212;1124;2014;822;1690;105;140;637;1377;742;1517
520110;202212;55447;136270;37515;106130;10036;30491;3215;7946;13251;38437
520120;202212;305;685;160;428;23;79;69;163;92;242
520130;202212;4833;10699;3706;8984;707;1802;1543;3570;2250;5372
520140;202212;63690;156043;43796;122331;14403;42966;5724;15779;20127;58745
520145;202212;729;1561;460;1171;103;271;166;379;269;650
520150;202212;855;1901;640;1623;79;198;361;874;440;1072
520160;202212;1074;2423;722;1802;140;319;291;740;431;1059
520170;202212;5863;11436;3853;9000;421;1032;2585;5882;3006;6914
520180;202212;3440;7979;2779;7046;363;1074;1799;4357;2162;5431
520215;202212;2231;4918;1631;4055;208;581;969;2288;1177;2869
520235;202212;935;1873;621;1446;100;255;363;806;463;1061
520250;202212;2119;4963;1545;4088;585;1656;258;802;843;2458
520260;202212;918;2023;551;1433;103;264;199;503;302;767
520280;202212;1055;2182;823;1842;166;368;427;944;593;1312
520310;202212;1255;2516;825;1886;186;505;384;835;570;1340
520320;202212;2453;5856;1864;4957;241;632;987;2665;1228;3297
520330;202212;6302;14803;4838;12398;699;2146;2837;6655;3536;8801
520340;202212;2786;5709;1633;4071;172;379;839;2166;1011;2545
520350;202212;3828;8703;2701;6991;879;2355;832;2150;1711;4505
520355;202212;2376;5995;1706;4752;501;1483;279;669;780;2152
520357;202212;1077;2304;780;1887;30;76;626;1491;656;1567
520360;202212;1007;2327;776;1960;131;380;370;852;501;1232
520380;202212;1714;4054;1020;2807;167;494;320;752;487;1246
520390;202212;1474;3232;930;2492;242;724;206;575;448;1299
520393;202212;852;1832;571;1408;80;211;257;579;337;790
520396;202212;1104;2518;920;2238;61;146;643;1485;704;1631
520400;202212;2000;4389;1551;3804;101;266;1140;2777;1241;3043
520410;202212;2770;5600;1886;4334;271;719;1075;2279;1346;2998
520420;202212;468;977;364;821;22;60;273;584;295;644
520425;202212;1865;4307;1027;2727;274;796;213;470;487;1266
520430;202212;3046;6662;1821;4654;395;1035;340;788;735;1823
520440;202212;3705;8489;2111;5644;432;1298;463;1136;895;2434
520450;202212;17795;39752;12162;30940;3170;8391;3441;8545;6611;16936
520455;202212;994;2408;691;1948;200;578;205;592;405;1170
520460;202212;1311;2862;1007;2455;204;438;594;1531;798;1969
520465;202212;1122;2437;912;2161;55;168;705;1627;760;1795
520470;202212;2884;6467;2211;5623;577;1554;971;2517;1548;4071
520480;202212;1202;3035;887;2495;203;590;369;981;572;1571
520485;202212;1813;5053;1404;4391;265;884;609;1820;874;2704
520490;202212;5397;12777;4120;10825;633;1813;2470;6255;3103;8068
520495;202212;2049;3928;1545;3261;110;235;1146;2393;1256;2628
520500;202212;2200;4915;1630;3970;192;555;964;2140;1156;2695
520505;202212;1212;2264;951;1952;100;175;722;1467;822;1642
520510;202212;12435;27953;9319;23275;1562;4581;4622;10526;6184;15107
520520;202212;1449;3391;1115;2893;295;830;448;1116;743;1946
520530;202212;3099;7615;2251;6139;418;1124;1072;3086;1490;4210
520540;202212;3797;9244;2506;6804;444;1293;788;1867;1232;3160
520545;202212;1825;4095;1407;3465;350;851;638;1545;988;2396
520547;202212;1685;4012;1291;3340;269;694;660;1673;929;2367
520549;202212;21213;49066;17571;43908;2136;5985;11808;28122;13944;34107
520551;202212;6371;14519;5321;13043;462;1399;3982;9238;4444;10637
520552;202212;1186;2821;918;2429;181;471;474;1295;655;1766
520570;202212;665;1408;419;1031;69;149;183;445;252;594
520580;202212;2691;5555;2038;4794;368;827;1172;2786;1540;3613
520590;202212;1704;3916;1163;3043;275;746;432;1075;707;1821
520620;202212;12148;28365;9758;24997;1777;4932;5340;13229;7117;18161
520630;202212;1096;2529;767;2002;95;264;350;865;445;1129
520640;202212;2869;6501;2120;5199;531;1302;647;1646;1178;2948
520650;202212;1328;2621;962;2123;209;409;485;1129;694;1538
520660;202212;647;1542;362;1038;75;232;102;285;177;517
520670;202212;1208;2855;985;2518;103;241;664;1672;767;1913
520680;202212;1039;2249;827;1952;123;251;516;1228;639;1479
520690;202212;417;969;277;745;84;216;75;189;159;405
520710;202212;551;1225;369;927;22;58;243;567;265;625
520725;202212;1742;3862;1157;2891;197;553;573;1370;770;1923
520735;202212;1143;2492;760;1888;219;499;245;614;464;1113
520740;202212;3145;6594;2263;5432;486;1166;1045;2494;1531;3660
520750;202212;921;1933;659;1559;95;237;377;845;472;1082
520753;202212;1630;3904;1220;3201;219;661;583;1392;802;2053
520760;202212;1811;3450;1520;3110;32;65;1402;2867;1434;2932
520780;202212;1862;4172;1340;3406;188;487;676;1641;864;2128
520790;202212;3945;8725;2688;6726;433;994;1385;3647;1818;4641
520800;202212;23315;53416;18233;45995;3108;8020;10422;26282;13530;34302
520810;202212;1493;2943;1102;2490;257;572;550;1358;807;1930
520815;202212;723;2064;520;1621;96;307;157;468;253;775
520830;202212;2191;4346;1571;3607;100;235;1200;2698;1300;2933
520840;202212;3659;8907;2899;7865;816;2438;1014;2714;1830;5152
520850;202212;1130;2253;853;1871;172;443;445;915;617;1358
520860;202212;11640;28312;8529;23018;2030;5690;3166;8212;5196;13902
520870;202212;190321;404842;137398;325642;25549;64372;64304;141672;89853;206044
520880;202212;11972;31208;9510;26792;1999;5781;3977;10790;5976;16571
520890;202212;6069;12444;4252;9729;651;1759;2311;4874;2962;6633
520910;202212;5958;13769;3855;10234;771;2186;1069;2528;1840;4714
520915;202212;1001;2432;655;1753;126;382;272;663;398;1045
520920;202212;5802;11703;4223;9791;797;1711;2319;5530;3116;7241
520929;202212;796;1776;602;1490;108;217;264;698;372;915
520940;202212;1190;2892;927;2501;77;250;703;1834;780;2084
520945;202212;576;1192;412;967;33;74;257;581;290;655
520960;202212;1410;2927;1078;2462;379;819;383;954;762;1773
520970;202212;4469;10593;3335;8813;1150;3077;678;1902;1828;4979
520980;202212;968;2041;698;1692;102;261;343;774;445;1035
520990;202212;3889;8545;3173;7669;515;1101;2154;5345;2669;6446
520993;202212;1524;3493;994;2541;193;532;393;946;586;1478
520995;202212;3164;7310;2325;6035;561;1417;628;1725;1189;3142
521000;202212;12053;28766;7931;21215;1253;3491;2591;6319;3844;9810
521010;202212;5011;11673;3621;9292;542;1563;1932;4616;2474;6179
521015;202212;975;2219;675;1695;48;131;438;1025;486;1156
521020;202212;5365;12332;3240;8486;722;2011;846;2090;1568;4101
521030;202212;978;1670;756;1371;22;50;662;1156;684;1206
521040;202212;10630;24265;7720;19791;1883;4843;2492;6705;4375;11548
521056;202212;1270;3092;881;2428;259;698;198;590;457;1288
521060;202212;1239;3027;852;2306;171;505;308;803;479;1308
521080;202212;1292;2618;691;1712;124;316;289;664;413;980
521090;202212;3906;9839;2585;7198;620;1877;291;742;911;2619
521100;202212;2452;5011;1825;4173;244;595;1154;2612;1398;3207
521120;202212;6282;13883;4708;11867;974;2189;1725;5084;2699;7273
521130;202212;1222;2696;565;1501;56;157;305;808;361;965
521140;202212;2022;4631;1449;3635;192;490;830;1954;1022;2444
521150;202212;17537;36526;11406;27673;2736;7297;4720;10889;7456;18186
521160;202212;1029;1959;647;1380;69;136;419;856;488;992
521170;202212;1354;2913;970;2331;152;394;447;988;599;1382
521180;202212;10838;25833;8349;21729;1595;4474;3901;9838;5496;14312
521190;202212;14552;33787;9257;25188;2193;6423;2761;7014;4954;13437
521200;202212;875;1988;581;1512;73;207;276;661;349;868
521205;202212;762;1662;582;1385;27;67;460;1049;487;1116
521210;202212;1012;2543;596;1666;133;400;147;304;280;704
521220;202212;4845;10531;3199;7957;834;2308;1192;2645;2026;4953
521225;202212;544;1038;410;890;36;77;319;692;355;769
521230;202212;1805;4154;1490;3725;639;1663;448;1105;1087;2768
521250;202212;47707;108165;38762;95944;8834;23617;21329;50410;30163;74027
521260;202212;649;1380;486;1143;68;193;281;604;349;797
521270;202212;2673;5656;2231;5107;229;450;1609;3768;1838;4218
521280;202212;2294;5662;1715;4734;347;1017;727;1985;1074;3002
521290;202212;713;1494;481;1194;47;124;298;698;345;822
521295;202212;1488;3000;1132;2553;157;307;727;1626;884;1933
521300;202212;2280;5170;1716;4346;329;796;912;2339;1241;3135
521305;202212;820;1767;557;1397;56;157;346;834;402;991
521308;202212;6027;14564;4143;11181;379;1128;2575;6557;2954;7685
521310;202212;13601;31498;9293;24020;1831;5214;3858;9102;5689;14316
521340;202212;501;1062;334;831;28;70;191;448;219;518
521350;202212;2382;5619;1795;4726;129;380;1278;3255;1407;3635
521370;202212;1553;3761;987;2834;304;949;173;511;477;1460
521375;202212;1934;4665;1271;3513;259;706;309;928;568;1634
521377;202212;1685;3321;1217;2736;134;247;886;2118;1020;2365
521380;202212;7882;19581;5045;14462;788;2374;1001;2933;1789;5307
521385;202212;857;1881;639;1590;95;213;340;896;435;1109
521390;202212;850;2055;567;1594;141;452;102;272;243;724
521400;202212;3719;7996;2914;6950;394;989;1765;4104;2159;5093
521405;202212;1686;4145;1110;3051;130;383;555;1425;685;1808
521410;202212;1159;2549;907;2173;225;477;468;1176;693;1653
521440;202212;1833;4122;1395;3485;426;1003;587;1529;1013;2532
521450;202212;5215;14139;3841;11495;996;3039;849;2572;1845;5611
521460;202212;7705;18171;5474;14225;1405;3852;1867;4631;3272;8483
521470;202212;1035;2395;710;1811;121;283;324;771;445;1054
521480;202212;641;1351;434;1016;65;162;230;467;295;629
521483;202212;2910;6529;2079;5291;554;1377;796;2063;1350;3440
521486;202212;2186;4852;1663;4095;157;291;1081;2666;1238;2957
521487;202212;592;1271;430;1056;81;189;265;655;346;844
521490;202212;1055;2551;768;2081;33;119;560;1416;593;1535
521500;202212;2586;6165;1953;5279;192;710;1160;2888;1352;3598
521520;202212;1026;2162;794;1846;132;266;456;1084;588;1350
521523;202212;18401;49003;15028;43638;4441;13395;5412;15147;9853;28542
521525;202212;1322;2903;996;2436;91;278;656;1508;747;1786
521530;202212;2805;6843;1739;4739;328;923;480;1190;808;2113
521540;202212;992;2344;712;1899;164;497;287;703;451;1200
521550;202212;2110;5005;1095;3002;199;575;256;728;455;1303
521560;202212;7091;16476;5172;13869;1452;3925;2108;5873;3560;9798
521565;202212;831;1920;567;1486;100;262;251;646;351;908
521570;202212;5078;12652;3497;9776;697;2158;424;1160;1121;3318
521580;202212;676;1459;436;1064;78;200;177;387;255;587
521590;202212;1074;2154;767;1724;93;222;472;999;565;1221
521600;202212;536;1302;332;918;60;174;164;408;224;582
521630;202212;2118;4282;1299;3117;402;991;338;746;740;1737
521640;202212;2433;5382;1533;4019;335;996;467;1131;802;2127
521645;202212;643;1562;376;1068;159;449;20;36;179;485
521680;202212;1777;4410;1365;3755;349;986;528;1412;877;2398
521690;202212;658;1519;542;1363;85;232;312;757;397;989
521710;202212;4381;9857;2857;7322;499;1438;802;1732;1301;3170
521720;202212;3083;6408;1975;4766;251;652;1110;2596;1361;3248
521730;202212;5090;12728;3728;10447;996;3159;874;2020;1870;5179
521740;202212;5823;13523;4559;11682;1372;3834;1490;3419;2862;7253
521760;202212;24117;55164;19603;48864;3774;10731;11254;26406;15028;37137
521770;202212;4122;8983;2640;6688;551;1451;619;1513;1170;2964
521800;202212;8846;21129;6266;16930;1872;5143;1784;5276;3656;10419
521805;202212;1403;2650;910;2020;195;397;453;1079;648;1476
521810;202212;916;1957;659;1605;125;300;360;895;485;1195
521830;202212;7566;18363;6097;16097;488;1507;4379;11134;4867;12641
521839;202212;1127;2369;852;1936;77;208;608;1276;685;1484
521850;202212;8998;19333;5546;14084;1688;4217;678;1655;2366;5872
521860;202212;2040;5168;1375;3926;236;737;432;1113;668;1850
521870;202212;863;2210;615;1742;113;360;222;530;335;890
521878;202212;1034;2516;664;1779;58;172;341;828;399;1000
521880;202212;29831;67474;21397;54510;4543;12415;9429;22544;13972;34959
521890;202212;4242;9969;2874;7655;750;2004;775;1919;1525;3923
521900;202212;1685;3743;880;2365;227;508;16;43;243;551
521910;202212;1765;3583;1237;2924;274;630;538;1234;812;1864
521920;202212;695;1638;533;1377;65;205;331;791;396;996
521925;202212;988;2355;716;1940;146;438;302;769;448;1207
521930;202212;6811;15351;4538;11946;1343;2963;1746;5097;3089;8060
521935;202212;1253;2832;863;2183;78;214;512;1215;590;1429
521940;202212;1657;3358;1086;2566;186;487;573;1283;759;1770
521945;202212;812;1887;559;1445;86;226;300;756;386;982
521950;202212;917;2018;632;1573;100;252;301;738;401;990
521960;202212;831;2019;562;1520;53;185;329;800;382;985
521970;202212;3499;7246;2647;6205;249;492;1965;4755;2214;5247
521971;202212;937;2141;638;1665;157;404;172;420;329;824
521973;202212;2007;4785;1498;3947;167;425;933;2404;1100;2829
521975;202212;17433;40423;14139;35750;2406;6656;8376;20391;10782;27047
521980;202212;2852;6120;2138;5191;149;369;1610;3866;1759;4235
521990;202212;1819;4008;1534;3605;261;695;953;2203;1214;2898
522000;202212;3410;8143;2634;7139;736;2069;1160;3303;1896;5372
522005;202212;477;1016;305;759;52;137;113;275;165;412
522010;202212;5757;13236;4025;10371;865;2368;1474;3549;2339;5917
522015;202212;1338;3193;981;2641;266;735;405;1050;671;1785
522020;202212;6793;14762;4551;11389;936;2420;1986;4942;2922;7362
522026;202212;943;2286;591;1667;93;317;177;402;270;719
522028;202212;637;1435;440;1103;70;212;223;492;293;704
522040;202212;4734;9369;3296;7435;355;901;2168;4524;2523;5425
522045;202212;25974;65003;19325;53912;4244;12579;5108;13498;9352;26077
522050;202212;1490;3533;1047;2777;192;573;461;1058;653;1631
522060;202212;3782;9238;2726;7550;491;1295;1231;3437;1722;4732
522068;202212;2316;4974;1852;4428;114;226;1499;3621;1613;3847
522070;202212;1043;2010;852;1740;21;39;750;1495;771;1534
522100;202212;1110;2571;719;1905;104;283;327;816;431;1099
522108;202212;1408;2870;1089;2436;53;135;859;1839;912;1974
522119;202212;2468;5217;1960;4590;366;730;1152;2775;1518;3505
522130;202212;666;1474;502;1256;45;93;379;968;424;1061
522140;202212;30929;73210;21572;56677;4626;12928;6739;16081;11365;29009
522145;202212;975;2170;687;1750;138;396;370;909;508;1305
522150;202212;1377;3026;903;2285;203;530;273;659;476;1189
522155;202212;1263;3000;968;2550;143;336;565;1500;708;1836
522157;202212;907;1811;731;1602;38;80;571;1248;609;1328
522160;202212;7706;18194;4870;13249;1284;3771;519;1484;1803;5255
522170;202212;3388;8029;2603;6868;356;941;1586;4168;1942;5109
522180;202212;929;1985;605;1411;114;276;182;432;296;708
522185;202212;30649;68990;22535;58184;8959;25112;4278;11622;13237;36734
522190;202212;997;2089;675;1600;146;348;292;628;438;976
522200;202212;2543;6440;1870;5257;488;1363;633;1759;1121;3122
522205;202212;2002;4557;1436;3693;445;1198;402;981;847;2179
522220;202212;1448;3187;1054;2657;134;327;621;1627;755;1954
522230;202212;1668;3679;1294;3134;190;521;784;1826;974;2347
530010;202212;322191;763223;270160;684838;37582;103918;164509;396820;202091;500738
110001;202211;4838;12580;3213;9570;765;2525;1080;3096;1845;5621
110002;202211;17383;41362;12557;33457;3207;9217;3626;9357;6833;18574
110003;202211;911;2507;652;1996;160;515;161;427;321;942
110004;202211;17100;40345;11703;31230;2593;7291;4098;10419;6691;17710
110005;202211;3101;7570;2188;6101;496;1386;680;1980;1176;3366
110006;202211;1765;4708;1074;3288;195;653;232;633;427;1286
110007;202211;1519;3671;976;2754;277;792;236;761;513;1553
110008;202211;4275;10030;3184;8524;644;1502;1769;5316;2413;6818
110009;202211;5501;14235;3518;10675;787;2625;1310;3755;2097;6380
110010;202211;10027;27741;7634;23528;1750;4895;3658;12787;5408;17682
110011;202211;9279;22717;6349;17590;1811;5208;1382;3692;3193;8900
110012;202211;21113;49256;13822;37159;3574;9765;3088;7831;6662;17596
110013;202211;7185;18910;4935;14612;1824;5751;823;2443;2647;8194
110014;202211;4723;11385;3189;8567;481;1432;1617;4140;2098;5572
110015;202211;7426;17554;4766;12750;973;2935;1512;3418;2485;6353
110018;202211;5459;12863;3452;9473;723;2100;889;2229;1612;4329
110020;202211;113188;237918;86173;201854;18174;43515;44689;105019;62863;148534
110025;202211;6179;13901;4241;10657;650;1816;2267;5401;2917;7217
110026;202211;689;1720;487;1387;115;344;148;437;263;781
110028;202211;9053;21568;5681;15739;1383;4293;672;1808;2055;6101
110029;202211;1884;4390;1147;3151;209;570;461;1257;670;1827
110030;202211;16891;37177;10583;27791;3010;8540;1485;4018;4495;12558
110032;202211;4495;11562;2699;7957;853;2511;483;1505;1336;4016
110033;202211;5685;15622;4275;13011;1373;4307;1370;4401;2743;8708
110034;202211;3827;8537;2584;6809;923;2697;622;1792;1545;4489
110037;202211;1917;5309;1329;4196;353;1152;421;1312;774;2464
110040;202211;3575;9248;2592;7517;670;2130;730;1968;1400;4098
110045;202211;5781;15306;4142;12386;1169;3760;1390;4092;2559;7852
110050;202211;2082;5294;1364;4029;432;1450;188;455;620;1905
110060;202211;1143;3155;743;2237;191;602;185;534;376;1136
110070;202211;1874;5391;1318;4177;352;1223;322;872;674;2095
110080;202211;7947;17665;5924;15002;1280;3315;2897;7612;4177;10927
110090;202211;696;1806;475;1396;119;392;133;372;252;764
110092;202211;1627;4349;1145;3465;253;786;561;1721;814;2507
110094;202211;3427;9353;2536;7681;984;3148;348;1099;1332;4247
110100;202211;2142;5693;1671;4850;593;1783;525;1554;1118;3337
110110;202211;2185;5476;1553;4478;466;1463;310;943;776;2406
110120;202211;1588;4182;1112;3265;281;863;321;918;602;1781
110130;202211;3334;7738;2003;5382;395;1088;266;684;661;1772
110140;202211;2979;7767;2177;6234;434;1399;1013;2703;1447;4102
110143;202211;1728;4374;1239;3495;347;1094;398;1043;745;2137
110145;202211;1166;2823;707;1977;168;459;283;816;451;1275
110146;202211;632;1553;419;1197;121;324;149;482;270;806
110147;202211;948;2267;626;1676;89;273;315;741;404;1014
110148;202211;1163;2985;588;1748;148;489;62;132;210;621
110149;202211;4182;10004;2844;7933;991;2867;666;1972;1657;4839
110150;202211;3054;7333;1961;5620;613;1910;344;1059;957;2969
110155;202211;1022;2758;703;2020;139;457;292;741;431;1198
110160;202211;1737;4817;1260;3826;437;1371;238;725;675;2096
110170;202211;2540;6006;1632;4367;242;722;949;2344;1191;3066
110175;202211;2587;6723;1754;4998;318;968;769;2073;1087;3041
110180;202211;1660;4153;1160;3209;162;477;568;1535;730;2012
120001;202211;4289;10836;3457;9608;485;1595;2279;6144;2764;7739
120005;202211;2406;8169;2144;7743;248;920;1592;5874;1840;6794
120010;202211;7522;18031;6479;16565;552;1318;5042;12978;5594;14296
120013;202211;3059;8756;2621;8152;790;2371;1163;4066;1953;6437
120017;202211;3751;9045;3178;8249;460;1128;2049;5641;2509;6769
120020;202211;19200;60090;17670;57402;1205;4392;14087;45570;15292;49962
120025;202211;4681;10550;3844;9593;548;1350;2567;6709;3115;8059
120030;202211;7602;27204;7006;26183;472;2123;5304;20260;5776;22383
120032;202211;2100;8285;1971;8036;100;608;1669;6679;1769;7287
120033;202211;5277;16067;4930;15471;112;542;4348;13430;4460;13972
120034;202211;3539;10520;3055;9755;157;650;2553;8001;2710;8651
120035;202211;5121;15778;4737;15139;273;1004;4039;12795;4312;13799
120038;202211;3858;10096;3312;9277;479;1413;2058;5867;2537;7280
120039;202211;2450;9258;2272;8920;148;735;1817;7106;1965;7841
120040;202211;75894;183071;65584;168086;8273;22560;43709;110290;51982;132850
120042;202211;4332;13058;3978;12450;212;794;3296;10170;3508;10964
120043;202211;1802;6440;1528;6051;55;359;1268;4927;1323;5286
120045;202211;7368;16746;6155;15292;564;1465;4671;11646;5235;13111
120050;202211;12180;36174;11193;34801;539;1992;9458;29365;9997;31357
120060;202211;12046;40115;10986;38581;506;2345;9437;32918;9943;35263
120070;202211;4232;11674;3634;10852;583;1598;2284;7301;2867;8899
120080;202211;6869;15865;6169;14896;745;1748;4666;11358;5411;13106
130002;202211;4106;13134;3604;12443;465;1203;2816;10359;3281;11562
130006;202211;3096;9777;2562;8945;620;1955;1349;5339;1969;7294
130008;202211;3274;9891;2821;9252;177;582;2269;7643;2446;8225
130010;202211;5353;12623;4608;11765;165;384;4136;10604;4301;10988
130014;202211;4829;12164;3605;10334;675;1941;2072;6234;2747;8175
130020;202211;3349;11833;2924;11220;135;750;2378;9021;2513;9771
130030;202211;19602;40479;18294;39024;199;522;17476;36931;17675;37453
130040;202211;4923;13258;4049;12143;563;1589;2910;9059;3473;10648
130050;202211;8793;28822;7408;27026;390;1336;6354;23739;6744;25075
130060;202211;8762;31707;7438;29993;401;2252;6166;24519;6567;26771
130063;202211;7726;22643;6810;21610;194;836;6197;19601;6391;20437
130068;202211;4664;13381;3901;12372;216;886;3103;9761;3319;10647
130070;202211;9196;23295;7551;21492;657;1590;5877;17366;6534;18956
130080;202211;9296;27837;8002;26346;399;1192;6904;23221;7303;24413
130083;202211;3411;9878;2985;9342;294;886;2328;7558;2622;8444
130090;202211;5142;12461;4594;11837;94;213;4058;10751;4152;10964
130100;202211;9075;25216;7587;23638;161;407;6995;22157;7156;22564
130110;202211;10752;26097;8747;23592;1640;3952;5476;16219;7116;20171
130115;202211;6240;17244;5361;16217;159;479;4671;14285;4830;14764
130120;202211;20054;55580;17866;52794;1468;4710;14887;43827;16355;48537
130130;202211;7288;19049;5643;17000;621;1733;4066;13030;4687;14763
130140;202211;8711;26695;7632;25472;362;1441;6556;21977;6918;23418
130150;202211;4761;14276;4477;13960;78;392;4150;12907;4228;13299
130160;202211;8000;20964;6909;19648;359;876;6060;17480;6419;18356
130165;202211;3994;13225;3756;12954;158;612;3336;11581;3494;12193
130170;202211;17020;39162;14130;35960;452;1422;12612;31872;13064;33294
130180;202211;5308;15029;5068;14768;40;229;4898;14202;4938;14431
130185;202211;24787;52340;20455;47700;1640;2132;17331;42655;18971;44787
130190;202211;25087;70978;20509;64464;1780;5423;15660;49897;17440;55320
130195;202211;3002;9697;2517;9098;109;434;2116;7777;2225;8211
130200;202211;3710;8624;3032;7752;198;610;2429;6072;2627;6682
130210;202211;1874;6193;1673;5944;144;646;1330;4675;1474;5321
130220;202211;3074;8608;2525;7958;78;267;2255;7243;2333;7510
130230;202211;6141;21458;5358;20417;200;1047;4739;18071;4939;19118
130240;202211;17939;39922;15001;36286;150;701;14029;33391;14179;34092
130250;202211;32022;84612;27345;79199;1734;4271;22306;66833;24040;71104
130255;202211;6141;16526;5229;14981;247;663;4296;12274;4543;12937
130260;202211;441208;978650;374955;891669;70652;179232;242077;562261;312729;741493
130270;202211;11806;36538;9751;33479;1772;5574;6216;22488;7988;28062
130280;202211;4524;15009;4117;14544;153;600;3788;13449;3941;14049
130290;202211;21197;50605;19049;48042;658;1822;17509;43936;18167;45758
130300;202211;6132;17529;5438;16600;150;641;4702;14234;4852;14875
130310;202211;10650;24568;9442;23124;418;1067;8337;20306;8755;21373
130320;202211;4198;12506;3483;11529;452;1415;2480;8532;2932;9947
130330;202211;5591;15603;4501;14319;220;788;3776;12237;3996;13025
130340;202211;30864;78985;26583;74230;1509;3778;22557;64744;24066;68522
130350;202211;4585;15085;4077;14431;157;760;3547;12520;3704;13280
130353;202211;9968;23699;8095;21293;1259;3033;5434;14968;6693;18001
130356;202211;7054;19165;5973;17560;1141;3264;3547;10952;4688;14216
130360;202211;3649;10814;2943;9948;83;355;2623;8880;2706;9235
130370;202211;6063;24210;5088;22765;761;4045;3059;13795;3820;17840
130380;202211;9260;36532;8629;35584;733;3491;6920;28505;7653;31996
130390;202211;8775;29778;7668;28170;407;1875;6762;24676;7169;26551
130395;202211;3037;8490;2518;7685;176;612;2033;6097;2209;6709
130400;202211;3451;9365;2911;8641;102;322;2566;7651;2668;7973
130406;202211;14141;44089;12007;41474;2310;7320;7978;29035;10288;36355
130410;202211;5420;16634;4662;15475;1245;4242;2518;8676;3763;12918
130420;202211;18326;54897;15380;51208;1822;6087;11025;37562;12847;43649
130423;202211;5201;14910;4507;14089;241;989;3901;12049;4142;13038
130426;202211;3883;12095;3489;11649;61;183;3093;10869;3154;11052
130430;202211;6115;13442;5264;12380;208;502;4689;10904;4897;11406
130440;202211;7330;17313;6319;16121;126;394;5947;15118;6073;15512
140002;202211;3038;7964;2608;7453;198;505;2078;6160;2276;6665
140005;202211;4019;10451;3498;9840;814;2148;2231;6659;3045;8807
140010;202211;64002;163407;51241;144768;12395;36852;21467;61713;33862;98565
140015;202211;6319;13871;5376;12843;363;731;4654;11430;5017;12161
140017;202211;7293;16493;6416;15421;409;934;5379;13106;5788;14040
140020;202211;7047;17237;6048;16005;449;1227;4739;12655;5188;13882
140023;202211;3413;8733;2732;7808;344;1028;2026;5853;2370;6881
140028;202211;2508;5835;2098;5326;135;353;1637;4162;1772;4515
140030;202211;8000;16282;7255;15436;342;495;6604;14340;6946;14835
140040;202211;3505;12156;3216;11777;104;530;2941;10737;3045;11267
140045;202211;4369;13999;3784;13210;987;2748;2079;8369;3066;11117
140047;202211;7435;19270;6189;17465;771;2250;4328;12411;5099;14661
140050;202211;2126;5446;1800;4987;312;761;1171;3401;1483;4162
140060;202211;2752;5817;2456;5427;256;482;2028;4562;2284;5044
140070;202211;2402;11411;2321;11265;141;921;2006;9580;2147;10501
150010;202211;64387;131794;57953;123739;1518;2917;52162;110270;53680;113187
150013;202211;2765;5721;2336;5256;150;264;1974;4529;2124;4793
150020;202211;19011;47513;17422;45380;1796;3649;13916;37636;15712;41285
150030;202211;11474;35715;10313;34366;765;2025;8346;29881;9111;31906
150034;202211;5478;11626;4410;10313;255;568;3675;8681;3930;9249
150040;202211;20040;46134;17564;43408;1177;1539;15460;40169;16637;41708
150050;202211;9840;26440;8910;25230;244;670;8083;23156;8327;23826
150060;202211;29067;70479;23444;62241;3334;8942;15035;40415;18369;49357
150070;202211;10984;30188;9775;28785;220;805;9099;26722;9319;27527
150080;202211;113381;239933;93433;213626;25359;57809;31260;81739;56619;139548
150085;202211;12087;26759;10989;25481;165;384;10389;24114;10554;24498
150090;202211;15506;39638;14441;37927;606;1600;12738;33058;13344;34658
150095;202211;9211;19510;8101;18185;911;1157;6633;15737;7544;16894
150100;202211;3548;11089;3103;10382;234;737;2498;8528;2732;9265
150110;202211;5588;19384;5176;18925;170;664;4781;17742;4951;18406
150120;202211;9898;26572;9164;25694;373;687;8147;23339;8520;24026
150125;202211;1093;2539;793;2114;102;308;499;1292;601;1600
150130;202211;30055;75411;25644;68885;4980;11808;15583;44652;20563;56460
150140;202211;369370;714489;315652;646117;31311;63668;226686;453104;257997;516772
150145;202211;5044;14520;4131;13105;1496;4611;1473;5490;2969;10101
150150;202211;22419;48727;19031;44496;1518;3296;14516;33960;16034;37256
150157;202211;4447;10897;3488;9597;439;1183;2265;6438;2704;7621
150160;202211;5098;10635;4723;10138;389;931;3845;7998;4234;8929
150170;202211;35673;89642;31679;83360;5410;12367;20506;57501;25916;69868
150172;202211;7173;15828;5837;14046;330;802;4626;11075;4956;11877
150175;202211;2297;5890;1914;5265;184;643;1415;3719;1599;4362
150178;202211;15722;32752;11970;28466;1217;1629;9405;24315;10622;25944
150180;202211;35707;90144;32323;86382;2876;4794;26116;75610;28992;80404
150190;202211;9620;23285;8874;22399;147;484;8286;20739;8433;21223
150195;202211;6408;17430;5927;16766;191;670;5386;15110;5577;15780
150200;202211;7135;18149;6410;17322;49;160;5928;16042;5977;16202
150210;202211;40363;104424;38045;101631;1255;3325;34208;92022;35463;95347
150215;202211;12699;32525;10824;29556;1847;5177;6464;17594;8311;22771
150220;202211;16853;40225;14716;37354;824;2055;11419;28599;12243;30654
150230;202211;17525;41132;15554;38540;1300;2787;11781;29707;13081;32494
150240;202211;45114;108926;37623;96813;7887;20878;17926;44024;25813;64902
150250;202211;5134;17199;4798;16834;448;1615;4111;14621;4559;16236
150260;202211;3562;9507;3116;8853;97;316;2685;7551;2782;7867
150270;202211;10919;28210;7645;22434;2116;6477;2170;6521;4286;12998
150275;202211;9546;24016;8723;22927;193;695;7810;20081;8003;20776
150276;202211;2823;6903;2441;6437;303;695;1698;4884;2001;5579
150277;202211;6966;14948;5541;13325;678;1675;4011;9811;4689;11486
150280;202211;8951;29332;8594;28798;591;1614;7269;25220;7860;26834
150285;202211;4290;12548;3686;11579;230;677;2899;9145;3129;9822
150290;202211;13727;31713;12397;30304;524;778;11212;28083;11736;28861
150293;202211;12198;26410;9526;22968;1046;2573;6623;15906;7669;18479
150295;202211;9088;22079;6389;18311;2095;5949;2181;7183;4276;13132
150300;202211;4136;8457;3791;8048;37;107;3589;7539;3626;7646
150304;202211;5416;13947;4505;12572;653;1626;3091;8975;3744;10601
150307;202211;6998;19706;6287;18563;303;870;5039;14894;5342;15764
150309;202211;8003;20415;6469;17971;845;2269;4103;11621;4948;13890
150310;202211;8742;30589;8199;29913;248;1140;7273;26872;7521;28012
150320;202211;11565;27189;10456;25641;844;1914;7920;19492;8764;21406
150330;202211;18555;49451;17052;47406;2269;4847;11980;36305;14249;41152
150340;202211;2945;7861;2567;7329;306;817;1889;5433;2195;6250
150345;202211;11288;26733;9955;25030;369;1030;8759;21828;9128;22858
150350;202211;12558;25755;11311;24184;813;1320;9651;20841;10464;22161
150360;202211;31131;76016;24938;68307;2515;4839;18777;54038;21292;58877
150370;202211;14195;36508;11598;33064;1504;3545;8269;25215;9773;28760
150375;202211;4753;17202;4279;16554;270;1024;3724;14551;3994;15575
150380;202211;13027;28907;10515;25633;240;712;9114;21931;9354;22643
150390;202211;9271;33027;8142;31190;1698;5514;4993;21006;6691;26520
150400;202211;8090;25068;7640;24352;161;548;6494;21318;6655;21866
150405;202211;10961;25160;9430;23362;729;1259;7458;19213;8187;20472
150410;202211;2371;6396;1987;5792;191;483;1404;4152;1595;4635
150420;202211;57347;138390;44991;120687;10282;28858;21522;59194;31804;88052
150430;202211;10041;25518;9095;24354;670;1309;7668;20970;8338;22279
150440;202211;7958;19392;7201;18423;530;1275;5915;15149;6445;16424
150442;202211;38622;77350;32595;70215;2071;4483;26010;54833;28081;59316
150445;202211;9946;23064;8902;21614;171;470;8179;19649;8350;20119
150450;202211;7974;23705;7431;23002;329;1520;6781;20470;7110;21990
150460;202211;10665;29182;9618;27884;498;1186;8034;24199;8532;25385
150470;202211;25693;60610;22867;57227;412;1430;20944;51787;21356;53217
150475;202211;6841;18491;5765;16829;940;2385;3767;11621;4707;14006
150480;202211;17656;46896;15847;44355;3311;7625;10242;31400;13553;39025
150490;202211;10062;31070;9033;29646;694;1931;7221;24574;7915;26505
150495;202211;6920;18847;6488;18291;166;666;5929;16524;6095;17190
150497;202211;3248;9248;2569;8079;527;1670;1388;4607;1915;6277
150500;202211;3854;8973;3370;8274;207;517;2699;6469;2906;6986
150503;202211;6825;16323;4915;13879;1597;4081;1861;5893;3458;9974
150506;202211;16437;40409;14057;37243;2411;5828;9445;26596;11856;32424
150510;202211;15503;40833;13483;37554;1116;2930;10584;29544;11700;32474
150520;202211;10062;30794;9612;30257;156;884;9068;28281;9224;29165
150530;202211;14883;45360;12864;42502;1096;3114;10041;34067;11137;37181
150540;202211;6558;14714;5621;13341;328;722;4702;11064;5030;11786
150543;202211;9068;22618;7488;20630;645;1809;5672;15985;6317;17794
150548;202211;12981;34733;11495;32661;524;1437;9961;28499;10485;29936
150549;202211;2394;6053;1996;5483;82;259;1623;4430;1705;4689
150550;202211;25242;66881;20403;59117;5369;15871;8013;24146;13382;40017
150553;202211;47524;118613;36192;99558;9156;25889;15660;43014;24816;68903
150555;202211;2495;5930;1923;5072;181;433;1273;3475;1454;3908
150560;202211;2399;5988;2120;5513;252;598;1394;3641;1646;4239
150563;202211;3255;8676;2622;7565;538;1608;1414;4047;1952;5655
150565;202211;5430;15631;4770;14612;135;475;3811;11855;3946;12330
150570;202211;9857;23092;9042;22027;310;905;8068;19382;8378;20287
150580;202211;13826;46817;11825;44608;1439;4259;9220;37104;10659;41363
150590;202211;10204;29908;8735;28168;235;950;7927;25570;8162;26520
150600;202211;13053;34114;12051;32897;402;1014;10918;30077;11320;31091
150610;202211;4017;9083;3571;8426;138;404;3102;7138;3240;7542
150611;202211;4039;9615;3485;8851;80;268;3064;7606;3144;7874
150613;202211;18066;45138;13694;37968;2609;7719;6931;18595;9540;26314
150616;202211;4677;11882;3346;9573;666;2067;1568;4295;2234;6362
150618;202211;8855;22554;7162;19947;1012;3000;4409;12298;5421;15298
150619;202211;8184;20665;6671;18581;713;1633;4890;14133;5603;15766
150620;202211;8993;26265;7804;24267;1514;4293;4432;14589;5946;18882
150630;202211;8703;18604;7942;17694;166;400;7229;15857;7395;16257
150635;202211;6752;16007;5636;14232;712;1637;3721;9497;4433;11134
150640;202211;2551;6831;2306;6524;49;136;2093;5959;2142;6095
150650;202211;14967;35970;12923;32868;3473;8450;5924;16057;9397;24507
150655;202211;6852;17050;6156;16059;104;365;5530;14202;5634;14567
150658;202211;5448;14478;3954;11964;975;3060;1729;5362;2704;8422
150660;202211;6888;17592;5984;16274;1197;3160;3464;9422;4661;12582
150670;202211;12453;24098;9904;21197;847;1684;7881;17247;8728;18931
150680;202211;96565;240118;76866;210778;16690;43168;40462;118149;57152;161317
150690;202211;3273;7073;2813;6540;131;235;2444;5775;2575;6010
150700;202211;8441;21191;7486;20006;917;1831;5548;15703;6465;17534
150710;202211;4681;13403;4171;12623;499;1458;2943;9108;3442;10566
150715;202211;6823;16147;5584;14385;324;810;4590;11798;4914;12608
150720;202211;10529;25953;9689;24827;350;1104;8593;21713;8943;22817
150730;202211;16314;43707;13838;40102;1901;5671;9639;28489;11540;34160
150740;202211;4871;12050;4200;11049;448;936;3090;8388;3538;9324
150745;202211;6884;16864;5554;14991;707;1997;3902;10718;4609;12715
150746;202211;2153;5453;1890;5074;56;163;1582;4159;1638;4322
150747;202211;6500;16411;5746;15325;437;1008;4529;12227;4966;13235
150750;202211;4655;12462;3765;11180;432;1284;2592;8047;3024;9331
150760;202211;14368;37063;12872;35004;2336;5754;8271;23645;10607;29399
150770;202211;8728;25675;7997;24856;259;561;7280;23303;7539;23864
150775;202211;1466;3456;1147;3052;144;429;794;2087;938;2516
150780;202211;6118;16010;5414;15188;336;916;4751;13558;5087;14474
150790;202211;7553;17906;6325;16567;562;1100;4227;13163;4789;14263
150795;202211;20172;51839;17370;47834;3187;8684;10816;30608;14003;39292
150796;202211;5229;10412;4486;9567;200;373;3908;8339;4108;8712
150797;202211;5566;14270;4705;13058;516;1329;3676;10287;4192;11616
150800;202211;17825;48007;15892;45484;2575;6763;10572;31758;13147;38521
150803;202211;10761;24936;9895;23791;291;811;8960;21224;9251;22035
150805;202211;4426;12011;3728;11059;357;1000;2791;8493;3148;9493
150808;202211;8048;21527;5890;17980;2033;6849;968;3204;3001;10053
150810;202211;26365;59474;19985;51843;4374;10959;10431;29813;14805;40772
150812;202211;8152;18531;7219;17140;437;1346;5817;13111;6254;14457
150815;202211;11749;30948;9790;28607;1325;3823;7399;22048;8724;25871
150820;202211;18970;38331;16660;35613;2028;3020;12776;29219;14804;32239
150830;202211;16261;45968;15105;44568;670;1697;13425;40426;14095;42123
150835;202211;4405;11403;3759;10436;430;1218;2646;7309;3076;8527
150840;202211;10421;25922;8438;22880;1182;3598;5130;13374;6312;16972
160005;202211;1761;3746;1549;3502;75;187;1343;3019;1418;3206
160010;202211;2669;6540;2457;6316;21;89;2370;6047;2391;6136
160015;202211;5061;10263;4574;9708;81;201;4341;9144;4422;9345
160020;202211;3176;8052;2735;7478;339;786;2012;5795;2351;6581
160021;202211;1539;5013;1362;4798;64;268;1008;3687;1072;3955
160023;202211;1712;5143;1515;4826;279;829;930;3116;1209;3945
160025;202211;2459;6196;2290;6011;60;100;2181;5776;2241;5876
160027;202211;14612;29349;13208;27663;750;1653;11504;23833;12254;25486
160030;202211;108414;256089;90107;232605;16761;40942;53527;145494;70288;186436
160040;202211;7587;21425;6656;20170;472;1334;5661;17383;6133;18717
160050;202211;7788;18743;6519;17151;2478;5442;2963;9434;5441;14876
160053;202211;5298;13628;4652;12736;276;678;3856;10810;4132;11488
160055;202211;2072;3861;1995;3778;29;85;1925;3601;1954;3686
160060;202211;38617;81029;32649;74310;3097;5720;25960;61107;29057;66827
160070;202211;3786;11576;3296;10852;413;1095;2365;8423;2778;9518
160080;202211;4059;10604;3534;10032;55;165;3266;9379;3321;9544
170025;202211;782;1918;479;1357;88;244;145;398;233;642
170030;202211;1356;3780;989;3100;193;588;371;1215;564;1803
170035;202211;1758;4172;1275;3415;110;322;772;1966;882;2288
170040;202211;2254;5523;1751;4829;210;597;1012;2880;1222;3477
170070;202211;2318;4924;1631;4048;90;244;974;2445;1064;2689
170100;202211;2953;7342;2388;6445;335;841;1512;4138;1847;4979
170105;202211;790;2103;519;1578;118;366;164;439;282;805
170110;202211;1220;3234;926;2756;68;272;571;1606;639;1878
170130;202211;1732;4357;1304;3663;131;426;810;2205;941;2631
170190;202211;1917;4450;1476;3781;202;647;898;2147;1100;2794
170200;202211;2432;5313;1582;3980;279;733;632;1501;911;2234
170210;202211;33351;83081;24979;69604;6984;20901;4760;13469;11744;34370
170215;202211;1537;3728;1211;3288;58;211;920;2456;978;2667
170220;202211;6872;19458;5568;17212;2151;6688;1406;5038;3557;11726
170230;202211;1487;3922;1106;3241;280;826;339;982;619;1808
170240;202211;3504;8110;2808;7048;180;536;2107;5120;2287;5656
170255;202211;4516;12009;3276;9896;582;1819;1556;4720;2138;6539
170270;202211;1022;2333;684;1814;83;224;370;938;453;1162
170290;202211;3768;9272;3220;8536;290;542;2446;6787;2736;7329
170300;202211;2632;5936;2122;5193;160;381;1594;3781;1754;4162
170305;202211;800;1988;645;1722;76;194;347;932;423;1126
170307;202211;1287;3595;1055;3185;137;456;663;1905;800;2361
170310;202211;1907;4358;1353;3522;173;483;715;1845;888;2328
170320;202211;1253;3096;936;2583;119;364;561;1531;680;1895
170330;202211;1184;3211;1076;3051;31;138;939;2581;970;2719
170360;202211;696;1638;495;1330;24;81;330;820;354;901
170370;202211;1566;3620;1112;2907;190;513;553;1343;743;1856
170380;202211;2153;5610;1616;4788;131;424;953;2895;1084;3319
170382;202211;611;1624;491;1430;21;74;350;980;371;1054
170384;202211;2025;6204;1666;5559;332;1092;903;2983;1235;4075
170386;202211;1111;2858;670;2015;78;277;241;648;319;925
170388;202211;866;2111;614;1694;90;262;324;838;414;1100
170389;202211;1019;2920;808;2555;86;300;504;1613;590;1913
170390;202211;2200;4335;1659;3703;37;97;1444;3228;1481;3325
170410;202211;743;1698;541;1375;27;90;375;883;402;973
170460;202211;479;1224;376;1061;52;156;237;666;289;822
170510;202211;1080;2742;756;2197;32;128;491;1300;523;1428
170550;202211;8110;19631;6084;16537;1615;4840;1972;5091;3587;9931
170555;202211;1635;3922;1280;3383;142;317;634;1743;776;2060
170560;202211;1183;2998;886;2587;101;282;520;1569;621;1851
170600;202211;1655;4046;1282;3493;230;581;721;2016;951;2597
170610;202211;1984;4572;1462;3805;121;383;968;2401;1089;2784
170625;202211;526;1248;343;926;42;98;141;351;183;449
170650;202211;1800;4438;1463;3927;134;431;978;2503;1112;2934
170700;202211;4251;11381;3193;9386;646;1960;1401;3941;2047;5901
170710;202211;1993;4333;1498;3638;172;424;1013;2398;1185;2822
170720;202211;2161;4794;1629;3988;147;439;1131;2639;1278;3078
170730;202211;1292;3119;972;2644;110;260;594;1636;704;1896
170740;202211;2384;7057;2014;6406;150;559;1511;4687;1661;5246
170755;202211;1005;2464;704;1980;132;404;326;857;458;1261
170765;202211;1367;3216;950;2556;154;400;487;1298;641;1698
170770;202211;2210;5650;1767;4979;173;511;1260;3477;1433;3988
170820;202211;4704;12236;3593;10373;667;1959;1840;5230;2507;7189
170825;202211;1284;2576;1048;2276;102;207;798;1722;900;1929
170830;202211;1607;3803;1184;3121;271;847;575;1319;846;2166
170900;202211;3481;9583;2977;8869;322;862;2320;7075;2642;7937
170930;202211;4785;11912;3599;9780;821;2358;1164;2948;1985;5306
170950;202211;13858;35817;9732;28592;2869;9087;1330;3914;4199;13001
170980;202211;601;1398;422;1107;48;151;239;583;287;734
171050;202211;1970;5555;1685;5077;122;397;1296;3918;1418;4315
171070;202211;1602;4044;1350;3686;290;687;667;2121;957;2808
171090;202211;1187;2864;914;2456;153;431;462;1233;615;1664
171110;202211;673;1707;461;1318;66;198;216;562;282;760
171150;202211;1171;2698;716;1949;66;205;429;1123;495;1328
171180;202211;879;2246;553;1638;103;283;214;658;317;941
171190;202211;2339;6667;1949;5998;317;1016;1141;3506;1458;4522
171195;202211;987;2781;768;2377;108;420;473;1357;581;1777
171200;202211;726;1878;521;1531;128;432;161;421;289;853
171215;202211;462;1121;356;951;39;115;190;485;229;600
171240;202211;893;2630;689;2278;19;117;473;1493;492;1610
171245;202211;895;2359;681;1945;52;167;406;1065;458;1232
171250;202211;1132;2904;782;2312;130;413;339;985;469;1398
171270;202211;564;1816;435;1534;71;301;213;732;284;1033
171280;202211;1051;2807;837;2459;65;198;540;1589;605;1787
171320;202211;4663;12061;3562;10163;710;2032;1429;4094;2139;6126
171330;202211;3392;8522;2585;7152;658;1885;1148;3114;1806;4999
171360;202211;1793;4498;1344;3869;136;373;866;2660;1002;3033
171370;202211;849;1959;636;1659;74;197;395;1001;469;1198
171380;202211;1744;4407;1417;3961;169;425;971;2867;1140;3292
171395;202211;1190;2838;793;2173;97;296;493;1300;590;1596
171420;202211;2368;5920;1782;4884;326;964;920;2408;1246;3372
171430;202211;1303;3417;1060;2983;74;237;701;1845;775;2082
171488;202211;2975;7512;2287;6392;420;1172;1171;3260;1591;4432
171500;202211;1046;2462;726;1933;82;253;435;1112;517;1365
171510;202211;989;2793;838;2532;77;283;562;1636;639;1919
171515;202211;590;1338;415;1067;32;103;273;637;305;740
171525;202211;851;2067;637;1720;80;228;393;995;473;1223
171550;202211;392;1039;298;911;38;148;153;420;191;568
171570;202211;1278;3356;1054;2971;159;459;616;1742;775;2201
171575;202211;1988;4837;1297;3672;133;383;667;1823;800;2206
171610;202211;7197;18741;5262;15501;1289;4179;1169;3613;2458;7792
171620;202211;3549;8057;3023;7338;176;461;2492;6028;2668;6489
171630;202211;1311;3112;987;2655;139;393;632;1704;771;2097
171650;202211;2700;7035;2049;5965;502;1613;607;1754;1109;3367
171660;202211;2760;6362;1921;5037;176;485;1255;3217;1431;3702
171665;202211;1488;3816;1162;3303;242;729;509;1436;751;2165
171670;202211;2242;5472;1644;4483;256;735;747;1959;1003;2694
171700;202211;1360;3444;986;2772;123;357;569;1558;692;1915
171720;202211;913;2149;692;1816;76;208;471;1217;547;1425
171750;202211;1668;4629;1172;3704;266;817;325;1220;591;2037
171780;202211;1544;3488;1090;2805;102;306;715;1756;817;2062
171790;202211;1634;4891;1281;4167;191;632;660;2095;851;2727
171800;202211;849;2079;643;1782;63;186;370;976;433;1162
171820;202211;14176;36620;10401;30398;2456;7731;2741;8201;5197;15932
171830;202211;1836;5215;1559;4761;285;820;814;2652;1099;3472
171840;202211;846;2047;623;1701;22;76;379;975;401;1051
171845;202211;812;1782;610;1493;50;162;428;975;478;1137
171850;202211;1174;3212;986;2844;42;184;778;2150;820;2334
171855;202211;1226;3411;1006;3024;109;332;581;1693;690;2025
171865;202211;591;1533;496;1389;58;185;304;794;362;979
171870;202211;939;2386;649;1882;108;332;313;889;421;1221
171875;202211;1743;4180;1427;3715;54;213;1130;2809;1184;3022
171880;202211;1751;4110;1514;3798;48;147;1224;3023;1272;3170
171884;202211;1320;3147;1000;2629;230;569;492;1308;722;1877
171886;202211;1778;4477;1288;3767;329;1062;334;1029;663;2091
171888;202211;674;1818;455;1399;31;121;256;740;287;861
171889;202211;509;1426;335;1070;78;270;115;332;193;602
171890;202211;1446;3832;1059;3198;140;463;635;1844;775;2307
171900;202211;666;2035;509;1727;75;215;233;797;308;1012
172000;202211;671;1848;515;1569;100;306;197;582;297;888
172010;202211;1494;4160;1241;3759;120;336;774;2359;894;2695
172015;202211;433;1367;328;1167;60;205;143;511;203;716
172020;202211;3437;8548;2986;7991;240;679;2180;5946;2420;6625
172025;202211;836;2086;588;1694;42;133;397;1118;439;1251
172030;202211;1449;3929;1173;3482;84;291;867;2519;951;2810
172049;202211;1449;3347;945;2634;128;352;485;1389;613;1741
172065;202211;1737;3962;1357;3474;155;310;944;2684;1099;2994
172080;202211;2831;7473;2263;6501;127;415;1514;4246;1641;4661
172085;202211;526;1341;329;935;57;173;121;309;178;482
172090;202211;4908;10591;3835;9201;143;365;3105;7277;3248;7642
172093;202211;532;1485;376;1202;30;136;218;646;248;782
172097;202211;814;1963;533;1492;85;261;197;513;282;774
172100;202211;60881;139028;44996;115048;8348;23573;19208;47367;27556;70940
172110;202211;1995;6272;1697;5827;115;487;1320;4506;1435;4993
172120;202211;6147;16077;4787;13947;486;1541;2928;8361;3414;9902
172125;202211;485;1201;365;1009;32;106;203;508;235;614
172130;202211;695;1638;518;1345;22;78;342;808;364;886
172208;202211;3056;6669;2360;5774;198;430;1710;4173;1908;4603
172210;202211;3159;7041;2433;6160;248;603;1599;4184;1847;4787
210005;202211;22982;59977;17222;50808;4457;13824;7277;21697;11734;35521
210010;202211;2630;6473;2415;6227;44;200;2224;5626;2268;5826
210015;202211;3699;10080;3161;9365;153;460;2605;7742;2758;8202
210020;202211;9803;19018;8493;17500;599;791;7436;15683;8035;16474
210030;202211;5257;16005;4756;15231;485;1579;3739;12095;4224;13674
210040;202211;2586;4994;2257;4605;59;163;2036;4051;2095;4214
210043;202211;6860;17658;5727;16130;368;1096;4528;12773;4896;13869
210047;202211;8083;21697;6348;19433;159;675;5482;16709;5641;17384
210050;202211;2909;8038;2321;7008;154;632;1766;5102;1920;5734
210055;202211;2464;6431;2153;5998;52;156;1878;5296;1930;5452
210060;202211;8716;28892;7659;27020;792;2920;5289;19081;6081;22001
210070;202211;7986;19067;7358;18273;84;225;6913;17098;6997;17323
210080;202211;5235;14517;4902;14145;43;226;4576;13141;4619;13367
210083;202211;7221;16565;6074;15316;100;322;5738;14398;5838;14720
210087;202211;3178;8259;2670;7584;161;510;2121;5971;2282;6481
210090;202211;10762;29747;9888;28334;419;1098;8541;24410;8960;25508
210095;202211;7389;22341;6659;21389;504;1565;5271;17607;5775;19172
210100;202211;7494;21012;6450;19217;845;2494;4250;12824;5095;15318
210110;202211;3577;9286;3266;8901;54;249;2965;7982;3019;8231
210120;202211;34766;74310;29622;67976;1592;3075;23824;54937;25416;58012
210125;202211;5218;12675;4521;11888;793;1569;3178;9008;3971;10577
210130;202211;4958;11353;4009;10182;85;194;3537;8946;3622;9140
210135;202211;2156;4729;1786;4212;54;123;1558;3638;1612;3761
210140;202211;25050;59503;19536;52405;2794;7429;12343;33397;15137;40826
210150;202211;5557;11763;4839;10814;118;315;4191;9158;4309;9473
210160;202211;26066;58358;22314;53680;1782;3776;17486;42706;19268;46482
210170;202211;20981;52481;19137;50054;1774;3705;15154;41067;16928;44772
210173;202211;2641;9090;2464;8803;96;493;2169;7651;2265;8144
210177;202211;3726;9485;3186;8793;444;1092;2353;6727;2797;7819
210180;202211;1804;4069;1574;3791;38;91;1417;3414;1455;3505
210190;202211;6613;14926;5467;13367;92;271;4794;11504;4886;11775
210193;202211;1606;4027;1370;3666;55;153;1057;2802;1112;2955
210197;202211;2306;6532;2065;6199;153;429;1650;5054;1803;5483
210200;202211;9416;26331;8237;24594;519;1658;6517;19399;7036;21057
210203;202211;8421;22104;7032;20298;550;1544;5526;16341;6076;17885
210207;202211;4487;9901;3663;8957;148;321;3045;7505;3193;7826
210210;202211;8720;24973;7801;23712;140;727;6717;20162;6857;20889
210215;202211;2826;8009;2438;7456;148;627;1989;5976;2137;6603
210220;202211;8165;22824;7664;22119;158;878;6936;19477;7094;20355
210230;202211;6794;17148;6126;16147;154;395;5576;14688;5730;15083
210232;202211;13861;37967;11330;34268;1619;4828;7510;23612;9129;28440
210235;202211;4020;10842;3480;10069;158;551;2909;8377;3067;8928
210237;202211;4912;10577;4216;9795;24;119;4022;9207;4046;9326
210240;202211;2951;8155;2621;7638;81;249;2150;6208;2231;6457
210250;202211;7071;17844;6380;16977;163;474;5746;15313;5909;15787
210255;202211;3101;8520;2624;7684;312;1005;1614;4561;1926;5566
210260;202211;6210;16718;5323;15439;397;1232;4267;12297;4664;13529
210270;202211;5770;13912;5067;13041;79;361;4581;11627;4660;11988
210275;202211;3967;8998;3346;8248;171;370;2752;6829;2923;7199
210280;202211;7381;17158;6083;15319;165;692;5020;12091;5185;12783
210290;202211;9889;21494;8852;20254;116;313;8375;19042;8491;19355
210300;202211;38273;96674;30854;86149;5855;15523;15714;48588;21569;64111
210310;202211;3564;8020;3075;7346;41;117;2822;6680;2863;6797
210312;202211;3331;7112;2947;6693;18;73;2734;6088;2752;6161
210315;202211;4360;9320;3901;8806;125;278;3611;8147;3736;8425
210317;202211;5162;14206;4668;13621;111;475;4248;12312;4359;12787
210320;202211;30869;67058;28656;64353;243;1132;26992;59506;27235;60638
210325;202211;4104;10539;3387;9579;401;1143;2503;7146;2904;8289
210330;202211;30886;74100;24846;66768;3904;8503;16321;48346;20225;56849
210340;202211;15149;33023;13615;31125;744;1382;11397;26585;12141;27967
210350;202211;11429;27504;10035;25803;136;439;9082;23160;9218;23599
210355;202211;4475;13725;3909;12832;105;481;3299;10782;3404;11263
210360;202211;14567;41842;13026;39419;545;2285;9823;28664;10368;30949
210370;202211;14329;26811;10749;23041;343;514;9866;21493;10209;22007
210375;202211;3832;9612;2775;8022;929;2852;667;2039;1596;4891
210380;202211;6554;14894;5636;13797;254;693;4868;11783;5122;12476
210390;202211;3756;9613;3479;9200;67;288;3184;8288;3251;8576
210400;202211;5458;14004;4801;13237;252;496;4240;12006;4492;12502
210405;202211;8936;20723;7258;18487;1214;2749;4409;11848;5623;14597
210407;202211;2405;6904;1986;6179;137;419;1526;4747;1663;5166
210408;202211;3161;10284;2908;9949;186;766;2327;7991;2513;8757
210409;202211;4405;13504;3918;12826;215;767;3154;10566;3369;11333
210410;202211;4265;11131;3585;9961;81;332;2964;8010;3045;8342
210420;202211;4376;12658;3847;11739;220;634;3146;9636;3366;10270
210430;202211;2573;6890;2220;6408;190;527;1792;5238;1982;5765
210440;202211;5014;12205;4330;11366;202;406;3841;10171;4043;10577
210450;202211;2656;7046;2272;6491;255;611;1677;4972;1932;5583
210455;202211;5728;13197;4432;11572;1041;2828;2169;5689;3210;8517
210460;202211;4159;11021;3449;10049;120;409;2882;8330;3002;8739
210462;202211;1927;5293;1602;4800;69;184;1250;3775;1319;3959
210465;202211;3100;8003;2668;7421;136;513;2224;6037;2360;6550
210467;202211;7342;19303;6308;17971;536;1341;5028;14724;5564;16065
210470;202211;2142;5447;1577;4652;156;429;1120;3359;1276;3788
210480;202211;19785;52948;16280;48678;2059;4433;11423;37682;13482;42115
210490;202211;3892;8882;3074;7792;86;221;2608;6561;2694;6782
210500;202211;7400;24837;6810;23881;348;1520;5744;19936;6092;21456
210510;202211;7878;20732;7001;19800;147;417;6476;18429;6623;18846
210515;202211;4387;11650;3726;10862;195;606;3087;9118;3282;9724
210520;202211;3017;7951;2685;7511;140;440;2248;6204;2388;6644
210530;202211;66201;149427;51641;128677;9697;25813;21833;57641;31530;83454
210535;202211;4315;11947;3899;11362;131;457;3432;9966;3563;10423
210540;202211;17786;46218;14742;41827;2005;5016;9823;29542;11828;34558
210542;202211;7581;16437;5860;14482;522;1194;4568;11438;5090;12632
210545;202211;2520;7108;2296;6739;49;186;1975;5720;2024;5906
210547;202211;4257;13727;3735;12817;211;756;2913;10185;3124;10941
210550;202211;6802;19107;5187;16532;630;2155;3207;10444;3837;12599
210560;202211;4262;11981;3732;11145;90;339;3190;9360;3280;9699
210565;202211;1744;4673;1423;4238;98;355;1076;3218;1174;3573
210570;202211;12665;31543;11170;29697;271;755;9986;26647;10257;27402
210580;202211;3415;8095;2674;7183;192;463;1941;5463;2133;5926
210590;202211;4780;13044;4065;12153;84;415;3603;10713;3687;11128
210592;202211;3300;8124;3048;7743;37;162;2693;6668;2730;6830
210594;202211;2845;7264;2210;6295;206;542;1536;4537;1742;5079
210596;202211;3382;10229;2984;9551;346;1117;2191;7207;2537;8324
210598;202211;2389;5795;2135;5459;87;250;1870;4749;1957;4999
210600;202211;3440;8730;2755;7754;316;813;1812;5139;2128;5952
210610;202211;3612;8309;3069;7660;56;218;2688;6590;2744;6808
210620;202211;3522;7706;2851;6865;149;302;2424;5765;2573;6067
210630;202211;3662;10606;3225;9880;174;638;2558;7752;2732;8390
210632;202211;7225;16278;6443;15265;187;630;5768;13315;5955;13945
210635;202211;1893;6232;1766;6004;181;554;1336;4678;1517;5232
210637;202211;3073;8767;2566;8046;164;585;1960;6212;2124;6797
210640;202211;5836;16924;5417;16444;61;314;5041;15222;5102;15536
210650;202211;8099;20723;7210;19593;107;367;6471;17514;6578;17881
210660;202211;9454;24572;8398;22903;168;748;7325;19345;7493;20093
210663;202211;3581;8141;3151;7622;314;492;2358;6196;2672;6688
210667;202211;2241;6507;1984;6117;57;199;1698;5349;1755;5548
210670;202211;6616;16857;5965;15872;121;494;5371;14018;5492;14512
210675;202211;6448;14454;5380;13108;593;1223;4148;10375;4741;11598
210680;202211;5741;11701;4850;10672;93;160;4537;9979;4630;10139
210690;202211;11095;24814;9438;22967;253;766;8623;20689;8876;21455
210700;202211;3248;8012;2563;7033;171;423;1961;5441;2132;5864
210710;202211;6253;16283;5463;15255;114;436;4909;13589;5023;14025
210720;202211;3567;10133;3086;9535;96;410;2709;8332;2805;8742
210725;202211;1531;4440;1305;4099;53;176;935;3035;988;3211
210730;202211;1720;3487;1434;3108;66;122;1246;2695;1312;2817
210735;202211;5341;13685;4500;12633;309;734;3665;10689;3974;11423
210740;202211;6103;14013;5159;12933;126;272;4394;10943;4520;11215
210745;202211;4919;12083;4426;11464;59;197;3984;10241;4043;10438
210750;202211;30227;71621;26152;66431;3846;8504;16959;45542;20805;54046
210760;202211;7540;15431;6380;14204;130;235;5910;13370;6040;13605
210770;202211;7302;16216;6221;14988;54;226;5821;13850;5875;14076
210780;202211;8627;24142;7404;22170;510;1541;5764;17218;6274;18759
210790;202211;5169;14060;4551;13241;277;742;3726;11110;4003;11852
210800;202211;5767;13669;4919;12529;77;295;4456;11123;4533;11418
210805;202211;4769;15109;4374;14533;201;705;3691;12353;3892;13058
210810;202211;5716;14948;5141;14220;430;1034;4181;11897;4611;12931
210820;202211;8371;21730;6943;19487;998;2622;4134;12023;5132;14645
210825;202211;9819;23060;8911;21912;231;669;8159;19851;8390;20520
210830;202211;10518;24278;9521;23067;912;1512;7746;19693;8658;21205
210840;202211;5774;10058;5302;9500;32;125;5042;8794;5074;8919
210845;202211;7230;17397;6344;16413;52;155;6068;15727;6120;15882
210850;202211;8179;21823;6774;19776;491;1379;5394;15872;5885;17251
210860;202211;25135;55448;20785;50262;975;2153;17283;42704;18258;44857
210870;202211;8841;19533;7014;17471;174;420;6263;15548;6437;15968
210880;202211;4829;12991;4264;12250;221;669;3368;9606;3589;10275
210890;202211;5895;12895;5399;12324;206;520;4840;10871;5046;11391
210900;202211;5718;15098;4406;12787;1593;4681;891;2939;2484;7620
210905;202211;2685;5656;2287;5165;46;84;2135;4831;2181;4915
210910;202211;8590;24286;7064;21841;923;2813;4550;14141;5473;16954
210920;202211;3666;10345;3199;9730;69;303;2898;8714;2967;9017
210923;202211;2287;5150;1973;4701;96;237;1623;3768;1719;4005
210927;202211;5345;16120;4604;15195;632;2017;3070;10598;3702;12615
210930;202211;3457;8946;3027;8188;89;364;2636;6873;2725;7237
210940;202211;4212;11049;3791;10533;340;1509;3083;7854;3423;9363
210945;202211;9396;21805;8357;20617;583;1061;6814;17496;7397;18557
210950;202211;6345;15689;4878;13651;610;1331;3298;9917;3908;11248
210955;202211;1760;4899;1459;4422;278;811;857;2646;1135;3457
210960;202211;10717;28943;9136;26530;2871;8199;3790;12070;6661;20269
210970;202211;2007;4690;1652;4121;90;273;1385;3309;1475;3582
210975;202211;2015;5581;1810;5273;191;556;1320;3842;1511;4398
210980;202211;12557;24371;11145;22902;157;271;10552;21673;10709;21944
210990;202211;20732;51251;16071;45335;1662;3998;11318;33381;12980;37379
211000;202211;17241;43929;14151;40114;2600;6450;9323;28235;11923;34685
211003;202211;7405;17498;6190;16078;115;439;5488;14238;5603;14677
211010;202211;8186;23344;7381;22356;78;363;6770;20568;6848;20931
211020;202211;10438;25356;9144;23923;206;640;8096;21525;8302;22165
211023;202211;2409;6950;2199;6678;130;390;1790;5431;1920;5821
211027;202211;4555;11098;4299;10715;103;341;3985;9761;4088;10102
211030;202211;4537;11263;4003;10598;387;964;2969;8020;3356;8984
211040;202211;5188;16607;4739;15852;121;611;4222;13996;4343;14607
211050;202211;10937;24503;9756;23033;132;401;8928;20918;9060;21319
211060;202211;9003;22160;8151;21046;168;607;7350;18677;7518;19284
211065;202211;2922;6629;2430;6017;126;256;2083;5236;2209;5492
211070;202211;9862;26604;8335;24377;337;1059;7067;20595;7404;21654
211080;202211;1577;3784;1237;3274;33;168;957;2343;990;2511
211085;202211;2541;6325;2097;5758;198;384;1623;4734;1821;5118
211090;202211;3618;8954;3247;8526;27;114;3012;7847;3039;7961
211100;202211;8334;17877;7627;17065;33;103;7188;16022;7221;16125
211102;202211;3951;11082;3568;10535;341;1020;2832;8403;3173;9423
211105;202211;2741;7739;2292;6970;123;384;1761;5251;1884;5635
211107;202211;5471;15602;4602;14328;176;592;3687;11928;3863;12520
211110;202211;7661;17686;6093;15418;258;760;4991;12271;5249;13031
211120;202211;58488;128124;47901;115664;8004;17701;30510;76673;38514;94374
211125;202211;2235;6145;1876;5605;38;176;1598;4734;1636;4910
211130;202211;227723;488384;195335;446611;27161;55550;124384;293934;151545;349484
211140;202211;5450;14732;4685;13736;173;531;3959;11682;4132;12213
211150;202211;11322;26779;9463;24485;528;1084;7682;20383;8210;21467
211153;202211;3460;8404;2398;7076;435;1143;1465;4605;1900;5748
211157;202211;1469;4061;1240;3633;86;258;890;2591;976;2849
211160;202211;6198;13745;5026;12150;132;460;4162;9535;4294;9995
211163;202211;1734;5055;1558;4807;58;201;1345;4175;1403;4376
211167;202211;2004;5158;1851;4950;33;115;1712;4549;1745;4664
211170;202211;8635;16958;7957;16169;60;160;7582;15222;7642;15382
211172;202211;2998;7547;2496;6791;91;295;2031;5286;2122;5581
211174;202211;3362;8467;3029;8095;32;161;2870;7592;2902;7753
211176;202211;4940;12699;3843;11119;312;969;2974;8545;3286;9514
211178;202211;6303;12006;5444;11095;34;119;5255;10604;5289;10723
211180;202211;4884;14290;4441;13659;171;692;3673;11158;3844;11850
211190;202211;3864;9472;3259;8612;33;169;2969;7712;3002;7881
211195;202211;1900;4363;1650;4004;64;151;1444;3491;1508;3642
211200;202211;2480;6679;1929;5811;192;608;1342;3981;1534;4589
211210;202211;7160;19876;6369;18784;496;1496;5105;15089;5601;16585
211220;202211;51354;109886;42802;99554;4083;8811;32226;75227;36309;84038
211223;202211;6229;15066;5016;13452;651;1766;3245;8719;3896;10485
211227;202211;1962;5604;1674;5199;60;232;1373;4265;1433;4497
211230;202211;10129;24596;8661;22546;325;681;7471;19540;7796;20221
211240;202211;12121;27596;11426;26744;162;613;10873;25023;11035;25636
211245;202211;9322;22683;8208;21506;170;426;7803;20449;7973;20875
211250;202211;18113;46410;16330;43754;1406;3732;12719;33969;14125;37701
211260;202211;9579;26715;8220;25135;186;741;7396;22706;7582;23447
211270;202211;11863;33342;10077;31053;398;1509;8237;25536;8635;27045
211280;202211;18701;39530;16742;37140;395;882;15385;33945;15780;34827
211285;202211;2361;6543;2090;6200;159;524;1580;4680;1739;5204
211290;202211;8310;22528;7391;21280;316;979;6070;17375;6386;18354
211300;202211;8382;22584;7250;20732;474;1429;5529;15545;6003;16974
211400;202211;13964;34413;11306;30784;1494;3859;7457;21236;8951;25095
220005;202211;2334;5221;2099;4899;53;120;1768;3993;1821;4113
220010;202211;1728;4422;1384;3848;50;142;1084;2977;1134;3119
220020;202211;5434;11517;4716;10579;225;513;4088;8994;4313;9507
220025;202211;2772;5397;2365;4809;66;114;1991;3896;2057;4010
220027;202211;1635;3503;1398;3179;28;86;1227;2716;1255;2802
220030;202211;4627;9596;4269;9131;99;252;3809;7951;3908;8203
220040;202211;9469;25549;8168;23160;1536;4033;4665;13666;6201;17699
220045;202211;1878;4797;1558;4303;22;111;1346;3600;1368;3711
220050;202211;6487;13901;5621;12833;66;220;5287;11866;5353;12086
220060;202211;3526;5832;3045;5285;61;81;2886;4991;2947;5072
220070;202211;2820;6518;2328;5817;72;158;1940;4771;2012;4929
220080;202211;863;2231;744;2063;18;69;615;1653;633;1722
220090;202211;2008;4333;1618;3766;65;94;1342;3145;1407;3239
220095;202211;1181;2077;1122;2014;19;36;1052;1871;1071;1907
220100;202211;1679;4020;1324;3485;31;124;1079;2701;1110;2825
220105;202211;2423;6581;2080;6003;149;465;1545;4422;1694;4887
220110;202211;4219;9960;3655;9056;42;165;3264;7950;3306;8115
220115;202211;3391;8521;3097;8151;157;445;2693;7001;2850;7446
220117;202211;1646;3486;1289;2999;20;63;1079;2417;1099;2480
220120;202211;20774;39261;19148;37235;88;295;18289;34951;18377;35246
220130;202211;1332;3133;1101;2824;30;121;976;2425;1006;2546
220140;202211;2812;5017;2391;4535;86;156;2145;4097;2231;4253
220150;202211;7666;19424;6877;18127;143;522;5802;14858;5945;15380
220155;202211;1386;3613;1094;3094;21;77;789;2142;810;2219
220157;202211;1316;2745;1102;2437;31;72;889;1918;920;1990
220160;202211;3333;8169;2830;7295;59;200;2311;5754;2370;5954
220170;202211;1835;4435;1525;3985;38;134;1304;3355;1342;3489
220173;202211;2485;6277;1972;5396;45;175;1568;4157;1613;4332
220177;202211;2835;6090;2689;5931;8;28;2647;5813;2655;5841
220180;202211;1427;2878;1161;2458;3;17;985;1937;988;1954
220190;202211;9959;19836;8478;17965;635;1147;6531;14180;7166;15327
220191;202211;1948;5129;1754;4814;134;403;1283;3419;1417;3822
220192;202211;2408;5670;1735;4527;41;130;1412;3598;1453;3728
220194;202211;2210;5279;1929;4829;44;166;1618;3854;1662;4020
220196;202211;2567;5766;2323;5417;20;87;2017;4577;2037;4664
220198;202211;1583;3529;1339;3233;16;39;1217;2946;1233;2985
220200;202211;5967;15674;5193;14630;146;532;4360;12161;4506;12693
220202;202211;2566;6236;2155;5589;30;121;1845;4677;1875;4798
220205;202211;3219;7552;2855;6942;89;258;2422;5717;2511;5975
220207;202211;901;2402;759;2167;76;190;480;1414;556;1604
220208;202211;2119;5862;1709;5117;284;890;892;2641;1176;3531
220209;202211;1807;4767;1512;4246;31;109;1167;3209;1198;3318
220210;202211;2314;4623;2020;4199;21;58;1788;3586;1809;3644
220211;202211;2057;4193;1877;3963;18;63;1661;3428;1679;3491
220213;202211;2138;4992;1797;4421;31;102;1461;3399;1492;3501
220217;202211;2881;6766;2657;6510;174;246;2335;5940;2509;6186
220220;202211;16203;32312;13972;29183;477;1057;11773;23925;12250;24982
220225;202211;1216;2707;990;2426;2;12;930;2253;932;2265
220230;202211;6986;15225;6006;13905;383;782;5056;11730;5439;12512
220240;202211;3799;9549;3084;8352;102;405;2498;6548;2600;6953
220245;202211;2462;4322;1903;3672;10;36;1774;3364;1784;3400
220250;202211;3636;8724;3170;8149;27;105;2963;7543;2990;7648
220253;202211;1942;4717;1630;4242;36;110;1389;3535;1425;3645
220255;202211;2353;4856;1978;4335;40;137;1706;3580;1746;3717
220260;202211;6084;14948;5262;13559;279;690;4219;10812;4498;11502
220265;202211;1821;4719;1646;4492;85;299;1382;3666;1467;3965
220270;202211;7188;20795;6688;19901;173;854;5678;16189;5851;17043
220271;202211;1798;3988;1568;3679;45;114;1351;3122;1396;3236
220272;202211;2020;5292;1745;4789;51;175;1325;3462;1376;3637
220273;202211;1508;3858;1248;3408;64;208;948;2539;1012;2747
220275;202211;3180;5940;2544;5084;65;96;2310;4573;2375;4669
220277;202211;2835;5878;2381;5253;94;180;1999;4322;2093;4502
220280;202211;2387;4321;2013;3865;27;52;1834;3444;1861;3496
220285;202211;2024;4012;1749;3688;11;47;1672;3465;1683;3512
220290;202211;8332;20406;6612;18062;571;1420;4656;13164;5227;14584
220300;202211;2328;6020;1809;5351;38;183;1470;4291;1508;4474
220310;202211;3848;8906;3023;7950;47;174;2644;6879;2691;7053
220320;202211;3649;9285;2764;7761;73;311;2180;5853;2253;6164
220323;202211;2026;5021;1547;4267;46;169;1294;3432;1340;3601
220325;202211;1419;3900;1171;3478;36;141;940;2732;976;2873
220327;202211;1983;4803;1719;4388;68;225;1440;3545;1508;3770
220330;202211;6453;12462;5554;11408;83;244;5105;10251;5188;10495
220335;202211;2230;5485;2020;5202;131;235;1691;4445;1822;4680
220340;202211;2102;5212;1575;4340;79;257;1003;2648;1082;2905
220342;202211;1490;3709;1325;3480;115;213;1001;2721;1116;2934
220345;202211;3682;7346;2789;6142;18;55;2495;5383;2513;5438
220350;202211;3896;9045;3109;7895;221;507;2181;5499;2402;6006
220360;202211;1568;3538;1205;2967;18;56;983;2331;1001;2387
220370;202211;10722;26636;9634;24982;400;1081;8137;20830;8537;21911
220375;202211;2042;4782;1802;4491;15;19;1737;4349;1752;4368
220380;202211;1890;3767;1503;3228;30;55;1319;2806;1349;2861
220385;202211;1117;2221;907;1874;6;10;815;1643;821;1653
220390;202211;15262;32557;12204;28219;1994;4716;6772;15338;8766;20054
220400;202211;1791;3833;1360;3174;18;62;1063;2333;1081;2395
220410;202211;1420;3485;1133;3011;32;111;933;2409;965;2520
220415;202211;1004;2330;796;1980;24;48;616;1496;640;1544
220420;202211;2210;5773;1752;4895;80;262;1270;3456;1350;3718
220430;202211;3500;7415;3107;6909;47;118;2814;6125;2861;6243
220435;202211;2459;5232;2128;4735;29;93;1830;3916;1859;4009
220440;202211;3883;8829;3287;7984;56;257;2925;6802;2981;7059
220450;202211;3287;7280;2723;6582;56;184;2413;5718;2469;5902
220455;202211;1666;4110;1577;4002;17;55;1440;3663;1457;3718
220460;202211;1398;2766;1285;2612;25;58;1148;2249;1173;2307
220465;202211;2896;7827;2543;7294;177;510;1997;5735;2174;6245
220470;202211;4634;10993;4084;10139;206;424;3151;7739;3357;8163
220480;202211;3139;7428;2476;6419;235;445;1651;4299;1886;4744
220490;202211;2887;6424;2450;5882;25;120;2158;5045;2183;5165
220500;202211;3974;8503;3302;7494;134;247;2570;5695;2704;5942
220510;202211;3230;7643;2587;6571;109;260;2034;5211;2143;5471
220515;202211;2132;4395;1944;4131;77;98;1658;3511;1735;3609
220520;202211;6205;13832;5572;12948;114;241;4788;11047;4902;11288
220525;202211;1682;3601;1400;3264;26;62;1262;2938;1288;3000
220527;202211;1975;4201;1635;3708;59;127;1448;3285;1507;3412
220530;202211;1992;4012;1654;3585;167;349;1269;2825;1436;3174
220535;202211;1028;2437;946;2314;29;103;780;1822;809;1925
220540;202211;3819;10714;3481;10068;225;626;2789;8033;3014;8659
220545;202211;1765;4598;1594;4337;86;310;1341;3562;1427;3872
220550;202211;10378;29297;9060;26874;529;1710;6652;19184;7181;20894
220551;202211;1742;4126;1483;3698;28;90;1253;3042;1281;3132
220552;202211;1923;5036;1545;4391;25;126;1244;3375;1269;3501
220553;202211;2532;4952;2130;4433;27;50;1938;3976;1965;4026
220554;202211;1162;2557;893;2160;81;156;632;1502;713;1658
220555;202211;4720;8401;4191;7770;33;89;3803;6959;3836;7048
220556;202211;1554;3909;1314;3493;40;175;960;2376;1000;2551
220557;202211;1979;5440;1622;4705;97;362;1175;3251;1272;3613
220558;202211;1747;3983;1389;3496;24;91;1195;2903;1219;2994
220559;202211;2235;4717;1884;4187;54;87;1569;3450;1623;3537
220560;202211;2369;4396;1998;3952;20;41;1880;3673;1900;3714
220570;202211;9743;24750;8706;23249;677;1665;6798;18088;7475;19753
220580;202211;8074;19385;7253;18171;102;280;6456;16063;6558;16343
220585;202211;2456;6826;2003;5985;68;175;1594;4753;1662;4928
220590;202211;1909;4117;1579;3659;108;219;1262;2880;1370;3099
220595;202211;3317;7789;2948;7285;85;272;2528;6088;2613;6360
220600;202211;2233;3744;1956;3430;20;34;1848;3203;1868;3237
220605;202211;1738;4632;1474;4173;24;118;1183;3216;1207;3334
220610;202211;3477;8331;3234;7988;16;91;3062;7471;3078;7562
220620;202211;10643;25676;9678;24395;136;624;8904;21971;9040;22595
220630;202211;421;1136;322;963;27;87;198;558;225;645
220635;202211;2119;5607;1857;5101;69;211;1485;3958;1554;4169
220640;202211;2823;7003;2376;6355;89;304;1915;5032;2004;5336
220650;202211;2958;6480;2522;5839;86;175;2095;4821;2181;4996
220660;202211;3100;8582;2577;7722;78;343;2126;6181;2204;6524
220665;202211;1605;4055;1366;3680;31;139;1181;3076;1212;3215
220667;202211;1920;5068;1728;4747;89;281;1394;3770;1483;4051
220669;202211;1966;5107;1861;4957;39;159;1668;4319;1707;4478
220670;202211;2814;5943;2257;5180;30;80;2000;4507;2030;4587
220672;202211;4133;8912;3401;8042;102;346;3017;6935;3119;7281
220675;202211;1537;3788;1360;3482;86;251;1023;2557;1109;2808
220680;202211;3701;7804;3503;7557;213;312;3083;6762;3296;7074
220690;202211;1863;4402;1589;3988;112;316;1196;2924;1308;3240
220695;202211;1109;2754;993;2558;21;60;833;2105;854;2165
220700;202211;14879;28813;12183;25356;454;1007;10034;20134;10488;21141
220710;202211;1040;2520;751;2036;23;80;575;1494;598;1574
220720;202211;2756;5444;2459;5069;27;75;2207;4436;2234;4511
220730;202211;1665;3905;1425;3539;15;61;1249;3010;1264;3071
220735;202211;1240;2468;951;2039;40;77;733;1531;773;1608
220740;202211;1632;3730;1298;3290;56;131;1056;2690;1112;2821
220750;202211;5292;10849;4667;10023;269;421;4121;8935;4390;9356
220755;202211;1796;3640;1487;3209;44;87;1235;2609;1279;2696
220760;202211;4281;8961;3739;8267;45;153;3510;7678;3555;7831
220770;202211;33223;83497;28554;76000;7223;20587;12816;33444;20039;54031
220775;202211;1685;3406;1505;3188;5;23;1471;3083;1476;3106
220777;202211;1869;4273;1461;3662;52;101;1014;2673;1066;2774
220779;202211;1456;3487;1239;3154;41;117;1026;2553;1067;2670
220780;202211;7060;15240;6305;14175;396;901;4924;10997;5320;11898
220785;202211;1749;3369;1534;3101;21;48;1447;2892;1468;2940
220790;202211;12595;30533;11229;28654;237;829;9677;24265;9914;25094
220793;202211;1180;2595;949;2222;16;35;809;1860;825;1895
220795;202211;1668;3793;1452;3487;31;88;1287;3063;1318;3151
220800;202211;26180;48835;22524;44172;1003;1883;18522;35294;19525;37177
220810;202211;3708;8956;3109;7985;78;170;2534;6574;2612;6744
220820;202211;7306;15114;6422;13894;310;507;5398;11656;5708;12163
220830;202211;9301;20659;8203;19105;468;1043;6636;15150;7104;16193
220840;202211;15864;40477;13421;36075;1950;5111;8429;22102;10379;27213
220850;202211;3588;9799;3166;9272;53;246;2824;8251;2877;8497
220855;202211;1041;1960;907;1795;19;52;832;1622;851;1674
220860;202211;1442;2835;1234;2547;22;65;1148;2318;1170;2383
220865;202211;2683;6701;2033;5574;45;185;1533;4027;1578;4212
220870;202211;3961;8763;3268;7887;38;160;2989;7084;3027;7244
220880;202211;8048;14359;6927;13027;139;303;6376;11859;6515;12162
220885;202211;1817;4385;1515;3944;93;262;1196;3073;1289;3335
220887;202211;1952;3592;1640;3186;39;54;1518;2930;1557;2984
220890;202211;1689;4475;1441;4122;57;197;1163;3305;1220;3502
220900;202211;2626;5173;2206;4625;24;51;1997;4089;2021;4140
220910;202211;2130;4620;1813;4158;301;495;1276;3118;1577;3613
220915;202211;1081;2678;836;2250;7;26;635;1602;642;1628
220920;202211;1883;4852;1620;4509;103;291;1336;3739;1439;4030
220930;202211;2425;5062;2047;4567;21;55;1840;4171;1861;4226
220935;202211;1242;3286;964;2708;20;89;651;1704;671;1793
220937;202211;1726;4082;1444;3635;38;115;1154;2824;1192;2939
220940;202211;2269;4787;1856;4120;43;122;1586;3366;1629;3488
220945;202211;581;1766;455;1538;24;125;312;1021;336;1146
220950;202211;1595;3384;1056;2564;12;32;854;1966;866;1998
220955;202211;1991;4307;1642;3747;17;39;1443;3235;1460;3274
220960;202211;879;2097;635;1695;35;113;404;985;439;1098
220965;202211;2193;4996;1905;4589;23;106;1686;3934;1709;4040
220970;202211;2615;5045;1953;4124;9;32;1730;3524;1739;3556
220975;202211;912;2087;768;1901;12;52;685;1629;697;1681
220980;202211;1548;3530;1377;3307;39;105;1202;2823;1241;2928
220985;202211;1761;3710;1518;3345;100;171;1179;2565;1279;2736
220987;202211;1792;4588;1582;4249;52;173;1319;3486;1371;3659
220990;202211;1952;4871;1691;4475;24;94;1425;3708;1449;3802
220995;202211;1687;3760;1388;3271;13;42;1193;2751;1206;2793
220997;202211;2901;7468;2612;7000;46;180;2326;6053;2372;6233
221000;202211;5841;13373;5058;12281;183;518;4271;10201;4454;10719
221005;202211;1993;4289;1809;3999;24;95;1575;3310;1599;3405
221010;202211;1555;2935;1232;2544;39;55;1089;2223;1128;2278
221020;202211;1765;4918;1581;4614;23;95;1237;3573;1260;3668
221030;202211;2057;4153;1753;3782;22;57;1577;3406;1599;3463
221035;202211;1917;4160;1610;3747;45;67;1402;3281;1447;3348
221037;202211;834;2008;695;1777;12;44;524;1250;536;1294
221038;202211;613;1550;474;1318;26;83;336;904;362;987
221039;202211;993;2460;809;2170;28;107;652;1690;680;1797
221040;202211;5262;13464;4476;12180;237;627;3561;9664;3798;10291
221050;202211;5652;10932;5071;10218;78;207;4657;9249;4735;9456
221060;202211;11711;27662;9587;24279;501;1109;7667;19211;8168;20320
221062;202211;1622;4003;1384;3645;120;245;1075;2882;1195;3127
221063;202211;1463;3368;1277;3109;63;180;1053;2482;1116;2662
221065;202211;3538;7408;3061;6645;15;51;2781;5912;2796;5963
221070;202211;3954;10939;3150;9336;483;1408;1871;5610;2354;7018
221080;202211;4356;9345;3550;8166;53;181;2995;6593;3048;6774
221090;202211;1679;3685;1384;3247;18;44;1209;2772;1227;2816
221093;202211;2033;4497;1836;4178;189;366;1333;2969;1522;3335
221095;202211;1079;2479;891;2211;37;100;713;1744;750;1844
221097;202211;985;2260;733;1840;18;53;569;1339;587;1392
221100;202211;175722;390998;149215;349772;10145;27329;110323;244559;120468;271888
221110;202211;13643;32577;12417;31048;413;925;10902;27185;11315;28110
221120;202211;5866;14974;5199;13999;192;581;4448;11879;4640;12460
221130;202211;7194;15415;5646;12747;928;1876;3603;7881;4531;9757
221135;202211;2435;4968;2101;4548;88;160;1802;3961;1890;4121
221140;202211;1925;3513;1590;3109;57;90;1390;2692;1447;2782
221150;202211;1337;2966;1008;2430;26;111;804;1813;830;1924
221160;202211;888;1963;784;1832;40;52;615;1447;655;1499
221170;202211;1238;2928;1145;2773;6;17;1048;2482;1054;2499
230010;202211;3595;8544;2916;7412;59;174;2389;5878;2448;6052
230015;202211;4353;11391;3749;10206;228;655;2679;7161;2907;7816
230020;202211;18667;46978;17232;44808;955;2388;14183;36905;15138;39293
230030;202211;15630;34330;13022;30866;537;1126;10624;25450;11161;26576
230040;202211;5474;11986;4544;10571;45;188;3783;8806;3828;8994
230050;202211;3069;8761;2333;7125;300;996;1166;3220;1466;4216
230060;202211;2953;6987;2283;5884;41;145;1830;4582;1871;4727
230070;202211;5335;11869;4237;10006;563;1215;2727;6475;3290;7690
230075;202211;11954;31669;10780;29721;538;1791;8780;23596;9318;25387
230080;202211;3748;6846;2860;5759;11;25;2673;5331;2684;5356
230090;202211;5614;11657;4673;10228;154;332;3927;8318;4081;8650
230100;202211;27086;57642;23492;53036;2113;4822;16701;37151;18814;41973
230110;202211;16518;43886;13853;38919;2114;6230;7749;20960;9863;27190
230120;202211;9899;22815;8462;20619;692;1703;6085;14689;6777;16392
230125;202211;3759;8713;3095;7675;64;233;2549;6044;2613;6277
230130;202211;6753;18392;5439;15683;348;1002;3801;10764;4149;11766
230140;202211;4297;11161;3561;9775;107;415;2800;7336;2907;7751
230150;202211;1931;5099;1577;4387;193;511;960;2658;1153;3169
230160;202211;8995;18002;7755;16257;245;462;6672;13669;6917;14131
230170;202211;7423;19234;5956;16373;432;1143;4126;11081;4558;12224
230180;202211;1952;4767;1601;4139;15;61;1306;3223;1321;3284
230185;202211;5656;13363;4653;11798;471;1177;3275;8347;3746;9524
230190;202211;17463;47157;14257;41224;1813;5402;8080;22687;9893;28089
230195;202211;6970;17609;6217;16395;354;928;4791;12545;5145;13473
230200;202211;5796;14629;4736;12717;314;843;3450;9027;3764;9870
230205;202211;5405;12972;4718;12026;375;844;3654;9250;4029;10094
230210;202211;13359;26893;11357;24290;476;998;9234;19204;9710;20202
230220;202211;18951;40345;16577;37076;969;2172;13555;29677;14524;31849
230230;202211;8746;21867;7838;20186;545;1293;5968;15209;6513;16502
230240;202211;16854;37674;14249;33529;892;1797;11070;25831;11962;27628
230250;202211;11289;27498;10439;26260;505;1308;7840;19086;8345;20394
230260;202211;18456;46583;15791;42156;2268;5798;9541;25234;11809;31032
230270;202211;8928;21316;6814;17632;933;2196;3892;10468;4825;12664
230280;202211;24753;56142;20334;49102;429;1641;16756;38130;17185;39771
230290;202211;6383;14375;5381;12623;234;537;4335;9806;4569;10343
230300;202211;6182;13887;5510;12974;77;197;4874;11436;4951;11633
230310;202211;5603;14382;4622;12630;167;583;3379;8878;3546;9461
230320;202211;9138;23719;7529;20966;248;974;5860;15752;6108;16726
230330;202211;5789;13949;4466;11544;149;477;3375;8390;3524;8867
230340;202211;4619;12820;3940;11496;258;809;2793;7881;3051;8690
230350;202211;23380;53992;20353;49757;994;2937;15044;35584;16038;38521
230360;202211;3675;8437;2873;7110;156;379;2107;5164;2263;5543
230365;202211;3761;7851;3111;6935;88;237;2724;5947;2812;6184
230370;202211;97020;207531;85188;191639;4747;12718;68010;145535;72757;158253
230380;202211;7508;18537;5853;15556;143;507;4447;11266;4590;11773
230390;202211;4110;10441;3501;9502;80;322;2800;7356;2880;7678
230393;202211;4100;10246;3254;8640;85;416;2624;6572;2709;6988
230395;202211;6811;16781;5743;14977;542;1389;3820;9747;4362;11136
230400;202211;6789;16202;5921;14868;82;385;4831;11486;4913;11871
230410;202211;15821;42732;13005;37813;1039;3145;8901;25631;9940;28776
230420;202211;36527;88040;29859;77156;2951;8018;18883;46606;21834;54624
230423;202211;5456;14539;4744;13255;316;955;3407;9242;3723;10197
230425;202211;7439;19596;6802;18421;722;1877;4745;12726;5467;14603
230426;202211;3254;7551;2338;5889;48;178;1795;4313;1843;4491
230427;202211;2115;5447;1472;4164;146;448;814;2084;960;2532
230428;202211;11991;29278;10241;26789;1458;3852;6033;15230;7491;19082
230430;202211;5809;14915;4498;12628;173;518;3409;9332;3582;9850
230435;202211;7732;17404;6245;14955;882;2048;3654;8607;4536;10655
230440;202211;598910;1233846;510764;1113362;33403;81433;382620;796039;416023;877472
230445;202211;4936;12264;3979;10655;254;688;2704;6911;2958;7599
230450;202211;4601;11256;3981;10364;195;688;3043;7502;3238;8190
230460;202211;2716;6304;2321;5692;65;222;1958;4668;2023;4890
230465;202211;5082;12337;4230;10792;140;417;3289;8030;3429;8447
230470;202211;13881;39539;12401;36882;810;2838;9189;26308;9999;29146
230480;202211;1834;4500;1524;3983;58;227;1182;2886;1240;3113
230490;202211;3311;8152;2725;7060;212;643;1835;4384;2047;5027
230495;202211;7365;18098;6403;16505;785;2139;4066;10120;4851;12259
230500;202211;11091;31937;9717;29533;408;1322;7708;23405;8116;24727
230510;202211;2126;5151;1662;4269;170;438;1046;2558;1216;2996
230520;202211;5763;13847;4936;12482;391;965;3608;8876;3999;9841
230523;202211;19783;52574;15394;43902;3488;9624;4214;12355;7702;21979
230526;202211;4762;11388;3973;10145;325;651;2810;7406;3135;8057
230530;202211;6492;18560;5392;16519;1129;3549;2989;9105;4118;12654
230533;202211;6006;11444;4778;9660;60;175;4143;7973;4203;8148
230535;202211;5939;15399;4960;13806;344;1050;3307;9062;3651;10112
230540;202211;18180;45458;15417;41329;285;1035;12781;33619;13066;34654
230550;202211;27945;63145;22897;55164;1917;4713;15921;36919;17838;41632
230560;202211;9176;19375;7199;16415;166;337;6144;13895;6310;14232
230565;202211;3739;9097;3081;7937;93;303;2465;6133;2558;6436
230570;202211;4021;9248;3345;8302;69;213;2780;6742;2849;6955
230580;202211;14852;32051;12741;29107;509;1110;10750;24185;11259;25295
230590;202211;11552;28550;9552;25171;733;1830;6932;17986;7665;19816
230600;202211;4532;10084;3547;8485;144;346;2496;5908;2640;6254
230610;202211;8069;19380;7084;17784;481;1209;5567;13825;6048;15034
230620;202211;2484;5985;1905;4927;96;298;1276;3057;1372;3355
230625;202211;12128;28909;10372;26012;2027;5388;4995;11868;7022;17256
230630;202211;14176;35089;12369;31941;1434;3414;8118;20947;9552;24361
230640;202211;32332;88438;29078;83224;1435;4869;23200;64838;24635;69707
230650;202211;6309;14963;5276;13276;174;632;4326;10395;4500;11027
230655;202211;11934;33459;11193;32266;918;2375;8899;26076;9817;28451
230660;202211;7177;18866;5738;16390;178;741;4592;12774;4770;13515
230670;202211;7164;15266;5098;12095;146;407;4125;9423;4271;9830
230680;202211;3310;7984;2709;6999;175;345;1882;4859;2057;5204
230690;202211;8340;22198;6974;19625;520;1549;4391;12238;4911;13787
230700;202211;12917;27952;10277;23370;430;1052;7989;17437;8419;18489
230710;202211;7915;22671;6881;20592;689;2099;4551;13299;5240;15398
230720;202211;2285;6060;1873;5331;138;386;1256;3467;1394;3853
230725;202211;5641;14572;5041;13559;369;1162;3475;8898;3844;10060
230730;202211;72711;172306;57036;150224;12331;32870;22985;61950;35316;94820
230740;202211;7150;18074;5949;16182;181;513;4690;12663;4871;13176
230750;202211;9987;23900;8079;20851;142;493;6554;16282;6696;16775
230760;202211;13945;32533;11998;29678;481;1517;9244;21854;9725;23371
230763;202211;5772;13903;4706;12148;94;372;3769;9305;3863;9677
230765;202211;54513;128953;46007;116026;4794;13085;29510;70550;34304;83635
230770;202211;35930;71243;30607;64634;2031;4425;23818;48609;25849;53034
230780;202211;7919;24207;7062;22286;968;2884;4263;13562;5231;16446
230790;202211;3827;9287;3397;8629;133;429;2698;6500;2831;6929
230800;202211;10540;28961;9123;26264;1143;3428;5486;15065;6629;18493
230810;202211;12613;34751;11098;32294;535;1716;8574;24371;9109;26087
230820;202211;4157;12192;3410;10640;345;1262;2118;6242;2463;7504
230830;202211;9420;22059;7917;19668;336;729;6306;15326;6642;16055
230835;202211;4991;10566;3856;8867;120;267;3188;7110;3308;7377
230837;202211;4642;10581;4160;9815;78;289;3656;8233;3734;8522
230840;202211;11405;29958;9720;27129;787;2179;7097;19615;7884;21794
230850;202211;12366;30148;10408;26708;590;1445;7751;19604;8341;21049
230860;202211;7861;14856;6576;13094;229;352;5835;11475;6064;11827
230870;202211;22282;44168;19103;39246;786;1537;15744;31424;16530;32961
230880;202211;2390;6499;2165;6131;72;308;1689;4585;1761;4893
230890;202211;5439;15194;4871;14208;228;802;3638;10332;3866;11134
230900;202211;3901;9826;3260;8618;128;453;2406;6021;2534;6474
230910;202211;4165;9157;3262;7844;67;259;2740;6410;2807;6669
230920;202211;5560;13937;4417;12061;119;417;3416;8979;3535;9396
230930;202211;8251;20651;6739;18059;346;1015;4724;12276;5070;13291
230940;202211;10012;21930;8648;19968;203;451;7428;16905;7631;17356
230945;202211;7902;19819;6672;17616;329;975;4893;12401;5222;13376
230950;202211;7601;16607;6684;15383;138;326;5718;13085;5856;13411
230960;202211;15620;40560;13359;36451;2084;5805;6943;18184;9027;23989
230970;202211;19222;44511;16223;40050;1553;4018;10833;25751;12386;29769
230980;202211;4207;9078;3628;8158;337;724;2688;5914;3025;6638
230990;202211;2026;5052;1671;4391;68;248;1232;3041;1300;3289
231000;202211;3305;7628;2571;6285;75;226;1979;4564;2054;4790
231010;202211;4608;8970;3560;7339;30;113;3201;6352;3231;6465
231020;202211;10768;27626;9525;25444;1496;3641;5879;15935;7375;19576
231025;202211;10380;23393;9178;21588;631;1369;7191;16674;7822;18043
231030;202211;8602;23321;6496;19134;839;2447;3801;11035;4640;13482
231040;202211;3792;8840;3225;7883;87;239;2714;6363;2801;6602
231050;202211;14752;32407;11875;27648;482;1250;9486;21200;9968;22450
231060;202211;3506;8506;3096;7890;118;342;2454;6271;2572;6613
231070;202211;9788;25044;8396;22647;756;2042;5727;15146;6483;17188
231080;202211;4595;11684;3768;10334;227;674;2643;7147;2870;7821
231085;202211;9006;18864;7190;16689;236;565;5724;12964;5960;13529
231090;202211;5149;12207;3764;9633;124;451;2695;6464;2819;6915
231095;202211;2591;7186;2039;6045;186;552;1348;3930;1534;4482
231100;202211;3492;9148;2860;8015;136;438;2183;5926;2319;6364
231110;202211;4403;11630;4024;10962;348;1085;2843;7377;3191;8462
231120;202211;2901;7307;2423;6527;113;314;1818;4777;1931;5091
231123;202211;2314;5416;1776;4475;118;280;1258;3126;1376;3406
231126;202211;6594;16149;5277;13772;311;756;3924;10063;4235;10819
231130;202211;30461;61979;25476;55812;1281;3564;20146;41820;21427;45384
231135;202211;5035;12623;4135;10967;159;462;3024;7819;3183;8281
231140;202211;21113;51178;17113;44791;751;2521;12796;31917;13547;34438
231150;202211;7057;17410;4995;13452;815;2259;1884;4943;2699;7202
231160;202211;8528;21667;7548;19936;754;1962;5035;13060;5789;15022
231170;202211;5592;14233;4595;12439;294;847;3317;8538;3611;9385
231180;202211;18707;46200;15170;39426;2364;6127;8051;20255;10415;26382
231190;202211;4975;12192;3870;10270;103;337;2993;7647;3096;7984
231195;202211;5948;16129;4830;14014;307;988;3463;9939;3770;10927
231200;202211;10215;25155;8788;22538;147;649;7519;18299;7666;18948
231210;202211;5772;14912;4817;13342;144;583;3867;10303;4011;10886
231220;202211;16156;34985;12650;28970;636;1380;9499;20754;10135;22134
231230;202211;11887;33377;10435;30800;755;2359;7777;22643;8532;25002
231240;202211;14353;37997;12512;34720;1686;4534;7790;21308;9476;25842
231250;202211;2499;5508;1633;3788;68;160;1135;2453;1203;2613
231260;202211;3992;9533;3375;8584;331;736;2336;6005;2667;6741
231270;202211;7786;17646;6284;15249;158;554;4858;11169;5016;11723
231280;202211;2124;5887;1828;5372;177;504;1242;3651;1419;4155
231290;202211;43933;118542;36718;105462;4914;14214;19621;54093;24535;68307
231300;202211;4953;12205;3811;10031;163;519;2666;6664;2829;7183
231310;202211;10118;21552;8024;18017;594;1501;5936;12588;6530;14089
231320;202211;8377;21244;6398;17735;166;451;4987;13637;5153;14088
231325;202211;2897;6750;2256;5733;154;287;1618;4095;1772;4382
231330;202211;13183;33204;10888;29052;1394;3580;7016;18614;8410;22194
231335;202211;6733;15768;5590;14032;155;470;4767;11780;4922;12250
231340;202211;22434;60677;19970;56695;1522;4258;14988;42808;16510;47066
231350;202211;19391;46384;17524;43761;316;967;15699;38677;16015;39644
231355;202211;5264;13710;4620;12569;226;668;3630;9650;3856;10318
231360;202211;9518;25465;8157;23239;410;1280;6410;17955;6820;19235
231370;202211;2439;6129;1923;5227;40;123;1479;3946;1519;4069
231375;202211;4867;13406;4306;12484;155;478;3469;10033;3624;10511
231380;202211;7373;16759;6476;15580;218;454;5391;12919;5609;13373
231390;202211;4041;10593;3582;9850;123;488;2710;7130;2833;7618
231395;202211;5191;13175;4322;11803;299;810;3041;8088;3340;8898
231400;202211;11949;29779;9949;26243;295;1166;7764;19565;8059;20731
231410;202211;19889;49315;17910;46350;961;2244;14769;38125;15730;40369
240010;202211;3064;7252;2365;6054;363;932;1193;2919;1556;3851
240020;202211;17148;40149;14210;35266;843;2509;10086;23732;10929;26241
240030;202211;4712;8680;4245;8039;92;264;3856;7005;3948;7269
240040;202211;920;2446;759;2156;18;63;507;1366;525;1429
240050;202211;4096;9808;3189;8219;69;181;2439;6121;2508;6302
240060;202211;1777;4146;1378;3453;47;124;1083;2647;1130;2771
240070;202211;3193;7782;2815;7017;213;591;2042;4772;2255;5363
240080;202211;3483;8483;2705;7169;118;351;1919;4932;2037;5283
240090;202211;2801;5859;2288;5061;42;85;1980;4285;2022;4370
240100;202211;13464;27993;10773;23616;220;662;8832;18217;9052;18879
240110;202211;5781;14434;4766;12617;175;589;3629;9147;3804;9736
240120;202211;4016;10255;3341;9342;247;837;2383;6438;2630;7275
240130;202211;4848;8386;3957;7258;29;73;3620;6505;3649;6578
240140;202211;2143;5886;1782;5232;209;699;1107;3113;1316;3812
240145;202211;8194;20770;6526;17963;742;2095;4185;11310;4927;13405
240150;202211;1277;3001;1063;2610;54;168;832;1947;886;2115
240160;202211;1741;4564;1418;3983;40;169;1039;2785;1079;2954
240165;202211;1163;2799;958;2438;27;94;795;1947;822;2041
240170;202211;3423;7909;2867;6988;294;721;1881;4490;2175;5211
240180;202211;3624;9694;2902;8251;618;1733;1318;3864;1936;5597
240185;202211;1632;4424;1455;4123;49;187;1152;3123;1201;3310
240190;202211;1378;3309;1140;2947;31;108;931;2353;962;2461
240200;202211;15813;33728;12736;28857;1458;3403;7885;16977;9343;20380
240210;202211;4245;8610;3507;7460;37;147;3076;6225;3113;6372
240220;202211;8685;23669;7682;22127;505;1727;5848;16529;6353;18256
240230;202211;7060;15892;5515;13446;306;610;4045;9980;4351;10590
240240;202211;2090;5589;1419;4138;185;585;502;1234;687;1819
240250;202211;3805;8374;3265;7598;63;214;2750;6133;2813;6347
240260;202211;19690;49879;17048;45615;4932;12753;7159;21213;12091;33966
240270;202211;2995;7594;2448;6738;112;339;1711;4811;1823;5150
240280;202211;1926;4518;1588;3980;61;146;1247;3072;1308;3218
240290;202211;1375;3576;1102;3029;31;129;759;1881;790;2010
240300;202211;2652;6222;1920;4977;96;250;1204;3006;1300;3256
240310;202211;10215;24682;8037;20921;1099;2854;4137;10481;5236;13335
240320;202211;2256;5676;1544;4287;102;319;1056;2764;1158;3083
240325;202211;44460;102080;36493;89348;4311;11928;22238;50853;26549;62781
240330;202211;2144;5288;1657;4426;74;245;1144;2866;1218;3111
240340;202211;2523;4882;2027;4172;60;145;1699;3324;1759;3469
240350;202211;3025;6196;2680;5796;74;144;2426;5233;2500;5377
240360;202211;15163;35502;13487;33000;2125;4912;8551;20956;10676;25868
240370;202211;2651;5683;2036;4604;90;245;1543;3251;1633;3496
240375;202211;1134;2489;907;2130;40;118;672;1453;712;1571
240380;202211;2735;6914;2100;5635;218;556;1214;3161;1432;3717
240390;202211;1170;2601;797;1937;24;54;527;1184;551;1238
240400;202211;1743;3868;1295;3143;41;151;936;2110;977;2261
240410;202211;699;1901;557;1627;60;211;309;835;369;1046
240420;202211;6214;18110;5536;16790;466;1763;3828;11034;4294;12797
240430;202211;4262;9602;3559;8462;111;346;2788;6281;2899;6627
240440;202211;3380;6747;2862;6020;301;556;2157;4498;2458;5054
240450;202211;5264;12959;4102;10887;327;1039;2576;6249;2903;7288
240460;202211;4224;9695;3773;9002;319;685;2988;7164;3307;7849
240470;202211;4043;11329;3066;9351;651;1796;1401;4526;2052;6322
240480;202211;686;1693;418;1133;29;68;209;541;238;609
240485;202211;2519;6427;1997;5530;160;471;1289;3550;1449;4021
240490;202211;1959;4317;1489;3522;88;171;1088;2505;1176;2676
240500;202211;2587;6195;2215;5579;112;274;1791;4443;1903;4717
240510;202211;1969;4772;1680;4347;71;217;1354;3394;1425;3611
240520;202211;1943;3905;1483;3301;105;219;1172;2594;1277;2813
240530;202211;2874;6731;2525;6184;162;296;2047;4990;2209;5286
240540;202211;2784;6043;2476;5584;47;123;2223;4959;2270;5082
240550;202211;1070;2294;946;2095;14;52;847;1809;861;1861
240560;202211;4803;9777;4140;8924;174;301;3474;7442;3648;7743
240570;202211;3242;7984;2163;5737;290;777;837;1996;1127;2773
240580;202211;10480;26326;9218;24199;535;1509;7468;19275;8003;20784
240590;202211;1101;2154;939;1916;23;33;780;1538;803;1571
240600;202211;2100;5108;1509;3979;59;166;1058;2632;1117;2798
240610;202211;5536;12629;4705;11226;234;598;3482;7952;3716;8550
240615;202211;1531;3484;1223;2984;94;250;901;2076;995;2326
240620;202211;2350;5584;1998;5012;71;212;1652;4010;1723;4222
240630;202211;2687;6118;2407;5681;209;361;1822;4362;2031;4723
240640;202211;1107;2617;860;2207;36;101;652;1619;688;1720
240650;202211;4787;12690;3953;11036;309;838;2661;7345;2970;8183
240660;202211;5186;9203;4733;8615;63;126;4455;8006;4518;8132
240670;202211;3055;7477;2393;6200;206;578;1578;3890;1784;4468
240680;202211;1924;4449;1522;3787;50;152;1195;2829;1245;2981
240690;202211;1431;3006;1109;2475;20;71;944;1977;964;2048
240700;202211;2832;7532;2259;6515;112;345;1672;4739;1784;5084
240710;202211;24048;50058;20593;44832;1722;3872;15470;32346;17192;36218
240720;202211;6218;14105;5194;12645;625;1567;3404;8109;4029;9676
240725;202211;1294;3358;974;2782;44;124;624;1712;668;1836
240730;202211;2724;6749;2127;5671;64;206;1630;4199;1694;4405
240740;202211;2238;5580;1777;4686;82;257;1261;3126;1343;3383
240750;202211;2723;7869;2279;6963;282;908;1321;3889;1603;4797
240760;202211;2058;4152;1490;3328;109;157;1110;2576;1219;2733
240770;202211;3990;9518;3358;8663;143;465;2776;6954;2919;7419
240780;202211;6423;15371;5350;13641;737;1864;3460;8623;4197;10487
240790;202211;1052;2625;853;2285;26;119;620;1549;646;1668
240800;202211;71094;144060;57219;124192;5287;12285;38045;77022;43332;89307
240810;202211;129621;282253;112858;256757;10285;24300;81730;179235;92015;203535
240820;202211;7637;19983;6668;18275;959;2660;4064;11105;5023;13765
240830;202211;10272;26187;8862;24129;335;1146;7096;18963;7431;20109
240840;202211;1290;2923;1019;2500;46;98;720;1710;766;1808
240850;202211;1649;4129;1111;3023;86;220;645;1658;731;1878
240860;202211;1772;3874;1348;3173;37;132;1110;2479;1147;2611
240870;202211;1244;2865;936;2365;159;383;475;1227;634;1610
240880;202211;1516;4392;1308;3990;109;418;914;2701;1023;3119
240890;202211;6493;14482;5109;12162;473;1304;3387;7300;3860;8604
240895;202211;3528;9482;3173;8919;409;1085;2268;6493;2677;7578
240910;202211;4154;10067;3410;8793;58;199;2775;6907;2833;7106
240920;202211;1256;2769;1007;2416;111;192;635;1567;746;1759
240930;202211;4368;8873;3512;7820;260;393;2323;5673;2583;6066
240933;202211;1908;4320;1588;3863;40;166;1334;3097;1374;3263
240940;202211;8808;18219;7009;15413;663;1439;4765;9944;5428;11383
240950;202211;1313;3512;1105;3099;34;137;874;2333;908;2470
240960;202211;856;2171;762;1982;15;53;597;1481;612;1534
240970;202211;2402;5090;1936;4367;67;200;1620;3511;1687;3711
240980;202211;4729;10888;4240;10121;69;278;3748;8611;3817;8889
240990;202211;3549;8152;3110;7404;232;672;2313;5128;2545;5800
241000;202211;1217;2677;939;2200;15;54;763;1680;778;1734
241010;202211;3800;9848;3426;9137;144;492;2783;7111;2927;7603
241020;202211;2517;6016;1890;4832;96;303;1352;3230;1448;3533
241025;202211;1916;5058;1530;4390;40;154;1093;3016;1133;3170
241030;202211;2937;8322;2341;7124;258;763;1536;4585;1794;5348
241040;202211;2562;7188;2175;6550;105;423;1647;4883;1752;5306
241050;202211;1713;4266;1353;3632;42;132;1014;2634;1056;2766
241060;202211;992;2422;828;2100;44;111;584;1395;628;1506
241070;202211;841;2008;698;1784;15;35;542;1322;557;1357
241080;202211;1351;3426;1033;2798;33;112;733;1894;766;2006
241090;202211;2457;6229;1935;5363;82;309;1436;3805;1518;4114
241100;202211;1383;3496;1038;2824;53;123;690;1824;743;1947
241105;202211;1276;3353;1023;2890;194;573;476;1283;670;1856
241110;202211;1078;2797;798;2226;47;136;504;1337;551;1473
241120;202211;9023;23066;7617;20736;797;2231;4977;13409;5774;15640
241140;202211;3938;9546;2979;7677;130;381;2163;5379;2293;5760
241142;202211;895;2216;677;1821;60;145;405;1016;465;1161
241150;202211;7038;16285;6127;14916;244;585;4834;11555;5078;12140
241160;202211;1394;3547;1052;2914;171;514;560;1443;731;1957
241170;202211;1580;3625;1329;3190;32;96;1101;2532;1133;2628
241180;202211;1232;2836;909;2278;86;225;510;1204;596;1429
241190;202211;1417;3224;1164;2763;18;64;879;1977;897;2041
241200;202211;31433;66708;27740;61137;2988;6974;19301;40173;22289;47147
241210;202211;1971;4476;1414;3491;107;286;907;2146;1014;2432
241220;202211;12156;30088;10677;27717;2394;6210;5249;13765;7643;19975
241230;202211;3500;8223;2998;7482;110;263;2478;6120;2588;6383
241240;202211;1426;3715;846;2480;98;306;291;797;389;1103
241250;202211;7388;17618;5942;15119;143;606;4685;11205;4828;11811
241255;202211;3265;8501;2766;7589;156;498;2034;5365;2190;5863
241260;202211;5948;13722;4733;11767;165;500;3643;8649;3808;9149
241270;202211;1893;5040;1556;4407;118;363;1089;2999;1207;3362
241280;202211;3114;6174;2701;5481;90;186;2331;4602;2421;4788
241290;202211;3851;8480;2792;6831;106;296;2222;5254;2328;5550
241300;202211;1863;4384;1509;3812;44;155;1065;2531;1109;2686
241310;202211;2852;5790;2448;5239;61;117;2123;4475;2184;4592
241320;202211;1133;3339;957;3009;102;344;578;1763;680;2107
241330;202211;2083;4715;1651;4148;21;69;1469;3642;1490;3711
241335;202211;4463;10873;3876;9862;128;425;3185;7797;3313;8222
241340;202211;2096;4959;1634;4107;199;605;934;2129;1133;2734
241350;202211;2621;6263;2256;5640;111;279;1735;4232;1846;4511
241355;202211;1629;3903;1295;3286;50;109;962;2393;1012;2502
241360;202211;2447;5648;1760;4347;61;173;1305;3046;1366;3219
241370;202211;1617;3885;1234;3161;60;177;909;2155;969;2332
241380;202211;840;1998;658;1695;73;183;381;963;454;1146
241390;202211;3216;8379;2813;7781;154;478;2160;5923;2314;6401
241400;202211;4363;10826;3815;9998;225;702;2927;7460;3152;8162
241410;202211;2951;7925;2359;6757;237;745;1524;4243;1761;4988
241415;202211;2302;5420;1945;4792;45;169;1612;3760;1657;3929
241420;202211;3744;9589;3345;8956;583;1618;2027;5415;2610;7033
241430;202211;843;1905;541;1348;19;55;372;853;391;908
241440;202211;10211;26835;9128;25056;289;939;7468;20022;7757;20961
241445;202211;1657;3370;1432;3076;32;67;1279;2724;1311;2791
241450;202211;3602;7471;2907;6434;224;444;2250;4908;2474;5352
241460;202211;4681;11336;3686;9395;324;879;2445;5896;2769;6775
241470;202211;1713;4058;1361;3544;43;145;1137;2889;1180;3034
241475;202211;1448;3552;1117;2955;19;71;845;2089;864;2160
241480;202211;3700;10208;3020;8835;843;2455;1074;3370;1917;5825
241490;202211;888;1790;629;1411;17;46;511;1104;528;1150
241500;202211;954;2287;848;2162;9;21;755;1924;764;1945
250010;202211;3269;8378;2639;7156;77;248;2005;5229;2082;5477
250020;202211;1913;4520;1416;3635;84;151;1065;2708;1149;2859
250030;202211;8545;20518;7422;18848;910;2381;5136;12903;6046;15284
250040;202211;5625;14316;4884;13066;737;1923;3003;7952;3740;9875
250050;202211;4475;10389;3965;9754;183;459;3261;8111;3444;8570
250053;202211;1539;3869;1388;3644;142;306;959;2526;1101;2832
250057;202211;882;2459;802;2346;8;36;734;2137;742;2173
250060;202211;7372;16406;6487;15195;448;1047;5056;11752;5504;12799
250070;202211;4839;11887;4025;10534;45;192;3236;8119;3281;8311
250073;202211;965;2245;760;1921;8;23;617;1522;625;1545
250077;202211;3232;6829;2499;5721;32;100;2128;4690;2160;4790
250080;202211;7267;14017;6048;12566;66;198;5538;11270;5604;11468
250090;202211;4749;8915;4173;8194;63;134;3734;7110;3797;7244
250100;202211;4047;11178;3614;10415;216;656;2754;7722;2970;8378
250110;202211;6063;14782;5482;13989;340;995;4226;10522;4566;11517
250115;202211;919;1914;696;1596;11;40;560;1230;571;1270
250120;202211;2227;5806;1889;5274;25;123;1507;4064;1532;4187
250130;202211;7587;15842;6482;14380;51;218;5785;12422;5836;12640
250135;202211;1674;3808;1450;3434;57;132;1220;2846;1277;2978
250140;202211;2647;6916;2418;6636;175;517;1956;5415;2131;5932
250150;202211;5696;15852;5096;14881;196;691;4071;11571;4267;12262
250153;202211;1670;3968;1359;3512;77;166;1070;2732;1147;2898
250157;202211;2626;6034;2318;5551;47;153;1960;4522;2007;4675
250160;202211;4669;10103;3736;8855;83;207;3212;7512;3295;7719
250170;202211;2254;5228;2001;4865;40;139;1705;4027;1745;4166
250180;202211;29766;58739;25675;53663;1183;3012;20892;41669;22075;44681
250190;202211;5195;11871;4361;10699;424;987;3096;7341;3520;8328
250200;202211;3227;5989;2768;5416;37;82;2501;4738;2538;4820
250205;202211;979;2798;823;2553;22;93;636;1952;658;2045
250210;202211;1706;4657;1503;4333;70;254;1157;3246;1227;3500
250215;202211;1915;4768;1607;4344;100;286;920;2503;1020;2789
250220;202211;802;1983;626;1704;34;122;439;1127;473;1249
250230;202211;1970;4026;1388;3196;24;60;1080;2402;1104;2462
250240;202211;3699;8073;3303;7447;40;160;2966;6479;3006;6639
250250;202211;5904;13774;5201;12822;451;734;3986;10407;4437;11141
250260;202211;1879;4857;1563;4300;66;173;1190;3285;1256;3458
250270;202211;1456;3881;1330;3730;101;296;936;2764;1037;3060
250280;202211;4895;10428;4334;9711;284;483;3386;7711;3670;8194
250290;202211;2219;4651;1852;4135;26;72;1546;3299;1572;3371
250300;202211;7431;15882;6656;14969;224;711;5597;12143;5821;12854
250310;202211;1450;3701;1173;3238;57;138;848;2306;905;2444
250320;202211;17772;32877;15606;30470;187;516;14425;27455;14612;27971
250330;202211;3248;7209;2756;6557;72;239;2407;5495;2479;5734
250340;202211;1523;3163;1312;2886;19;45;1181;2564;1200;2609
250350;202211;4586;11903;3947;10799;331;693;2958;8339;3289;9032
250355;202211;2675;6401;2362;6017;18;74;2190;5544;2208;5618
250360;202211;2177;5062;1932;4739;65;200;1619;3831;1684;4031
250370;202211;19470;40093;16529;35891;245;767;14605;30569;14850;31336
250375;202211;1589;3307;1284;2957;4;11;1184;2757;1188;2768
250380;202211;2192;4591;2013;4384;47;147;1799;3761;1846;3908
250390;202211;2364;5166;1992;4610;143;322;1536;3531;1679;3853
250400;202211;88769;201199;67615;169669;19390;51265;21109;52739;40499;104004
250403;202211;2926;5846;2604;5493;57;263;2251;4415;2308;4678
250407;202211;1857;3691;1317;2930;136;240;847;2005;983;2245
250410;202211;856;1992;732;1791;22;58;608;1429;630;1487
250415;202211;2402;5666;2098;5223;31;112;1848;4493;1879;4605
250420;202211;1718;3591;1553;3372;14;31;1447;3096;1461;3127
250430;202211;9390;18350;8086;16674;287;571;6903;13747;7190;14318
250435;202211;1912;4883;1478;4153;26;102;1123;3028;1149;3130
250440;202211;5269;12803;4545;11863;109;267;3924;10142;4033;10409
250450;202211;2189;5053;1791;4517;92;170;1387;3595;1479;3765
250460;202211;9175;22125;8031;20531;564;1557;6225;15672;6789;17229
250470;202211;2100;4550;1725;3974;74;145;1384;3100;1458;3245
250480;202211;4595;11324;3849;10397;71;174;3300;8957;3371;9131
250485;202211;827;1729;616;1436;65;95;412;944;477;1039
250490;202211;7075;13570;6261;12652;109;319;5659;11093;5768;11412
250500;202211;2412;5983;2115;5491;52;155;1730;4394;1782;4549
250510;202211;7082;14694;6069;13349;244;331;5099;11356;5343;11687
250520;202211;2189;5342;1862;4919;84;259;1457;3742;1541;4001
250523;202211;2779;5765;2419;5285;195;463;1874;3955;2069;4418
250527;202211;2048;4450;1847;4225;18;63;1683;3804;1701;3867
250530;202211;796;1823;677;1653;17;43;553;1295;570;1338
250535;202211;1610;4193;1421;3858;26;115;1145;2997;1171;3112
250540;202211;4135;7484;3494;6786;461;510;2770;5723;3231;6233
250550;202211;898;2659;784;2447;53;170;537;1651;590;1821
250560;202211;2055;5036;1760;4613;49;184;1466;3713;1515;3897
250570;202211;3299;8586;2836;7783;169;486;2110;5744;2279;6230
250580;202211;1245;2931;1094;2728;59;206;889;2135;948;2341
250590;202211;1282;2617;1158;2449;29;74;1041;2126;1070;2200
250600;202211;9089;22169;7492;19991;266;765;5819;15192;6085;15957
250610;202211;3446;8809;3055;8235;130;412;2458;6572;2588;6984
250620;202211;1115;2358;938;2088;45;126;747;1577;792;1703
250625;202211;2783;7317;2462;6804;48;221;2103;5656;2151;5877
250630;202211;15130;33629;12739;29821;1169;2959;9088;20277;10257;23236
250640;202211;4532;10346;4025;9696;87;317;3503;8216;3590;8533
250650;202211;1317;2707;1035;2340;11;51;900;1975;911;2026
250660;202211;1868;4147;1463;3565;36;97;1221;2839;1257;2936
250670;202211;2872;7703;2590;7216;46;188;2249;6089;2295;6277
250680;202211;7409;14449;6645;13594;38;156;6223;12388;6261;12544
250690;202211;8820;17157;7404;15453;173;327;6421;13175;6594;13502
250700;202211;5528;13989;4806;12876;706;1927;3102;8169;3808;10096
250710;202211;5187;13522;4481;12531;369;1078;3211;8958;3580;10036
250720;202211;3385;8131;2967;7522;69;262;2583;6411;2652;6673
250730;202211;5481;12244;4807;11358;212;592;4082;9323;4294;9915
250740;202211;2504;5453;2050;4857;137;294;1545;3665;1682;3959
250750;202211;149392;319404;128322;290688;8860;22389;97670;212207;106530;234596
250760;202211;3651;6798;3274;6255;53;164;3008;5552;3061;5716
250770;202211;4879;13120;4328;12378;693;1690;2784;8405;3477;10095
250780;202211;2303;5208;1929;4576;58;169;1597;3650;1655;3819
250790;202211;3129;8033;2719;7443;103;406;2173;5707;2276;6113
250800;202211;2941;6888;2536;6253;110;216;2044;4983;2154;5199
250810;202211;1762;3826;1452;3402;160;237;1081;2686;1241;2923
250820;202211;2555;5816;2341;5571;46;158;2116;4948;2162;5106
250830;202211;7404;19697;6094;17179;227;821;4412;11776;4639;12597
250840;202211;879;2586;760;2367;39;143;557;1732;596;1875
250850;202211;2154;5557;1885;5104;31;138;1558;4077;1589;4215
250855;202211;1358;3276;1201;3050;43;127;992;2446;1035;2573
250860;202211;4206;10806;3479;9660;490;1414;1997;5373;2487;6787
250870;202211;1262;2988;1054;2669;63;144;807;2041;870;2185
250880;202211;1938;4459;1583;3937;129;308;1168;2866;1297;3174
250890;202211;14694;29693;12971;27563;270;1107;11418;22882;11688;23989
250900;202211;4018;8989;3503;8158;79;217;3017;6794;3096;7011
250905;202211;2983;7398;2733;7075;46;177;2473;6343;2519;6520
250910;202211;9240;17488;7922;16041;84;254;7208;14326;7292;14580
250915;202211;2641;5289;1925;4512;29;52;1697;3987;1726;4039
250920;202211;4735;10026;4243;9328;267;518;3525;7609;3792;8127
250930;202211;2852;6774;2530;6368;110;322;2065;5059;2175;5381
250933;202211;1485;3834;1285;3497;53;194;1005;2645;1058;2839
250937;202211;975;2290;810;2041;23;75;665;1654;688;1729
250939;202211;2492;5438;2179;5036;47;119;1837;4137;1884;4256
250940;202211;4730;10959;4092;10111;63;170;3586;8762;3649;8932
250950;202211;2008;4780;1607;4234;43;146;1273;3263;1316;3409
250960;202211;1363;3483;1185;3195;31;137;967;2485;998;2622
250970;202211;10858;24085;9385;21761;327;742;7670;17350;7997;18092
250980;202211;2889;6724;2592;6319;20;89;2267;5343;2287;5432
250990;202211;2561;6797;2171;6141;113;386;1638;4485;1751;4871
251000;202211;2358;6040;1886;5254;45;161;1521;4185;1566;4346
251010;202211;3053;7430;2684;6885;32;145;2345;5871;2377;6016
251020;202211;1886;4655;1691;4359;31;135;1469;3671;1500;3806
251030;202211;1225;2954;1003;2566;73;167;672;1696;745;1863
251040;202211;2205;5428;1868;4888;24;106;1597;4103;1621;4209
251050;202211;1181;3095;976;2703;45;159;693;1809;738;1968
251060;202211;1348;2613;998;2174;40;88;745;1609;785;1697
251065;202211;552;1403;402;1119;11;35;288;756;299;791
251070;202211;916;2035;758;1813;13;42;640;1475;653;1517
251080;202211;26171;56324;21489;49596;3602;8250;12259;28619;15861;36869
251090;202211;3393;8729;2835;7796;69;197;2332;6280;2401;6477
251100;202211;943;2730;804;2456;31;96;599;1732;630;1828
251110;202211;2236;5147;1836;4439;120;261;1371;3239;1491;3500
251120;202211;9731;22453;8205;20600;568;1543;6121;14976;6689;16519
251130;202211;5941;10003;5209;9198;114;179;4834;8422;4948;8601
251140;202211;4835;12479;4245;11648;119;385;3381;9185;3500;9570
251150;202211;3379;8525;3071;8047;63;301;2646;6713;2709;7014
251160;202211;2967;6876;2583;6321;28;137;2331;5546;2359;5683
251170;202211;2242;4852;1980;4527;37;108;1784;3956;1821;4064
251180;202211;3392;7646;2807;6855;283;544;1907;4825;2190;5369
251190;202211;6668;13314;6001;12562;64;261;5396;10797;5460;11058
251200;202211;5619;13619;4918;12731;163;353;4128;10791;4291;11144
251203;202211;1165;3390;1032;3084;56;164;676;1950;732;2114
251207;202211;1333;3243;997;2702;21;93;681;1778;702;1871
251210;202211;9865;21669;8016;19141;649;1206;5645;13966;6294;15172
251220;202211;1631;3295;1205;2750;95;206;924;2100;1019;2306
251230;202211;5654;14133;4850;12743;123;418;3880;9775;4003;10193
251240;202211;4436;11350;3711;10124;302;740;2449;6737;2751;7477
251250;202211;14813;33213;13008;30307;764;1906;10100;22562;10864;24468
251260;202211;665;1527;592;1412;14;62;485;1079;499;1141
251270;202211;5518;14299;4902;13457;282;704;3846;10832;4128;11536
251272;202211;1739;3920;1595;3746;49;180;1403;3162;1452;3342
251274;202211;998;2573;791;2210;66;180;489;1335;555;1515
251275;202211;1906;3977;1608;3519;75;181;1325;2774;1400;2955
251276;202211;1618;3920;1381;3596;40;155;1110;2767;1150;2922
251278;202211;803;1849;702;1696;32;93;563;1313;595;1406
251280;202211;3411;6970;3091;6538;49;163;2786;5683;2835;5846
251290;202211;10087;17547;9231;16562;292;556;8231;14420;8523;14976
251300;202211;1047;2697;915;2494;16;68;774;2067;790;2135
251310;202211;3423;8514;2937;7760;56;252;2464;6307;2520;6559
251315;202211;2183;6063;1952;5633;98;274;1517;4328;1615;4602
251320;202211;2015;4721;1520;3871;39;142;1171;2854;1210;2996
251330;202211;2609;5235;2087;4617;35;77;1823;3995;1858;4072
251335;202211;1315;3273;1176;3069;24;105;1056;2678;1080;2783
251340;202211;4713;9684;3758;8458;140;331;2999;6602;3139;6933
251350;202211;1303;3257;1173;3057;37;105;972;2489;1009;2594
251360;202211;2225;5379;1743;4679;27;81;1383;3621;1410;3702
251365;202211;951;2242;688;1747;21;53;536;1344;557;1397
251370;202211;32667;75615;28018;69270;3942;9549;17620;43405;21562;52954
251380;202211;1850;4001;1603;3632;50;133;1386;3068;1436;3201
251385;202211;933;2186;710;1807;28;79;495;1198;523;1277
251390;202211;9482;21907;8410;20317;698;1737;6178;14593;6876;16330
251392;202211;1260;3013;1044;2683;41;113;810;2055;851;2168
251394;202211;814;2057;659;1792;63;179;446;1156;509;1335
251396;202211;858;2100;718;1863;25;72;497;1222;522;1294
251398;202211;1210;2852;841;2202;21;75;612;1525;633;1600
251400;202211;1782;3425;1428;2963;46;100;1185;2330;1231;2430
251410;202211;1925;3879;1518;3305;13;50;1299;2678;1312;2728
251420;202211;2539;5643;2063;5095;52;173;1670;3983;1722;4156
251430;202211;1807;4854;1624;4542;61;203;1354;3714;1415;3917
251440;202211;1300;3186;1052;2759;70;157;776;2061;846;2218
251445;202211;2078;4826;1898;4590;30;102;1646;3843;1676;3945
251450;202211;5639;14005;5018;13068;60;234;4366;11109;4426;11343
251455;202211;1051;2783;938;2590;32;99;740;1984;772;2083
251460;202211;1166;2872;930;2486;67;185;684;1811;751;1996
251465;202211;591;1489;489;1310;14;62;373;939;387;1001
251470;202211;1382;3530;1020;2812;123;390;541;1335;664;1725
251480;202211;1217;2877;930;2389;19;59;694;1677;713;1736
251490;202211;2478;5656;2002;5008;136;274;1510;3755;1646;4029
251500;202211;2669;5980;2419;5647;72;189;2089;4721;2161;4910
251510;202211;3144;8603;2585;7524;123;409;1781;4972;1904;5381
251520;202211;1208;2857;895;2317;84;171;559;1422;643;1593
251530;202211;19251;38656;15824;34479;167;713;14146;29879;14313;30592
251540;202211;3580;9196;3170;8496;87;317;2582;6669;2669;6986
251550;202211;5343;10039;4361;8862;129;217;3706;7450;3835;7667
251560;202211;658;1826;583;1719;41;158;428;1191;469;1349
251570;202211;1116;2866;917;2475;20;97;721;1865;741;1962
251580;202211;2744;5337;2448;4913;27;102;2148;4074;2175;4176
251590;202211;2007;4208;1698;3839;62;142;1454;3183;1516;3325
251593;202211;1159;3094;1026;2868;89;292;706;1905;795;2197
251597;202211;2741;6237;2470;5888;13;59;2282;5335;2295;5394
251600;202211;7710;18772;6674;17198;264;764;5457;13752;5721;14516
251610;202211;4045;9787;3514;8888;299;717;2589;6431;2888;7148
251615;202211;1660;3486;1318;2993;22;64;1120;2440;1142;2504
251620;202211;24611;47795;19251;41345;229;464;16811;35926;17040;36390
251630;202211;6417;12623;5185;10924;283;624;4106;8222;4389;8846
251640;202211;2643;6317;2333;5870;20;89;2102;5179;2122;5268
251650;202211;5128;11393;4394;10449;138;320;3746;8752;3884;9072
251660;202211;4398;11258;3858;10353;60;265;3226;8347;3286;8612
251670;202211;5769;12510;5141;11696;58;230;4719;10450;4777;10680
251675;202211;1086;2243;978;2107;46;119;852;1792;898;1911
251680;202211;3190;7242;2674;6578;111;199;2165;5364;2276;5563
251690;202211;3901;9833;3287;8804;127;364;2481;6574;2608;6938
251700;202211;2739;6690;2260;6039;43;170;1881;4819;1924;4989
251710;202211;955;2220;681;1704;44;118;428;983;472;1101
251720;202211;1581;3999;1249;3441;20;95;972;2553;992;2648
251740;202211;800;1961;637;1687;33;102;477;1208;510;1310
260005;202211;38476;72240;32188;64424;1816;3768;25973;50159;27789;53927
260010;202211;12576;29338;10361;25876;629;1732;6631;15881;7260;17613
260020;202211;8591;16770;7071;14716;78;292;6096;12228;6174;12520
260030;202211;9811;19480;8364;17496;81;303;7394;14873;7475;15176
260040;202211;8949;20302;7506;18344;468;1206;5563;13516;6031;14722
260050;202211;18233;38074;15718;35258;252;676;14671;32640;14923;33316
260060;202211;5203;10942;4417;9768;393;666;3294;7517;3687;8183
260070;202211;14515;29246;12550;26557;213;734;10902;22064;11115;22798
260080;202211;8680;16120;7574;14744;135;316;6601;12416;6736;12732
260090;202211;6858;14427;6087;13432;431;842;4846;10694;5277;11536
260100;202211;3985;8600;3410;7806;37;165;3045;6752;3082;6917
260105;202211;6077;14409;5431;13559;101;382;4638;11219;4739;11601
260110;202211;26448;66598;23301;62054;1119;3401;18836;49055;19955;52456
260120;202211;19156;42482;16230;38375;1826;3952;11307;26631;13133;30583
260130;202211;4080;8697;3515;7937;90;203;2878;6240;2968;6443
260140;202211;16975;31803;14746;29184;412;903;12891;24844;13303;25747
260150;202211;4759;8949;4174;8243;111;219;3758;7347;3869;7566
260160;202211;9348;17923;8108;16439;133;264;7495;15121;7628;15385
260170;202211;27710;55154;23751;49931;1146;2518;19427;39772;20573;42290
260180;202211;4375;9927;3702;8987;86;317;3142;7454;3228;7771
260190;202211;26569;43513;22831;39230;172;356;21071;35278;21243;35634
260200;202211;13648;28786;11782;26410;502;965;10269;22967;10771;23932
260210;202211;13656;34091;11448;30640;400;1201;9143;24166;9543;25367
260220;202211;15355;28361;14238;27024;362;605;12740;23766;13102;24371
260230;202211;16252;30363;14193;27829;337;633;12282;23546;12619;24179
260240;202211;3368;8776;2891;7912;66;279;2318;6137;2384;6416
260250;202211;2912;6342;2466;5680;96;236;1983;4409;2079;4645
260260;202211;17348;38212;15367;35477;1134;2400;11731;27412;12865;29812
260270;202211;6356;11599;5675;10838;74;231;5161;9565;5235;9796
260280;202211;16093;39177;14585;37062;343;1334;12971;31920;13314;33254
260290;202211;52639;117874;45359;107837;3966;9924;32861;75894;36827;85818
260300;202211;13162;28245;11325;25693;289;820;9744;21523;10033;22343
260310;202211;8142;16149;7327;15166;388;649;6185;12818;6573;13467
260320;202211;8899;23424;7423;21040;150;560;6151;17200;6301;17760
260330;202211;2910;8053;2453;7150;68;232;1954;5524;2022;5756
260340;202211;2769;6101;2417;5600;33;116;2141;4781;2174;4897
260345;202211;36091;79473;30692;72080;2921;7503;20710;45892;23631;53395
260350;202211;7766;14106;6764;13003;27;93;6303;11844;6330;11937
260360;202211;2929;6820;2545;6129;100;279;1801;4180;1901;4459
260370;202211;6824;16503;5786;14808;173;588;4660;11360;4833;11948
260380;202211;6061;15566;5148;14114;241;586;3923;10712;4164;11298
260390;202211;5572;15036;4426;12821;209;596;2963;8365;3172;8961
260392;202211;4916;11912;4444;11320;58;333;3935;9808;3993;10141
260400;202211;27789;51688;24349;47306;349;1022;21004;38443;21353;39465
260410;202211;101025;214979;81178;187960;14373;35512;41065;93917;55438;129429
260415;202211;5838;12410;5042;11255;32;130;4440;9562;4472;9692
260420;202211;17199;28620;14816;26040;81;243;14170;24504;14251;24747
260430;202211;3211;9186;2680;8151;180;586;1782;5323;1962;5909
260440;202211;5341;10713;4739;9942;34;125;4377;8996;4411;9121
260450;202211;6879;15333;6113;14332;372;673;5074;12059;5446;12732
260460;202211;6857;16910;5858;15268;442;1355;4090;10113;4532;11468
260470;202211;6250;13146;5250;12010;133;285;4631;10845;4764;11130
260480;202211;4661;10707;3909;9682;323;859;2791;6842;3114;7701
260490;202211;7040;13136;6206;12027;30;110;5773;10924;5803;11034
260500;202211;7501;16454;6412;14955;489;1097;4553;10569;5042;11666
260510;202211;14125;27396;12085;24649;139;435;10922;21619;11061;22054
260515;202211;5677;12843;4462;10712;108;312;3364;7500;3472;7812
260520;202211;20198;41370;17604;38107;1045;2245;14371;30456;15416;32701
260530;202211;12504;29427;10711;26835;113;500;9590;23403;9703;23903
260540;202211;9737;17249;8699;16006;118;253;8091;14630;8209;14883
260545;202211;145;394;96;291;17;62;33;81;50;143
260550;202211;3789;9200;3033;7975;183;613;2048;4990;2231;5603
260560;202211;6980;15777;5775;14021;137;454;4920;11586;5057;12040
260570;202211;11618;23297;10253;21579;212;581;9162;18741;9374;19322
260580;202211;6393;11857;5802;11102;27;65;5418;10208;5445;10273
260590;202211;10110;17326;8735;15826;101;234;8018;14205;8119;14439
260600;202211;43198;93712;36102;83453;1191;3353;29280;64534;30471;67887
260610;202211;9508;21679;8281;20050;391;1041;6396;15116;6787;16157
260620;202211;27151;54258;24221;50431;1162;3192;19962;39205;21124;42397
260630;202211;2855;6820;2330;6009;59;158;1917;4826;1976;4984
260640;202211;32426;59401;27876;54250;955;1913;24007;45804;24962;47717
260650;202211;7695;17145;6168;15257;490;907;5063;12633;5553;13540
260660;202211;9616;19912;8444;18471;283;764;7595;16280;7878;17044
260670;202211;2781;6361;2264;5538;78;217;1753;4078;1831;4295
260680;202211;38702;79508;32777;71519;2105;4883;24822;51774;26927;56657
260690;202211;4135;9560;3394;8443;89;308;2680;6469;2769;6777
260700;202211;9069;18625;8469;17975;46;186;8241;17401;8287;17587
260710;202211;1640;3818;1363;3405;56;182;1094;2663;1150;2845
260720;202211;37994;74443;33109;68576;1804;4161;27260;54820;29064;58981
260730;202211;10225;24846;8842;22933;201;734;7714;19493;7915;20227
260740;202211;1607;3923;1313;3458;25;97;1071;2786;1096;2883
260750;202211;9688;21072;7614;18575;192;363;6695;16712;6887;17075
260760;202211;8483;16250;7438;15050;119;326;6716;13293;6835;13619
260765;202211;10676;25822;9379;24096;644;1886;6855;17054;7499;18940
260770;202211;4688;10492;3808;9097;95;290;3094;7155;3189;7445
260775;202211;7365;16347;6456;15010;159;539;5308;11596;5467;12135
260780;202211;4635;11802;4088;10928;366;1177;2680;6604;3046;7781
260790;202211;182503;347185;154598;311978;18925;38949;108431;211413;127356;250362
260795;202211;4665;8733;4018;7937;150;321;3461;6702;3611;7023
260800;202211;7985;14245;7190;13197;265;439;6389;11477;6654;11916
260805;202211;4718;10879;4048;9812;147;467;3291;7609;3438;8076
260810;202211;8334;19153;7282;17293;298;788;5849;13262;6147;14050
260820;202211;6043;11373;5361;10617;81;222;4697;9209;4778;9431
260825;202211;3559;9360;3095;8589;116;370;2410;6559;2526;6929
260830;202211;5367;13459;4457;11947;529;1158;2981;8190;3510;9348
260840;202211;5817;11897;5168;11044;253;481;4503;9513;4756;9994
260845;202211;5683;12833;5005;11760;203;579;4006;8960;4209;9539
260850;202211;6172;14499;5149;12711;385;1026;3528;8172;3913;9198
260860;202211;4116;10489;3495;9410;151;443;2795;7314;2946;7757
260870;202211;5678;11153;4901;10219;119;251;4362;9002;4481;9253
260875;202211;10632;20674;8767;18119;697;1396;6370;13077;7067;14473
260880;202211;14143;31284;12415;28606;280;796;10771;24077;11051;24873
260890;202211;16798;36559;14443;33155;1108;2580;9954;22399;11062;24979
260900;202211;6902;17053;5699;15374;537;1435;3642;9769;4179;11204
260910;202211;4300;9567;3754;8787;139;339;3003;6873;3142;7212
260915;202211;7371;15326;6667;14482;30;117;6344;13588;6374;13705
260920;202211;4358;8358;3717;7683;106;189;3281;6720;3387;6909
260930;202211;4959;12738;4212;11505;167;585;3338;8773;3505;9358
260940;202211;19481;39219;16894;35706;1164;2566;13130;26834;14294;29400
260950;202211;9553;21361;7742;18491;367;1069;5508;12134;5875;13203
260960;202211;114101;207432;96461;185866;7551;15294;73198;134385;80749;149679
260970;202211;6958;15832;6017;14616;389;724;4555;11208;4944;11932
260980;202211;5881;14163;5106;13202;77;203;4645;12017;4722;12220
260990;202211;20964;51090;17597;46512;751;2289;14005;36128;14756;38417
261000;202211;21698;42059;18271;37826;571;1394;15334;30589;15905;31983
261010;202211;2746;6115;2344;5578;97;255;2009;4726;2106;4981
261020;202211;8567;18803;7493;17102;352;835;6140;13478;6492;14313
261030;202211;5051;12708;4428;11680;115;420;3602;9082;3717;9502
261040;202211;6617;16343;5420;14287;170;602;4301;10795;4471;11397
261050;202211;9705;21544;8739;20183;201;448;7410;16818;7611;17266
261060;202211;18665;39560;16266;36727;395;1023;13840;30451;14235;31474
261070;202211;92078;177109;77384;158150;7290;14723;56519;112277;63809;127000
261080;202211;8572;17464;7708;16429;104;209;7244;15326;7348;15535
261090;202211;26173;49982;23299;46336;750;1408;20342;39762;21092;41170
261100;202211;10902;25321;9458;23298;631;1535;7171;17375;7802;18910
261110;202211;95059;225450;80408;200387;9835;26535;50726;121080;60561;147615
261120;202211;5002;9968;4363;9105;109;253;3828;7756;3937;8009
261130;202211;9721;19522;8533;17956;175;355;7538;15585;7713;15940
261140;202211;4994;9512;4404;8754;314;569;3430;6762;3744;7331
261150;202211;7195;14976;6341;13794;241;469;5395;11577;5636;12046
261153;202211;2303;6166;1879;5383;77;235;1325;3731;1402;3966
261160;202211;310241;623182;257161;553518;61809;134460;115462;251333;177271;385793
261170;202211;9723;18464;8487;16855;260;509;7475;14396;7735;14905
261180;202211;11889;25426;10429;23602;481;1038;8178;18228;8659;19266
261190;202211;6584;14902;5912;13893;135;561;5049;11278;5184;11839
261200;202211;4410;8472;3824;7714;139;291;3233;6353;3372;6644
261210;202211;2248;4902;1919;4449;111;191;1587;3661;1698;3852
261220;202211;18634;43260;15884;38798;1440;3714;11122;25761;12562;29475
261230;202211;4722;11782;3890;10707;46;170;3271;8984;3317;9154
261240;202211;7932;15194;7057;13974;218;448;6218;11998;6436;12446
261245;202211;4700;11100;3817;9652;67;297;3159;7564;3226;7861
261247;202211;3733;9761;3077;8624;351;950;1953;5523;2304;6473
261250;202211;37616;68873;33408;64107;3301;6624;26601;50296;29902;56920
261255;202211;4888;12681;3916;10878;176;591;2978;8010;3154;8601
261260;202211;20272;39355;17971;36494;240;846;16862;33278;17102;34124
261270;202211;6669;12302;5909;11413;215;407;5292;10007;5507;10414
261280;202211;3147;7619;2713;6940;95;313;2179;5332;2274;5645
261290;202211;3676;7941;3083;7285;92;279;2515;5936;2607;6215
261300;202211;17226;38355;14810;34685;386;1307;12127;26863;12513;28170
261310;202211;12516;26232;10800;23969;879;1997;8126;17523;9005;19520
261320;202211;7469;18202;6452;16626;80;279;5542;13952;5622;14231
261330;202211;8135;15720;7379;14768;183;447;6642;12951;6825;13398
261340;202211;7509;14918;6740;13994;98;313;6213;12543;6311;12856
261350;202211;10149;27052;8787;24769;300;815;6863;19183;7163;19998
261360;202211;11106;21788;9436;19502;412;867;7704;15393;8116;16260
261370;202211;30360;66551;25709;60495;2157;5255;18515;42377;20672;47632
261380;202211;5472;13104;4699;11863;480;1190;3288;8263;3768;9453
261390;202211;20955;52697;17456;47322;1209;3704;12146;31790;13355;35494
261400;202211;6274;15250;5465;13764;235;757;4363;10389;4598;11146
261410;202211;12326;26008;10205;22934;314;894;8623;18530;8937;19424
261420;202211;10509;25110;9481;23906;597;1852;7544;18555;8141;20407
261430;202211;5531;11014;4798;9964;39;145;4356;8704;4395;8849
261440;202211;1647;4495;1337;3909;52;227;971;2701;1023;2928
261450;202211;18892;42441;16642;39210;635;1496;13456;31317;14091;32813
261460;202211;9497;22222;8076;20111;260;689;6590;16183;6850;16872
261470;202211;4705;10464;4022;9518;51;205;3434;7917;3485;8122
261480;202211;6829;17430;5797;15743;246;877;4591;11951;4837;12828
261485;202211;6890;16509;6006;15216;419;1244;4542;11094;4961;12338
261500;202211;8564;18363;7447;16882;656;1219;5203;12215;5859;13434
261510;202211;2171;5784;1866;5300;68;247;1449;4053;1517;4300
261520;202211;2918;7539;2587;6914;140;386;1901;4937;2041;5323
261530;202211;15424;38176;12600;33519;713;2585;8078;19536;8791;22121
261540;202211;12163;29466;11135;28082;2711;6159;5569;15664;8280;21823
261550;202211;4657;10627;4036;9682;213;596;3074;7014;3287;7610
261560;202211;11827;26343;10420;24387;351;979;8764;19933;9115;20912
261570;202211;4379;10494;3425;8944;265;750;2367;5941;2632;6691
261580;202211;8810;19178;7710;17733;64;290;7167;16177;7231;16467
261590;202211;3505;7420;2851;6504;69;221;2336;5083;2405;5304
261600;202211;7787;14776;6711;13328;182;367;5727;10903;5909;11270
261610;202211;2698;6974;2150;6001;220;615;1270;3575;1490;4190
261618;202211;3623;6780;3214;6237;72;214;2840;5271;2912;5485
261620;202211;5933;13787;5454;13118;606;1306;3978;9918;4584;11224
261630;202211;7316;18719;6203;16640;475;1413;4048;10266;4523;11679
261640;202211;49510;93434;42346;84969;2237;3601;33723;68097;35960;71698
261650;202211;5528;11011;4697;10021;226;451;3848;8116;4074;8567
270010;202211;5096;15247;4368;14051;157;766;3489;10882;3646;11648
270020;202211;5161;10563;4509;9774;114;452;4007;8212;4121;8664
270030;202211;41351;102441;34804;92352;2424;6870;26424;68571;28848;75441
270040;202211;12516;29345;10574;27016;654;1797;8470;21465;9124;23262
270050;202211;6632;13519;5653;12425;159;368;5190;11319;5349;11687
270060;202211;2699;6222;2293;5738;145;382;1853;4550;1998;4932
270070;202211;6375;14174;5579;13099;89;375;4968;11195;5057;11570
270080;202211;1687;4112;1395;3654;77;202;1062;2710;1139;2912
270090;202211;2184;5716;1978;5357;31;138;1745;4612;1776;4750
270100;202211;8680;16273;7604;14865;170;402;6822;12960;6992;13362
270110;202211;4038;8476;3280;7600;213;353;2606;6304;2819;6657
270120;202211;3014;7509;2626;6986;79;253;2175;5669;2254;5922
270130;202211;6087;13841;5199;12788;150;482;4477;10825;4627;11307
270135;202211;2363;5038;2002;4645;26;121;1845;4222;1871;4343
270140;202211;10541;23419;8383;20503;327;1022;6496;15051;6823;16073
270150;202211;3724;8525;3436;8139;17;72;3291;7732;3308;7804
270160;202211;6308;15992;5405;14887;172;592;4847;13221;5019;13813
270170;202211;3831;10198;3178;9255;200;839;2305;6362;2505;7201
270180;202211;2762;7387;2483;7035;37;198;2210;6116;2247;6314
270190;202211;2993;5934;2740;5646;34;100;2581;5231;2615;5331
270200;202211;3144;8302;2704;7668;350;854;1804;5272;2154;6126
270210;202211;7236;14519;6221;13372;79;240;5803;12257;5882;12497
270220;202211;2080;4535;1692;4006;110;319;1290;2877;1400;3196
270230;202211;12053;29124;10147;26292;917;2575;7550;19057;8467;21632
270235;202211;7172;19837;6242;18378;252;817;5120;14869;5372;15686
270240;202211;14192;33527;11815;30334;963;2601;8924;22591;9887;25192
270250;202211;4031;8053;3632;7520;143;296;3234;6585;3377;6881
270255;202211;5221;13457;4114;11576;142;502;3231;8805;3373;9307
270260;202211;6380;17656;5763;16636;92;432;5010;14175;5102;14607
270270;202211;1201;2848;994;2594;117;283;736;1911;853;2194
270280;202211;4557;9702;3622;8571;271;566;2711;6577;2982;7143
270290;202211;9522;26673;8572;25225;173;763;7650;22207;7823;22970
270300;202211;4881;11475;3792;10276;170;397;3055;8410;3225;8807
270310;202211;8118;20455;6915;18695;162;562;5827;15542;5989;16104
270320;202211;6442;17344;5484;15592;238;830;4141;11201;4379;12031
270330;202211;5204;14262;4558;13332;188;818;3828;10947;4016;11765
270340;202211;1951;4581;1654;4181;76;149;1394;3517;1470;3666
270350;202211;2298;4646;1856;4126;155;288;1364;3096;1519;3384
270360;202211;4144;7834;3760;7407;49;121;3606;7044;3655;7165
270370;202211;1585;4438;1433;4172;33;154;1219;3489;1252;3643
270375;202211;4767;8545;4146;7870;18;52;4009;7551;4027;7603
270380;202211;6745;15820;5731;14606;626;1426;4242;11079;4868;12505
270390;202211;1486;3240;1181;2883;10;59;1010;2437;1020;2496
270400;202211;7821;18170;6502;16248;245;651;5126;12472;5371;13123
270410;202211;5841;14673;5075;13563;137;458;4351;11469;4488;11927
270420;202211;8257;19258;7522;18237;167;617;6765;15913;6932;16530
270430;202211;195952;405630;156366;355884;19700;46727;97064;213689;116764;260416
270440;202211;5587;13478;4878;12590;138;439;4269;10962;4407;11401
270450;202211;11060;23115;9827;21661;503;908;8281;18514;8784;19422
270460;202211;4712;9179;4023;8349;231;364;3579;7493;3810;7857
270470;202211;14343;34727;12443;32102;647;1924;10038;25369;10685;27293
270480;202211;3667;8430;3070;7614;169;495;2536;6095;2705;6590
270490;202211;1073;2679;930;2505;36;119;772;2029;808;2148
270500;202211;5924;15634;5257;14552;261;813;4261;11627;4522;12440
270510;202211;7816;16908;6579;15370;324;929;5317;11889;5641;12818
270520;202211;4881;12150;3866;10591;733;2103;1877;5126;2610;7229
270530;202211;1577;4145;1342;3777;90;226;930;2651;1020;2877
270540;202211;2710;6518;2276;5960;68;221;1979;5097;2047;5318
270550;202211;7845;18203;6180;16353;606;1485;4514;12214;5120;13699
270560;202211;3541;8021;2939;7228;165;494;2344;5571;2509;6065
270570;202211;6840;14136;5989;12980;475;1161;4965;10329;5440;11490
270580;202211;2875;6960;2592;6582;107;302;2263;5665;2370;5967
270590;202211;1724;4761;1584;4574;17;71;1488;4283;1505;4354
270600;202211;3290;8909;2982;8454;63;224;2639;7399;2702;7623
270610;202211;4363;10218;3815;9513;140;273;3367;8366;3507;8639
270620;202211;1438;3919;1304;3688;26;106;1127;3089;1153;3195
270630;202211;23287;48072;20272;44057;716;1964;17617;37049;18333;39013
270640;202211;6563;16444;5468;14721;150;560;4462;11740;4612;12300
270642;202211;3023;8597;2636;7963;195;650;1967;5814;2162;6464
270644;202211;4789;10458;3984;9450;249;590;3211;7509;3460;8099
270650;202211;4505;10476;3958;9782;270;799;3315;8015;3585;8814
270660;202211;2379;5284;2040;4835;91;212;1589;3676;1680;3888
270670;202211;23308;44673;19870;40550;661;1383;17282;34329;17943;35712
270680;202211;7973;14466;7239;13665;308;403;6671;12761;6979;13164
270690;202211;12440;26731;10403;24131;262;776;8744;19702;9006;20478
270700;202211;662;1754;570;1612;65;197;382;1036;447;1233
270710;202211;6834;18079;5980;16791;373;1112;4690;12985;5063;14097
270720;202211;4510;11082;3998;10260;98;315;3553;8926;3651;9241
270730;202211;9650;19137;8331;17751;1032;1310;6231;14615;7263;15925
270740;202211;2745;6662;2401;6264;82;252;2015;5183;2097;5435
270750;202211;6814;15618;5993;14587;102;403;5391;12820;5493;13223
270760;202211;4010;9830;3322;8889;54;242;2826;7399;2880;7641
270770;202211;28376;62685;23186;56169;3401;8274;14781;35532;18182;43806
270780;202211;2482;5365;2288;5114;50;160;2089;4575;2139;4735
270790;202211;2086;4885;1774;4480;147;359;1401;3509;1548;3868
270800;202211;14588;32540;13124;30543;592;1423;10994;25275;11586;26698
270810;202211;4038;9839;3192;8581;182;586;2410;6283;2592;6869
270820;202211;1905;5176;1614;4722;58;235;1307;3753;1365;3988
270830;202211;6242;13496;5064;12066;189;548;4165;9690;4354;10238
270840;202211;9790;26394;8472;24409;343;1460;6834;18929;7177;20389
270850;202211;10921;22172;9597;20664;659;1546;8152;17347;8811;18893
270860;202211;17583;34946;14135;31081;577;1396;11798;25319;12375;26715
270870;202211;2720;6990;2185;6112;205;566;1459;4049;1664;4615
270880;202211;9296;25303;8278;23763;203;820;6934;19398;7137;20218
270890;202211;4198;10192;3535;9244;449;1150;2147;5544;2596;6694
270895;202211;4619;10852;4126;10235;132;362;3663;8940;3795;9302
270900;202211;1921;4484;1480;3815;20;69;1226;3064;1246;3133
270910;202211;5082;12833;4397;11849;220;478;3622;9710;3842;10188
270915;202211;11401;28793;9221;25382;827;2720;6345;16607;7172;19327
270920;202211;7283;18168;6361;16881;118;473;5537;14318;5655;14791
270930;202211;22016;44855;17345;39534;2005;4019;12509;29370;14514;33389
270940;202211;7358;17554;6145;16163;194;804;4988;12641;5182;13445
280010;202211;703;1842;541;1513;20;77;383;976;403;1053
280020;202211;6532;13785;5512;12241;393;888;4273;9126;4666;10014
280030;202211;121547;237796;101363;210547;15798;33711;61059;122744;76857;156455
280040;202211;3740;8568;3243;7870;165;520;2532;5850;2697;6370
280050;202211;5065;12965;4219;11604;922;2517;2128;5810;3050;8327
280060;202211;9150;19736;7453;17279;1004;2624;4689;10467;5693;13091
280067;202211;8984;18361;7643;16388;638;1040;5641;12064;6279;13104
280070;202211;2053;5683;1873;5409;117;405;1479;4134;1596;4539
280100;202211;5303;11840;4466;10590;549;1160;2864;7021;3413;8181
280110;202211;1961;4112;1681;3718;25;75;1546;3339;1571;3414
280120;202211;9691;23375;8553;21634;1133;2498;6021;15573;7154;18071
280130;202211;10615;22200;9208;20284;603;1344;7316;15823;7919;17167
280140;202211;7678;14788;6790;13596;687;1118;5127;10493;5814;11611
280150;202211;4825;11002;4152;10059;474;1059;2951;7065;3425;8124
280160;202211;1610;3857;1365;3467;138;385;958;2287;1096;2672
280170;202211;7289;14977;6544;14056;216;499;5640;11816;5856;12315
280190;202211;2093;3397;1905;3160;37;98;1780;2865;1817;2963
280200;202211;1479;3521;1212;3132;76;233;889;2197;965;2430
280210;202211;22007;46296;19116;42343;2113;4615;12988;27979;15101;32594
280220;202211;2119;4780;1803;4376;109;251;1444;3517;1553;3768
280230;202211;5014;11398;4050;9972;277;544;2775;6838;3052;7382
280240;202211;3893;9179;3416;8495;37;185;2982;7173;3019;7358
280250;202211;1205;2356;1016;2098;61;136;792;1557;853;1693
280260;202211;3054;5877;2693;5432;38;91;2500;4979;2538;5070
280270;202211;2947;6890;2572;6352;115;358;2219;5320;2334;5678
280280;202211;4711;12408;4148;11593;577;1351;2850;8227;3427;9578
280290;202211;27245;57933;23429;52830;2141;4997;15237;34656;17378;39653
280300;202211;16573;31453;14441;29173;1261;1687;11289;23997;12550;25684
280310;202211;1653;3801;1372;3359;45;119;1088;2571;1133;2690
280320;202211;11440;25916;9907;23676;991;2447;7202;16518;8193;18965
280330;202211;5556;12289;4601;10951;334;764;3384;7872;3718;8636
280340;202211;6448;11985;5383;10799;196;306;4755;9549;4951;9855
280350;202211;40349;72752;35805;66905;1041;2334;31092;55839;32133;58173
280360;202211;6786;16993;5845;15530;645;1867;3718;9650;4363;11517
280370;202211;2906;5942;2323;5006;140;247;1765;3727;1905;3974
280380;202211;1266;2942;1062;2663;96;205;745;1881;841;2086
280390;202211;5177;10111;4376;8930;287;462;3574;7237;3861;7699
280400;202211;5082;10560;4424;9710;431;862;3330;7275;3761;8137
280410;202211;3385;7906;2826;7050;280;745;1860;4387;2140;5132
280420;202211;5460;12195;4895;11503;120;280;4431;10409;4551;10689
280430;202211;2888;5778;2558;5350;61;164;2248;4529;2309;4693
280440;202211;5460;12151;4824;11223;186;506;4125;9261;4311;9767
280445;202211;2658;6312;2388;5884;51;164;1920;4542;1971;4706
280450;202211;11907;26341;10257;24095;2310;5482;5149;12336;7459;17818
280460;202211;8794;17887;7959;16786;425;986;6798;13979;7223;14965
280470;202211;2000;5011;1653;4377;115;325;1217;3099;1332;3424
280480;202211;62973;127503;54664;116375;5243;11920;39123;80207;44366;92127
280490;202211;4210;11095;3508;9891;139;571;2649;7077;2788;7648
280500;202211;1281;2591;1054;2310;26;75;881;1918;907;1993
280510;202211;4398;7444;3904;6826;57;156;3591;6011;3648;6167
280520;202211;2341;4768;2046;4375;175;300;1551;3316;1726;3616
280530;202211;2803;6391;2426;5879;125;300;1917;4569;2042;4869
280540;202211;10131;24400;9089;22947;391;1008;7773;19444;8164;20452
280550;202211;8329;16736;6937;14825;118;439;5953;12106;6071;12545
280560;202211;9101;21317;8487;20446;124;409;7672;18099;7796;18508
280570;202211;8788;17635;7279;15802;309;717;5834;12267;6143;12984
280580;202211;7708;16149;6797;14894;469;914;5501;11856;5970;12770
280590;202211;3339;7037;2812;6413;164;424;2122;4607;2286;5031
280600;202211;5231;11112;4616;10248;153;369;3666;7933;3819;8302
280610;202211;3490;6909;3107;6432;129;310;2678;5337;2807;5647
280620;202211;7692;15508;6572;14105;576;857;4784;10691;5360;11548
280630;202211;5016;11336;4587;10788;360;754;3598;8571;3958;9325
280640;202211;2964;6549;2573;6109;107;222;2271;5417;2378;5639
280650;202211;1449;3426;1192;3056;113;281;842;2075;955;2356
280660;202211;4873;8972;4265;8268;136;236;3805;7267;3941;7503
280670;202211;25282;51861;21776;47390;3023;6386;14503;31390;17526;37776
280680;202211;3554;7461;3050;6753;296;538;2080;4766;2376;5304
280690;202211;1276;2589;1072;2333;53;140;901;1879;954;2019
280700;202211;1444;3012;1231;2715;31;80;1021;2178;1052;2258
280710;202211;18901;36533;16072;33342;1065;1593;13696;28768;14761;30361
280720;202211;3242;6395;2664;5723;54;124;2218;4750;2272;4874
280730;202211;1219;2855;1031;2569;77;209;741;1747;818;1956
280740;202211;21292;39951;18427;35976;979;2156;15090;28156;16069;30312
280750;202211;4048;10274;3448;9247;223;636;2488;6533;2711;7169
280760;202211;9113;19159;7781;17361;792;1588;5544;12402;6336;13990
290010;202211;3863;7043;2546;5108;20;53;2231;4269;2251;4322
290020;202211;7627;15262;6944;14449;539;840;5807;12309;6346;13149
290030;202211;5755;11226;4703;10050;333;592;3716;8159;4049;8751
290035;202211;6560;12074;5264;10410;261;441;4239;8258;4500;8699
290040;202211;7235;12187;6242;11037;337;450;5410;9583;5747;10033
290050;202211;2472;7173;2080;6382;146;480;1409;4190;1555;4670
290060;202211;1865;3643;1361;2964;164;384;961;2018;1125;2402
290070;202211;52887;99051;45543;89934;2921;5535;35847;68970;38768;74505
290080;202211;8174;18964;7086;17419;746;1800;5077;12482;5823;14282
290090;202211;2794;4490;2046;3694;20;53;1906;3382;1926;3435
290100;202211;11998;27519;9635;24126;1664;3846;5074;13169;6738;17015
290110;202211;6904;15613;5939;14122;797;1772;3653;8659;4450;10431
290115;202211;4855;12802;4103;11517;348;1011;3189;8844;3537;9855
290120;202211;8272;17460;6917;15610;207;554;5938;13033;6145;13587
290130;202211;5574;11687;4320;10042;289;558;3054;7356;3343;7914
290135;202211;5585;11324;4530;9628;171;431;3699;7419;3870;7850
290140;202211;5426;12342;4174;10698;227;525;3390;8747;3617;9272
290150;202211;4188;7652;3672;7067;162;400;3135;5802;3297;6202
290160;202211;4343;8408;3850;7743;201;354;3246;6446;3447;6800
290170;202211;4602;9229;4078;8667;138;288;3638;7726;3776;8014
290180;202211;3681;8661;3075;7720;73;260;2628;6400;2701;6660
290190;202211;6250;13118;5589;12278;122;344;4901;10524;5023;10868
290195;202211;3378;6725;2688;5871;175;307;2196;4818;2371;5125
290200;202211;4937;12301;3862;10503;263;605;2724;7440;2987;8045
290205;202211;4462;9682;3920;8886;177;456;3192;7041;3369;7497
290210;202211;17979;39608;15851;36503;1582;3033;12065;28208;13647;31241
290220;202211;4164;7711;3683;7140;95;232;3260;6121;3355;6353
290225;202211;4036;6958;3124;6023;45;121;2902;5456;2947;5577
290230;202211;3981;7508;3648;7135;201;267;2971;6011;3172;6278
290240;202211;5293;10362;4329;9216;78;247;3850;7991;3928;8238
290250;202211;4922;12076;3997;10758;158;383;3300;9017;3458;9400
290260;202211;6672;14113;5641;12626;260;651;4783;10375;5043;11026
290265;202211;3985;10674;3186;9213;291;878;2099;5923;2390;6801
290270;202211;12984;39204;11800;37196;842;2771;9034;28471;9876;31242
290280;202211;7311;20065;6250;18007;519;1695;4287;11918;4806;13613
290290;202211;11648;30975;9226;26676;962;2982;5848;16523;6810;19505
290300;202211;5071;12238;3673;9698;203;597;2612;6638;2815;7235
290310;202211;2838;4901;2334;4326;23;78;2187;3954;2210;4032
290320;202211;36126;80614;29333;70825;4886;12024;17296;41072;22182;53096
290323;202211;4646;11201;3927;10062;105;292;3101;7859;3206;8151
290327;202211;5082;12815;4234;11256;417;1005;2830;7426;3247;8431
290330;202211;3048;5049;2461;4427;24;32;2291;4118;2315;4150
290340;202211;7886;16172;6167;14151;513;1128;4873;11134;5386;12262
290350;202211;5639;14346;4655;12687;240;743;3388;9030;3628;9773
290360;202211;6780;13913;5894;12733;109;282;5256;11153;5365;11435
290370;202211;5767;12659;4183;10566;171;430;2994;7475;3165;7905
290380;202211;7207;15495;5987;13881;191;325;5068;11839;5259;12164
290390;202211;18811;46793;15457;41472;1455;3923;10712;28411;12167;32334
290395;202211;3552;8774;2790;7513;72;267;2187;5724;2259;5991
290400;202211;4554;11061;3612;9552;176;538;2727;6960;2903;7498
290405;202211;5365;13903;4501;12444;448;1211;2974;8363;3422;9574
290410;202211;6599;16004;4999;13560;192;697;3776;9896;3968;10593
290420;202211;3751;9043;3023;7931;104;275;2367;6169;2471;6444
290430;202211;4479;9570;3728;8490;168;491;2998;6454;3166;6945
290440;202211;3484;7705;2495;6180;173;378;1769;4396;1942;4774
290450;202211;5290;9960;4266;8560;94;232;3795;7304;3889;7536
290460;202211;15332;39442;12612;34486;2632;7339;5153;13865;7785;21204
290470;202211;6155;12080;4688;10161;422;948;3200;6665;3622;7613
290475;202211;7919;19968;6548;17716;94;448;5509;14537;5603;14985
290480;202211;2280;4944;1850;4333;71;224;1416;3110;1487;3334
290485;202211;5650;14221;4905;13167;231;694;3955;10581;4186;11275
290490;202211;12058;23497;10906;22001;455;932;9143;18238;9598;19170
290500;202211;4989;13551;3809;11186;682;2127;1558;4353;2240;6480
290510;202211;4506;9219;3765;8284;104;231;3306;7288;3410;7519
290515;202211;4175;10376;3595;9565;28;91;3261;8713;3289;8804
290520;202211;14995;37302;11510;30769;531;1738;7808;19355;8339;21093
290530;202211;5831;15045;4853;13492;99;387;4107;11250;4206;11637
290540;202211;4714;10538;4260;10040;170;452;3774;8856;3944;9308
290550;202211;5144;11492;4468;10701;45;109;4089;9853;4134;9962
290560;202211;7779;17782;5951;15155;542;1557;3891;9376;4433;10933
290570;202211;68982;146017;61731;136869;3955;9411;50002;107982;53957;117393
290580;202211;11220;25850;9747;23839;956;2029;7161;17968;8117;19997
290590;202211;8242;22993;6857;20613;163;572;5655;17001;5818;17573
290600;202211;22782;56790;19605;51763;1059;2885;15533;40424;16592;43309
290610;202211;2924;8310;2261;7014;98;320;1595;4878;1693;5198
290620;202211;7281;18905;6229;17200;448;1138;4970;13754;5418;14892
290630;202211;12895;24914;10634;22098;802;1637;8495;17530;9297;19167
290640;202211;3369;7373;2593;6295;266;495;1762;4533;2028;5028
290650;202211;22698;42985;20770;40862;1008;2306;18518;35648;19526;37954
290660;202211;4587;10636;3588;9022;177;498;2562;6391;2739;6889
290670;202211;10633;21081;9288;19208;230;617;8196;16498;8426;17115
290680;202211;13568;31993;11148;28549;241;944;9325;23272;9566;24216
290682;202211;6814;13714;5905;12536;514;699;4377;10073;4891;10772
290685;202211;4325;8732;3116;7025;484;994;1765;4146;2249;5140
290687;202211;10041;21403;8344;18839;1175;2463;5260;12106;6435;14569
290689;202211;3367;8361;2510;6879;316;874;1606;4388;1922;5262
290690;202211;7063;16045;5772;14250;382;956;4244;10260;4626;11216
290700;202211;3954;7848;3509;7315;69;181;3150;6435;3219;6616
290710;202211;11274;25393;9534;23065;227;753;8388;19889;8615;20642
290720;202211;25831;57542;23023;53403;1679;3416;18049;41220;19728;44636
290730;202211;8639;18198;7256;16578;480;886;5235;12302;5715;13188
290740;202211;1302;2984;993;2504;24;48;874;2179;898;2227
290750;202211;17042;33650;14584;30063;346;920;12239;23725;12585;24645
290755;202211;2381;6179;1908;5359;111;299;1320;3703;1431;4002
290760;202211;4494;11731;3687;10322;222;527;2618;7420;2840;7947
290770;202211;3750;8736;3462;8401;84;205;3081;7443;3165;7648
290780;202211;9427;21293;8008;19404;340;661;6166;15082;6506;15743
290790;202211;6251;14772;5342;13483;283;687;4389;11087;4672;11774
290800;202211;8625;15126;6238;12407;402;633;4631;9354;5033;9987
290810;202211;7079;14995;5725;13090;227;523;4484;10184;4711;10707
290820;202211;6495;14557;5623;13262;346;719;4018;9339;4364;10058
290830;202211;5193;11498;4540;10479;106;333;3660;7921;3766;8254
290840;202211;22232;51697;18721;46378;2074;4275;12305;32007;14379;36282
290850;202211;11367;20369;9858;18739;491;734;8299;15613;8790;16347
290860;202211;7848;18600;6825;17426;382;853;5711;14869;6093;15722
290870;202211;5781;14145;4364;11549;356;868;2921;7626;3277;8494
290880;202211;1691;3699;1338;3259;202;438;759;2003;961;2441
290890;202211;12043;20843;10603;19234;414;652;9473;17151;9887;17803
290900;202211;2737;6671;2072;5524;178;457;1267;3317;1445;3774
290910;202211;6237;12913;4762;10755;49;125;4155;9239;4204;9364
290920;202211;6469;13783;5571;12714;161;232;4744;11398;4905;11630
290930;202211;8713;22227;6884;19078;279;966;5160;13838;5439;14804
290940;202211;4084;10535;3343;9428;162;552;2612;7211;2774;7763
290950;202211;1703;3866;1359;3355;122;288;882;2200;1004;2488
290960;202211;7455;15914;6613;14898;323;598;5521;12399;5844;12997
290970;202211;3662;10177;2956;8865;122;412;2255;6688;2377;7100
290980;202211;17595;36074;15263;32696;826;1997;11057;22345;11883;24342
290990;202211;12012;27579;10631;25487;335;1096;8990;20722;9325;21818
291000;202211;3998;9087;3066;7945;163;420;2454;6411;2617;6831
291005;202211;21280;45250;18745;42092;979;2227;15502;34141;16481;36368
291010;202211;3515;9997;2736;8319;148;500;1784;5223;1932;5723
291020;202211;1538;3455;1235;2957;32;92;901;1998;933;2090
291030;202211;3084;6532;2252;5216;202;414;1437;3229;1639;3643
291040;202211;6342;15406;5134;13719;266;781;3964;10603;4230;11384
291050;202211;14288;27745;12638;25561;1491;2906;9280;18473;10771;21379
291060;202211;10802;23641;9473;21951;947;2034;7123;16475;8070;18509
291070;202211;22199;48235;18797;43089;364;1191;16322;36147;16686;37338
291072;202211;35506;75817;27077;62831;3920;9217;15643;34797;19563;44014
291075;202211;6411;14231;5721;13181;102;281;4760;10516;4862;10797
291077;202211;2001;4713;1549;3950;89;157;1095;2786;1184;2943
291080;202211;166797;348228;135222;306314;28024;63805;66366;147347;94390;211152
291085;202211;6585;15079;5290;13089;200;537;4326;10472;4526;11009
291090;202211;2625;4317;1946;3576;52;97;1687;3014;1739;3111
291100;202211;4072;7452;2893;6076;126;246;2296;4760;2422;5006
291110;202211;7043;19248;5874;17318;346;1226;4439;12688;4785;13914
291120;202211;10579;21036;9097;19231;591;1198;7153;14989;7744;16187
291125;202211;2901;4405;2216;3646;103;138;1922;3131;2025;3269
291130;202211;3767;9635;2793;7810;82;316;2176;5816;2258;6132
291140;202211;5800;13748;4164;10885;662;1537;2441;6376;3103;7913
291150;202211;3456;5919;2744;5145;45;66;2568;4786;2613;4852
291160;202211;6114;15058;5002;13449;555;1517;3188;8345;3743;9862
291165;202211;2451;6249;1748;4909;25;114;1206;3240;1231;3354
291170;202211;27065;61164;22496;53783;1657;4019;14864;33813;16521;37832
291180;202211;9970;16980;7851;14315;244;494;6967;12347;7211;12841
291185;202211;4324;9124;3838;8419;220;453;3076;6674;3296;7127
291190;202211;9342;20045;7712;18024;302;697;6035;14298;6337;14995
291200;202211;3250;8137;2363;6505;92;329;1591;4078;1683;4407
291210;202211;9455;16925;7023;14190;396;682;5406;10888;5802;11570
291220;202211;6029;14008;5332;12999;504;1151;3653;8807;4157;9958
291230;202211;6136;10486;4881;9125;62;95;4559;8471;4621;8566
291240;202211;4972;11537;4203;10293;83;237;3629;8708;3712;8945
291250;202211;3839;10388;2934;8766;197;566;1794;5429;1991;5995
291260;202211;1768;3617;1444;3206;42;84;1181;2652;1223;2736
291270;202211;6779;14973;5291;12945;505;1123;3783;9425;4288;10548
291280;202211;3465;7464;2565;6161;162;401;1812;4132;1974;4533
291290;202211;6799;16108;5147;13583;505;1392;3420;8780;3925;10172
291300;202211;4771;11218;3778;9607;205;490;2799;7013;3004;7503
291310;202211;6366;14721;5444;13171;130;380;4713;11112;4843;11492
291320;202211;7980;19100;6186;16109;1280;3170;3264;8699;4544;11869
291330;202211;2238;5132;1816;4433;69;186;1382;3269;1451;3455
291340;202211;5077;11706;4012;9997;228;435;2709;6725;2937;7160
291345;202211;3633;9012;3232;8416;205;536;2573;6706;2778;7242
291350;202211;8821;18236;6930;15931;183;431;5856;13286;6039;13717
291360;202211;54591;103772;43857;91377;5241;10602;29163;61284;34404;71886
291370;202211;9982;23893;8756;22042;614;1752;6654;16019;7268;17771
291380;202211;5807;11363;5200;10575;122;322;4646;9200;4768;9522
291390;202211;16728;30672;12940;26506;641;1152;10958;22212;11599;23364
291400;202211;20324;41365;17013;36614;1602;3247;11993;25785;13595;29032
291410;202211;3543;8387;2754;7070;59;190;2062;5110;2121;5300
291420;202211;2268;4906;1756;4269;22;75;1557;3713;1579;3788
291430;202211;3125;7837;2644;7043;94;337;2094;5366;2188;5703
291440;202211;7966;19820;6787;18004;536;1340;4928;13323;5464;14663
291450;202211;13598;24914;11287;22283;323;449;10089;20132;10412;20581
291460;202211;22412;48045;19608;44083;1696;3533;14523;32033;16219;35566
291465;202211;10841;23310;8585;20726;261;919;7360;17245;7621;18164
291470;202211;25704;46316;21947;42069;1184;2097;17550;33331;18734;35428
291480;202211;59625;114094;45744;95994;5119;10735;27668;55930;32787;66665
291490;202211;9137;17393;8150;16305;248;550;7455;14750;7703;15300
291500;202211;6679;12898;5622;11581;190;424;5114;10462;5304;10886
291510;202211;5899;11414;4513;9669;74;209;3974;8338;4048;8547
291520;202211;5558;11231;4241;9573;291;669;3394;7554;3685;8223
291530;202211;2889;5787;2102;4787;230;503;1427;3283;1657;3786
291535;202211;4658;11299;3894;10013;212;482;3084;7988;3296;8470
291540;202211;2700;5145;1908;4203;63;152;1628;3545;1691;3697
291550;202211;8303;15066;6537;12940;552;956;4820;9404;5372;10360
291560;202211;22170;47475;16510;40188;3507;8139;7997;20199;11504;28338
291570;202211;2956;5774;2282;5006;77;168;2006;4395;2083;4563
291580;202211;7796;17386;6124;15240;317;917;4680;11200;4997;12117
291590;202211;3444;6283;3056;5844;76;187;2788;5196;2864;5383
291600;202211;6850;13907;5260;11602;493;1181;3547;7567;4040;8748
291610;202211;8763;16715;7800;15651;739;1002;6125;12851;6864;13853
291620;202211;3693;7216;2807;6249;239;431;2070;4749;2309;5180
291630;202211;4343;8020;3324;6783;551;817;2358;5069;2909;5886
291640;202211;22533;45624;17470;38775;1571;3609;11005;23153;12576;26762
291650;202211;12797;25355;11339;23674;926;1307;9262;20007;10188;21314
291660;202211;2407;5283;1761;4326;129;386;1200;2718;1329;3104
291670;202211;2409;5753;1965;5112;210;477;1317;3538;1527;4015
291680;202211;4983;10799;4028;9495;523;1229;2513;5989;3036;7218
291685;202211;5684;12627;4523;11031;182;374;3519;8545;3701;8919
291690;202211;5571;9861;4002;7780;145;307;3505;6607;3650;6914
291700;202211;11790;27466;10373;25228;341;1050;8906;20942;9247;21992
291710;202211;6817;13531;5210;11389;346;777;3944;8303;4290;9080
291720;202211;5223;14297;4283;12510;882;2651;2220;6393;3102;9044
291730;202211;9883;18342;8528;16640;413;811;7258;14018;7671;14829
291733;202211;3545;7989;2917;7147;117;221;2152;5477;2269;5698
291735;202211;3169;8018;2418;6694;83;200;1700;4710;1783;4910
291740;202211;4640;11035;3210;8424;121;261;2242;5814;2363;6075
291750;202211;27412;55792;22732;49025;3086;5896;14966;32546;18052;38442
291760;202211;13776;34307;10739;29739;3257;10457;2885;7465;6142;17922
291770;202211;9250;21714;7662;19030;374;1170;5886;13790;6260;14960
291780;202211;6384;14529;5729;13666;157;437;4943;11546;5100;11983
291790;202211;3768;8183;3426;7772;385;602;2542;6057;2927;6659
291800;202211;44401;92237;35550;80107;4241;10209;22592;48233;26833;58442
291810;202211;13273;27325;11290;24962;472;884;9402;20891;9874;21775
291820;202211;4791;10943;4138;10107;141;360;3373;8126;3514;8486
291830;202211;5978;11441;4871;10027;366;525;3762;7846;4128;8371
291835;202211;7800;21081;6174;18167;688;2055;4014;11865;4702;13920
291840;202211;63251;148751;55012;136535;5763;15141;39378;95885;45141;111026
291845;202211;4233;8088;3526;7242;273;431;2850;6040;3123;6471
291850;202211;5459;12873;4583;11535;136;338;3922;9813;4058;10151
291855;202211;2960;4728;2400;4121;30;56;2274;3876;2304;3932
291860;202211;2508;6202;1697;4659;44;114;1142;3024;1186;3138
291870;202211;1495;3484;993;2610;51;156;667;1693;718;1849
291875;202211;3427;9494;2909;8453;66;265;2143;5978;2209;6243
291880;202211;6670;16315;5567;14558;353;844;4198;11091;4551;11935
291890;202211;2098;3826;1388;3004;200;431;883;1866;1083;2297
291900;202211;1635;3399;1253;2841;38;88;1006;2188;1044;2276
291905;202211;2751;6474;2219;5643;113;337;1681;4087;1794;4424
291910;202211;4486;8376;3854;7639;86;175;3433;6756;3519;6931
291915;202211;8885;22256;7116;19357;280;719;5177;14431;5457;15150
291920;202211;42903;91637;37582;84787;1961;5449;30295;65293;32256;70742
291930;202211;3390;7426;2863;6714;308;671;2068;4926;2376;5597
291940;202211;4503;10346;3016;7956;270;668;1820;4723;2090;5391
291950;202211;10967;30594;9106;27226;511;1563;6067;17996;6578;19559
291955;202211;24512;52132;21904;48835;1462;3474;17545;38579;19007;42053
291960;202211;4712;9365;3962;8420;311;488;3165;6919;3476;7407
291970;202211;6149;12564;5193;11430;193;461;4204;9077;4397;9538
291980;202211;12240;30698;9874;26872;927;2330;6614;18194;7541;20524
291990;202211;2736;6208;2279;5656;30;109;2102;5159;2132;5268
291992;202211;5789;11501;4915;10416;238;507;4079;8385;4317;8892
291995;202211;2823;6242;2328;5510;83;260;1923;4367;2006;4627
292000;202211;3313;6682;2730;5993;91;232;2288;4936;2379;5168
292010;202211;7072;14183;5758;12318;108;367;4944;10180;5052;10547
292020;202211;5830;13984;4922;12507;148;543;4057;9864;4205;10407
292030;202211;2529;6541;2181;5950;147;429;1446;3819;1593;4248
292040;202211;5809;12246;4630;10593;173;417;3848;8661;4021;9078
292045;202211;5764;11106;4593;9458;22;69;4327;8836;4349;8905
292050;202211;7730;19199;6205;16664;272;852;4251;11040;4523;11892
292060;202211;16274;30603;15040;29134;517;892;13418;25518;13935;26410
292070;202211;8556;17035;7537;15849;528;1048;6392;13361;6920;14409
292080;202211;4667;8761;3876;7784;43;140;3605;7118;3648;7258
292090;202211;5278;10201;3759;8358;218;515;2965;6555;3183;7070
292100;202211;16096;33894;13756;31004;2089;4645;8395;19088;10484;23733
292105;202211;4005;9246;3460;8511;48;163;2915;7087;2963;7250
292110;202211;8332;16401;6044;13286;728;1741;4008;8498;4736;10239
292120;202211;8699;19475;7108;16906;741;1544;4940;11691;5681;13235
292130;202211;4129;8728;3342;7744;201;510;2490;5644;2691;6154
292140;202211;7157;13711;6055;12200;190;385;5372;10618;5562;11003
292145;202211;3183;7562;2644;6714;142;274;2010;5209;2152;5483
292150;202211;19587;42771;16861;38528;400;1037;14468;32056;14868;33093
292160;202211;3550;7516;2697;6449;36;108;2107;5309;2143;5417
292170;202211;10730;25366;8861;22414;506;1475;6715;16432;7221;17907
292180;202211;3462;8664;2566;7042;199;571;1604;4233;1803;4804
292190;202211;3691;8390;3098;7545;282;735;2171;5235;2453;5970
292200;202211;11594;25352;8734;21382;1790;4464;4233;10513;6023;14977
292205;202211;4700;11224;4037;10241;114;310;3489;8810;3603;9120
292210;202211;8232;15812;6816;14074;86;299;6340;12828;6426;13127
292220;202211;2741;5556;2327;4946;165;337;1738;3541;1903;3878
292225;202211;3813;9831;3299;9081;68;272;2855;7714;2923;7986
292230;202211;10682;22340;9352;20641;303;808;7874;16946;8177;17754
292240;202211;6097;15384;5214;13790;308;769;3762;9900;4070;10669
292250;202211;7696;16755;6841;15562;304;778;5547;12199;5851;12977
292260;202211;4079;9467;3593;8863;63;187;3189;7801;3252;7988
292265;202211;4512;10331;3728;9133;66;260;3181;7529;3247;7789
292270;202211;6208;11204;5083;9886;195;302;4282;8225;4477;8527
292273;202211;3431;6538;2719;5675;160;260;1967;4330;2127;4590
292275;202211;2359;5102;1925;4541;53;161;1611;3704;1664;3865
292280;202211;3386;6785;2704;6001;131;233;2252;5099;2383;5332
292285;202211;3157;6518;2468;5620;109;198;2000;4617;2109;4815
292290;202211;9208;20579;7339;17993;204;505;6169;14908;6373;15413
292300;202211;12921;28705;10168;24989;1411;3458;6288;15580;7699;19038
292303;202211;4178;9259;3619;8427;62;144;3245;7432;3307;7576
292305;202211;2769;6648;2508;6295;54;178;2246;5551;2300;5729
292310;202211;8591;18274;7411;16829;139;426;6502;14403;6641;14829
292320;202211;6962;16841;5518;14400;181;558;4305;10904;4486;11462
292330;202211;4031;6702;3385;5992;161;239;2867;5102;3028;5341
292335;202211;6138;14028;5382;12923;254;578;4487;10800;4741;11378
292340;202211;6498;16574;5177;14127;372;918;3580;9708;3952;10626
292350;202211;3360;7692;2819;6982;147;389;2327;5697;2474;6086
292360;202211;6048;14219;5005;12548;275;738;3668;8988;3943;9726
292370;202211;13638;26952;11731;24485;88;334;11107;22749;11195;23083
292380;202211;8403;20558;7417;18875;447;1204;5815;14438;6262;15642
292390;202211;6156;9669;4739;8075;117;191;4297;7272;4414;7463
292400;202211;28125;69220;24133;63257;2264;5878;16976;44072;19240;49950
292405;202211;5562;11797;4608;10353;137;320;3621;8245;3758;8565
292410;202211;3032;5641;2607;5130;96;168;2312;4544;2408;4712
292420;202211;6195;11888;5568;11057;119;251;5066;9804;5185;10055
292430;202211;5933;15904;4421;13149;342;1092;2948;8598;3290;9690
292440;202211;11405;29239;10437;27862;126;593;9474;24889;9600;25482
292450;202211;4864;12343;3643;10065;98;309;2839;7695;2937;8004
292460;202211;7850;16022;6654;14274;159;443;5804;12008;5963;12451
292465;202211;3145;7048;2633;6403;131;269;1773;4603;1904;4872
292467;202211;2596;6057;2295;5666;334;679;1562;4122;1896;4801
292470;202211;3388;7984;2537;6669;150;346;1797;4748;1947;5094
292480;202211;8426;15499;6970;13777;173;340;6315;12368;6488;12708
292490;202211;3438;6568;2840;5797;86;171;2280;4650;2366;4821
292500;202211;8965;19877;7146;17080;430;925;5265;12296;5695;13221
292510;202211;17554;39296;13804;33661;1066;2534;9752;23572;10818;26106
292520;202211;9236;20430;8126;18831;420;1135;6569;14812;6989;15947
292525;202211;8206;16058;6772;14426;144;334;6089;12890;6233;13224
292530;202211;43717;98998;34967;85508;6780;17646;18161;42941;24941;60587
292540;202211;5470;8836;4367;7673;132;207;3979;6994;4111;7201
292550;202211;10345;24606;8030;21799;630;1575;5519;15721;6149;17296
292560;202211;5511;12192;4568;10897;169;500;3523;8052;3692;8552
292570;202211;4563;10370;3789;9073;51;182;3262;7520;3313;7702
292575;202211;8194;21161;7432;20120;882;2284;5363;14791;6245;17075
292580;202211;9988;20319;8276;17918;562;791;6787;14826;7349;15617
292590;202211;8803;20955;7362;18444;316;1010;6063;14662;6379;15672
292593;202211;3547;7822;2796;6582;79;192;2336;5398;2415;5590
292595;202211;7019;15793;6074;14638;329;675;4988;12220;5317;12895
292600;202211;13924;32453;11961;29642;666;1488;9433;23385;10099;24873
292610;202211;5615;12105;4717;10683;158;351;3842;8497;4000;8848
292620;202211;8500;18783;7031;17018;120;293;6460;15620;6580;15913
292630;202211;11495;23905;9235;20458;949;2290;6378;13481;7327;15771
292640;202211;9685;24923;8061;22271;491;1343;5540;15333;6031;16676
292650;202211;5108;11444;4506;10660;61;191;4134;9633;4195;9824
292660;202211;12984;32595;10994;29646;645;1607;8274;22525;8919;24132
292665;202211;2427;6446;2025;5904;112;280;1584;4741;1696;5021
292670;202211;4076;10397;3140;8678;258;821;2031;5365;2289;6186
292680;202211;4761;11172;3759;9486;110;279;2924;7121;3034;7400
292690;202211;2991;7174;2042;5651;218;546;1260;3577;1478;4123
292700;202211;12848;29578;11040;26895;673;1470;8270;19921;8943;21391
292710;202211;4158;8834;3891;8514;84;175;3664;7993;3748;8168
292720;202211;10855;22161;9116;20155;487;914;6991;15941;7478;16855
292730;202211;6843;12916;6163;11964;386;602;5155;9964;5541;10566
292740;202211;494379;994913;439121;920273;46631;100977;317010;642064;363641;743041
292750;202211;8648;18176;7573;16777;321;650;6422;14114;6743;14764
292760;202211;4768;11958;4095;10836;204;596;3114;8055;3318;8651
292770;202211;9612;20581;7925;18319;985;2289;5523;12862;6508;15151
292780;202211;2633;4449;1955;3657;45;108;1682;2961;1727;3069
292790;202211;4745;8722;3590;7483;325;577;2786;5929;3111;6506
292800;202211;14956;31357;12789;28166;948;1840;9944;21961;10892;23801
292805;202211;4661;9327;3722;8168;147;354;3124;6705;3271;7059
292810;202211;16834;32381;13855;28081;508;1305;11713;22435;12221;23740
292820;202211;8219;21052;5965;17266;463;1492;4112;11621;4575;13113
292830;202211;3599;7374;3069;6758;151;312;2500;5599;2651;5911
292840;202211;12496;25339;10727;23033;171;488;9772;20453;9943;20941
292850;202211;3138;7272;2641;6583;237;564;1835;4506;2072;5070
292860;202211;23081;42706;20686;39852;424;1021;18397;34414;18821;35435
292870;202211;28577;58538;24674;53180;1683;3548;17813;36895;19496;40443
292880;202211;13550;33816;11257;30234;429;1501;8227;20999;8656;22500
292890;202211;10712;23060;9490;21379;208;635;8362;18309;8570;18944
292895;202211;4270;7559;3317;6197;257;397;2644;4934;2901;5331
292900;202211;3726;8039;3358;7535;56;198;2858;6143;2914;6341
292905;202211;5476;12224;4341;10551;147;410;3396;7933;3543;8343
292910;202211;6806;14986;5978;13914;182;394;4874;11056;5056;11450
292920;202211;12218;28831;11205;27424;337;1042;9665;23093;10002;24135
292925;202211;6276;16254;5101;14061;456;1044;3463;9585;3919;10629
292930;202211;8413;21564;7234;19483;944;2606;4202;10961;5146;13567
292935;202211;3499;6417;2839;5696;22;59;2621;5222;2643;5281
292937;202211;3390;7745;2875;7088;290;620;1955;4929;2245;5549
292940;202211;3661;8103;2915;6998;501;1040;1748;4377;2249;5417
292950;202211;11143;26098;9656;23980;539;1305;7300;17753;7839;19058
292960;202211;6722;14051;5634;12564;214;382;4549;10026;4763;10408
292970;202211;4860;11861;4267;11036;123;341;3523;9177;3646;9518
292975;202211;5327;10290;4736;9625;105;246;4360;8764;4465;9010
292980;202211;4843;9064;4054;7988;64;189;3643;6967;3707;7156
292990;202211;13907;34178;11510;30150;420;1297;9048;22841;9468;24138
293000;202211;3308;7074;2774;6257;167;316;2086;4733;2253;5049
293010;202211;23235;51327;18807;44862;2334;5767;12143;28485;14477;34252
293015;202211;10425;28102;8117;23826;700;2096;5464;15996;6164;18092
293020;202211;12752;30161;11528;28457;169;600;10497;25631;10666;26231
293030;202211;6208;14656;4796;12514;412;750;3138;8622;3550;9372
293040;202211;5298;11980;4271;10578;142;379;3594;8817;3736;9196
293050;202211;31839;62264;27972;56824;1973;3861;21533;42498;23506;46359
293060;202211;4599;10823;3664;9136;235;595;2679;6418;2914;7013
293070;202211;41513;79180;37030;73640;2308;4862;29907;57545;32215;62407
293075;202211;4383;11784;3776;10825;70;350;3242;9219;3312;9569
293076;202211;4190;8977;3783;8511;114;210;3338;7571;3452;7781
293077;202211;7948;18878;6387;16480;922;2150;3659;10068;4581;12218
293080;202211;5482;14368;4590;12844;89;366;3771;10295;3860;10661
293090;202211;3657;9894;2790;8406;199;609;1934;5748;2133;6357
293100;202211;7055;16696;5658;14335;328;716;4326;10927;4654;11643
293105;202211;4536;13020;3814;11588;243;749;2624;7962;2867;8711
293110;202211;3176;6473;2661;5757;132;288;2122;4506;2254;4794
293120;202211;6610;13528;6016;12707;540;740;4831;10629;5371;11369
293130;202211;4413;10500;3791;9707;132;417;3248;8164;3380;8581
293135;202211;39110;83960;28808;70104;5252;13871;11891;28274;17143;42145
293140;202211;3629;6031;3192;5525;108;147;2845;4853;2953;5000
293150;202211;6187;16424;5051;14366;407;1266;3446;9464;3853;10730
293160;202211;5217;10442;4596;9744;556;744;3564;8182;4120;8926
293170;202211;6839;11084;5830;9935;115;251;5148;8547;5263;8798
293180;202211;5594;13525;4618;11839;101;340;3763;9342;3864;9682
293190;202211;20669;42102;18245;38792;125;506;16777;34749;16902;35255
293200;202211;11830;23110;9740;20026;581;902;7998;16407;8579;17309
293210;202211;6627;14645;5573;13136;536;1122;4065;9710;4601;10832
293220;202211;7559;15147;5726;12325;769;1613;3797;7828;4566;9441
293230;202211;5978;11652;4544;9875;351;669;3434;7509;3785;8178
293240;202211;5537;12434;4429;10746;214;378;3265;8277;3479;8655
293245;202211;4958;11479;4468;10791;275;639;3674;8747;3949;9386
293250;202211;7102;15119;5683;13200;395;952;4328;9900;4723;10852
293260;202211;5930;13214;4794;11531;185;362;3486;8399;3671;8761
293270;202211;9535;17712;7617;15678;633;774;6092;13326;6725;14100
293280;202211;5547;12446;4816;11435;295;644;3844;9068;4139;9712
293290;202211;20957;50332;18392;46416;1704;4424;13354;33064;15058;37488
293300;202211;8446;16708;7225;14955;560;1136;5539;11098;6099;12234
293305;202211;5375;10877;4529;9812;43;119;4150;8919;4193;9038
293310;202211;2695;5998;2261;5336;32;115;1880;4286;1912;4401
293315;202211;5791;11077;4814;9729;468;652;3805;7847;4273;8499
293317;202211;3510;7087;3109;6518;324;483;2271;4864;2595;5347
293320;202211;17478;33652;15609;31594;230;562;14295;28363;14525;28925
293325;202211;2277;4904;1781;4284;208;487;1169;2795;1377;3282
293330;202211;96906;220193;80238;193474;9567;26065;49040;109284;58607;135349
293340;202211;2567;6489;2075;5637;157;437;1409;3770;1566;4207
293345;202211;4726;10761;3801;9408;486;893;2468;6736;2954;7629
293350;202211;7092;17750;6022;16404;161;456;5244;14319;5405;14775
293360;202211;19484;40442;16784;36966;581;1221;14521;32200;15102;33421
310010;202211;1187;2476;807;1981;98;271;338;728;436;999
310020;202211;3856;9233;2908;7590;503;1416;1207;2861;1710;4277
310030;202211;2411;6113;1873;5184;257;767;1221;3245;1478;4012
310040;202211;991;2354;765;1976;70;236;443;987;513;1223
310050;202211;2000;5017;1678;4529;148;482;1134;2929;1282;3411
310060;202211;3926;9553;3300;8728;140;452;2493;6677;2633;7129
310070;202211;433;934;326;785;14;45;250;579;264;624
310080;202211;914;2298;670;1873;94;288;331;865;425;1153
310090;202211;6534;13864;5398;12146;212;613;4366;9397;4578;10010
310100;202211;4578;10327;3820;9190;103;370;3260;7548;3363;7918
310110;202211;5909;13971;4626;11844;618;1824;2800;6710;3418;8534
310120;202211;817;1838;536;1426;91;310;270;602;361;912
310130;202211;534;1193;454;1074;29;93;354;779;383;872
310140;202211;414;1060;314;921;61;202;164;422;225;624
310150;202211;7814;17495;5924;14285;519;1551;3564;7674;4083;9225
310160;202211;12711;28044;9774;23559;1535;4282;4879;10719;6414;15001
310163;202211;1416;3872;1088;3227;246;816;308;779;554;1595
310170;202211;12143;26541;9869;23157;955;2231;6999;16092;7954;18323
310180;202211;2505;5377;1813;4314;193;531;1180;2647;1373;3178
310190;202211;3256;8612;2610;7510;597;1847;545;1441;1142;3288
310200;202211;2446;6334;1840;5278;358;1200;818;2086;1176;3286
310205;202211;1391;3451;1111;3026;148;427;710;1948;858;2375
310210;202211;2921;7169;2362;6180;124;308;1663;4194;1787;4502
310220;202211;1395;3508;1028;2816;82;261;650;1677;732;1938
310230;202211;2851;6762;2328;5848;266;790;1476;3430;1742;4220
310240;202211;1245;3196;1055;2884;56;191;729;1874;785;2065
310250;202211;1508;3205;1258;2842;36;100;1028;2234;1064;2334
310260;202211;4554;10956;3077;8269;760;2391;1082;2328;1842;4719
310270;202211;3649;7056;2956;6157;100;231;2481;5120;2581;5351
310280;202211;3519;6861;2758;5864;133;366;2106;4139;2239;4505
310285;202211;2240;6295;1813;5530;180;614;1116;3350;1296;3964
310290;202211;1966;4649;1654;4090;190;558;1053;2351;1243;2909
310300;202211;2036;5131;1575;4323;167;563;855;2076;1022;2639
310310;202211;402;866;270;655;44;116;144;320;188;436
310320;202211;589;1376;402;1068;25;80;225;562;250;642
310330;202211;595;1325;346;878;56;151;147;332;203;483
310340;202211;10127;23286;7842;19465;925;2349;4212;10131;5137;12480
310350;202211;16815;37611;12033;30040;1749;4905;6455;14875;8204;19780
310360;202211;739;1464;605;1295;27;68;399;815;426;883
310370;202211;1466;4241;1263;3899;239;823;423;1352;662;2175
310375;202211;1079;2441;749;1960;221;566;237;590;458;1156
310380;202211;451;990;255;686;24;67;140;348;164;415
310390;202211;716;1945;574;1675;100;325;249;647;349;972
310400;202211;15487;34573;11715;28957;834;2494;7939;18393;8773;20887
310410;202211;1284;3435;766;2341;84;294;330;862;414;1156
310420;202211;6196;14852;4602;12068;558;1667;2409;5692;2967;7359
310430;202211;2093;5293;1464;4171;244;724;629;1533;873;2257
310440;202211;791;1876;538;1438;76;203;257;643;333;846
310445;202211;1630;4167;1223;3392;86;223;858;2305;944;2528
310450;202211;5900;12526;4512;10427;267;791;3456;7510;3723;8301
310460;202211;2093;5256;1545;4255;193;583;485;1113;678;1696
310470;202211;4170;8669;3208;7402;451;953;2010;4731;2461;5684
310480;202211;1232;2893;927;2395;108;351;547;1264;655;1615
310490;202211;3716;8987;2916;7694;382;1165;1613;3854;1995;5019
310500;202211;1903;4424;1506;3810;196;531;968;2311;1164;2842
310510;202211;2942;6851;2152;5462;370;1015;971;2315;1341;3330
310520;202211;1352;3222;953;2499;140;394;456;1156;596;1550
310530;202211;1004;2417;733;1969;112;352;291;637;403;989
310540;202211;3641;9619;2928;8277;519;1601;1330;3452;1849;5053
310550;202211;1562;3444;1115;2712;76;243;724;1570;800;1813
310560;202211;20982;49738;15405;39818;1735;5222;8058;18002;9793;23224
310570;202211;1509;3230;1187;2802;56;178;990;2242;1046;2420
310590;202211;5287;12370;4212;10453;270;783;2601;5891;2871;6674
310600;202211;1721;4481;1397;3840;175;525;742;1863;917;2388
310610;202211;595;1529;357;1105;94;307;72;200;166;507
310620;202211;284285;641574;217610;525004;21752;63299;130679;279510;152431;342809
310630;202211;5715;14253;4346;11630;549;1505;2535;6443;3084;7948
310640;202211;1900;4365;1543;3783;119;378;1092;2407;1211;2785
310650;202211;2863;7060;2089;5657;140;442;1260;3204;1400;3646
310660;202211;1788;4059;1461;3618;26;69;1283;3126;1309;3195
310665;202211;1729;3763;1438;3383;46;144;1165;2698;1211;2842
310670;202211;83428;187101;69876;165240;6270;17073;48886;107693;55156;124766
310680;202211;967;2024;795;1779;19;69;663;1414;682;1483
310690;202211;3115;6561;2319;5411;228;560;1577;3424;1805;3984
310700;202211;663;1225;521;1057;12;29;435;847;447;876
310710;202211;7669;19719;5580;16544;1250;4220;953;2483;2203;6703
310720;202211;1424;2896;1131;2519;41;125;859;1832;900;1957
310730;202211;12710;29303;10785;26418;496;1510;8065;18690;8561;20200
310740;202211;8557;20977;6507;17158;764;2434;3331;7669;4095;10103
310750;202211;1667;3541;1269;2967;113;300;777;1632;890;1932
310760;202211;881;1984;631;1600;70;142;384;978;454;1120
310770;202211;1311;3253;912;2627;124;417;438;1077;562;1494
310780;202211;5169;10675;4161;9292;307;726;2972;6510;3279;7236
310790;202211;2259;6512;1931;5844;408;1421;474;1169;882;2590
310800;202211;2805;7844;2031;6293;459;1579;139;357;598;1936
310810;202211;1839;3879;1532;3409;71;199;1176;2442;1247;2641
310820;202211;1412;3312;861;2405;164;463;233;618;397;1081
310825;202211;3254;8069;2582;7038;47;233;2140;5559;2187;5792
310830;202211;2619;6427;1995;5346;360;1087;991;2357;1351;3444
310840;202211;2755;6885;2078;5750;432;1356;691;1619;1123;2975
310850;202211;1617;4010;1318;3567;50;200;935;2389;985;2589
310855;202211;4039;9402;3182;8093;222;609;2326;5691;2548;6300
310860;202211;8302;21421;6718;18561;818;2058;3992;11155;4810;13213
310870;202211;1097;2455;863;2128;59;157;623;1476;682;1633
310880;202211;1083;2978;812;2401;95;294;467;1335;562;1629
310890;202211;2709;7236;1766;5359;347;1136;282;732;629;1868
310900;202211;5208;13375;3835;10617;712;2233;1661;4033;2373;6266
310910;202211;2670;6047;1847;4756;269;748;508;1151;777;1899
310920;202211;2310;5371;1741;4542;207;617;1104;2727;1311;3344
310925;202211;1342;3010;1057;2588;50;160;801;1831;851;1991
310930;202211;6668;15598;4631;12439;878;2446;2193;6034;3071;8480
310940;202211;8656;17468;7009;15219;270;750;5587;11544;5857;12294
310945;202211;1638;3784;1262;3176;153;429;754;1744;907;2173
310950;202211;2223;6159;1404;4327;233;813;388;947;621;1760
310960;202211;853;2163;502;1458;78;238;135;360;213;598
310970;202211;1398;3927;982;3065;246;785;187;549;433;1334
310980;202211;405;879;226;577;21;61;114;264;135;325
310990;202211;1857;4374;1505;3803;171;498;922;2117;1093;2615
311000;202211;5303;12982;4023;10904;673;2060;2226;5506;2899;7566
311010;202211;1226;2943;1000;2563;219;584;516;1295;735;1879
311020;202211;1425;3317;931;2464;71;223;516;1274;587;1497
311030;202211;2284;5244;1652;4210;388;1127;697;1614;1085;2741
311040;202211;352;1014;269;831;76;261;63;172;139;433
311050;202211;3819;8720;2900;7337;444;1303;1472;3377;1916;4680
311060;202211;4390;10151;3258;8193;396;1155;1530;3383;1926;4538
311070;202211;3089;6804;2229;5520;314;966;1172;2590;1486;3556
311080;202211;1403;2801;1110;2374;37;110;876;1744;913;1854
311090;202211;2816;7968;2291;7032;511;1681;723;2141;1234;3822
311100;202211;3009;7820;1955;5806;382;1270;559;1388;941;2658
311110;202211;4573;9029;2433;5890;551;1310;490;1143;1041;2453
311115;202211;1759;3313;1464;2943;43;97;1270;2474;1313;2571
311120;202211;8843;21238;6737;17542;1037;3015;2835;6264;3872;9279
311130;202211;2298;5548;1764;4809;171;581;1028;2622;1199;3203
311140;202211;1911;4370;1476;3779;154;439;945;2360;1099;2799
311150;202211;1757;5121;1385;4415;187;675;735;2189;922;2864
311160;202211;5035;13021;3705;10679;643;2135;1565;4086;2208;6221
311170;202211;1124;2649;919;2389;55;158;580;1579;635;1737
311180;202211;1881;3853;1265;2976;191;441;696;1552;887;1993
311190;202211;1042;2755;776;2225;118;371;325;786;443;1157
311200;202211;2729;6686;2039;5415;370;1111;885;1957;1255;3068
311205;202211;1128;2931;906;2530;36;121;599;1549;635;1670
311210;202211;1254;3336;1103;3127;145;365;752;2228;897;2593
311220;202211;1080;2433;939;2189;28;95;737;1568;765;1663
311230;202211;9584;26192;7146;21287;1375;4224;2633;7750;4008;11974
311240;202211;1387;3163;1097;2760;166;491;618;1415;784;1906
311250;202211;1629;4108;1252;3460;238;707;509;1258;747;1965
311260;202211;3232;7354;2110;5479;268;795;1033;2306;1301;3101
311265;202211;1683;3631;1209;2905;50;147;925;2111;975;2258
311270;202211;3684;9764;3151;8930;196;763;2172;5821;2368;6584
311280;202211;1454;3604;864;2478;199;628;214;525;413;1153
311290;202211;2159;6029;1929;5579;123;386;1275;3606;1398;3992
311300;202211;5464;13340;4499;11779;194;632;3660;9310;3854;9942
311310;202211;670;1696;560;1508;45;119;353;903;398;1022
311320;202211;3834;10606;3292;9437;307;1042;1753;4450;2060;5492
311330;202211;7721;16701;6024;14165;607;1545;3278;7611;3885;9156
311340;202211;13320;33620;10520;28795;2270;6636;3427;8706;5697;15342
311350;202211;2822;6359;2030;4982;250;678;1001;2121;1251;2799
311360;202211;1388;3077;995;2536;259;713;432;1077;691;1790
311370;202211;5724;12685;4174;10268;492;1408;2337;5283;2829;6691
311380;202211;481;1354;358;1111;55;178;182;544;237;722
311390;202211;2106;5883;1680;5302;660;2291;408;1095;1068;3386
311400;202211;1996;4957;1427;3915;241;702;458;1000;699;1702
311410;202211;2318;6243;1848;5455;280;929;913;2520;1193;3449
311420;202211;1991;5283;1487;4373;309;978;478;1155;787;2133
311430;202211;5563;13406;3726;9942;530;1500;1552;3836;2082;5336
311440;202211;3761;9506;2890;8075;887;2824;598;1408;1485;4232
311450;202211;2913;7882;1835;5601;454;1584;412;962;866;2546
311455;202211;1327;2772;941;2224;99;244;571;1290;670;1534
311460;202211;720;1998;465;1449;92;326;108;264;200;590
311470;202211;601;1709;407;1302;96;363;61;163;157;526
311480;202211;1396;2912;1150;2556;82;198;917;1987;999;2185
311490;202211;330;908;253;757;44;161;114;290;158;451
311500;202211;603;1374;476;1189;54;161;289;676;343;837
311510;202211;4307;9672;3088;7712;340;978;1650;3627;1990;4605
311520;202211;798;1960;689;1761;55;168;443;1099;498;1267
311530;202211;11438;24320;7985;19092;1691;4693;2916;6184;4607;10877
311535;202211;1090;2687;776;2064;127;378;368;905;495;1283
311540;202211;650;1731;560;1581;79;239;388;1072;467;1311
311545;202211;2360;6115;2032;5610;100;310;1568;4252;1668;4562
311547;202211;2182;4208;1911;3840;37;78;1668;3236;1705;3314
311550;202211;3655;8962;2978;7825;429;1300;1381;3220;1810;4520
311560;202211;370;733;223;504;33;81;88;171;121;252
311570;202211;1741;3780;1214;3059;51;141;886;2269;937;2410
311580;202211;2766;4863;1943;3886;175;332;1362;2622;1537;2954
311590;202211;761;1771;634;1596;69;208;416;993;485;1201
311600;202211;1847;4116;1485;3628;183;534;1030;2404;1213;2938
311610;202211;2768;7476;2192;6445;165;553;1391;3886;1556;4439
311615;202211;4427;10155;3559;8793;139;442;2873;6804;3012;7246
311620;202211;698;1734;527;1451;68;202;311;809;379;1011
311630;202211;1545;3940;1227;3296;111;327;741;1931;852;2258
311640;202211;945;2290;749;1982;104;303;420;1025;524;1328
311650;202211;2279;5098;1823;4421;227;577;1103;2523;1330;3100
311660;202211;3779;9909;2761;7930;394;1302;813;1780;1207;3082
311670;202211;1978;4498;1464;3630;154;447;767;1791;921;2238
311680;202211;2790;6662;2138;5590;169;404;1480;3913;1649;4317
311690;202211;749;1417;542;1158;37;87;371;793;408;880
311700;202211;2460;5338;1876;4503;27;105;1571;3612;1598;3717
311710;202211;1878;5020;1391;4202;363;1204;448;1274;811;2478
311720;202211;514;1399;417;1221;47;161;233;657;280;818
311730;202211;5575;12676;3966;9759;823;2293;1905;4157;2728;6450
311740;202211;1169;2817;953;2508;75;149;735;1977;810;2126
311750;202211;4850;12896;3900;11221;324;1148;2555;6789;2879;7937
311760;202211;892;2249;690;1865;109;382;291;579;400;961
311770;202211;2697;6936;2104;5918;441;1339;808;2055;1249;3394
311780;202211;1843;4721;1371;3872;268;808;494;1216;762;2024
311783;202211;2846;6508;2325;5694;52;207;1916;4458;1968;4665
311787;202211;971;2576;732;2071;124;387;293;685;417;1072
311790;202211;1857;4786;1259;3682;248;832;349;882;597;1714
311800;202211;6112;16756;4776;13956;1031;3100;837;1914;1868;5014
311810;202211;1243;3058;1017;2681;56;177;772;1911;828;2088
311820;202211;1196;2521;913;2114;74;187;631;1368;705;1555
311830;202211;10817;28148;7835;22076;2178;6454;1530;4027;3708;10481
311840;202211;4777;10626;3807;9276;287;745;2756;6678;3043;7423
311850;202211;418;969;325;813;13;51;229;528;242;579
311860;202211;93500;206978;74089;174942;7735;21049;47704;103688;55439;124737
311870;202211;2243;5495;1581;4385;253;835;698;1694;951;2529
311880;202211;7621;17734;6325;15934;449;1090;4635;11740;5084;12830
311890;202211;2338;4675;1866;4039;48;164;1516;3052;1564;3216
311900;202211;803;1859;604;1596;114;279;315;844;429;1123
311910;202211;5280;11918;4111;10381;698;1881;2237;5375;2935;7256
311920;202211;2725;6054;2192;5296;152;344;1527;3636;1679;3980
311930;202211;5978;11892;4566;10036;737;1940;2665;5148;3402;7088
311940;202211;19204;45969;13801;36134;1902;5429;6255;14870;8157;20299
311950;202211;2868;6733;2118;5442;183;535;1287;3248;1470;3783
311960;202211;587;1374;453;1165;53;160;217;489;270;649
311970;202211;500;1505;372;1196;71;257;96;252;167;509
311980;202211;551;1369;293;870;32;100;116;311;148;411
311990;202211;639;1426;412;1081;63;212;182;391;245;603
311995;202211;1137;3049;591;1811;40;142;94;180;134;322
312000;202211;979;2049;744;1717;32;82;566;1265;598;1347
312010;202211;1363;3088;1084;2683;71;187;762;1806;833;1993
312015;202211;1580;4010;1381;3696;61;240;1109;2852;1170;3092
312020;202211;2180;6053;1496;4517;268;890;353;899;621;1789
312030;202211;2672;5222;2261;4757;73;196;2042;4212;2115;4408
312040;202211;1012;2757;722;2186;116;351;319;894;435;1245
312050;202211;1443;4050;1171;3556;217;821;426;1127;643;1948
312060;202211;1204;2700;761;2091;181;525;300;774;481;1299
312070;202211;1088;2845;752;2136;36;135;477;1234;513;1369
312080;202211;3573;7896;2785;6749;145;411;1934;4278;2079;4689
312083;202211;1351;2807;1057;2379;59;183;850;1803;909;1986
312087;202211;3073;6772;2490;5919;89;230;2005;4687;2094;4917
312090;202211;14360;33352;11331;28615;1170;3528;6840;15809;8010;19337
312100;202211;2011;4965;1556;4208;106;353;958;2344;1064;2697
312110;202211;1198;3424;983;2978;167;621;468;1252;635;1873
312120;202211;1260;3210;868;2527;216;737;279;662;495;1399
312125;202211;2432;5338;2076;4852;97;274;1705;3823;1802;4097
312130;202211;1445;3061;1069;2464;73;221;644;1275;717;1496
312140;202211;904;2415;740;2093;181;546;313;796;494;1342
312150;202211;621;1488;528;1323;33;93;367;845;400;938
312160;202211;11864;27915;9165;23365;964;2948;5022;11462;5986;14410
312170;202211;1074;2475;818;2011;49;138;555;1301;604;1439
312180;202211;1694;4029;1371;3480;143;409;814;1916;957;2325
312190;202211;1007;2385;790;2020;67;224;475;1071;542;1295
312200;202211;5789;13998;4512;12001;527;1443;2744;7003;3271;8446
312210;202211;1783;3349;1364;2788;57;130;1119;2200;1176;2330
312220;202211;2023;5509;1723;4984;185;558;1113;3213;1298;3771
312230;202211;24489;56175;17761;44631;3443;9856;6455;13247;9898;23103
312235;202211;2676;5544;2182;4880;124;329;1712;3618;1836;3947
312240;202211;964;2808;741;2359;154;524;222;660;376;1184
312245;202211;4070;7502;3488;6706;41;97;3231;6066;3272;6163
312247;202211;1266;2643;875;2065;106;266;539;1194;645;1460
312250;202211;1108;2731;697;1958;95;287;253;658;348;945
312260;202211;1242;2881;1008;2522;72;217;779;1845;851;2062
312270;202211;885;2212;676;1801;33;122;409;952;442;1074
312280;202211;514;1415;413;1242;93;313;147;391;240;704
312290;202211;1157;3008;964;2700;156;507;377;937;533;1444
312300;202211;1409;3872;1019;2963;226;720;243;545;469;1265
312310;202211;1239;3348;948;2751;120;423;491;1311;611;1734
312320;202211;2531;5880;1826;4694;362;913;537;1285;899;2198
312330;202211;1122;2894;918;2517;126;399;535;1366;661;1765
312340;202211;297;695;208;555;32;110;115;260;147;370
312350;202211;303;581;218;486;13;33;151;300;164;333
312352;202211;1793;5141;1570;4731;284;909;740;2388;1024;3297
312360;202211;4218;10928;3175;8987;664;2014;1277;3240;1941;5254
312370;202211;2552;5782;2036;5002;239;681;1276;2921;1515;3602
312380;202211;2644;5302;2176;4708;21;51;1877;3919;1898;3970
312385;202211;1522;3723;1180;3142;388;1058;293;823;681;1881
312390;202211;2269;5881;1703;4826;257;802;498;1186;755;1988
312400;202211;3731;9743;3162;8839;1031;3126;742;2050;1773;5176
312410;202211;18651;43470;15354;38312;1822;4891;10008;23676;11830;28567
312420;202211;4897;11862;3944;10337;767;2287;1943;4751;2710;7038
312430;202211;11084;23981;9123;20766;288;859;7141;15307;7429;16166
312440;202211;1255;3615;1049;3211;514;1657;201;581;715;2238
312450;202211;1649;4394;1258;3692;331;1050;489;1407;820;2457
312460;202211;599;1308;435;1077;24;63;295;705;319;768
312470;202211;552;1293;334;916;52;154;98;225;150;379
312480;202211;1290;2956;929;2431;82;259;515;1243;597;1502
312490;202211;3195;6391;2534;5489;206;508;1589;3227;1795;3735
312500;202211;1338;2816;1129;2543;53;158;889;1940;942;2098
312510;202211;6100;14893;4092;11098;813;2192;1171;2900;1984;5092
312520;202211;446;1016;352;875;66;196;214;495;280;691
312530;202211;859;1764;721;1602;40;99;551;1212;591;1311
312540;202211;1876;4633;1270;3499;155;412;692;1804;847;2216
312550;202211;998;2311;717;1799;36;100;462;1047;498;1147
312560;202211;2163;5165;1648;4365;111;324;1155;2988;1266;3312
312570;202211;3301;6967;2482;5940;417;1004;1280;3028;1697;4032
312580;202211;777;1949;524;1435;49;164;265;640;314;804
312590;202211;1830;4794;1398;3944;157;526;808;2066;965;2592
312595;202211;2573;6587;2103;5874;297;771;1182;3545;1479;4316
312600;202211;1668;3792;1076;2578;160;473;362;818;522;1291
312610;202211;8523;20219;5817;15303;921;2743;2070;4605;2991;7348
312620;202211;3035;6789;2321;5806;61;245;1919;4696;1980;4941
312630;202211;399;1028;292;843;51;183;130;324;181;507
312640;202211;646;1657;481;1392;60;208;238;620;298;828
312650;202211;2508;5579;1737;4214;53;176;1314;2922;1367;3098
312660;202211;1598;3470;1232;2879;87;208;863;1885;950;2093
312670;202211;7471;15536;6266;13708;130;528;5174;10486;5304;11014
312675;202211;1452;3336;1181;2955;60;173;944;2288;1004;2461
312680;202211;1936;4221;1740;3941;40;149;1576;3449;1616;3598
312690;202211;3644;6807;2748;5701;112;231;2216;4494;2328;4725
312695;202211;1255;2883;1054;2569;51;91;875;2108;926;2199
312700;202211;2449;6103;1755;4873;196;626;943;2428;1139;3054
312705;202211;2032;3787;1775;3447;13;46;1684;3229;1697;3275
312707;202211;1633;4189;1143;3329;55;231;757;2014;812;2245
312710;202211;9134;19705;5950;14858;1533;3819;1821;4631;3354;8450
312720;202211;1332;3173;1048;2735;101;301;692;1683;793;1984
312730;202211;1908;4180;1370;3457;119;302;877;2145;996;2447
312733;202211;1540;3801;1150;3100;46;164;774;1916;820;2080
312735;202211;954;2244;726;1825;53;152;478;1092;531;1244
312737;202211;1003;1999;724;1613;72;174;499;1062;571;1236
312738;202211;988;2236;706;1759;64;196;458;1023;522;1219
312740;202211;522;1270;324;930;67;207;87;179;154;386
312750;202211;1742;4541;1262;3656;153;513;582;1539;735;2052
312760;202211;2208;5964;1591;4737;232;721;624;1732;856;2453
312770;202211;55916;124782;36330;91838;6123;17348;14878;34263;21001;51611
312780;202211;3189;8118;2667;7259;328;899;1635;4361;1963;5260
312790;202211;281;637;139;395;3;10;33;53;36;63
312800;202211;7020;16990;5589;14449;554;1775;3455;8144;4009;9919
312810;202211;1971;4958;1289;3814;363;1179;390;1011;753;2190
312820;202211;2118;5056;1696;4352;113;291;1203;3036;1316;3327
312825;202211;1881;3580;1579;3198;37;81;1367;2708;1404;2789
312830;202211;3346;8598;2212;6411;522;1622;703;1795;1225;3417
312840;202211;1785;4194;1389;3555;157;467;735;1716;892;2183
312850;202211;1375;2656;1032;2189;20;74;774;1452;794;1526
312860;202211;1280;3078;878;2444;225;666;272;658;497;1324
312870;202211;7185;18036;4576;13155;788;2417;1347;3418;2135;5835
312880;202211;1835;4081;1420;3423;233;512;705;1708;938;2220
312890;202211;2834;6225;2082;5036;135;321;1252;2858;1387;3179
312900;202211;1574;3654;1281;3264;162;448;765;1944;927;2392
312910;202211;1780;3143;1066;2228;151;308;584;1178;735;1486
312920;202211;1128;2822;797;2296;130;448;292;691;422;1139
312930;202211;2944;6485;2150;5314;358;943;1081;2649;1439;3592
312940;202211;1202;2952;940;2582;91;296;498;1258;589;1554
312950;202211;4141;9015;2986;7267;446;1282;1676;3667;2122;4949
312960;202211;2082;4978;1720;4435;108;259;1236;3282;1344;3541
312965;202211;2007;4853;1615;4238;160;395;1043;2743;1203;3138
312970;202211;1952;4922;1562;4326;152;540;927;2347;1079;2887
312980;202211;31730;79199;25522;68260;4783;13534;11550;28746;16333;42280
312990;202211;631;1447;428;1115;75;225;202;471;277;696
313000;202211;576;1491;437;1249;28;118;272;698;300;816
313005;202211;2935;7654;2428;6831;121;367;1757;4751;1878;5118
313010;202211;7194;17529;5779;15261;896;2685;3457;8608;4353;11293
313020;202211;1229;3473;933;2870;175;586;195;494;370;1080
313030;202211;1469;3032;1041;2440;71;205;756;1661;827;1866
313040;202211;1071;2955;893;2621;37;149;561;1544;598;1693
313050;202211;2207;5577;1542;4562;248;828;427;1085;675;1913
313055;202211;2285;5501;1946;4979;612;1756;994;2378;1606;4134
313060;202211;1284;2905;932;2299;204;601;227;494;431;1095
313065;202211;2054;5063;1805;4657;31;126;1540;3824;1571;3950
313070;202211;1052;2608;819;2222;91;272;414;1051;505;1323
313080;202211;479;1223;354;1004;59;205;142;323;201;528
313090;202211;6756;15403;5592;13607;263;742;4030;9486;4293;10228
313100;202211;1623;3809;1289;3337;59;206;933;2288;992;2494
313110;202211;1827;4442;1290;3497;127;392;666;1612;793;2004
313115;202211;3543;8958;2816;7616;279;913;1668;4025;1947;4938
313120;202211;4517;9989;3279;8332;217;571;2233;5628;2450;6199
313130;202211;39941;93034;30258;76139;3042;8775;17951;41403;20993;50178
313140;202211;962;1845;650;1457;37;101;492;1069;529;1170
313150;202211;1696;4467;1219;3601;344;1158;203;473;547;1631
313160;202211;1716;3845;1306;3240;26;76;1009;2381;1035;2457
313170;202211;14116;36592;10484;29727;1707;5280;4144;10331;5851;15611
313180;202211;3090;7212;2332;5718;165;440;1608;3733;1773;4173
313190;202211;5638;14561;4169;11703;716;2231;1724;4250;2440;6481
313200;202211;1393;3233;1178;2864;31;94;968;2257;999;2351
313210;202211;5099;12020;4213;10657;449;1272;2787;6637;3236;7909
313220;202211;2372;5700;1572;4161;203;604;752;1686;955;2290
313230;202211;3419;8328;2758;7487;62;210;2264;6121;2326;6331
313240;202211;14093;31279;10042;25020;998;3106;5886;13166;6884;16272
313250;202211;7531;20114;5745;16409;1076;3251;2661;7070;3737;10321
313260;202211;973;2198;690;1760;67;241;407;884;474;1125
313270;202211;8718;16691;7365;14950;450;904;6151;12345;6601;13249
313280;202211;549;1375;366;1027;47;156;173;450;220;606
313290;202211;1236;3673;961;3169;247;922;331;1012;578;1934
313300;202211;2259;5622;1716;4684;369;1070;597;1448;966;2518
313310;202211;1808;4891;1441;4127;241;774;487;1102;728;1876
313320;202211;2437;5948;1761;4881;388;1160;624;1719;1012;2879
313330;202211;5179;11875;3865;9941;282;817;2535;6347;2817;7164
313340;202211;2077;4201;1621;3588;107;277;1209;2552;1316;2829
313350;202211;3618;9167;2454;6709;280;896;1140;2607;1420;3503
313360;202211;2079;4635;1427;3600;233;697;753;1671;986;2368
313370;202211;2000;4993;1527;4096;313;898;587;1373;900;2271
313375;202211;2293;5584;1469;4091;270;870;422;982;692;1852
313380;202211;8570;19696;6228;15508;920;2691;3153;6757;4073;9448
313390;202211;955;2681;816;2436;49;205;560;1578;609;1783
313400;202211;4569;9970;3448;8344;146;421;2622;6099;2768;6520
313410;202211;1716;4008;1281;3284;353;890;641;1590;994;2480
313420;202211;19141;40292;10879;26952;2576;7145;2771;5993;5347;13138
313430;202211;1539;3453;1295;3023;68;259;1006;2125;1074;2384
313440;202211;8992;16709;6611;13812;196;510;5300;10587;5496;11097
313450;202211;883;2184;622;1702;106;317;219;485;325;802
313460;202211;2886;7393;2300;6444;408;1286;1077;2874;1485;4160
313470;202211;3401;7699;2724;6729;148;422;2104;5068;2252;5490
313480;202211;1368;3613;855;2530;82;289;364;940;446;1229
313490;202211;3800;9069;2101;5981;390;1212;591;1517;981;2729
313500;202211;679;1608;456;1197;64;159;208;503;272;662
313505;202211;12931;29364;11003;26737;482;1242;8841;21100;9323;22342
313507;202211;1666;3822;1312;3286;51;160;1008;2419;1059;2579
313510;202211;18952;44874;14859;37317;1346;3685;8703;19864;10049;23549
313520;202211;19371;44992;15694;39095;690;2114;12252;29155;12942;31269
313530;202211;703;1941;511;1533;70;254;217;549;287;803
313535;202211;2764;7058;2183;5945;244;639;1319;3509;1563;4148
313540;202211;1062;2766;820;2228;109;340;384;898;493;1238
313545;202211;1352;4029;1129;3614;169;560;519;1600;688;2160
313550;202211;2529;6582;2088;5614;245;698;1370;3589;1615;4287
313560;202211;3764;6003;2861;4952;42;68;2564;4361;2606;4429
313570;202211;1213;3155;967;2727;192;580;454;1171;646;1751
313580;202211;7616;16080;6039;13608;347;964;4420;9344;4767;10308
313590;202211;1397;3356;1119;2967;234;647;586;1589;820;2236
313600;202211;5528;11578;4705;10381;91;302;4240;9051;4331;9353
313610;202211;1214;2790;991;2413;81;228;649;1449;730;1677
313620;202211;6974;16921;5673;14660;533;1661;3713;9042;4246;10703
313630;202211;11054;24549;7992;20023;814;2445;4894;11522;5708;13967
313640;202211;1631;3024;1122;2382;91;218;827;1702;918;1920
313650;202211;1977;5473;1536;4727;132;452;925;2848;1057;3300
313652;202211;1096;2747;962;2509;64;202;712;1739;776;1941
313655;202211;1459;3139;1137;2740;81;202;843;1996;924;2198
313657;202211;1350;3213;1039;2718;36;141;748;1796;784;1937
313660;202211;1434;3316;1187;2922;70;252;899;2039;969;2291
313665;202211;7120;16567;5641;14021;466;1417;3778;8604;4244;10021
313670;202211;69626;156523;48112;121171;6214;17276;24639;57057;30853;74333
313680;202211;1298;3000;1043;2603;45;117;699;1637;744;1754
313690;202211;1191;3314;864;2670;160;553;215;596;375;1149
313695;202211;2160;5198;1592;4269;115;291;1055;2871;1170;3162
313700;202211;3443;9568;2966;8963;240;747;2359;7166;2599;7913
313710;202211;1775;3689;1262;3022;104;301;833;1913;937;2214
313720;202211;7792;19525;5694;15338;746;2249;2748;6509;3494;8758
313730;202211;1720;3300;1283;2742;78;149;859;1798;937;1947
313740;202211;1994;6667;1674;5897;367;1465;436;1319;803;2784
313750;202211;2886;6655;2329;5765;335;980;1412;3148;1747;4128
313753;202211;2548;5836;1697;4481;318;926;656;1636;974;2562
313760;202211;7402;18681;5877;15892;894;2754;2972;7175;3866;9929
313770;202211;4894;12615;3882;11053;195;539;2938;8476;3133;9015
313780;202211;4913;11692;3627;9717;522;1381;1271;3321;1793;4702
313790;202211;717;1869;610;1663;72;229;379;964;451;1193
313800;202211;1655;3417;1200;2787;112;306;710;1502;822;1808
313810;202211;2235;4699;1794;4079;69;224;1447;3117;1516;3341
313820;202211;21265;50607;14029;35909;2305;6158;4387;10078;6692;16236
313830;202211;481;1314;355;1055;72;249;142;379;214;628
313835;202211;1152;2878;860;2414;85;291;451;1133;536;1424
313840;202211;9917;23515;7829;20271;1798;4904;2256;5578;4054;10482
313850;202211;1221;2644;972;2302;159;412;528;1126;687;1538
313860;202211;3478;8232;2627;6767;352;976;1327;3081;1679;4057
313862;202211;1444;2978;756;1966;48;146;381;947;429;1093
313865;202211;3180;7309;2620;6458;78;239;2029;4750;2107;4989
313867;202211;1658;4684;1314;4011;261;829;639;2002;900;2831
313868;202211;2034;5516;1607;4733;59;229;1211;3382;1270;3611
313870;202211;1304;3056;867;2281;115;324;387;903;502;1227
313880;202211;2702;6296;2055;5214;265;822;1124;2449;1389;3271
313890;202211;2980;5277;2196;4287;66;139;1748;3275;1814;3414
313900;202211;6541;16719;4596;12916;1167;3489;1381;3297;2548;6786
313910;202211;929;2513;703;2074;138;415;175;498;313;913
313920;202211;3445;9201;2826;8006;506;1496;1463;4101;1969;5597
313925;202211;2031;4571;1557;3758;201;439;958;2253;1159;2692
313930;202211;6189;15187;4937;13121;420;1098;3274;8620;3694;9718
313940;202211;12381;32975;9499;28221;1991;6413;2292;7248;4283;13661
313950;202211;6945;13371;5385;11444;263;633;3984;8196;4247;8829
313960;202211;7137;15631;4820;11857;718;2073;2129;4529;2847;6602
313970;202211;1960;4570;1646;4064;54;143;1146;2656;1200;2799
313980;202211;1819;4338;1284;3532;229;693;556;1413;785;2106
313990;202211;2617;6939;2042;5803;308;1089;1199;2936;1507;4025
314000;202211;13125;29531;10435;25052;707;2096;6786;15652;7493;17748
314010;202211;1648;3557;1282;3060;66;205;951;2137;1017;2342
314015;202211;2960;7199;2352;6159;255;811;1434;3365;1689;4176
314020;202211;624;1556;409;1195;146;514;33;87;179;601
314030;202211;1000;2578;744;2096;109;314;318;859;427;1173
314040;202211;773;1964;644;1737;86;282;363;918;449;1200
314050;202211;2460;5765;1832;4679;108;347;1185;2733;1293;3080
314053;202211;2523;6473;2016;5539;309;797;1190;3357;1499;4154
314055;202211;2819;6231;2363;5596;77;214;1952;4609;2029;4823
314060;202211;1550;3708;1147;3068;40;123;818;2118;858;2241
314070;202211;6230;14901;5034;12853;706;1905;2824;6760;3530;8665
314080;202211;2388;5804;1736;4711;151;483;849;2036;1000;2519
314085;202211;2896;6890;2292;6018;237;664;1474;3812;1711;4476
314090;202211;6174;14417;5266;13141;477;1219;3402;8618;3879;9837
314100;202211;3641;8052;2790;6881;81;201;2063;5035;2144;5236
314110;202211;6171;15700;5013;13576;608;1825;2707;6617;3315;8442
314120;202211;833;1841;399;1076;75;235;149;354;224;589
314130;202211;850;2010;602;1557;24;89;420;1003;444;1092
314140;202211;5629;13669;4426;11545;466;1329;2528;6232;2994;7561
314150;202211;1723;4005;1230;3167;117;335;764;1897;881;2232
314160;202211;2901;6619;2047;5198;207;539;902;2191;1109;2730
314170;202211;1144;2813;899;2350;44;163;621;1455;665;1618
314180;202211;6735;16455;5228;14074;597;1618;2746;7291;3343;8909
314190;202211;767;1735;577;1463;68;223;345;773;413;996
314200;202211;3621;9106;2976;8067;283;742;1908;5076;2191;5818
314210;202211;2374;5699;1810;4700;294;792;645;1545;939;2337
314220;202211;2040;5061;1626;4416;251;803;760;1849;1011;2652
314225;202211;1262;3340;982;2811;103;328;617;1679;720;2007
314230;202211;1068;2528;844;2204;92;272;524;1315;616;1587
314240;202211;1310;3281;1026;2866;225;650;421;1166;646;1816
314250;202211;501;1362;316;963;41;141;126;333;167;474
314260;202211;1350;3171;1064;2793;340;911;370;889;710;1800
314270;202211;4032;9895;3309;8752;91;283;2541;6533;2632;6816
314280;202211;4385;9420;3048;7493;317;887;1818;4126;2135;5013
314290;202211;5612;12692;4719;11203;252;669;3528;7985;3780;8654
314300;202211;2413;6314;1541;4476;335;1055;482;1190;817;2245
314310;202211;4670;11523;3224;9099;893;2842;474;1119;1367;3961
314315;202211;1195;3315;952;2823;61;231;653;1823;714;2054
314320;202211;4073;9920;2776;7535;421;1356;1195;2860;1616;4216
314330;202211;68394;176929;52213;148594;12262;35833;14690;40289;26952;76122
314340;202211;3249;7580;2195;5741;416;1326;836;1753;1252;3079
314345;202211;1982;4776;1601;4129;124;320;1148;2830;1272;3150
314350;202211;1120;2870;746;2177;134;416;152;310;286;726
314360;202211;643;1731;433;1290;63;187;132;345;195;532
314370;202211;916;2114;739;1854;73;203;499;1186;572;1389
314380;202211;1505;3754;1056;2987;240;761;338;870;578;1631
314390;202211;19263;43420;13591;33961;1880;5416;6111;13058;7991;18474
314400;202211;4792;13289;3677;11153;1163;3739;1133;3544;2296;7283
314410;202211;3622;9518;2475;7268;529;1762;558;1505;1087;3267
314420;202211;925;2096;671;1706;25;90;444;1060;469;1150
314430;202211;9837;21275;7018;16847;989;2493;3473;7820;4462;10313
314435;202211;2253;5499;1752;4721;295;818;931;2364;1226;3182
314437;202211;1087;2459;801;2010;71;196;511;1216;582;1412
314440;202211;720;1948;519;1555;130;448;142;332;272;780
314450;202211;1805;4284;1462;3725;182;529;820;1876;1002;2405
314460;202211;4255;11565;3241;9548;753;2450;1226;3149;1979;5599
314465;202211;2808;7014;2248;5994;49;183;1746;4407;1795;4590
314467;202211;1180;2736;959;2381;103;299;639;1519;742;1818
314470;202211;2787;7199;2294;6284;402;1190;1099;2766;1501;3956
314480;202211;10835;27042;8185;21732;1185;3515;3803;8821;4988;12336
314490;202211;1278;2992;917;2329;75;217;588;1415;663;1632
314500;202211;2308;5084;1632;4183;434;1098;459;1187;893;2285
314505;202211;2838;5606;2322;4917;143;258;1814;3737;1957;3995
314510;202211;2588;6321;1895;5313;537;1735;665;1708;1202;3443
314520;202211;9089;24829;7193;21198;1517;4757;1741;4612;3258;9369
314530;202211;6778;18155;5985;16771;350;1218;4463;11972;4813;13190
314535;202211;3500;7496;2803;6497;156;402;2243;5107;2399;5509
314537;202211;1473;3697;1113;3119;77;204;744;2014;821;2218
314540;202211;513;1172;369;943;18;56;217;498;235;554
314545;202211;2330;4835;2055;4513;68;187;1653;3627;1721;3814
314550;202211;907;2003;595;1493;48;150;318;696;366;846
314560;202211;5961;15727;4480;12685;603;2034;2074;4996;2677;7030
314570;202211;380;986;274;800;28;88;139;395;167;483
314580;202211;585;1580;461;1338;103;307;162;447;265;754
314585;202211;891;2420;664;1953;60;217;322;859;382;1076
314587;202211;2737;6628;2136;5698;568;1510;1085;2835;1653;4345
314590;202211;5460;13276;4184;11057;508;1537;2125;5093;2633;6630
314600;202211;2191;5662;1402;4193;327;1081;176;457;503;1538
314610;202211;11810;27088;9111;22920;1039;3143;4556;11289;5595;14432
314620;202211;3075;6052;2471;5305;162;272;1940;4243;2102;4515
314625;202211;1952;4375;1651;3964;43;181;1418;3267;1461;3448
314630;202211;6110;13884;4867;12175;195;567;3851;9462;4046;10029
314640;202211;1029;2015;795;1664;34;100;614;1178;648;1278
314650;202211;1032;2249;686;1707;63;195;416;911;479;1106
314655;202211;1782;4468;1242;3553;155;440;671;1892;826;2332
314660;202211;432;846;324;680;12;30;247;481;259;511
314670;202211;1952;3981;1351;3156;31;85;957;2112;988;2197
314675;202211;2049;4686;1725;4179;103;245;1333;3170;1436;3415
314690;202211;2498;6271;1909;5384;497;1445;737;1995;1234;3440
314700;202211;14419;35874;9936;27852;1555;4793;4487;11557;6042;16350
314710;202211;10338;26717;7625;21182;1157;3538;3028;7245;4185;10783
314720;202211;2856;7879;1982;6074;381;1283;396;1002;777;2285
314730;202211;3040;7380;2119;5727;393;1187;729;1676;1122;2863
314740;202211;3968;10036;3116;8563;529;1583;1610;4100;2139;5683
314750;202211;364;873;284;715;29;98;170;361;199;459
314760;202211;2219;6048;1424;4300;214;791;432;959;646;1750
314770;202211;1215;3337;712;2153;122;363;178;492;300;855
314780;202211;429;995;298;783;29;98;176;421;205;519
314790;202211;14663;35931;10535;28587;1789;5409;4517;11385;6306;16794
314795;202211;1817;4213;1525;3737;67;205;1190;2770;1257;2975
314800;202211;14410;34348;9740;26047;1637;4833;3619;8358;5256;13191
314810;202211;13073;31282;9869;26004;2430;6803;3817;9307;6247;16110
314820;202211;1555;3436;1207;2920;83;253;781;1781;864;2034
314830;202211;2131;5362;1750;4722;166;458;1083;2748;1249;3206
314840;202211;1086;2955;848;2529;82;310;572;1584;654;1894
314850;202211;3322;5680;2748;4994;38;78;2550;4559;2588;4637
314860;202211;4095;10188;3402;9014;145;518;2530;6407;2675;6925
314870;202211;8555;16754;6594;14406;289;623;5047;11119;5336;11742
314875;202211;2194;5969;1915;5569;199;507;1404;4130;1603;4637
314880;202211;944;2153;721;1808;44;127;452;1079;496;1206
314890;202211;620;1729;454;1364;61;214;228;596;289;810
314900;202211;1098;2420;842;2019;97;266;471;1051;568;1317
314910;202211;2024;5331;1508;4488;277;994;679;1811;956;2805
314915;202211;2524;6664;2036;5832;195;559;1266;3599;1461;4158
314920;202211;699;1574;503;1303;22;65;366;936;388;1001
314930;202211;7748;19713;6017;16501;969;3022;2762;6673;3731;9695
314940;202211;513;1088;423;950;33;82;294;621;327;703
314950;202211;810;1850;552;1444;54;191;304;709;358;900
314960;202211;1164;2481;913;2083;71;163;630;1397;701;1560
314970;202211;1350;3707;1046;3115;184;615;452;1200;636;1815
314980;202211;2518;5794;2025;5088;204;560;1384;3382;1588;3942
314990;202211;3305;8885;2372;6845;393;1182;668;1651;1061;2833
314995;202211;2036;5079;1576;4273;55;194;1026;2575;1081;2769
315000;202211;1320;3069;942;2481;86;256;605;1526;691;1782
315010;202211;493;1209;399;1069;37;129;255;629;292;758
315015;202211;3074;7508;2683;6890;255;805;1902;4626;2157;5431
315020;202211;956;2554;676;2008;60;216;330;883;390;1099
315030;202211;821;1951;567;1512;194;481;130;315;324;796
315040;202211;1204;2836;1007;2530;160;457;649;1502;809;1959
315050;202211;1398;3299;1027;2739;81;253;519;1300;600;1553
315053;202211;1504;3424;1104;2750;118;308;644;1507;762;1815
315057;202211;2191;5624;1722;4848;148;352;1102;3293;1250;3645
315060;202211;857;2339;618;1845;119;389;169;457;288;846
315070;202211;1071;2104;830;1761;77;214;606;1140;683;1354
315080;202211;4006;9542;3014;7777;147;454;2178;5286;2325;5740
315090;202211;996;2682;752;2252;100;332;350;950;450;1282
315100;202211;1747;4721;1165;3465;150;512;495;1277;645;1789
315110;202211;2740;5830;1999;4747;160;364;1159;2674;1319;3038
315120;202211;15754;33124;11530;26913;1178;2769;6927;15749;8105;18518
315130;202211;2171;5350;1850;4815;198;603;986;2288;1184;2891
315140;202211;3993;9953;3198;8586;580;1723;1722;4268;2302;5991
315150;202211;5473;12892;3955;10429;641;1889;1838;4592;2479;6481
315160;202211;2422;5314;1689;4180;253;661;943;2214;1196;2875
315170;202211;1710;5050;1194;3827;226;771;345;1026;571;1797
315180;202211;21783;50065;12870;34167;1752;5312;4906;11090;6658;16402
315190;202211;2751;5561;2091;4699;200;443;1553;3491;1753;3934
315200;202211;5713;14096;4311;11828;1204;3600;1512;3670;2716;7270
315210;202211;10756;25820;7598;19626;791;2287;3797;8508;4588;10795
315213;202211;1252;3059;1088;2828;21;82;896;2253;917;2335
315217;202211;3261;8382;2419;6981;95;408;1708;4658;1803;5066
315220;202211;10335;25639;8012;21779;648;1571;4515;12326;5163;13897
315230;202211;3700;7304;3037;6445;184;328;2182;4615;2366;4943
315240;202211;3041;7846;2489;6915;580;1706;1142;3074;1722;4780
315250;202211;18588;45615;13919;37076;2112;6294;6491;15469;8603;21763
315260;202211;1174;2937;701;1997;140;408;122;266;262;674
315270;202211;1182;3066;893;2538;124;425;413;971;537;1396
315280;202211;3896;9107;2593;6818;694;1906;671;1652;1365;3558
315290;202211;1475;3360;939;2533;201;603;377;920;578;1523
315300;202211;812;1819;596;1502;34;96;428;1050;462;1146
315310;202211;1589;3583;1199;2940;79;250;830;1823;909;2073
315320;202211;770;2072;541;1619;78;256;206;567;284;823
315330;202211;889;2631;533;1754;67;248;222;624;289;872
315340;202211;3450;7882;2374;6249;547;1468;943;2377;1490;3845
315350;202211;2333;5245;1962;4700;148;419;1484;3376;1632;3795
315360;202211;2073;5485;1632;4643;218;663;792;2081;1010;2744
315370;202211;683;1730;557;1505;71;200;254;612;325;812
315380;202211;299;775;201;568;39;108;29;55;68;163
315390;202211;1548;3957;1259;3461;121;415;737;1791;858;2206
315400;202211;5123;12271;4069;10490;490;1385;2410;5823;2900;7208
315410;202211;2886;6014;2071;4826;379;1040;601;1253;980;2293
315415;202211;1798;4532;1454;3988;418;1358;308;715;726;2073
315420;202211;1821;4714;1293;3765;300;953;352;866;652;1819
315430;202211;4331;9815;3021;7899;487;1413;1454;3610;1941;5023
315440;202211;1259;2939;977;2508;98;286;608;1434;706;1720
315445;202211;2796;5442;2066;4452;121;254;1624;3454;1745;3708
315450;202211;2659;6542;2141;5704;205;581;1422;3611;1627;4192
315460;202211;57754;138208;48677;122942;4760;14533;32177;74472;36937;89005
315470;202211;809;2086;571;1543;53;157;286;692;339;849
315480;202211;1794;4546;1302;3535;178;520;612;1487;790;2007
315490;202211;3476;8003;2428;6345;350;1020;986;2328;1336;3348
315500;202211;622;1552;382;1070;25;78;215;533;240;611
315510;202211;1684;3688;1382;3265;17;70;1190;2678;1207;2748
315520;202211;1351;3059;1134;2742;40;108;949;2211;989;2319
315530;202211;978;2179;825;1923;60;191;643;1373;703;1564
315540;202211;2035;4896;1345;3635;118;388;604;1457;722;1845
315550;202211;2208;5592;1515;4321;261;881;496;1369;757;2250
315560;202211;8004;20906;6876;18980;423;1100;5008;13656;5431;14756
315570;202211;3039;7036;2161;5501;299;922;1150;2492;1449;3414
315580;202211;3999;8409;3142;7130;418;1056;1435;2966;1853;4022
315590;202211;1580;2973;1321;2605;42;159;1097;1936;1139;2095
315600;202211;2950;8171;2064;6483;470;1415;853;2855;1323;4270
315610;202211;1165;2703;883;2229;116;383;461;966;577;1349
315620;202211;638;1557;475;1307;36;109;247;674;283;783
315630;202211;1452;3552;1101;2897;165;462;543;1289;708;1751
315640;202211;496;1096;389;963;33;88;255;591;288;679
315645;202211;1179;2855;819;2292;133;396;220;572;353;968
315650;202211;2193;4436;1777;3864;58;152;1452;3047;1510;3199
315660;202211;2466;5896;1852;4804;193;504;1093;2745;1286;3249
315670;202211;20328;48586;15887;40769;2674;7358;8183;19350;10857;26708
315680;202211;3814;9664;2855;7967;384;1176;1484;3904;1868;5080
315690;202211;4657;10731;2822;7613;561;1473;814;2280;1375;3753
315700;202211;10660;25933;8134;21133;759;2240;4706;11138;5465;13378
315710;202211;2180;4824;1552;3915;71;208;1060;2533;1131;2741
315720;202211;5424;13296;4443;11622;215;798;3183;7774;3398;8572
315725;202211;2784;6361;2185;5458;206;494;1458;3757;1664;4251
315727;202211;749;1733;545;1397;66;211;284;652;350;863
315730;202211;735;2014;617;1786;125;385;230;591;355;976
315733;202211;1821;4151;1397;3490;218;595;659;1485;877;2080
315737;202211;1395;3469;1020;2763;28;106;723;1842;751;1948
315740;202211;1029;2628;841;2260;77;255;560;1372;637;1627
315750;202211;1596;3649;1209;3084;89;226;790;2024;879;2250
315760;202211;1509;3009;1244;2664;28;96;1058;2158;1086;2254
315765;202211;2502;5356;2049;4790;26;91;1843;4293;1869;4384
315770;202211;1488;3796;1195;3394;419;1276;294;803;713;2079
315780;202211;38655;95183;32224;83919;2081;6634;21739;52655;23820;59289
315790;202211;4213;11888;3550;10669;335;999;2081;6564;2416;7563
315800;202211;1616;4774;1231;3907;161;620;537;1433;698;2053
315810;202211;1686;3627;1400;3186;58;159;1127;2453;1185;2612
315820;202211;3607;7844;2931;6963;265;603;2096;4928;2361;5531
315830;202211;1506;4129;1012;3045;114;378;291;690;405;1068
315840;202211;1049;2336;756;1853;51;142;415;901;466;1043
315850;202211;1438;3764;1126;3246;153;477;616;1671;769;2148
315860;202211;694;1761;519;1465;100;311;183;417;283;728
315870;202211;544;1381;432;1202;24;79;306;809;330;888
315880;202211;1378;3112;1006;2501;120;364;474;975;594;1339
315890;202211;2180;5552;1779;5009;510;1567;719;2002;1229;3569
315895;202211;7793;19373;5744;15541;631;1944;2790;6752;3421;8696
315900;202211;1035;2502;856;2251;124;373;495;1229;619;1602
315910;202211;767;1733;662;1587;48;141;521;1215;569;1356
315920;202211;1726;4058;1004;2734;160;552;368;829;528;1381
315930;202211;1412;2853;978;2260;82;213;562;1225;644;1438
315935;202211;1355;3610;1079;3113;205;614;482;1343;687;1957
315940;202211;744;1808;583;1573;83;251;309;772;392;1023
315950;202211;1525;3705;1282;3336;124;356;956;2468;1080;2824
315960;202211;6799;17495;4645;13231;1090;3402;1078;2215;2168;5617
315970;202211;683;1710;551;1532;69;214;362;997;431;1211
315980;202211;5292;10605;3131;7197;535;1326;1580;3216;2115;4542
315990;202211;4202;9959;3284;8409;426;1156;1734;4138;2160;5294
316000;202211;948;1998;750;1720;62;177;490;1036;552;1213
316010;202211;872;2280;643;1866;80;251;275;654;355;905
316020;202211;1119;2856;891;2441;91;308;555;1408;646;1716
316030;202211;3335;8165;2525;6773;369;1013;1498;4038;1867;5051
316040;202211;3243;8759;2259;6906;399;1393;590;1494;989;2887
316045;202211;2790;5642;2560;5355;156;219;2228;4759;2384;4978
316050;202211;503;1229;379;1031;30;89;236;564;266;653
316060;202211;887;1883;649;1569;31;92;470;1075;501;1167
316070;202211;7280;17862;5901;15326;915;2408;3000;7304;3915;9712
316080;202211;966;2707;766;2311;170;571;243;611;413;1182
316090;202211;628;1539;520;1343;46;146;338;771;384;917
316095;202211;1511;4295;1146;3413;257;841;429;1159;686;2000
316100;202211;2947;7686;2151;6065;326;1072;942;2337;1268;3409
316105;202211;851;2037;671;1746;50;130;433;1138;483;1268
316110;202211;18129;42465;15043;37584;900;2788;11221;26489;12121;29277
316120;202211;1490;3735;958;2637;152;482;346;749;498;1231
316130;202211;1569;3243;1038;2400;84;231;629;1332;713;1563
316140;202211;1305;3265;791;2295;136;400;281;768;417;1168
316150;202211;2695;5562;2137;4749;146;421;1282;2607;1428;3028
316160;202211;1208;2902;964;2486;42;148;699;1733;741;1881
316165;202211;1071;2317;844;1996;83;211;561;1255;644;1466
316170;202211;1716;3480;1341;2956;74;229;1009;2020;1083;2249
316180;202211;1950;5042;1365;3929;269;822;398;988;667;1810
316190;202211;3235;8574;1852;5379;226;721;805;1963;1031;2684
316200;202211;4552;11301;3633;9805;598;1834;1770;4351;2368;6185
316210;202211;6681;18064;4757;13724;1488;4685;499;1213;1987;5898
316220;202211;863;2400;595;1883;119;400;128;376;247;776
316225;202211;1983;4013;1506;3299;50;188;1189;2345;1239;2533
316230;202211;613;1465;477;1248;104;305;242;591;346;896
316240;202211;6926;17667;5994;16042;444;1297;4401;11389;4845;12686
316245;202211;3862;10684;3445;10021;192;842;2579;7018;2771;7860
316250;202211;13791;30489;10437;25111;1926;4993;4347;9985;6273;14978
316255;202211;3558;9177;3053;8363;167;467;2233;6122;2400;6589
316257;202211;1885;3888;1413;3161;136;282;979;2108;1115;2390
316260;202211;3307;6471;2584;5407;268;519;1709;3499;1977;4018
316265;202211;1312;3258;1031;2778;31;91;750;1932;781;2023
316270;202211;4574;12570;3866;11108;478;1491;2151;5729;2629;7220
316280;202211;3643;8906;3024;7828;378;1027;1719;4254;2097;5281
316290;202211;4915;11940;3778;9852;462;1289;1615;3819;2077;5108
316292;202211;7529;18034;6071;15731;663;1937;4020;9820;4683;11757
316294;202211;1135;3118;870;2677;178;632;269;715;447;1347
316295;202211;4416;11117;3621;9806;300;951;2340;5904;2640;6855
316300;202211;1351;3210;1069;2790;57;166;793;1979;850;2145
316310;202211;975;2455;679;1934;142;468;215;555;357;1023
316320;202211;812;2109;608;1787;117;367;130;331;247;698
316330;202211;1255;2944;962;2458;58;162;733;1818;791;1980
316340;202211;1267;3018;985;2545;78;282;655;1539;733;1821
316350;202211;1716;4097;1453;3663;146;415;1050;2516;1196;2931
316360;202211;790;1890;667;1701;64;153;509;1331;573;1484
316370;202211;7302;16781;5598;13965;620;1945;3113;6628;3733;8573
316380;202211;2141;4499;1710;3905;96;192;1253;2808;1349;3000
316390;202211;906;2294;675;1911;247;802;145;345;392;1147
316400;202211;1454;3823;923;2777;106;355;335;861;441;1216
316410;202211;1523;3453;1275;3076;39;127;1078;2496;1117;2623
316420;202211;2330;5636;1955;5105;32;131;1582;3953;1614;4084
316430;202211;1083;2632;745;2058;111;351;306;738;417;1089
316440;202211;1031;2949;823;2587;152;551;233;658;385;1209
316443;202211;688;1750;487;1378;101;335;161;410;262;745
316447;202211;2725;5974;2331;5398;31;92;2079;4688;2110;4780
316450;202211;2554;6764;1913;5512;231;706;1134;3152;1365;3858
316460;202211;1651;3967;1340;3458;126;358;863;2071;989;2429
316470;202211;9109;23637;6826;19200;923;2995;3160;7801;4083;10796
316480;202211;264;620;224;569;36;103;131;306;167;409
316490;202211;407;1069;285;834;53;185;96;228;149;413
316500;202211;1585;4490;1083;3321;196;624;302;805;498;1429
316510;202211;960;2841;773;2477;134;426;376;1190;510;1616
316520;202211;1670;3739;1248;3002;195;537;542;1114;737;1651
316530;202211;1379;3176;1039;2599;104;369;594;1273;698;1642
316540;202211;1308;2958;1041;2587;167;470;493;1104;660;1574
316550;202211;1784;4379;1501;3899;58;193;1242;3136;1300;3329
316553;202211;5933;15634;4368;12166;550;1726;2057;4896;2607;6622
316555;202211;3327;8588;2877;8009;86;326;2430;6645;2516;6971
316556;202211;671;1449;496;1154;39;103;297;581;336;684
316557;202211;1491;4047;1286;3734;434;1404;507;1354;941;2758
316560;202211;500;1391;359;1113;59;215;130;357;189;572
316570;202211;1723;4434;1433;3932;354;888;465;1387;819;2275
316580;202211;498;962;347;735;28;65;219;429;247;494
316590;202211;1581;3643;1085;2738;150;356;618;1459;768;1815
316600;202211;1196;3115;1027;2800;138;423;639;1624;777;2047
316610;202211;759;2025;609;1780;59;199;373;1030;432;1229
316620;202211;2754;6175;2406;5666;169;366;1906;4438;2075;4804
316630;202211;1869;5098;1563;4533;436;1214;604;1999;1040;3213
316640;202211;206;512;160;434;29;89;67;153;96;242
316650;202211;1362;3462;1105;3078;81;226;747;2007;828;2233
316660;202211;218;503;104;273;11;31;37;78;48;109
316670;202211;1976;4609;1481;3869;393;1061;476;1126;869;2187
316680;202211;2846;6700;2122;5378;168;482;1446;3511;1614;3993
316690;202211;1633;4328;1172;3473;210;684;231;513;441;1197
316695;202211;1141;3084;920;2687;23;85;612;1719;635;1804
316700;202211;614;1059;526;963;10;23;475;836;485;859
316710;202211;4310;11842;3460;10204;409;1452;2006;5336;2415;6788
316720;202211;27445;67748;21284;56555;3133;9135;10949;26533;14082;35668
316730;202211;654;1417;523;1208;55;146;305;619;360;765
316740;202211;1059;2633;927;2441;149;420;627;1629;776;2049
316750;202211;488;1251;361;1039;64;204;158;407;222;611
316760;202211;4849;13524;4118;12202;1348;4488;1587;4530;2935;9018
316770;202211;1912;3868;1421;3226;48;125;1120;2549;1168;2674
316780;202211;736;1959;602;1722;208;669;130;269;338;938
316790;202211;900;2215;656;1755;111;319;177;446;288;765
316800;202211;8145;20450;6477;17635;832;2451;3343;8606;4175;11057
316805;202211;1477;2658;1207;2352;30;81;1044;1971;1074;2052
316810;202211;913;2238;696;1859;79;233;483;1262;562;1495
316820;202211;475;938;291;653;18;65;191;365;209;430
316830;202211;1101;2529;842;2109;92;235;524;1267;616;1502
316840;202211;3696;8198;2990;7114;159;481;2331;5258;2490;5739
316850;202211;2781;6165;2119;5088;182;531;1372;2971;1554;3502
316860;202211;28629;63887;21949;54003;2804;8261;12069;27409;14873;35670
316870;202211;10968;26264;8309;21453;944;2855;4596;10478;5540;13333
316880;202211;1391;3227;1173;2929;136;416;747;1704;883;2120
316890;202211;1394;2983;870;2293;100;338;553;1351;653;1689
316900;202211;3224;7673;2572;6536;410;1133;1213;2718;1623;3851
316905;202211;586;1602;471;1387;216;641;114;352;330;993
316910;202211;1246;2996;858;2357;214;626;221;561;435;1187
316920;202211;2414;4996;1830;4164;188;555;1281;2613;1469;3168
316930;202211;11719;29668;9268;25556;1812;5528;3920;9628;5732;15156
316935;202211;5395;12928;4027;10481;671;1945;1914;4444;2585;6389
316940;202211;7619;20380;6016;17293;976;3063;2711;6933;3687;9996
316950;202211;2472;4942;1915;4209;70;144;1620;3491;1690;3635
316960;202211;6578;13126;4819;10846;383;956;3441;7494;3824;8450
316970;202211;5132;12493;4320;11138;565;1611;2249;5214;2814;6825
316980;202211;1050;2670;819;2313;239;756;322;814;561;1570
316990;202211;16092;39129;12143;31645;2818;7828;2874;6446;5692;14274
317000;202211;3138;7867;2743;7347;204;449;2120;5747;2324;6196
317005;202211;3171;8041;2470;6699;376;1138;1315;3335;1691;4473
317010;202211;35735;78265;25198;62370;3878;10672;13674;31912;17552;42584
317020;202211;91790;204246;58689;148072;11008;30380;21925;49030;32933;79410
317030;202211;810;1971;649;1746;18;69;487;1269;505;1338
317040;202211;14188;33298;9734;25897;2335;6708;2797;7463;5132;14171
317043;202211;1130;2212;837;1829;37;89;674;1434;711;1523
317047;202211;1383;2966;966;2311;50;143;686;1549;736;1692
317050;202211;1466;4271;1048;3312;159;573;397;1016;556;1589
317052;202211;3076;7181;2443;6220;214;607;1690;4084;1904;4691
317057;202211;2756;5132;2145;4262;31;95;1776;3293;1807;3388
317060;202211;596;1520;362;1046;51;169;143;358;194;527
317065;202211;1346;3547;1101;3069;80;273;702;1760;782;2033
317070;202211;9824;25601;7741;21721;1179;3822;3631;9129;4810;12951
317075;202211;1375;3099;1069;2621;134;344;656;1481;790;1825
317080;202211;8197;17520;6211;14402;1123;2793;3120;6905;4243;9698
317090;202211;5743;14600;5000;13444;308;821;3742;9924;4050;10745
317100;202211;3179;7057;2158;5423;414;1104;963;2247;1377;3351
317103;202211;3064;6387;2602;5747;140;413;2136;4465;2276;4878
317107;202211;1850;4225;1383;3387;50;161;934;1955;984;2116
317110;202211;826;1811;471;1259;75;237;188;467;263;704
317115;202211;1343;3513;1098;3074;144;414;648;1783;792;2197
317120;202211;24015;56193;19712;49460;1345;4175;13338;30857;14683;35032
317130;202211;14100;30498;9805;23566;1349;3573;3951;9151;5300;12724
317140;202211;1170;2543;891;2117;67;161;632;1470;699;1631
317150;202211;1295;2651;999;2265;32;104;861;1866;893;1970
317160;202211;4130;9226;2691;6944;276;671;1351;3680;1627;4351
317170;202211;2513;5697;1943;4710;91;279;1338;2887;1429;3166
317180;202211;2254;6465;1627;5049;324;1052;378;1079;702;2131
317190;202211;1321;3326;969;2744;185;569;451;1182;636;1751
317200;202211;7811;19105;5821;15356;1253;3459;1480;3450;2733;6909
317210;202211;1515;3211;1170;2761;45;154;838;1932;883;2086
317220;202211;396;1019;343;929;62;189;201;492;263;681
320010;202211;5807;15835;4397;12959;649;2099;2239;6305;2888;8404
320013;202211;2577;6447;1823;5034;306;902;832;2308;1138;3210
320016;202211;3505;8305;2664;7003;214;577;1796;4622;2010;5199
320020;202211;6047;13820;4639;11449;661;1925;2514;5772;3175;7697
320030;202211;2190;5566;1428;4058;199;630;637;1614;836;2244
320035;202211;2406;5789;1984;5113;340;1018;1159;2832;1499;3850
320040;202211;5576;14214;4603;12506;614;1791;2567;6519;3181;8310
320050;202211;2345;4776;2020;4316;213;599;1370;2647;1583;3246
320060;202211;18102;45241;13484;36352;2304;6687;6147;15043;8451;21730
320070;202211;2443;5788;1849;4698;210;698;1060;2323;1270;3021
320080;202211;6977;16392;4906;12447;851;2338;2110;4809;2961;7147
320090;202211;10331;25732;6963;19123;1453;4374;2535;6184;3988;10558
320100;202211;4234;9923;3446;8606;476;1285;2036;4871;2512;6156
320110;202211;2957;6078;2164;4906;251;669;1359;2775;1610;3444
320115;202211;2682;7683;2287;7035;712;2263;939;2993;1651;5256
320120;202211;33034;76257;23972;60684;3178;8810;12366;28464;15544;37274
320130;202211;72429;173608;59698;151937;7326;20365;36893;88509;44219;108874
320140;202211;5114;12574;3738;9952;518;1624;1902;4580;2420;6204
320150;202211;18120;43322;13039;34244;3057;9096;2326;4775;5383;13871
320160;202211;8076;20187;5990;16473;771;2346;3040;7911;3811;10257
320170;202211;2245;5825;1581;4563;415;1222;523;1568;938;2790
320180;202211;910;2654;701;2228;212;751;173;493;385;1244
320190;202211;3862;11152;2846;8992;601;2156;599;1641;1200;3797
320200;202211;1624;4123;1089;3153;216;674;298;842;514;1516
320210;202211;5804;13374;4474;11153;690;1892;2476;5685;3166;7577
320220;202211;4483;10353;3394;8606;685;1795;1508;3596;2193;5391
320225;202211;1891;5326;1282;3981;369;1279;288;856;657;2135
320230;202211;6989;17014;5291;14219;1212;3470;1522;4194;2734;7664
320240;202211;22184;51717;16641;43153;4151;11780;5184;12641;9335;24421
320245;202211;4040;11042;2892;8588;814;2589;423;1127;1237;3716
320250;202211;3554;8484;2425;6101;383;1065;1166;2524;1549;3589
320255;202211;2617;7096;2268;6484;386;1178;1441;4113;1827;5291
320260;202211;1789;4681;1140;3345;277;846;298;729;575;1575
320265;202211;2843;8187;2136;6745;829;2853;286;821;1115;3674
320270;202211;2784;7164;2093;5872;525;1674;664;1768;1189;3442
320280;202211;10774;24759;8861;21704;1051;3078;5909;13411;6960;16489
320290;202211;1622;4532;1044;3220;268;920;288;808;556;1728
320300;202211;5541;14787;4434;12698;1169;3716;1521;4131;2690;7847
320305;202211;6653;16904;5010;13885;913;2833;2379;6124;3292;8957
320310;202211;2597;6541;1841;4994;321;967;840;2010;1161;2977
320313;202211;3119;7079;2131;5327;402;1126;798;1655;1200;2781
320316;202211;1905;5006;1455;4254;224;657;788;2308;1012;2965
320320;202211;27528;67395;20059;54897;4784;13803;7043;18695;11827;32498
320330;202211;3642;8878;2839;7542;443;1210;1611;4245;2054;5455
320332;202211;10814;25785;8683;22138;1599;4461;4648;11175;6247;15636
320334;202211;2388;6197;1622;4697;294;1016;410;909;704;1925
320335;202211;2246;5981;1504;4364;298;1026;483;1236;781;2262
320340;202211;7087;14910;5957;13334;446;1136;4170;9042;4616;10178
320350;202211;6650;14668;4654;11282;481;1348;2628;5760;3109;7108
320360;202211;1708;4056;1211;3145;131;369;605;1440;736;1809
320370;202211;3560;9746;2745;8064;763;2510;988;2660;1751;5170
320380;202211;3836;8482;3215;7478;258;795;2318;4923;2576;5718
320390;202211;9989;23996;7340;18932;1466;4041;3044;7168;4510;11209
320400;202211;4093;10719;3025;8514;808;2508;1125;2897;1933;5405
320405;202211;6698;15573;5046;12849;708;1927;2776;6652;3484;8579
320410;202211;5969;14341;4491;12016;772;2093;2198;5866;2970;7959
320420;202211;5169;11681;3975;9843;850;2265;1602;3710;2452;5975
320425;202211;2716;5791;2070;4776;147;366;1427;3071;1574;3437
320430;202211;3905;9111;3095;7747;427;1136;1901;4536;2328;5672
320435;202211;2901;8312;2295;7078;707;2375;804;2510;1511;4885
320440;202211;1893;4796;1423;3919;234;714;651;1593;885;2307
320450;202211;2686;6536;2164;5625;323;1064;1250;2850;1573;3914
320455;202211;5468;15529;3733;11629;870;3036;890;2317;1760;5353
320460;202211;2600;7206;1894;5783;534;1817;527;1414;1061;3231
320465;202211;1944;5007;1393;3969;315;979;589;1662;904;2641
320470;202211;5249;12765;3856;10108;725;2160;1435;3248;2160;5408
320480;202211;3053;6633;2472;5692;290;673;1691;3731;1981;4404
320490;202211;32478;74538;24332;61047;4434;11292;11025;27070;15459;38362
320495;202211;1798;4492;1297;3541;308;983;254;522;562;1505
320500;202211;84880;199902;68416;172361;7983;22787;42861;100142;50844;122929
320501;202211;6224;16322;4595;13401;1290;4131;1181;3260;2471;7391
320503;202211;3177;8382;2153;6315;598;1929;573;1515;1171;3444
320506;202211;3405;9345;2530;7506;724;2390;524;1268;1248;3658
320510;202211;15392;36738;12392;31732;1630;4373;7131;17450;8761;21823
320515;202211;2234;5713;1659;4538;463;1363;531;1357;994;2720
320517;202211;2740;7382;2183;6266;627;1956;828;2263;1455;4219
320520;202211;59674;137234;46669;115917;6847;18905;23468;54003;30315;72908
320530;202211;45844;106060;36702;90863;2690;8242;24756;55989;27446;64231
330010;202211;36215;80275;30342;71127;2334;6324;22715;50604;25049;56928
330015;202211;2235;4658;1746;3911;215;605;1130;2298;1345;2903
330020;202211;28057;61766;23728;55619;2441;6499;17407;39286;19848;45785
330022;202211;2538;6292;1950;5341;368;1070;853;2263;1221;3333
330023;202211;9359;19745;7465;16930;1017;2566;4816;10246;5833;12812
330025;202211;10020;20450;6876;15503;1129;2815;3196;6473;4325;9288
330030;202211;15281;34541;12073;29566;857;2686;8536;19174;9393;21860
330040;202211;24275;54562;20281;48191;900;2803;15694;34818;16594;37621
330045;202211;146873;277067;125810;251084;5457;12282;108108;209674;113565;221956
330050;202211;4583;10253;3692;8877;567;1701;2307;4870;2874;6571
330060;202211;7748;17601;5978;14635;1073;3028;2541;5570;3614;8598
330070;202211;41919;88486;35366;79522;4237;10274;24046;52519;28283;62793
330080;202211;14346;29580;12173;26618;1470;3332;8371;17984;9841;21316
330090;202211;4512;8360;3314;6783;276;488;2281;4719;2557;5207
330093;202211;3868;8050;3035;6965;175;468;2470;5474;2645;5942
330095;202211;1918;4699;1501;3967;153;456;904;2195;1057;2651
330100;202211;103246;227455;90274;209393;3926;11353;73494;164526;77420;175879
330110;202211;3205;7502;2644;6611;273;829;1812;4158;2085;4987
330115;202211;3683;7908;2658;6338;425;1165;1528;3295;1953;4460
330120;202211;4779;9102;3718;7797;170;450;2994;5929;3164;6379
330130;202211;7134;16720;5904;14909;789;2088;3812;9300;4601;11388
330140;202211;5815;11750;4888;10535;199;612;4115;8407;4314;9019
330150;202211;3450;7900;2747;6802;449;1232;1568;3643;2017;4875
330160;202211;2137;4964;1676;4202;289;843;987;2197;1276;3040
330170;202211;220362;426556;189235;386178;20662;44848;141934;281630;162596;326478
330180;202211;2986;5904;2450;5181;102;299;1981;3948;2083;4247
330185;202211;16970;33279;14576;30203;490;1395;12676;25227;13166;26622
330187;202211;7900;16578;6254;14070;758;1992;4139;8579;4897;10571
330190;202211;65579;127294;57186;116077;2475;6048;48025;93868;50500;99916
330200;202211;26528;55784;22209;50415;2767;6515;16034;35741;18801;42256
330205;202211;2947;6564;2240;5441;142;406;1553;3473;1695;3879
330210;202211;4352;9505;3253;7766;414;1088;1870;4072;2284;5160
330220;202211;19804;42488;14944;34800;2259;6062;7783;16030;10042;22092
330225;202211;5898;13026;4624;11154;334;940;3217;7396;3551;8336
330227;202211;27816;55595;24374;51477;524;1495;22117;45364;22641;46859
330230;202211;2431;5138;1646;4064;148;389;786;1916;934;2305
330240;202211;38054;83429;32475;75129;2709;7281;24276;53495;26985;60776
330245;202211;2175;4955;1361;3558;266;753;601;1381;867;2134
330250;202211;65158;134863;55755;121827;6231;14685;40470;85740;46701;100425
330260;202211;8330;17038;6694;14913;335;899;5438;11626;5773;12525
330270;202211;45963;97962;29692;71657;3726;10081;15671;34648;19397;44729
330280;202211;3853;8227;3056;6993;184;534;2184;4552;2368;5086
330285;202211;43651;83889;36476;74071;1356;3653;30841;59404;32197;63057
330290;202211;6588;12691;5423;11199;305;885;4452;8587;4757;9472
330300;202211;8204;16417;6116;13553;412;1064;4624;9680;5036;10744
330310;202211;3801;7825;2896;6443;147;376;2196;4628;2343;5004
330320;202211;25290;51019;20247;44783;2215;4489;15161;33109;17376;37598
330330;202211;71725;137112;59104;120699;4133;9427;46679;91543;50812;100970
330340;202211;26861;56410;20543;47067;2642;7291;12206;25091;14848;32382
330350;202211;239409;450787;205607;410614;7807;17459;181732;354419;189539;371878
330360;202211;10808;21707;9433;20053;352;732;8306;17364;8658;18096
330370;202211;7821;18632;6240;16082;1090;3182;3294;7919;4384;11101
330380;202211;10040;21729;8188;18686;595;1749;6073;12832;6668;14581
330385;202211;5948;14112;4873;12557;773;2282;2691;6527;3464;8809
330390;202211;49313;108785;38668;91299;3661;10679;26481;56988;30142;67667
330395;202211;4828;10038;4018;9035;147;455;3235;6899;3382;7354
330400;202211;4956;11249;4156;10000;196;655;3231;7174;3427;7829
330410;202211;4673;10207;3533;8388;425;1288;2398;5125;2823;6413
330411;202211;3838;9292;3079;7992;187;612;2139;5135;2326;5747
330412;202211;2365;5577;1951;4931;147;447;1382;3232;1529;3679
330414;202211;34689;75027;28932;67307;1778;4763;22760;51123;24538;55886
330415;202211;6207;15017;4596;12270;439;1284;2744;6923;3183;8207
330420;202211;17684;39511;13303;32585;1358;3896;8115;18058;9473;21954
330430;202211;15915;30139;13674;27236;451;1146;11631;22192;12082;23338
330440;202211;4002;9052;3106;7587;312;953;2178;4864;2490;5817
330450;202211;1993;4815;1582;4155;129;377;1010;2471;1139;2848
330452;202211;27341;59819;22602;52931;1819;5299;16887;37148;18706;42447
330455;202211;1020843;1978492;857493;1757126;83403;185279;638096;1260053;721499;1445332
330460;202211;1683;3972;1312;3436;213;589;714;1813;927;2402
330470;202211;8052;17194;5984;14184;1296;3434;2516;5552;3812;8986
330475;202211;13219;29000;10788;25882;1393;3872;7277;16710;8670;20582
330480;202211;7764;17686;6585;15984;520;1360;4680;10761;5200;12121
330490;202211;165729;331511;138348;295610;11566;26454;105552;218712;117118;245166
330500;202211;11616;24655;9831;22294;585;1534;7727;16929;8312;18463
330510;202211;67876;142859;54498;124756;5054;12974;40740;89203;45794;102177
330513;202211;1747;3924;1412;3476;194;528;839;2016;1033;2544
330515;202211;4044;9245;3297;8202;403;1168;2019;4652;2422;5820
330520;202211;20258;44251;17206;39821;1458;4043;12492;27306;13950;31349
330530;202211;2240;4876;1609;3927;293;777;771;1820;1064;2597
330540;202211;4211;9708;3266;8160;708;1876;1542;3615;2250;5491
330550;202211;20818;42125;16369;35980;2174;5484;10892;22429;13066;27913
330555;202211;30635;53012;26078;47651;984;2056;22418;40264;23402;42320
330560;202211;5380;12149;4375;10603;608;1536;2861;6611;3469;8147
330570;202211;4351;9692;3813;8948;520;1426;2697;6108;3217;7534
330575;202211;9049;19049;7916;17180;309;873;6737;13790;7046;14663
330580;202211;32369;71476;27115;62728;3820;9400;16873;36112;20693;45512
330590;202211;2219;4864;1857;4414;227;527;1239;2958;1466;3485
330600;202211;18361;40551;15257;35766;842;2508;11265;24608;12107;27116
330610;202211;14025;30918;11592;27218;1023;2827;8168;17991;9191;20818
330615;202211;2946;6773;2428;6096;420;946;1573;4069;1993;5015
330620;202211;6033;14596;4903;12777;774;2301;2772;6663;3546;8964
330630;202211;42926;90977;33747;76786;1398;4304;26076;55359;27474;59663
350010;202211;2949;7241;1835;5014;335;987;497;1107;832;2094
350020;202211;877;2141;535;1492;77;225;190;472;267;697
350030;202211;4654;11670;3647;9985;729;2270;1866;4683;2595;6953
350040;202211;957;2541;577;1757;81;303;181;418;262;721
350050;202211;1895;4324;1311;3374;207;637;482;967;689;1604
350055;202211;1215;2716;960;2332;139;386;553;1182;692;1568
350060;202211;383;851;209;504;35;90;93;201;128;291
350070;202211;4627;11082;3202;8570;462;1376;1446;3380;1908;4756
350075;202211;857;2248;638;1849;206;599;126;371;332;970
350080;202211;838;2057;561;1527;52;165;292;688;344;853
350090;202211;819;1648;535;1228;67;190;334;680;401;870
350100;202211;3363;7796;2460;6335;141;485;1658;3862;1799;4347
350110;202211;632;1373;476;1114;15;43;349;769;364;812
350115;202211;1471;3997;1204;3477;195;633;591;1529;786;2162
350120;202211;809;1795;477;1231;41;128;266;628;307;756
350130;202211;4342;10360;3445;8776;424;1244;2005;4478;2429;5722
350140;202211;881;2250;625;1780;47;164;363;931;410;1095
350150;202211;577;1637;467;1423;90;305;153;390;243;695
350160;202211;16143;38016;11601;29708;1583;4491;6845;16159;8428;20650
350170;202211;3542;8868;2959;7658;448;1256;1652;3887;2100;5143
350180;202211;1251;2805;767;1963;101;272;415;969;516;1241
350190;202211;4716;12196;3465;9413;452;1516;1934;4403;2386;5919
350200;202211;707;1606;543;1316;38;99;359;790;397;889
350210;202211;8466;17679;6067;13971;456;1313;4292;9092;4748;10405
350220;202211;3976;10036;2852;7899;512;1531;1224;2981;1736;4512
350230;202211;1396;3210;1120;2836;155;455;652;1552;807;2007
350240;202211;748;1977;458;1315;80;233;129;310;209;543
350250;202211;4546;11323;3466;9597;882;2554;1123;2966;2005;5520
350260;202211;1087;2309;688;1654;82;226;412;891;494;1117
350270;202211;5656;13545;4517;11482;576;1641;2680;6198;3256;7839
350275;202211;3743;8808;3116;7893;222;721;2366;5614;2588;6335
350280;202211;24532;52441;16270;39326;2269;5953;8452;18579;10721;24532
350290;202211;4475;11265;3251;8878;518;1602;1532;3685;2050;5287
350300;202211;892;2069;686;1700;83;235;447;999;530;1234
350310;202211;1219;3112;931;2582;125;400;457;1119;582;1519
350315;202211;770;1730;548;1392;29;103;335;734;364;837
350320;202211;21696;51611;16669;42900;2769;8018;8280;19105;11049;27123
350330;202211;18213;40907;13689;32790;1184;3322;9323;20595;10507;23917
350335;202211;450;1182;326;942;34;105;149;413;183;518
350340;202211;1714;4122;1070;2936;149;470;490;1172;639;1642
350350;202211;915;2094;723;1887;121;310;425;1113;546;1423
350360;202211;1495;3922;1208;3360;218;639;523;1386;741;2025
350370;202211;905;2042;652;1586;186;439;241;540;427;979
350380;202211;6212;15899;4540;12460;1011;2909;1615;4033;2626;6942
350390;202211;14594;34534;11445;29403;1459;4102;6942;16520;8401;20622
350395;202211;528;1253;261;753;29;90;98;242;127;332
350400;202211;11015;25300;7876;20140;1994;5523;2453;5829;4447;11352
350410;202211;14097;36036;10619;29601;2003;6165;4551;11576;6554;17741
350420;202211;1430;3379;992;2570;178;471;355;755;533;1226
350430;202211;825;1982;642;1701;94;300;353;819;447;1119
350440;202211;2745;6029;2189;5193;113;352;1538;3340;1651;3692
350450;202211;9154;23024;7197;19676;1416;4373;3480;8567;4896;12940
350460;202211;2836;6752;1800;4827;282;820;823;1949;1105;2769
350470;202211;316;720;243;605;8;21;182;434;190;455
350480;202211;1218;2887;794;2142;178;548;191;442;369;990
350490;202211;2543;5848;1862;4809;299;882;910;2020;1209;2902
350500;202211;774;1935;545;1534;72;219;218;568;290;787
350510;202211;1540;3536;1175;2907;112;309;730;1655;842;1964
350520;202211;3020;8166;2373;6983;336;1085;1130;3000;1466;4085
350530;202211;4045;9415;3093;7667;240;710;1948;4367;2188;5077
350535;202211;1907;4609;1591;4155;234;678;1001;2488;1235;3166
350540;202211;2588;5120;1994;4294;189;497;1477;2921;1666;3418
350550;202211;11857;26910;8440;21285;799;2423;5200;11807;5999;14230
350560;202211;5900;13543;4948;12074;236;769;3843;8775;4079;9544
350570;202211;39937;99050;32729;86252;5044;14619;17965;43959;23009;58578
350580;202211;2820;6881;1831;5008;508;1588;556;1146;1064;2734
350590;202211;6537;16126;4931;12754;603;1766;3048;7176;3651;8942
350600;202211;42480;94004;27522;68783;4102;11732;13248;29478;17350;41210
350610;202211;9452;23267;6960;18576;817;2540;4020;9711;4837;12251
350620;202211;496;1217;326;950;36;123;189;506;225;629
350630;202211;2223;4751;1645;3822;101;301;1200;2525;1301;2826
350635;202211;14315;30869;11107;26031;1161;3047;7725;17028;8886;20075
350640;202211;1128;2845;613;1759;96;275;187;447;283;722
350650;202211;11070;27540;8089;21828;1365;4076;3628;8768;4993;12844
350660;202211;6517;14913;5098;12686;584;1438;3260;7852;3844;9290
350670;202211;2353;5815;1752;4780;286;827;888;2330;1174;3157
350680;202211;1437;3551;968;2696;152;441;418;1039;570;1480
350690;202211;1857;4597;1369;3759;239;682;716;1931;955;2613
350700;202211;6431;14749;4974;12522;926;2736;2781;6330;3707;9066
350710;202211;3945;9395;3304;8351;565;1682;1842;4201;2407;5883
350715;202211;913;2426;760;2157;157;526;365;873;522;1399
350720;202211;207;481;149;398;20;64;44;91;64;155
350730;202211;787;2112;590;1728;55;186;327;830;382;1016
350740;202211;2107;5100;1436;3749;228;665;543;1228;771;1893
350745;202211;754;1821;435;1213;43;144;211;529;254;673
350750;202211;14851;35425;11874;30478;1930;5790;6078;13965;8008;19755
350760;202211;23466;51212;17973;42154;2254;6513;11110;22835;13364;29348
350770;202211;1333;2995;859;2199;90;257;526;1236;616;1493
350775;202211;902;1910;602;1465;85;215;323;726;408;941
350780;202211;2999;6733;2207;5649;567;1338;866;2417;1433;3755
350790;202211;2727;6816;1736;4998;368;1081;477;1133;845;2214
350800;202211;4581;11607;3903;10482;336;1056;2661;6688;2997;7744
350810;202211;3716;8180;2769;6785;635;1602;1259;2902;1894;4504
350820;202211;1167;2521;723;1735;56;162;445;964;501;1126
350830;202211;1071;2659;624;1731;104;330;217;463;321;793
350840;202211;4608;12419;3568;10503;667;2217;1621;4275;2288;6492
350850;202211;10705;26641;8408;22622;1327;3940;4746;11796;6073;15736
350860;202211;5042;11664;4376;10756;334;913;3169;7605;3503;8518
350870;202211;3513;8698;2560;7205;399;1179;1315;3512;1714;4691
350880;202211;2021;5010;1658;4332;412;1129;667;1516;1079;2645
350890;202211;621;1528;411;1106;62;172;144;329;206;501
350900;202211;12508;29987;9163;23426;1331;3872;5124;11633;6455;15505
350910;202211;1216;2575;1015;2288;88;212;773;1699;861;1911
350920;202211;16539;37334;13941;33244;566;1699;11278;25533;11844;27232
350925;202211;5582;13477;4117;11023;672;2045;2207;5205;2879;7250
350930;202211;1831;4478;1253;3377;98;288;684;1755;782;2043
350940;202211;3455;7848;2776;6772;228;681;2051;4618;2279;5299
350945;202211;1207;3053;876;2415;160;434;374;941;534;1375
350950;202211;126809;295288;98951;245180;11918;32611;61901;142971;73819;175582
350960;202211;8788;21700;6809;17988;1004;2974;3654;8872;4658;11846
350970;202211;4953;12667;3675;10310;939;2995;1235;2702;2174;5697
350980;202211;977;2243;809;1968;123;346;500;1098;623;1444
350990;202211;2699;6418;2099;5473;483;1441;967;2259;1450;3700
350995;202211;1098;3026;992;2825;73;271;689;1830;762;2101
351000;202211;3958;9827;2567;7069;546;1580;789;2042;1335;3622
351010;202211;498;1169;308;820;45;143;156;384;201;527
351015;202211;1258;3407;1026;2946;197;620;439;1078;636;1698
351020;202211;10787;26146;8199;21668;1509;4333;4242;10186;5751;14519
351030;202211;3974;10469;3184;8954;506;1623;1703;4450;2209;6073
351040;202211;7417;15837;6199;14023;233;652;5117;11031;5350;11683
351050;202211;23090;52209;17719;44166;2868;7779;9930;23317;12798;31096
351060;202211;64256;147296;49714;123244;4245;12094;34655;81237;38900;93331
351070;202211;1838;4281;1088;3031;281;851;215;504;496;1355
351080;202211;3678;8056;2785;6968;324;944;1823;4258;2147;5202
351090;202211;429;1078;326;896;64;177;123;321;187;498
351100;202211;3667;9040;2366;6472;466;1412;835;2102;1301;3514
351110;202211;7451;18199;5455;14606;849;2600;2933;7240;3782;9840
351120;202211;929;2221;634;1683;110;306;228;527;338;833
351130;202211;1412;3670;670;1985;117;391;162;393;279;784
351140;202211;2899;7350;2181;6058;451;1418;944;2283;1395;3701
351150;202211;3861;9902;2733;7640;411;1320;1107;2697;1518;4017
351160;202211;1727;4886;1221;3770;240;807;269;689;509;1496
351170;202211;2072;4952;1772;4417;132;415;1287;2945;1419;3360
351190;202211;1243;3245;847;2455;202;591;252;678;454;1269
351200;202211;2000;4542;1482;3779;137;394;989;2345;1126;2739
351210;202211;1925;4342;1277;3230;85;276;794;1797;879;2073
351220;202211;4892;11596;4176;10457;445;1084;2785;6737;3230;7821
351230;202211;2856;6717;2205;5629;400;1140;1032;2272;1432;3412
351240;202211;2929;7183;1859;5040;483;1318;472;1103;955;2421
351250;202211;1280;3236;762;2169;98;297;275;724;373;1021
351260;202211;1050;2431;734;1876;150;375;283;671;433;1046
351270;202211;663;1679;468;1292;50;151;230;510;280;661
351280;202211;5033;12404;3815;10214;828;2283;1526;3735;2354;6018
351290;202211;1912;4189;1292;3144;119;333;918;2107;1037;2440
351300;202211;28251;69179;20884;55826;3696;10800;10339;25415;14035;36215
351310;202211;4802;10633;3717;8888;165;545;2806;6255;2971;6800
351320;202211;1009;2754;701;2154;118;373;193;517;311;890
351330;202211;466;1100;335;844;18;59;212;452;230;511
351340;202211;10533;23893;8902;21101;1455;4116;5647;11829;7102;15945
351350;202211;16899;38319;14002;33596;978;2786;10807;24427;11785;27213
351360;202211;5178;12027;4242;10671;748;2189;2262;5106;3010;7295
351370;202211;2554;6620;1689;4876;392;1221;406;942;798;2163
351380;202211;61341;135063;44520;107271;4578;12291;28811;64976;33389;77267
351385;202211;472;1165;206;583;34;101;89;229;123;330
351390;202211;1789;3962;1252;3214;64;203;1000;2466;1064;2669
351400;202211;1459;3647;1174;3093;180;454;627;1574;807;2028
351410;202211;3368;8513;2520;6963;427;1278;1131;2876;1558;4154
351420;202211;629;1407;386;1004;43;110;245;579;288;689
351430;202211;1341;3095;1103;2718;73;207;833;1942;906;2149
351440;202211;4494;10901;3038;8072;555;1562;955;2110;1510;3672
351450;202211;2137;5263;1476;4099;298;984;409;865;707;1849
351460;202211;1291;3039;1061;2689;152;409;658;1584;810;1993
351470;202211;1553;3633;1208;3062;77;234;797;1883;874;2117
351480;202211;3163;8144;2509;7116;393;1318;1289;3263;1682;4581
351490;202211;2895;7221;2495;6519;82;306;2001;5001;2083;5307
351492;202211;452;1061;382;926;8;26;301;693;309;719
351495;202211;280;686;222;577;25;52;124;308;149;360
351500;202211;57479;124070;44978;104492;5502;14185;30208;65496;35710;79681
351510;202211;17818;38625;13421;31547;1442;3837;8849;19581;10291;23418
351512;202211;588;1469;414;1104;84;229;131;312;215;541
351515;202211;4191;9102;2641;6488;516;1319;667;1678;1183;2997
351518;202211;2619;6358;1735;4757;278;860;726;1677;1004;2537
351519;202211;753;1938;458;1362;101;329;104;257;205;586
351520;202211;1530;3585;734;2060;81;271;355;870;436;1141
351530;202211;434;1065;262;726;45;124;111;248;156;372
351535;202211;2113;4869;1472;3756;227;609;680;1610;907;2219
351540;202211;3350;7542;2282;5716;227;699;1223;2644;1450;3343
351550;202211;9537;21922;6697;16977;735;2099;3809;8743;4544;10842
351560;202211;638;1712;493;1417;98;309;171;451;269;760
351565;202211;343;854;260;718;36;133;109;247;145;380
351570;202211;29351;70250;23174;58789;1860;5451;15934;37884;17794;43335
351580;202211;274;681;164;480;16;46;71;210;87;256
351590;202211;555;1229;290;763;22;63;158;375;180;438
351600;202211;1672;4176;1276;3410;210;597;602;1442;812;2039
351610;202211;844;1855;531;1326;55;154;292;663;347;817
351620;202211;30347;74968;22521;62182;3330;10698;10975;27351;14305;38049
351630;202211;37305;86743;30368;75706;2554;7530;21816;51013;24370;58543
351640;202211;26279;59631;21225;51257;1355;4021;15679;35423;17034;39444
351650;202211;464;1217;209;628;39;123;48;125;87;248
351660;202211;783;2072;532;1545;89;283;154;371;243;654
351670;202211;7820;19566;5158;13872;1075;2863;2202;5331;3277;8194
351680;202211;513;1342;344;997;74;213;101;250;175;463
351685;202211;588;1512;465;1318;86;246;195;474;281;720
351690;202211;1484;3535;862;2363;96;311;377;927;473;1238
351700;202211;1692;3871;1250;3128;223;633;668;1493;891;2126
351710;202211;976;2314;733;1891;60;186;422;955;482;1141
351720;202211;1941;4623;1371;3649;241;637;645;1588;886;2225
351730;202211;1280;2938;1040;2567;68;195;664;1487;732;1682
351740;202211;4230;9831;3421;8423;439;1226;2033;4550;2472;5776
351750;202211;2207;5309;1398;3877;192;567;697;1776;889;2343
351760;202211;4178;10509;3190;8677;553;1765;1575;3781;2128;5546
351770;202211;2627;6404;2156;5573;558;1383;1112;2750;1670;4133
351780;202211;1415;3349;826;2254;107;331;343;848;450;1179
351790;202211;1963;4232;1507;3580;247;572;907;2086;1154;2658
351800;202211;566;1245;288;746;36;101;116;248;152;349
351810;202211;1429;3400;1169;3024;266;761;557;1314;823;2075
351820;202211;3899;9593;2906;7752;628;1816;1079;2563;1707;4379
351830;202211;6481;14909;4961;12438;387;1178;3372;7765;3759;8943
351840;202211;12036;29997;9427;25389;944;2892;5978;14736;6922;17628
351850;202211;1888;4898;1229;3584;205;679;403;911;608;1590
351860;202211;3426;9022;2663;7685;562;1812;1365;3682;1927;5494
351870;202211;33941;79422;26357;67176;5500;14574;12514;31031;18014;45605
351880;202211;217756;481963;172215;408064;24406;68797;109559;236205;133965;305002
351885;202211;1308;3000;1066;2637;55;181;786;1816;841;1997
351890;202211;1040;2523;666;1907;118;373;161;390;279;763
351900;202211;1584;3871;1211;3318;105;298;793;2098;898;2396
351905;202211;770;2011;576;1626;72;220;255;611;327;831
351907;202211;29300;70228;23127;59659;2434;7150;15174;36587;17608;43737
351910;202211;2152;4980;1566;3872;148;424;945;2006;1093;2430
351920;202211;1112;2720;849;2239;126;374;370;856;496;1230
351925;202211;1254;3032;988;2584;98;320;575;1354;673;1674
351930;202211;5606;12481;5096;11633;482;1335;4107;8947;4589;10282
351940;202211;1381;3324;992;2634;178;521;411;1062;589;1583
351950;202211;2085;4109;1591;3432;81;216;1169;2368;1250;2584
351960;202211;6981;16211;5271;13334;1264;3376;2258;5129;3522;8505
351970;202211;13678;32637;11434;29047;1343;4247;7767;18081;9110;22328
351980;202211;1355;3022;895;2279;129;381;463;1065;592;1446
351990;202211;1799;3950;1329;3283;56;193;738;1604;794;1797
352000;202211;3490;8651;2986;7657;263;805;2065;4872;2328;5677
352010;202211;2996;7179;2365;6179;686;1814;675;1768;1361;3582
352020;202211;2196;5169;1731;4384;241;737;997;2246;1238;2983
352030;202211;7975;18149;6458;15789;733;2168;4335;9856;5068;12024
352040;202211;5584;13078;4033;10262;675;1893;1584;3541;2259;5434
352042;202211;4670;10070;3289;7973;371;1024;2152;4990;2523;6014
352044;202211;2576;6367;1545;4436;236;772;383;871;619;1643
352050;202211;16680;41181;11416;31068;3204;9365;2650;5807;5854;15172
352060;202211;964;2347;726;1930;131;365;340;833;471;1198
352070;202211;1209;2377;810;1842;69;170;446;922;515;1092
352080;202211;564;1377;349;966;47;123;112;267;159;390
352090;202211;1957;5223;1618;4605;192;632;826;2086;1018;2718
352100;202211;4847;12431;3737;10351;636;2034;1707;4349;2343;6383
352110;202211;911;2356;677;1910;140;404;279;688;419;1092
352115;202211;635;1578;528;1432;128;400;271;648;399;1048
352120;202211;1063;2758;830;2300;77;221;524;1333;601;1554
352130;202211;2402;6289;1524;4195;211;610;705;1730;916;2340
352140;202211;1666;4160;1209;3243;242;646;502;1303;744;1949
352150;202211;1061;2574;778;2100;97;301;481;1209;578;1510
352160;202211;1192;2710;856;2162;93;257;429;1013;522;1270
352170;202211;3737;9291;2887;7626;449;1391;1424;3290;1873;4681
352180;202211;3486;8752;2689;7360;547;1591;1094;2743;1641;4334
352190;202211;2098;4758;1672;4112;295;778;896;2138;1191;2916
352200;202211;414;1219;301;974;43;150;109;325;152;475
352210;202211;30366;61350;24340;53286;1335;3379;19590;41253;20925;44632
352215;202211;776;1898;593;1578;97;282;315;788;412;1070
352220;202211;36003;77493;27570;63803;3593;9642;17459;36337;21052;45979
352230;202211;20203;52191;15872;44421;3928;12130;6207;15220;10135;27350
352240;202211;13731;32178;10705;27339;1917;5491;5696;13029;7613;18520
352250;202211;31793;81576;26236;72437;3249;9880;17405;46059;20654;55939
352260;202211;6488;15104;4616;11508;688;1963;2656;5821;3344;7784
352265;202211;1101;2890;968;2695;160;484;555;1473;715;1957
352270;202211;2665;6897;2092;5762;386;1180;894;2189;1280;3369
352280;202211;3061;6815;2342;5760;313;855;1341;3005;1654;3860
352290;202211;1946;4955;1564;4229;189;568;877;2106;1066;2674
352300;202211;1206;2873;767;1998;82;221;406;960;488;1181
352310;202211;52030;126447;40332;107588;6362;18059;24189;62136;30551;80195
352320;202211;8914;20326;7037;17082;854;2502;4405;9351;5259;11853
352330;202211;3409;7619;2709;6654;275;883;1828;4061;2103;4944
352340;202211;9515;23087;7212;18883;1139;3340;3822;8942;4961;12282
352350;202211;3228;7891;2615;6659;135;423;1939;4673;2074;5096
352360;202211;1952;4597;1553;3903;143;384;1062;2502;1205;2886
352370;202211;1317;3379;1104;3021;43;131;835;2202;878;2333
352380;202211;1196;2847;890;2333;185;508;325;781;510;1289
352390;202211;19783;45385;13937;35250;2120;6142;8068;18535;10188;24677
352400;202211;4624;12120;3588;10121;873;2662;1257;3108;2130;5770
352410;202211;4820;10944;3780;9259;413;1097;2383;5452;2796;6549
352420;202211;1053;2483;713;1925;134;391;253;610;387;1001
352430;202211;11533;24922;8698;20297;1185;3093;5010;10774;6195;13867
352440;202211;25111;62631;19206;51670;4289;12130;7220;18369;11509;30499
352450;202211;976;2298;539;1527;80;249;213;519;293;768
352460;202211;3573;8949;2563;7183;470;1448;1146;2916;1616;4364
352470;202211;3951;9607;3087;8209;256;826;1995;4835;2251;5661
352480;202211;5666;12435;3862;9354;491;1444;2042;4284;2533;5728
352490;202211;1062;2705;839;2320;170;513;360;930;530;1443
352500;202211;14227;34079;9927;26392;3603;11203;2212;3693;5815;14896
352510;202211;5603;13580;4464;11625;467;1410;3032;7339;3499;8749
352520;202211;3832;9340;2946;7858;504;1552;1616;3810;2120;5362
352530;202211;15174;35678;10716;27606;2093;6124;4075;8606;6168;14730
352540;202211;676;1768;498;1412;66;194;242;616;308;810
352550;202211;1208;3048;820;2368;160;546;311;768;471;1314
352560;202211;812;1970;673;1726;46;159;479;1124;525;1283
352570;202211;2662;6952;1774;5223;412;1420;254;417;666;1837
352580;202211;959;2154;803;1896;120;313;513;1120;633;1433
352585;202211;464;1198;334;969;37;128;174;446;211;574
352590;202211;16739;41404;12384;33533;2323;7151;6764;16591;9087;23742
352600;202211;2502;6019;2049;5247;201;584;1387;3260;1588;3844
352610;202211;3607;8807;2745;7402;441;1384;1361;3342;1802;4726
352620;202211;7701;17105;5907;14584;1346;3484;2796;6663;4142;10147
352630;202211;1065;2418;805;2066;143;411;397;936;540;1347
352640;202211;4171;9654;3054;7682;295;829;1900;4360;2195;5189
352650;202211;699;1840;470;1364;73;218;182;483;255;701
352660;202211;1384;3604;1133;3136;100;346;762;1919;862;2265
352670;202211;14113;33728;10255;26506;1776;5107;4924;11253;6700;16360
352680;202211;4099;11022;3022;8649;571;1948;1476;3445;2047;5393
352690;202211;33746;78870;26743;67548;1186;3772;19861;47401;21047;51173
352700;202211;988;2346;745;1936;118;323;362;880;480;1203
352710;202211;7026;16705;5186;13492;1256;3715;2220;5081;3476;8796
352720;202211;13080;29979;10638;25749;1672;4538;6050;13382;7722;17920
352725;202211;650;1431;376;973;18;50;229;535;247;585
352730;202211;5686;16035;5086;14694;644;2111;2488;6022;3132;8133
352740;202211;2980;6718;2253;5661;292;843;1176;2711;1468;3554
352750;202211;508;1196;329;900;38;113;151;365;189;478
352760;202211;2050;5181;1597;4354;202;553;873;2254;1075;2807
352770;202211;1172;2852;829;2224;121;340;421;1038;542;1378
352780;202211;797;2097;562;1619;140;388;161;452;301;840
352790;202211;499;1216;369;959;47;122;159;358;206;480
352800;202211;1696;4658;1170;3518;248;777;221;481;469;1258
352810;202211;1454;3294;975;2458;171;428;507;1219;678;1647
352820;202211;544;1444;406;1207;89;271;102;264;191;535
352830;202211;677;1630;337;948;27;78;120;284;147;362
352840;202211;4946;12870;4021;11254;934;2835;1786;4722;2720;7557
352850;202211;16957;36475;12590;29759;2333;6242;6865;14484;9198;20726
352860;202211;1451;3709;1085;3057;193;595;415;1065;608;1660
352870;202211;1044;2523;714;1867;78;228;431;1057;509;1285
352880;202211;2101;4727;1479;3633;235;606;613;1334;848;1940
352885;202211;449;1097;345;914;46;143;212;520;258;663
352890;202211;882;1916;617;1407;49;134;428;859;477;993
352900;202211;24642;59053;16884;44376;2774;7613;7068;17059;9842;24672
352910;202211;449;1117;246;715;20;60;98;245;118;305
352920;202211;3519;8242;2721;6916;139;443;1987;4746;2126;5189
352930;202211;7361;17855;5677;14581;850;2564;2851;6300;3701;8864
352940;202211;34732;84219;27788;70664;4054;11458;16923;39944;20977;51402
352950;202211;662;1669;416;1211;86;280;116;276;202;556
352960;202211;903;2243;525;1458;61;192;178;368;239;560
352965;202211;315;829;212;630;48;137;59;161;107;298
352970;202211;4966;9344;4093;8075;109;288;3543;6627;3652;6915
352980;202211;1816;4140;1417;3583;328;884;785;1887;1113;2771
352990;202211;5719;13401;4371;11250;740;2100;2418;5888;3158;7988
353000;202211;559;1431;319;913;44;151;120;290;164;441
353010;202211;3286;7573;2308;5813;433;1214;1093;2468;1526;3682
353020;202211;4105;9912;2520;6805;387;1192;999;2399;1386;3591
353030;202211;6020;14239;4162;11094;989;2847;1245;3020;2234;5867
353040;202211;948;1960;701;1594;74;197;477;982;551;1179
353050;202211;6530;17016;4690;13364;788;2514;2448;6469;3236;8983
353060;202211;64671;148005;53577;130882;3208;9833;41024;94556;44232;104389
353070;202211;14157;36147;10530;28653;1703;5225;5134;12321;6837;17546
353080;202211;6509;15903;4555;12230;922;2814;1894;4270;2816;7084
353090;202211;739;1991;592;1714;53;172;365;995;418;1167
353100;202211;366;890;157;450;34;113;51;106;85;219
353110;202211;10448;24286;8411;21461;1933;4902;4154;11001;6087;15903
353120;202211;618;1460;469;1208;62;210;251;544;313;754
353130;202211;3794;8307;2592;6256;615;1637;1157;2393;1772;4030
353140;202211;3849;8436;2924;6972;275;809;1929;4254;2204;5063
353150;202211;1916;4477;1402;3664;272;782;635;1544;907;2326
353160;202211;788;1896;549;1493;69;218;256;592;325;810
353170;202211;767;1826;605;1593;86;243;339;834;425;1077
353180;202211;12184;28260;9590;23907;2238;6174;4374;9843;6612;16017
353190;202211;4382;10732;3387;8810;397;1176;1970;4622;2367;5798
353200;202211;2156;5450;1374;3938;198;656;525;1312;723;1968
353205;202211;584;1545;482;1327;41;135;275;666;316;801
353210;202211;1199;2371;788;1712;27;75;605;1219;632;1294
353215;202211;498;1217;393;1041;50;159;178;403;228;562
353220;202211;935;2420;638;1817;118;317;191;469;309;786
353230;202211;996;2571;775;2216;198;644;207;531;405;1175
353240;202211;3165;7619;2638;6806;376;1096;1587;3831;1963;4927
353250;202211;1712;3521;1181;2702;157;385;701;1534;858;1919
353260;202211;1431;3152;825;2174;161;462;346;822;507;1284
353270;202211;997;2305;830;2024;90;270;532;1175;622;1445
353280;202211;892;2190;650;1802;135;399;241;639;376;1038
353282;202211;2127;5481;1768;4851;148;473;1100;2795;1248;3268
353284;202211;453;1033;258;674;21;62;106;222;127;284
353286;202211;205;499;124;364;26;81;35;75;61;156
353290;202211;1514;3755;877;2472;163;438;252;658;415;1096
353300;202211;2718;6668;2006;5341;312;941;942;2106;1254;3047
353310;202211;505;1128;379;928;28;94;243;525;271;619
353320;202211;832;2030;680;1793;43;149;432;1035;475;1184
353325;202211;979;2542;695;1967;117;342;313;809;430;1151
353330;202211;797;1850;518;1359;73;215;258;587;331;802
353340;202211;4252;10711;3305;8933;523;1662;1818;4401;2341;6063
353350;202211;5473;12381;4036;9879;956;2470;1258;2714;2214;5184
353360;202211;854;2217;699;1930;75;258;433;1111;508;1369
353370;202211;728;1921;591;1695;47;151;384;1059;431;1210
353380;202211;391;999;315;864;37;131;176;418;213;549
353390;202211;8156;18877;6099;15556;506;1497;3795;8939;4301;10436
353400;202211;698;1708;533;1420;91;279;225;460;316;739
353410;202211;664;1596;492;1280;122;346;241;556;363;902
353420;202211;592;1416;400;1043;67;182;98;203;165;385
353430;202211;2971;7494;2360;6401;444;1263;1111;2810;1555;4073
353440;202211;97353;235877;73822;190607;9622;28365;45226;106215;54848;134580
353450;202211;487;1121;343;888;50;158;174;392;224;550
353460;202211;4174;10431;3086;8435;631;1956;749;1681;1380;3637
353470;202211;11759;28159;8712;22636;1424;4176;4134;9471;5558;13647
353475;202211;2041;4715;1402;3554;141;414;780;1753;921;2167
353480;202211;2053;4775;1687;4229;114;353;1220;2852;1334;3205
353490;202211;1327;3221;972;2590;130;362;480;1149;610;1511
353500;202211;1518;3397;1095;2722;236;645;568;1296;804;1941
353510;202211;1240;3255;900;2514;160;463;332;763;492;1226
353520;202211;1349;3261;869;2411;120;365;380;899;500;1264
353530;202211;3242;7547;2628;6500;297;869;1612;3595;1909;4464
353540;202211;2679;6569;2174;5802;355;1050;1246;3145;1601;4195
353550;202211;7988;18041;6413;15528;982;2522;3884;8737;4866;11259
353560;202211;2936;7230;2299;6291;637;1868;832;1998;1469;3866
353570;202211;791;1983;509;1439;88;279;192;452;280;731
353580;202211;3118;7450;2466;6274;449;1140;1363;3304;1812;4444
353590;202211;921;2156;681;1773;89;229;385;952;474;1181
353600;202211;1910;4556;1398;3661;173;500;722;1789;895;2289
353610;202211;982;2580;743;2115;111;341;356;907;467;1248
353620;202211;3750;8899;2703;7201;578;1621;903;2081;1481;3702
353625;202211;770;1772;445;1190;52;173;238;578;290;751
353630;202211;1963;5277;1656;4683;237;741;932;2380;1169;3121
353640;202211;1777;4200;1364;3492;182;467;868;2096;1050;2563
353650;202211;9274;23277;7214;19624;936;2830;4112;10254;5048;13084
353657;202211;448;1114;338;942;33;107;156;401;189;508
353660;202211;1702;3262;1209;2598;162;385;824;1684;986;2069
353670;202211;5558;13901;4348;11689;782;2431;2126;5079;2908;7510
353680;202211;924;2175;687;1838;99;292;408;1015;507;1307
353690;202211;540;1389;248;736;28;79;69;177;97;256
353700;202211;2736;6396;2235;5618;206;551;1529;3666;1735;4217
353710;202211;6136;13130;3864;9116;571;1350;2132;4358;2703;5708
353715;202211;524;1328;302;864;29;89;131;333;160;422
353720;202211;2535;6056;1953;5158;364;1070;939;2374;1303;3444
353730;202211;6254;14833;4939;12612;624;1898;3030;7031;3654;8929
353740;202211;2638;6390;1910;5127;364;1069;834;2006;1198;3075
353750;202211;1145;3200;853;2660;197;615;225;669;422;1284
353760;202211;19278;38529;15048;33089;2639;6332;8784;18480;11423;24812
353770;202211;786;2091;449;1384;64;236;62;141;126;377
353780;202211;8792;20696;7267;18069;1165;3241;4270;9893;5435;13134
353790;202211;3628;9972;2711;8124;624;2084;644;1555;1268;3639
353800;202211;23736;56793;19232;49809;2761;7412;11449;28353;14210;35765
353810;202211;1472;3590;1034;2728;176;480;433;1067;609;1547
353820;202211;2269;5584;1568;4281;408;1123;424;1009;832;2132
353830;202211;770;1773;579;1484;82;247;309;708;391;955
353850;202211;2025;5002;1557;4183;290;804;697;1727;987;2531
353860;202211;3485;8517;2695;7226;619;1937;1294;2975;1913;4912
353870;202211;37605;90926;27305;71794;3785;11018;14061;32963;17846;43981
353880;202211;3921;9755;3122;8293;230;761;2017;4895;2247;5656
353890;202211;4071;7833;2851;6034;172;469;2031;3821;2203;4290
353900;202211;899;2351;668;1915;86;292;276;694;362;986
353910;202211;4011;9437;3422;8561;246;722;2515;6070;2761;6792
353920;202211;2525;6325;1837;5087;510;1552;455;946;965;2498
353930;202211;6942;16597;4951;12851;914;2632;2214;5022;3128;7654
353940;202211;1644;4387;1180;3473;174;572;471;1215;645;1787
353950;202211;4429;10736;3418;8931;863;2479;1206;2762;2069;5241
353960;202211;953;2319;657;1793;161;412;165;435;326;847
353970;202211;829;1754;649;1497;59;161;482;1051;541;1212
353980;202211;21751;48929;16965;41154;776;2401;13028;29599;13804;32000
353990;202211;1190;2642;822;2044;177;451;431;991;608;1442
354000;202211;3207;7319;1888;4873;370;1011;626;1415;996;2426
354010;202211;414;1008;308;835;53;171;176;443;229;614
354020;202211;5079;12132;4047;10211;760;2137;1996;4436;2756;6573
354025;202211;909;2321;598;1721;85;272;187;469;272;741
354030;202211;643;1350;354;878;59;146;170;390;229;536
354040;202211;993;2093;672;1615;42;128;479;1057;521;1185
354050;202211;1290;3387;906;2736;169;586;381;1063;550;1649
354060;202211;5152;13006;3810;10225;610;1890;1987;4605;2597;6495
354070;202211;5311;12407;3669;9305;584;1680;1774;3880;2358;5560
354075;202211;3642;9189;2952;8025;453;1374;1785;4458;2238;5832
354080;202211;1790;4650;1250;3616;189;579;550;1402;739;1981
354085;202211;519;967;402;824;1;4;301;563;302;567
354090;202211;2204;5516;1882;4868;103;293;1460;3600;1563;3893
354100;202211;30387;75155;22381;61789;4270;12927;10956;28165;15226;41092
354105;202211;1602;3739;1165;3019;162;511;580;1326;742;1837
354110;202211;584;1529;449;1281;84;271;189;493;273;764
354120;202211;1796;4517;1215;3294;243;719;429;960;672;1679
354130;202211;7445;17889;5147;13576;1453;3964;1060;2272;2513;6236
354140;202211;23942;56032;17594;44411;2469;7045;9397;20998;11866;28043
354150;202211;3556;7938;2812;6803;712;1769;929;2200;1641;3969
354160;202211;3520;9180;2839;7952;651;1992;1220;3084;1871;5076
354165;202211;911;2417;720;2053;84;311;440;1110;524;1421
354170;202211;2498;6268;2049;5473;239;752;1094;2548;1333;3300
354180;202211;557;1428;439;1192;38;117;259;640;297;757
354190;202211;1889;4978;1366;3901;98;339;731;1914;829;2253
354200;202211;1160;2605;866;2136;82;241;560;1249;642;1490
354210;202211;1316;3156;1036;2703;98;277;662;1575;760;1852
354220;202211;3923;9535;2931;7712;517;1477;1418;3437;1935;4914
354230;202211;1024;2309;835;2074;37;115;625;1488;662;1603
354240;202211;2292;5920;1562;4412;273;814;605;1467;878;2281
354250;202211;793;1847;534;1419;119;315;189;448;308;763
354260;202211;11451;26253;8934;22137;1313;3552;4730;10961;6043;14513
354270;202211;1266;3379;1034;2957;155;479;499;1259;654;1738
354280;202211;1056;2319;876;2049;41;122;659;1399;700;1521
354290;202211;1184;3379;967;2931;146;471;522;1520;668;1991
354300;202211;4285;11374;3602;10136;904;2558;1683;4543;2587;7101
354310;202211;977;2548;827;2292;150;467;461;1175;611;1642
354320;202211;1199;2698;794;2050;118;326;385;840;503;1166
354323;202211;574;1272;363;899;38;104;189;406;227;510
354325;202211;1696;4797;1055;3271;199;624;179;494;378;1118
354330;202211;12759;29323;9186;22523;1018;2906;5777;12857;6795;15763
354340;202211;50040;115390;37049;93698;4882;13818;22011;52165;26893;65983
354350;202211;1470;3348;1175;2879;134;430;767;1654;901;2084
354360;202211;788;1768;493;1318;112;316;163;378;275;694
354370;202211;1252;3218;1024;2858;158;470;606;1604;764;2074
354380;202211;763;1914;579;1634;79;285;212;476;291;761
354390;202211;19500;43386;13621;33373;2008;5444;7435;16534;9443;21978
354400;202211;2093;6085;1639;5097;280;944;592;1728;872;2672
354410;202211;9010;20809;7083;17424;1048;2928;4113;9171;5161;12099
354420;202211;1814;4360;1290;3395;159;480;708;1649;867;2129
354425;202211;3613;8017;2648;6405;510;1297;1371;3122;1881;4419
354430;202211;2085;4914;1666;4264;134;398;1095;2594;1229;2992
354440;202211;739;1767;479;1267;56;169;252;578;308;747
354450;202211;595;1503;327;981;49;159;110;263;159;422
354460;202211;1004;2418;687;1869;156;474;241;601;397;1075
354470;202211;519;1271;338;912;29;100;128;263;157;363
354480;202211;1683;3547;1122;2647;92;258;724;1554;816;1812
354490;202211;1009;2733;747;2171;149;436;335;882;484;1318
354500;202211;2863;7232;2287;6305;634;1870;769;1930;1403;3800
354510;202211;954;2428;747;2046;69;227;433;1035;502;1262
354515;202211;545;1454;376;1113;61;189;130;352;191;541
354520;202211;10408;25700;7683;20213;965;2981;4448;10483;5413;13464
354530;202211;6548;16259;5192;13758;1354;3593;1950;4887;3304;8480
354540;202211;1608;3904;1179;3160;203;590;531;1310;734;1900
354550;202211;704;1807;562;1553;77;244;295;729;372;973
354560;202211;2687;6019;1466;3787;157;440;870;2021;1027;2461
354570;202211;1206;2879;540;1509;112;316;85;224;197;540
354580;202211;10937;27425;7601;21101;1109;3462;4063;10376;5172;13838
354600;202211;2614;6321;2018;5249;304;799;1179;2906;1483;3705
354610;202211;556;1388;306;880;30;91;144;386;174;477
354620;202211;619;1588;389;1151;37;123;186;485;223;608
354625;202211;371;975;212;657;26;87;65;178;91;265
354630;202211;3034;7881;2517;6930;722;2021;706;1764;1428;3785
354640;202211;4948;12471;3857;10414;466;1507;2058;4913;2524;6420
354650;202211;1078;2613;868;2266;179;438;445;1108;624;1546
354660;202211;4438;9785;2577;6823;313;978;1148;2701;1461;3679
354670;202211;1409;3628;986;2779;206;643;323;775;529;1418
354680;202211;7993;18185;6358;15614;1016;2737;3779;8818;4795;11555
354690;202211;666;1875;479;1471;74;228;193;535;267;763
354700;202211;1101;2696;781;2088;90;274;439;1049;529;1323
354710;202211;578;1431;384;1060;44;131;171;399;215;530
354720;202211;379;851;188;497;60;150;56;147;116;297
354730;202211;14301;37401;11293;31786;1544;4831;6751;17789;8295;22620
354740;202211;399;1036;174;515;34;109;29;65;63;174
354750;202211;3014;7287;2062;5467;322;964;903;2052;1225;3016
354760;202211;2800;6826;2043;5498;423;1242;741;1729;1164;2971
354765;202211;432;1094;195;573;19;70;69;158;88;228
354770;202211;3142;7201;2306;5704;449;1184;1051;2364;1500;3548
354780;202211;81779;182582;64046;149690;4432;12644;46099;98522;50531;111166
354790;202211;1168;2978;913;2575;74;237;583;1569;657;1806
354800;202211;3494;8317;2599;6839;557;1565;1082;2530;1639;4095
354805;202211;1784;3830;1316;3159;111;290;884;1911;995;2201
354810;202211;720;1987;436;1399;69;254;129;351;198;605
354820;202211;1192;3141;859;2536;167;545;305;719;472;1264
354830;202211;666;1500;379;986;76;207;138;302;214;509
354840;202211;1064;2590;635;1684;51;153;358;844;409;997
354850;202211;28766;66112;21145;53357;1885;5752;14358;33278;16243;39030
354860;202211;2106;5333;1374;3920;211;645;526;1328;737;1973
354870;202211;85406;195454;67323;163549;5265;15074;46530;104096;51795;119170
354880;202211;7827;18271;4346;11126;527;1556;2033;4116;2560;5672
354890;202211;23390;53150;18585;45008;2399;6725;10859;24465;13258;31190
354900;202211;454;1079;294;794;67;201;109;241;176;442
354910;202211;7578;18660;4771;13650;1072;3265;1348;3341;2420;6606
354920;202211;605;1539;308;933;43;139;74;171;117;310
354925;202211;354;955;198;617;22;68;50;138;72;206
354930;202211;445;1036;303;779;36;97;154;348;190;445
354940;202211;3225;8720;2460;7118;722;2245;886;2195;1608;4440
354950;202211;1977;4481;1626;4030;108;357;1179;2714;1287;3071
354960;202211;1053;2586;745;2086;90;303;336;827;426;1130
354970;202211;5547;13930;4428;12122;363;1244;3073;7899;3436;9143
354980;202211;45291;100125;32220;78237;3274;9612;21152;46749;24426;56361
354990;202211;100905;227580;74352;181294;4885;14809;51828;115466;56713;130275
354995;202211;4277;8093;3363;6946;150;386;2759;5444;2909;5830
355000;202211;1965;4467;1494;3776;230;699;785;1762;1015;2461
355010;202211;5189;12973;3473;9441;1143;3012;783;2044;1926;5056
355020;202211;4286;11223;3272;9510;733;2360;1368;3591;2101;5951
355030;202211;1751981;4002892;1317192;3204193;175503;476836;748545;1654554;924048;2131390
355040;202211;4526;9801;3594;8582;320;845;2726;6313;3046;7158
355050;202211;1409;2973;1036;2456;249;600;439;964;688;1564
355060;202211;8524;20973;6437;17259;1017;3117;3545;8599;4562;11716
355070;202211;13699;31325;11415;27784;1232;3545;7659;17225;8891;20770
355080;202211;1208;3238;766;2443;172;584;135;360;307;944
355090;202211;1739;4325;1398;3758;249;732;733;1776;982;2508
355100;202211;36790;84597;30488;75343;3335;9368;21624;50603;24959;59971
355110;202211;1210;3067;865;2552;177;552;69;167;246;719
355120;202211;922;2217;648;1812;80;250;326;845;406;1095
355130;202211;1048;2145;606;1370;25;70;441;896;466;966
355140;202211;2902;5368;2479;4795;81;204;2197;4099;2278;4303
355150;202211;6225;14588;5058;12656;563;1542;3326;7873;3889;9415
355160;202211;2963;7439;2131;6026;484;1494;608;1524;1092;3018
355170;202211;15469;35512;12309;30371;1978;5470;7092;16349;9070;21819
355180;202211;3594;8367;2683;6996;499;1522;1364;3184;1863;4706
355190;202211;2373;5818;1871;5023;709;1966;570;1626;1279;3592
355200;202211;1100;3056;929;2785;263;888;324;903;587;1791
355210;202211;4032;10006;3068;8043;685;1864;1324;3231;2009;5095
355220;202211;68324;162051;55696;138930;7588;21622;32620;73428;40208;95050
355230;202211;1503;3616;806;2227;149;433;303;699;452;1132
355240;202211;31365;77412;22716;61071;2401;7262;13990;34871;16391;42133
355250;202211;52032;125539;40194;103628;8326;23157;20072;47394;28398;70551
355255;202211;787;1864;413;1192;51;137;126;345;177;482
355260;202211;2003;4271;1479;3482;117;356;1044;2241;1161;2597
355270;202211;1493;4000;1174;3380;271;802;500;1317;771;2119
355280;202211;42212;97396;31358;78235;3761;10392;18318;42107;22079;52499
355290;202211;1187;2885;930;2474;183;494;455;1119;638;1613
355300;202211;1764;4666;1455;4106;244;745;660;1645;904;2390
355310;202211;1150;2890;849;2356;112;345;486;1277;598;1622
355320;202211;700;1736;512;1380;111;346;204;443;315;789
355330;202211;3846;8889;3014;7475;128;418;2311;5356;2439;5774
355340;202211;5219;10873;4006;9317;752;1777;1982;4724;2734;6501
355350;202211;1789;4565;1363;3771;249;790;610;1499;859;2289
355360;202211;1658;3791;1300;3246;146;397;767;1725;913;2122
355365;202211;449;1058;243;706;44;125;75;192;119;317
355370;202211;7179;16724;5633;14332;1229;2833;2654;6968;3883;9801
355380;202211;3750;9120;2881;7596;572;1656;1108;2470;1680;4126
355385;202211;1783;4205;1454;3721;111;349;954;2202;1065;2551
355390;202211;1001;2574;722;2006;108;337;347;838;455;1175
355395;202211;2251;5987;1623;4727;263;864;682;1700;945;2564
355400;202211;12060;31618;9751;27261;2071;6603;4208;10334;6279;16937
355410;202211;31582;79942;21260;59443;4118;12723;8020;20508;12138;33231
355420;202211;767;2254;632;2004;132;477;207;596;339;1073
355430;202211;4748;10993;3685;9172;613;1681;1951;4587;2564;6268
355440;202211;922;2311;590;1663;100;278;130;294;230;572
355450;202211;4557;10878;3162;8266;457;1333;1565;3555;2022;4888
355460;202211;603;1398;400;1056;41;120;177;432;218;552
355465;202211;546;1296;436;1122;59;147;279;702;338;849
355470;202211;1481;3522;868;2339;228;684;302;716;530;1400
355475;202211;423;911;343;808;17;44;253;566;270;610
355480;202211;5389;13663;4291;11945;606;1937;2696;7174;3302;9111
355490;202211;1123;2852;639;1884;71;233;299;794;370;1027
355495;202211;1170;2883;864;2370;117;399;404;936;521;1335
355500;202211;8918;21008;5922;15473;799;2418;2794;6331;3593;8749
355510;202211;1684;3901;1145;3008;204;550;486;1137;690;1687
355520;202211;385;883;191;544;37;114;47;118;84;232
355530;202211;369;801;160;411;8;30;91;203;99;233
355535;202211;667;1689;532;1467;103;330;272;647;375;977
355540;202211;17080;37297;14340;33537;1506;3915;10381;23208;11887;27123
355550;202211;807;2179;682;1950;82;271;392;995;474;1266
355560;202211;1372;3383;783;2242;173;546;31;98;204;644
355570;202211;358;885;199;553;49;142;55;136;104;278
355580;202211;1503;3454;874;2312;158;468;240;554;398;1022
355590;202211;208;511;154;424;17;48;81;213;98;261
355600;202211;1750;4122;1111;2978;162;475;304;749;466;1224
355610;202211;2484;5697;1696;4350;260;724;932;2139;1192;2863
355620;202211;6463;15907;4963;13116;533;1720;2955;6981;3488;8701
355630;202211;3289;8037;2387;6382;269;796;1417;3426;1686;4222
355635;202211;1235;3304;887;2609;135;419;326;869;461;1288
355640;202211;4392;11222;2931;8385;701;1982;564;1587;1265;3569
355645;202211;4815;12534;3511;10214;507;1629;1916;5253;2423;6882
355650;202211;9849;23951;7947;20623;1586;4358;3986;9448;5572;13806
355660;202211;1710;4187;1124;3153;211;548;253;648;464;1196
355670;202211;5512;13520;3980;10344;508;1623;2083;4579;2591;6202
355680;202211;3428;8909;1727;5149;468;1494;130;348;598;1842
355690;202211;898;2461;603;1908;183;606;11;20;194;626
355695;202211;324;832;190;554;20;63;39;81;59;144
355700;202211;10533;26877;8889;23532;1093;3293;5492;13490;6585;16783
355710;202211;12867;28367;8914;21266;1197;3407;4828;9817;6025;13224
355715;202211;567;1470;315;909;84;241;59;159;143;400
355720;202211;1868;4664;1464;3982;236;712;801;1971;1037;2683
355730;202211;1328;3294;1057;2831;107;342;608;1484;715;1826
410010;202211;1507;3952;1130;3172;247;726;268;687;515;1413
410020;202211;1356;3596;996;2846;290;808;265;690;555;1498
410030;202211;2113;5132;1746;4563;254;684;900;2325;1154;3009
410040;202211;18266;46092;13499;37409;2841;8381;4473;11206;7314;19587
410045;202211;900;2322;661;1830;131;406;197;456;328;862
410050;202211;2685;6476;1883;5108;305;935;684;1668;989;2603
410060;202211;2519;6611;2015;5696;504;1541;578;1489;1082;3030
410070;202211;2416;5701;1756;4538;337;978;690;1536;1027;2514
410080;202211;1638;4128;1172;3331;265;781;247;633;512;1414
410090;202211;1400;3080;1130;2701;145;305;549;1428;694;1733
410100;202211;2553;6790;1737;4997;316;987;168;427;484;1414
410105;202211;661;1514;421;1067;28;85;235;517;263;602
410110;202211;4030;9225;2883;7258;364;1042;1528;3444;1892;4486
410115;202211;669;1645;480;1314;59;180;192;453;251;633
410120;202211;3999;9404;3509;8684;591;1406;2247;5475;2838;6881
410130;202211;1618;3897;1417;3551;203;544;841;2020;1044;2564
410140;202211;21583;49282;14429;36881;2676;7471;4767;10763;7443;18234
410150;202211;20132;45480;11001;28236;1834;5173;3658;7904;5492;13077
410160;202211;3624;9532;2932;8323;626;2016;1095;2856;1721;4872
410165;202211;745;1911;580;1570;78;241;293;730;371;971
410170;202211;3546;8627;2185;5833;397;1150;339;747;736;1897
410180;202211;21380;54872;16614;45571;2718;8248;8258;20117;10976;28365
410185;202211;546;1481;406;1148;78;236;141;336;219;572
410190;202211;2696;6392;1922;5020;397;1068;510;1125;907;2193
410200;202211;7059;15142;3938;9955;773;2115;765;1666;1538;3781
410210;202211;3802;9084;2367;6557;376;1173;795;1832;1171;3005
410220;202211;656;1605;442;1211;92;267;146;347;238;614
410230;202211;2401;5975;1818;4835;278;847;779;1737;1057;2584
410240;202211;6159;15366;4258;11820;842;2712;703;1640;1545;4352
410250;202211;2799;6385;2048;5195;238;633;945;2275;1183;2908
410260;202211;2450;5538;1560;3942;292;729;773;1791;1065;2520
410270;202211;593;1471;424;1171;57;190;172;395;229;585
410275;202211;727;1888;496;1399;76;248;210;517;286;765
410280;202211;2865;7069;1959;5382;256;808;875;2105;1131;2913
410290;202211;3907;10103;2700;7690;856;2357;706;1976;1562;4333
410300;202211;843;1956;667;1691;68;208;355;781;423;989
410302;202211;402;955;243;676;27;90;108;275;135;365
410304;202211;1818;3942;1551;3494;163;400;1043;2275;1206;2675
410305;202211;2093;4639;1471;3737;149;425;961;2295;1110;2720
410310;202211;3789;8870;3122;7746;244;822;2119;4819;2363;5641
410315;202211;897;1905;561;1388;167;414;170;410;337;824
410320;202211;1166;3107;746;2254;93;300;116;294;209;594
410322;202211;782;2010;396;1146;52;154;138;330;190;484
410330;202211;1805;4144;1254;3148;204;517;432;970;636;1487
410335;202211;1019;2533;763;2074;133;391;285;690;418;1081
410337;202211;959;2276;658;1709;93;256;232;515;325;771
410340;202211;556;1485;373;1049;29;99;163;368;192;467
410345;202211;3301;8089;2028;5479;460;1246;756;1814;1216;3060
410347;202211;925;2241;681;1825;89;248;197;494;286;742
410350;202211;2010;4590;1448;3718;140;424;831;1890;971;2314
410360;202211;4797;11495;3525;9288;612;1680;1189;2962;1801;4642
410370;202211;17376;43774;11420;30415;1350;4110;4929;10831;6279;14941
410380;202211;2150;4908;1510;3818;218;625;576;1256;794;1881
410390;202211;3542;7899;2381;6017;492;1501;969;2051;1461;3552
410395;202211;1094;2890;852;2431;180;514;311;904;491;1418
410400;202211;9763;22432;7455;18352;865;2426;4646;10349;5511;12775
410405;202211;1087;2391;761;1908;114;323;381;854;495;1177
410410;202211;1942;4530;1729;4202;131;378;1206;2853;1337;3231
410420;202211;15194;37512;11507;30580;1893;5486;5234;12260;7127;17746
410425;202211;4576;11594;3162;8785;563;1650;1192;2909;1755;4559
410430;202211;16407;38302;11653;29943;1802;5146;4752;10817;6554;15963
410440;202211;2955;7701;2549;6971;401;1227;1419;3649;1820;4876
410442;202211;3031;8272;2399;6976;671;2030;622;1690;1293;3720
410445;202211;2732;7230;1862;5554;396;1293;258;815;654;2108
410450;202211;1857;4299;1370;3563;238;650;473;1121;711;1771
410460;202211;2969;6817;2130;5382;309;888;1056;2341;1365;3229
410465;202211;3647;9643;2774;8038;547;1619;933;2291;1480;3910
410470;202211;2944;7500;2078;6008;640;2097;193;541;833;2638
410480;202211;49521;112657;28512;76781;4136;12577;8616;19194;12752;31771
410490;202211;14542;36786;10602;29009;1761;5241;4848;11766;6609;17007
410500;202211;2203;5341;1431;3918;286;812;301;644;587;1456
410510;202211;2217;5168;1542;4019;340;857;469;1205;809;2062
410520;202211;3684;10475;3227;9624;1017;3226;1186;3463;2203;6689
410530;202211;1871;4390;892;2409;119;367;247;516;366;883
410540;202211;3436;8622;2387;6588;398;1269;1042;2543;1440;3812
410550;202211;9469;23820;6472;17671;1080;3295;1984;4447;3064;7742
410560;202211;1892;4602;1373;3601;301;876;389;820;690;1696
410570;202211;3305;8138;2333;6474;801;2563;241;609;1042;3172
410580;202211;35988;85187;27187;69699;4047;11703;14289;33238;18336;44941
410590;202211;2093;5407;1440;3935;199;585;459;1000;658;1585
410600;202211;2217;5351;1719;4439;355;915;637;1560;992;2475
410610;202211;842;2010;625;1628;55;164;316;724;371;888
410620;202211;3451;8672;2468;6628;619;1809;686;1592;1305;3401
410630;202211;3107;7487;2060;5490;393;1243;495;980;888;2223
410640;202211;6234;13733;4273;10383;939;2509;692;1662;1631;4171
410645;202211;1707;3905;1428;3565;142;396;1119;2729;1261;3125
410650;202211;3052;7693;2104;5809;410;1233;874;2118;1284;3351
410655;202211;1030;2354;705;1810;81;250;293;635;374;885
410657;202211;734;1882;459;1301;67;210;197;449;264;659
410660;202211;4564;10606;2780;7035;429;1167;1037;2247;1466;3414
410670;202211;1202;2863;727;1958;119;332;270;615;389;947
410680;202211;2860;8026;1888;5690;439;1350;325;950;764;2300
410685;202211;635;1538;458;1224;101;294;190;465;291;759
410690;202211;177368;403075;123992;307929;18993;53792;55395;118475;74388;172267
410700;202211;2987;7116;2424;6257;556;1502;931;2201;1487;3703
410710;202211;1087;2592;694;1870;173;499;273;639;446;1138
410712;202211;822;2095;680;1833;102;286;370;952;472;1238
410715;202211;1050;2808;649;1954;75;256;268;730;343;986
410720;202211;4659;10755;3828;9399;537;1632;1439;3229;1976;4861
410725;202211;1436;3308;881;2328;204;602;193;394;397;996
410730;202211;989;2373;687;1831;98;305;153;392;251;697
410740;202211;1017;2678;768;2222;60;213;395;1103;455;1316
410750;202211;2391;5408;1864;4488;310;803;908;2006;1218;2809
410752;202211;474;1089;254;682;74;183;80;201;154;384
410753;202211;415;1132;293;880;36;118;92;243;128;361
410754;202211;1391;3225;1139;2864;81;207;821;2081;902;2288
410755;202211;685;1645;494;1311;62;166;231;543;293;709
410760;202211;4409;10816;3119;8541;742;2438;846;2098;1588;4536
410765;202211;22222;55685;17565;47187;3531;10533;5885;13253;9416;23786
410770;202211;1231;2784;847;2154;83;182;424;1066;507;1248
410773;202211;1614;3823;1370;3428;191;543;862;1995;1053;2538
410775;202211;2036;4234;1781;3882;43;112;1387;2848;1430;2960
410780;202211;754;1768;503;1311;94;262;161;374;255;636
410785;202211;964;2188;699;1775;97;291;309;740;406;1031
410790;202211;1288;3485;1050;3047;230;723;155;348;385;1071
410800;202211;4229;8408;3373;7229;67;193;2359;4748;2426;4941
410810;202211;546;1362;404;1095;45;163;206;470;251;633
410820;202211;1229;3233;672;1850;153;444;140;289;293;733
410830;202211;55760;121930;40124;96493;6350;17709;19809;42573;26159;60282
410832;202211;1340;3284;1088;2856;94;306;678;1594;772;1900
410840;202211;11160;26316;6576;17732;1330;4082;1929;4070;3259;8152
410845;202211;1469;3175;1159;2736;139;373;699;1497;838;1870
410850;202211;2608;6718;2241;6086;424;1303;1066;2654;1490;3957
410855;202211;856;2028;539;1424;67;202;268;594;335;796
410860;202211;5974;12961;4744;10992;221;694;3356;7093;3577;7787
410865;202211;1742;4589;1476;4108;203;606;779;2252;982;2858
410870;202211;1435;3569;1123;3036;147;434;623;1603;770;2037
410880;202211;5780;14440;3931;11126;702;2030;725;2036;1427;4066
410890;202211;1405;3536;1112;3005;209;575;497;1237;706;1812
410895;202211;1220;3549;994;3058;321;1105;254;662;575;1767
410900;202211;1016;2563;680;1972;98;305;161;341;259;646
410910;202211;532;1152;329;785;18;46;193;404;211;450
410920;202211;1119;2452;827;2008;105;294;459;1026;564;1320
410930;202211;2112;5066;1444;3956;366;1117;247;582;613;1699
410940;202211;30771;76657;22624;62426;4324;13372;9144;22853;13468;36225
410950;202211;2436;6209;2159;5774;186;478;1642;4327;1828;4805
410960;202211;10724;23921;7546;18903;2023;5913;3004;6701;5027;12614
410965;202211;1363;3306;858;2370;114;359;384;950;498;1309
410970;202211;5201;13079;3635;10062;904;2960;664;1392;1568;4352
410975;202211;1798;3988;1309;3208;190;520;580;1314;770;1834
410980;202211;9185;21259;5992;15695;640;1911;2943;6777;3583;8688
410990;202211;1833;4011;1268;3174;222;624;600;1427;822;2051
411000;202211;818;2107;563;1647;102;333;176;435;278;768
411005;202211;569;1328;353;910;42;115;142;302;184;417
411007;202211;3106;7628;2259;6145;452;1371;829;2025;1281;3396
411010;202211;5567;14978;4247;12380;1199;3587;727;1811;1926;5398
411020;202211;2868;7401;2340;6531;596;1757;728;1908;1324;3665
411030;202211;858;2028;578;1483;79;235;252;534;331;769
411040;202211;1229;2948;648;1744;126;329;180;404;306;733
411050;202211;2412;7014;1889;5924;398;1390;340;858;738;2248
411060;202211;2734;6796;1748;4805;342;978;512;1174;854;2152
411065;202211;465;1118;289;769;28;89;120;282;148;371
411070;202211;9595;22025;7584;18823;1014;2938;4188;9499;5202;12437
411080;202211;2441;5953;1955;5123;468;1406;593;1374;1061;2780
411090;202211;947;2425;580;1702;80;255;139;349;219;604
411095;202211;2990;6739;1722;4532;241;663;310;663;551;1326
411100;202211;1481;3593;980;2678;115;389;352;870;467;1259
411110;202211;771;1955;356;1063;39;109;29;53;68;162
411120;202211;1989;4810;1634;4261;284;919;794;1811;1078;2730
411125;202211;6628;17609;5792;16137;1526;4422;2257;6278;3783;10700
411130;202211;902;2221;626;1700;170;445;173;479;343;924
411140;202211;2631;7538;2125;6487;522;1660;612;1869;1134;3529
411150;202211;4922;11700;3218;8396;664;1877;330;660;994;2537
411155;202211;1328;3050;895;2283;113;343;464;977;577;1320
411160;202211;477;1003;306;735;35;99;89;208;124;307
411170;202211;987;2628;745;2137;167;535;318;839;485;1374
411180;202211;6618;15661;5373;13492;744;2135;2992;6731;3736;8866
411190;202211;2568;6187;1952;5134;263;783;890;2017;1153;2800
411200;202211;6185;15276;4660;12588;965;3022;1548;3371;2513;6393
411210;202211;4340;9114;3057;7050;393;1056;1446;3004;1839;4060
411220;202211;1188;2789;809;2115;164;452;273;638;437;1090
411230;202211;1028;2584;754;2067;172;497;240;598;412;1095
411240;202211;1910;4263;1329;3310;236;631;515;1177;751;1808
411250;202211;2764;6772;1976;5395;410;1240;576;1388;986;2628
411260;202211;380;925;247;666;34;120;106;238;140;358
411270;202211;2433;6045;1767;4772;273;797;840;2003;1113;2800
411275;202211;1998;4090;1419;3211;139;406;898;1790;1037;2196
411280;202211;1810;4507;1308;3578;300;888;414;975;714;1863
411290;202211;1023;2455;663;1768;68;229;356;865;424;1094
411295;202211;1532;3651;1111;2893;183;506;497;1157;680;1663
411300;202211;1208;2878;755;2023;89;265;284;594;373;859
411310;202211;1155;2368;894;2033;150;386;477;976;627;1362
411320;202211;7184;16622;5393;13549;773;2207;2690;5782;3463;7989
411325;202211;1722;4451;1391;3843;274;776;656;1848;930;2624
411330;202211;3941;9873;2892;8037;685;2123;864;2216;1549;4339
411340;202211;990;2558;591;1709;87;265;178;426;265;691
411342;202211;1275;2932;691;1789;123;360;262;556;385;916
411345;202211;1486;3448;1066;2732;72;221;696;1702;768;1923
411350;202211;3601;9049;2348;6600;612;1838;372;892;984;2730
411360;202211;958;2074;715;1699;75;231;396;796;471;1027
411370;202211;72476;168560;53168;136528;4176;12874;31753;73826;35929;86700
411373;202211;1748;4056;1364;3491;160;428;656;1675;816;2103
411375;202211;1341;3179;912;2377;114;314;361;842;475;1156
411380;202211;1409;3030;945;2197;39;106;636;1340;675;1446
411390;202211;1905;4731;1468;3834;232;697;635;1342;867;2039
411400;202211;2881;6502;2172;5289;218;620;1230;2734;1448;3354
411410;202211;3556;9358;2623;7431;611;1914;671;1625;1282;3539
411420;202211;5101;11899;2721;7492;373;1146;532;1047;905;2193
411430;202211;4933;11897;3725;9748;719;2102;1305;2870;2024;4972
411435;202211;535;1354;302;887;41;123;71;162;112;285
411440;202211;3234;8201;2424;6683;514;1520;696;1683;1210;3203
411450;202211;3153;7646;2367;6371;339;900;1319;3518;1658;4418
411460;202211;5483;13422;3458;9622;528;1685;857;1885;1385;3570
411470;202211;1086;2508;833;2088;103;327;453;984;556;1311
411480;202211;6629;16204;4802;12919;937;2969;1515;3408;2452;6377
411490;202211;2070;4812;1560;4037;206;600;705;1626;911;2226
411500;202211;1674;4148;1164;3105;202;590;264;526;466;1116
411510;202211;2824;6391;2210;5451;341;1008;674;1584;1015;2592
411520;202211;43876;101662;26436;68226;3127;9611;11812;25971;14939;35582
411530;202211;1134;2733;614;1749;94;310;127;317;221;627
411535;202211;623;1721;416;1269;50;163;124;330;174;493
411540;202211;3222;7299;2283;5662;141;357;1385;3271;1526;3628
411545;202211;1081;2894;904;2573;69;219;589;1637;658;1856
411550;202211;845;1969;645;1619;89;241;221;469;310;710
411560;202211;2352;6170;1266;3827;199;646;100;203;299;849
411570;202211;9430;20406;6608;16214;1548;4112;2158;4792;3706;8904
411573;202211;952;2380;765;2058;128;408;402;953;530;1361
411575;202211;2475;6128;1801;4855;332;951;578;1406;910;2357
411580;202211;5439;12498;3253;8839;475;1462;579;1185;1054;2647
411585;202211;719;2030;356;1131;61;188;57;163;118;351
411590;202211;562;1403;415;1118;43;138;225;539;268;677
411600;202211;422;985;268;730;41;110;110;264;151;374
411605;202211;1927;4153;1240;3103;156;450;600;1502;756;1952
411610;202211;3580;7268;2607;5643;65;210;1971;3857;2036;4067
411620;202211;3688;8697;3058;7754;536;1412;1485;3700;2021;5112
411630;202211;1031;2459;671;1838;107;365;265;590;372;955
411640;202211;561;1398;378;1015;49;142;135;297;184;439
411650;202211;234;627;148;445;26;83;38;92;64;175
411660;202211;1063;2497;737;1887;100;264;307;678;407;942
411670;202211;1876;4140;1247;3028;124;325;720;1577;844;1902
411680;202211;1716;4296;1266;3428;241;723;452;1104;693;1827
411690;202211;4866;11476;3550;9211;771;1978;1087;2821;1858;4799
411695;202211;761;2124;519;1528;46;143;231;615;277;758
411700;202211;1975;4883;1336;3687;323;931;281;696;604;1627
411705;202211;2974;7548;2496;6761;399;1135;1564;4248;1963;5383
411710;202211;2528;6055;1728;4593;362;1004;526;1212;888;2216
411720;202211;1269;2928;887;2257;134;352;310;710;444;1062
411721;202211;1195;2842;874;2262;151;395;271;637;422;1032
411722;202211;1141;2971;665;1900;111;327;239;547;350;874
411725;202211;1543;4125;980;3009;234;784;219;591;453;1375
411727;202211;1715;4476;1117;3241;228;675;138;296;366;971
411729;202211;704;1704;406;1126;73;241;113;242;186;483
411730;202211;6756;16288;5176;13330;1015;2961;2260;5368;3275;8329
411740;202211;588;1467;320;907;76;198;68;150;144;348
411745;202211;938;2526;641;1872;88;284;156;342;244;626
411750;202211;7738;18766;5715;15060;733;2131;2895;7074;3628;9205
411760;202211;9152;21990;6872;18349;2049;5715;1469;3970;3518;9685
411770;202211;3982;10680;2918;8451;643;1986;660;1666;1303;3652
411780;202211;3225;8281;2715;7415;712;1987;932;2636;1644;4623
411790;202211;3855;8628;2384;6087;331;1007;930;1947;1261;2954
411800;202211;1405;3773;1001;2817;191;594;247;551;438;1145
411810;202211;1867;4521;1356;3550;223;631;504;1142;727;1773
411820;202211;20498;49037;17231;43668;3898;10124;9006;21931;12904;32055
411830;202211;586;1426;430;1140;104;232;64;163;168;395
411840;202211;15391;37976;10773;28899;1640;4825;4013;9208;5653;14033
411845;202211;773;2054;474;1397;72;245;138;352;210;597
411850;202211;9872;23296;6804;18058;1773;5012;1386;3103;3159;8115
411860;202211;910;2387;668;1901;105;329;149;396;254;725
411870;202211;711;1923;515;1508;131;447;93;210;224;657
411880;202211;2973;6565;2145;5267;300;811;983;2194;1283;3005
411885;202211;1290;3214;898;2481;123;386;246;547;369;933
411890;202211;1802;4513;1303;3661;239;721;144;368;383;1089
411900;202211;1030;2619;631;1796;164;493;90;230;254;723
411910;202211;1312;3635;937;2870;188;677;303;801;491;1478
411915;202211;19970;46017;13818;35053;2063;5819;6100;13597;8163;19416
411920;202211;1438;3790;1172;3309;276;866;441;1099;717;1965
411925;202211;581;1409;389;1059;72;204;179;433;251;637
411930;202211;6222;17004;5238;15270;2545;7802;588;1852;3133;9654
411940;202211;4100;10854;3191;9070;744;2182;1147;2871;1891;5053
411950;202211;19517;47585;16195;42296;1878;5720;10260;25021;12138;30741
411960;202211;7271;17861;5694;14916;1036;3047;2304;5327;3340;8374
411965;202211;598;1540;429;1200;61;186;203;498;264;684
411970;202211;1425;2906;1104;2489;216;411;495;1316;711;1727
411980;202211;2029;4406;1485;3594;287;709;705;1582;992;2291
411990;202211;49671;120557;33461;92046;5904;18009;14075;35264;19979;53273
411995;202211;6167;13812;4722;11617;1289;3576;1468;3297;2757;6873
412000;202211;2389;5007;1720;3903;41;126;1309;2726;1350;2852
412010;202211;732;2044;490;1532;59;205;116;269;175;474
412015;202211;629;1646;503;1410;79;234;258;707;337;941
412020;202211;565;1521;341;1054;52;183;109;296;161;479
412030;202211;761;1989;575;1656;75;233;262;675;337;908
412033;202211;1116;2759;771;2118;86;244;316;746;402;990
412035;202211;837;2143;531;1580;95;300;244;683;339;983
412040;202211;850;2133;526;1490;76;222;133;293;209;515
412050;202211;1732;4092;1197;3156;297;867;243;610;540;1477
412060;202211;8933;23632;7211;20252;1905;6083;2016;5129;3921;11212
412065;202211;765;1932;557;1539;100;296;145;365;245;661
412070;202211;1595;3762;1232;3098;144;411;587;1243;731;1654
412080;202211;3282;7880;2414;6263;314;928;1229;2653;1543;3581
412085;202211;399;929;151;430;11;42;43;85;54;127
412090;202211;7943;18432;5848;14911;1257;3532;2536;6176;3793;9708
412100;202211;2263;5549;1655;4507;499;1481;411;1133;910;2614
412110;202211;1148;2848;698;1943;80;237;221;508;301;745
412120;202211;2818;7212;2173;6090;458;1460;681;1603;1139;3063
412125;202211;892;2335;555;1646;92;267;125;347;217;614
412130;202211;946;2238;619;1634;114;305;141;347;255;652
412135;202211;693;1767;343;1002;43;159;134;319;177;478
412140;202211;2408;5496;1696;4283;294;809;453;1075;747;1884
412150;202211;3371;8047;2787;7042;507;1474;1425;3169;1932;4643
412160;202211;1053;3153;547;1789;39;126;45;98;84;224
412170;202211;5653;13879;4694;12383;864;2497;2250;5295;3114;7792
412175;202211;1599;4262;1298;3721;309;906;441;1223;750;2129
412180;202211;2054;5291;1508;4306;205;674;605;1546;810;2220
412190;202211;3925;9277;2788;7269;348;1039;1176;2763;1524;3802
412200;202211;2340;6212;1513;4388;387;1232;307;761;694;1993
412210;202211;787;1786;483;1292;69;208;220;529;289;737
412215;202211;4064;10098;2882;7797;632;1799;1270;3383;1902;5182
412217;202211;1235;2872;1006;2482;17;60;766;1740;783;1800
412220;202211;7292;19700;5775;16876;1339;3927;1569;4432;2908;8359
412230;202211;3366;9048;2595;7630;379;1294;476;1170;855;2464
412240;202211;9739;23899;6384;17565;1126;3359;2028;4751;3154;8110
412250;202211;2346;5711;1681;4486;415;1196;344;747;759;1943
412260;202211;1657;3993;1243;3204;226;602;419;971;645;1573
412265;202211;1240;2948;986;2553;115;340;630;1492;745;1832
412270;202211;1278;3297;849;2409;111;350;349;859;460;1209
412280;202211;505;1297;379;1070;83;237;92;220;175;457
412290;202211;1291;3002;939;2414;161;446;357;844;518;1290
412300;202211;2186;5221;1596;4226;268;749;522;1216;790;1965
412310;202211;789;2180;564;1718;100;366;150;367;250;733
412320;202211;889;2169;553;1506;56;208;183;448;239;656
412330;202211;1934;4745;1266;3537;260;801;342;876;602;1677
412340;202211;1438;3653;1006;2820;157;488;141;354;298;842
412350;202211;3830;9517;2499;6964;457;1385;666;1572;1123;2957
412360;202211;346;831;261;674;5;18;187;457;192;475
412370;202211;1344;3401;931;2621;193;556;224;585;417;1141
412380;202211;1819;4789;1298;3785;319;996;79;242;398;1238
412382;202211;597;1378;389;1028;42;147;207;443;249;590
412385;202211;2871;6886;2257;5786;636;1588;818;2162;1454;3750
412390;202211;3017;6851;2340;5767;433;1132;747;1748;1180;2880
412395;202211;908;2320;638;1748;88;249;315;794;403;1043
412400;202211;1138;2766;782;2093;138;399;249;566;387;965
412402;202211;2922;6742;2005;5276;435;1129;577;1496;1012;2625
412405;202211;3662;9210;2387;6909;663;1905;345;916;1008;2821
412410;202211;7881;19226;5778;15849;1046;3321;1895;4668;2941;7989
412420;202211;632;1492;398;1044;39;117;165;381;204;498
412430;202211;654;1577;357;964;49;126;143;357;192;483
412440;202211;3621;8766;2533;6911;579;1616;783;2015;1362;3631
412450;202211;635;1741;398;1175;52;161;41;77;93;238
412460;202211;1412;3222;1077;2682;197;532;492;1163;689;1695
412470;202211;1926;5509;1567;4742;371;1270;443;1185;814;2455
412480;202211;1625;3792;1096;2792;190;527;444;978;634;1505
412490;202211;1619;3666;1234;3026;82;237;736;1630;818;1867
412500;202211;2491;5799;1827;4637;309;853;615;1351;924;2204
412510;202211;2352;6566;1680;4983;452;1451;310;685;762;2136
412520;202211;1670;4001;1011;2721;202;532;159;376;361;908
412530;202211;818;2075;591;1640;101;294;135;342;236;636
412535;202211;959;2428;553;1600;80;244;67;133;147;377
412540;202211;1291;3158;914;2500;169;590;226;573;395;1163
412545;202211;866;2127;568;1548;100;288;183;467;283;755
412550;202211;45766;112063;33462;88787;4851;14252;16117;37650;20968;51902
412555;202211;354;855;233;600;28;94;80;146;108;240
412560;202211;6525;16943;4845;13368;1154;3533;1166;2770;2320;6303
412570;202211;5514;12807;3307;8791;571;1722;641;1355;1212;3077
412575;202211;1377;3104;1085;2631;211;520;552;1201;763;1721
412580;202211;1941;4521;1381;3544;120;344;785;1804;905;2148
412590;202211;546;1358;289;816;57;179;39;73;96;252
412600;202211;2083;4926;1641;4112;103;338;1075;2430;1178;2768
412610;202211;1009;2535;726;1955;97;274;333;764;430;1038
412620;202211;1539;3694;1184;3145;227;662;504;1210;731;1872
412625;202211;11390;28670;7500;21150;1490;4485;1040;2398;2530;6883
412627;202211;1379;3592;954;2783;229;751;206;538;435;1289
412630;202211;3351;9268;2313;7070;386;1290;557;1466;943;2756
412635;202211;545;1370;337;962;50;158;100;225;150;383
412640;202211;1192;3000;682;1936;102;288;127;284;229;572
412650;202211;2037;5244;1592;4342;260;802;629;1496;889;2298
412660;202211;3460;8122;2447;6253;284;820;963;2124;1247;2944
412665;202211;502;1186;380;978;75;208;154;366;229;574
412667;202211;2033;5106;1461;3992;221;674;622;1595;843;2269
412670;202211;1144;2440;772;1858;141;395;321;623;462;1018
412680;202211;2513;6288;1694;4802;184;598;518;1194;702;1792
412690;202211;1394;3365;967;2561;181;528;347;796;528;1324
412700;202211;2283;5514;1875;4876;385;1106;882;2102;1267;3208
412710;202211;6859;18500;5061;14858;891;2862;1401;3330;2292;6192
412720;202211;1556;4152;1249;3533;188;585;397;855;585;1440
412730;202211;3312;7951;2427;6313;406;1210;1041;2343;1447;3553
412740;202211;2468;6420;1661;4886;316;1041;282;750;598;1791
412750;202211;4816;11810;3855;10312;467;1398;2206;5490;2673;6888
412760;202211;3844;9368;3179;8266;610;1847;1750;4173;2360;6020
412770;202211;14633;36167;8169;23660;1082;3357;1987;4670;3069;8027
412780;202211;1534;3707;1113;2979;263;796;374;873;637;1669
412785;202211;2692;5805;1873;4496;252;637;1205;2746;1457;3383
412788;202211;1678;4423;1346;3841;339;985;516;1373;855;2358
412790;202211;1669;4114;1053;2958;169;533;411;941;580;1474
412795;202211;1454;3522;843;2349;135;414;198;468;333;882
412796;202211;2676;7158;2240;6411;506;1569;723;1876;1229;3445
412800;202211;5123;11142;3700;8675;376;1102;2075;4154;2451;5256
412810;202211;16032;38257;10757;28084;1228;3703;4704;10585;5932;14288
412820;202211;7752;19906;5492;15498;1339;4017;1529;4055;2868;8072
412830;202211;414;1095;306;879;36;99;85;217;121;316
412840;202211;2380;5200;1699;3966;133;393;1070;2179;1203;2572
412850;202211;3354;8139;2505;6769;289;924;1277;3090;1566;4014
412853;202211;1984;4505;1658;3958;198;564;978;1994;1176;2558
412855;202211;1645;4000;866;2393;123;378;194;401;317;779
412860;202211;896;2152;581;1625;106;326;222;531;328;857
412862;202211;786;1868;527;1440;100;261;212;537;312;798
412863;202211;1535;4153;1344;3804;288;916;656;1652;944;2568
412865;202211;817;2087;586;1622;152;439;153;389;305;828
412870;202211;1184;2815;843;2279;239;727;236;602;475;1329
412880;202211;1134;2893;824;2322;177;539;298;746;475;1285
420005;202211;535;1481;311;938;29;82;150;440;179;522
420010;202211;3904;8861;2594;6649;169;489;1910;4828;2079;5317
420020;202211;567;1665;384;1217;73;269;136;335;209;604
420030;202211;149;498;108;392;27;107;28;96;55;203
420040;202211;714;2059;431;1425;83;314;35;97;118;411
420050;202211;922;2089;635;1552;112;322;375;793;487;1115
420055;202211;202;582;115;368;21;79;42;119;63;198
420060;202211;211;574;151;437;22;65;71;193;93;258
420070;202211;1074;2914;836;2445;167;541;439;1192;606;1733
420075;202211;96;244;50;150;7;25;19;39;26;64
420080;202211;510;1396;353;1008;72;221;109;264;181;485
420090;202211;538;1577;348;1142;74;267;84;222;158;489
420100;202211;1832;4106;1496;3583;106;258;1108;2623;1214;2881
420110;202211;353;1040;297;921;46;163;161;476;207;639
420120;202211;763;1963;528;1471;72;226;268;671;340;897
420125;202211;453;1303;315;990;64;206;101;294;165;500
420127;202211;395;1017;173;511;31;107;67;178;98;285
420130;202211;5798;15042;4428;12661;850;2785;1850;4511;2700;7296
420140;202211;5628;14121;4327;11895;1200;3676;1145;2788;2345;6464
420150;202211;843;2039;624;1692;50;155;363;938;413;1093
420160;202211;258;616;110;318;20;74;35;87;55;161
420165;202211;216;617;132;419;27;94;37;90;64;184
420170;202211;389;1092;303;890;52;171;138;336;190;507
420180;202211;189;584;106;380;16;73;27;85;43;158
420190;202211;265;747;157;478;32;98;51;138;83;236
420195;202211;2405;5850;1869;4989;468;1427;832;1987;1300;3414
420200;202211;9510;21302;6310;15560;818;2371;3148;6437;3966;8808
420205;202211;2699;6702;1829;4952;268;797;953;2402;1221;3199
420207;202211;2736;6566;1798;4840;320;974;770;1827;1090;2801
420208;202211;427;1167;255;809;86;283;54;130;140;413
420209;202211;210;630;127;400;14;51;62;171;76;222
420210;202211;5306;12812;3840;10293;604;1826;1996;4926;2600;6752
420213;202211;991;2738;802;2353;159;511;319;882;478;1393
420215;202211;291;817;199;612;47;152;60;175;107;327
420220;202211;426;1237;290;940;48;186;112;311;160;497
420230;202211;7471;18429;5867;15524;714;2166;3393;8201;4107;10367
420240;202211;19544;51632;12812;36240;1590;5258;6028;14281;7618;19539
420243;202211;583;1379;477;1195;77;221;317;754;394;975
420245;202211;2508;5898;1916;4888;165;495;1199;2821;1364;3316
420250;202211;763;1717;668;1582;47;151;529;1170;576;1321
420253;202211;591;1352;425;1115;40;102;257;659;297;761
420257;202211;204;497;140;386;24;74;67;181;91;255
420260;202211;1538;3561;1179;3085;92;294;888;2249;980;2543
420270;202211;715;1768;363;965;44;131;161;378;205;509
420280;202211;1891;5079;1514;4298;203;687;723;1853;926;2540
420285;202211;192;529;115;338;21;86;34;64;55;150
420287;202211;581;1266;413;1029;78;204;178;425;256;629
420290;202211;7026;18572;5553;15473;776;2530;3230;8127;4006;10657
420300;202211;9628;25612;5613;16391;1074;3415;1754;4373;2828;7788
420310;202211;1129;2392;626;1541;65;179;329;720;394;899
420315;202211;1108;2861;718;2088;94;302;374;1003;468;1305
420320;202211;7952;20033;6029;16945;1724;5224;1900;4927;3624;10151
420325;202211;412;1102;288;854;42;142;115;286;157;428
420330;202211;1295;3613;814;2538;156;531;256;679;412;1210
420340;202211;1510;3640;1158;3024;261;735;456;1038;717;1773
420350;202211;1716;3805;1308;3121;150;398;880;2008;1030;2406
420360;202211;3674;9578;2011;6069;358;1168;183;490;541;1658
420370;202211;1719;4140;1379;3554;117;388;951;2257;1068;2645
420380;202211;5687;13955;3937;10792;737;2287;1753;4310;2490;6597
420390;202211;1346;3252;956;2486;181;529;337;589;518;1118
420395;202211;1559;4110;1103;3247;156;502;218;470;374;972
420400;202211;1448;3628;1023;2824;129;400;555;1415;684;1815
420410;202211;726;1794;538;1418;68;189;311;793;379;982
420415;202211;428;1151;311;890;58;192;137;371;195;563
420417;202211;776;2188;600;1808;140;406;276;866;416;1272
420419;202211;187;619;131;461;43;162;13;55;56;217
420420;202211;18019;44503;12679;34516;3184;9785;4363;10406;7547;20191
420425;202211;786;2062;542;1543;50;173;281;736;331;909
420430;202211;4164;10549;2647;7338;446;1418;1112;2618;1558;4036
420435;202211;399;998;243;709;50;153;115;320;165;473
420440;202211;1052;2557;709;1847;239;576;238;601;477;1177
420445;202211;290;666;183;473;29;82;60;118;89;200
420450;202211;1056;2916;774;2298;144;514;307;769;451;1283
420455;202211;2638;5880;1945;4835;477;1188;787;1962;1264;3150
420460;202211;12301;30502;9569;25581;1316;4091;5419;13255;6735;17346
420470;202211;779;1958;432;1193;74;233;122;264;196;497
420475;202211;85;219;38;115;5;19;12;29;17;48
420480;202211;7129;16668;4678;12494;827;2347;2042;5170;2869;7517
420490;202211;473;1241;325;916;51;168;149;377;200;545
420500;202211;1683;4323;1128;3340;200;698;521;1400;721;2098
420510;202211;190;504;113;342;19;72;33;75;52;147
420515;202211;151;409;106;313;16;60;38;85;54;145
420517;202211;884;2179;730;1895;87;241;417;1070;504;1311
420519;202211;384;933;268;738;36;109;126;331;162;440
420520;202211;353;934;197;635;30;101;8;12;38;113
420530;202211;977;2806;668;2110;124;456;221;567;345;1023
420535;202211;259;715;105;332;12;41;30;74;42;115
420540;202211;51841;117868;36328;92061;4858;14332;15770;33899;20628;48231
420543;202211;296;819;227;659;29;103;96;236;125;339
420545;202211;1847;5320;1391;4297;288;946;529;1471;817;2417
420550;202211;5318;12896;3466;9616;568;1706;1460;3790;2028;5496
420555;202211;427;1160;290;877;36;131;153;421;189;552
420560;202211;526;1179;377;968;58;153;205;515;263;668
420570;202211;3791;9098;2865;7428;464;1392;1537;3624;2001;5016
420580;202211;2194;5775;1536;4637;350;1153;468;1276;818;2429
420590;202211;3801;9793;2421;6840;388;1257;724;1614;1112;2871
420600;202211;1592;4055;1296;3514;108;402;848;2114;956;2516
420610;202211;693;1811;468;1365;104;298;219;619;323;917
420620;202211;1045;2546;720;1986;135;412;291;759;426;1171
420630;202211;1293;3694;938;2848;157;534;432;1206;589;1740
420640;202211;594;1590;310;989;81;258;23;59;104;317
420650;202211;4708;11635;3160;8501;452;1426;1418;3084;1870;4510
420660;202211;539;1314;336;880;62;176;72;150;134;326
420665;202211;891;2179;600;1678;99;309;272;657;371;966
420670;202211;1522;4141;893;2732;100;345;197;461;297;806
420675;202211;259;637;165;470;15;57;99;249;114;306
420680;202211;353;754;197;537;22;87;114;274;136;361
420690;202211;1151;3119;757;2196;107;336;258;620;365;956
420700;202211;3915;9670;3073;8195;261;807;2070;5206;2331;6013
420710;202211;1355;3650;1103;3123;136;475;631;1544;767;2019
420720;202211;1656;4217;1251;3488;195;606;740;1901;935;2507
420730;202211;4593;11199;3554;9475;609;1834;1857;4507;2466;6341
420740;202211;583;1620;338;1086;85;297;49;124;134;421
420750;202211;2685;7409;1782;5366;288;1062;674;1751;962;2813
420757;202211;131;330;64;199;8;26;31;95;39;121
420760;202211;485;1338;259;754;40;121;84;205;124;326
420765;202211;681;1862;358;1065;55;186;193;550;248;736
420768;202211;1686;4268;1452;3886;169;455;1039;2740;1208;3195
420770;202211;419;1107;182;627;19;80;36;102;55;182
420775;202211;358;946;213;654;39;135;79;209;118;344
420780;202211;1212;3244;731;2153;134;383;129;349;263;732
420785;202211;275;674;201;531;18;56;89;170;107;226
420790;202211;1446;3823;1110;3132;216;743;629;1556;845;2299
420800;202211;940;2127;590;1488;141;375;310;723;451;1098
420810;202211;1865;5210;1544;4587;373;1316;737;1860;1110;3176
420820;202211;17533;42031;12999;34744;1918;5653;6767;16687;8685;22340
420830;202211;6358;15552;4774;12755;811;2474;2152;5269;2963;7743
420840;202211;713;2143;367;1267;77;281;38;123;115;404
420845;202211;3748;9082;2611;7104;501;1632;1168;2892;1669;4524
420850;202211;1364;3980;935;2932;170;577;283;749;453;1326
420860;202211;478;1232;288;878;77;241;77;202;154;443
420870;202211;1033;2744;693;2051;150;477;239;643;389;1120
420880;202211;1494;4173;1184;3566;245;809;489;1333;734;2142
420890;202211;9956;25804;6253;18115;918;2947;2146;5271;3064;8218
420895;202211;226;623;146;432;24;77;64;165;88;242
420900;202211;2004;4735;1249;3417;163;565;572;1278;735;1843
420910;202211;44810;112223;30485;85494;4619;14860;13733;33105;18352;47965
420915;202211;570;1923;457;1642;77;311;229;800;306;1111
420917;202211;601;1445;288;710;47;92;161;393;208;485
420920;202211;113;285;48;138;3;7;13;31;16;38
420930;202211;22957;54380;17083;44207;2391;7122;9447;22035;11838;29157
420940;202211;4388;10211;2842;7610;596;1834;816;1666;1412;3500
420945;202211;234;679;137;403;25;84;56;139;81;223
420950;202211;499;1330;327;952;56;194;97;231;153;425
420960;202211;1366;3229;994;2624;154;474;450;1026;604;1500
420970;202211;2920;7372;2013;5710;416;1234;641;1808;1057;3042
420980;202211;321;1059;262;916;91;337;59;200;150;537
420985;202211;467;1227;266;828;52;176;70;188;122;364
420990;202211;451;1298;279;896;48;158;59;158;107;316
421000;202211;697;2004;482;1536;106;361;99;249;205;610
421003;202211;539;1288;189;529;14;35;16;35;30;70
421005;202211;127;362;89;278;15;46;34;109;49;155
421010;202211;4627;11647;3360;9299;587;1918;1257;2789;1844;4707
421020;202211;488;1439;387;1241;60;235;201;587;261;822
421030;202211;1301;3424;992;2804;215;674;390;997;605;1671
421040;202211;841;1922;508;1392;55;166;314;807;369;973
421050;202211;1475;3766;994;2719;157;495;380;838;537;1333
421055;202211;195;510;115;335;16;52;57;145;73;197
421060;202211;948;2538;679;1951;119;399;310;752;429;1151
421070;202211;816;2257;512;1523;80;270;236;602;316;872
421080;202211;655;1805;512;1514;84;295;223;601;307;896
421085;202211;418;1154;186;609;23;72;34;94;57;166
421090;202211;353;882;203;538;20;73;83;174;103;247
421100;202211;1088;2290;510;1352;81;227;147;322;228;549
421105;202211;1977;4965;1421;3929;257;756;625;1586;882;2342
421110;202211;1631;3828;1357;3436;119;370;890;2183;1009;2553
421120;202211;1355;3870;947;2977;132;458;305;807;437;1265
421125;202211;463;1125;330;839;88;246;139;320;227;566
421130;202211;7607;20152;6290;17544;1165;3634;3375;8671;4540;12305
421140;202211;441;1143;297;857;71;203;105;265;176;468
421145;202211;515;1338;348;998;94;307;101;237;195;544
421150;202211;941;2486;637;1843;119;394;265;642;384;1036
421160;202211;795;2039;619;1689;84;284;394;974;478;1258
421165;202211;287;808;178;528;30;91;57;135;87;226
421170;202211;1487;3656;1272;3318;115;311;943;2426;1058;2737
421175;202211;1299;3237;795;2344;150;515;333;896;483;1411
421180;202211;499;1216;282;778;35;117;145;338;180;455
421185;202211;401;982;286;759;44;130;138;320;182;450
421187;202211;322;959;196;641;39;120;72;230;111;350
421189;202211;508;1363;384;1116;59;201;164;419;223;620
421190;202211;17253;43594;12868;35204;2156;6738;5987;14426;8143;21164
421200;202211;972;2508;749;2077;98;322;412;1064;510;1386
421205;202211;280;714;213;592;43;129;89;234;132;363
421210;202211;1380;3311;782;2273;168;482;265;723;433;1205
421220;202211;1799;4912;1415;4130;375;1167;486;1261;861;2428
421223;202211;501;1223;342;946;68;206;190;489;258;695
421225;202211;1306;3438;1133;3163;128;441;764;2056;892;2497
421227;202211;876;2327;563;1663;119;380;225;644;344;1024
421230;202211;775;1944;530;1491;109;338;188;494;297;832
421240;202211;327;929;149;504;22;98;32;81;54;179
421250;202211;3204;7661;2403;6364;404;1063;1393;3504;1797;4567
421260;202211;306;938;83;260;17;54;10;25;27;79
421265;202211;1157;2572;1007;2381;86;197;836;1953;922;2150
421270;202211;477;1250;244;769;59;196;88;259;147;455
421280;202211;3171;7848;2410;6549;391;1213;1247;3129;1638;4342
421290;202211;1387;3616;658;1866;108;326;143;341;251;667
421300;202211;402;1046;196;613;28;93;37;100;65;193
421310;202211;284;774;196;591;62;191;74;208;136;399
421315;202211;371;933;229;635;47;129;80;206;127;335
421320;202211;772;2330;426;1364;39;122;64;108;103;230
421330;202211;754;2109;504;1545;105;342;144;394;249;736
421335;202211;491;1398;397;1225;62;213;194;560;256;773
421340;202211;1786;4713;1245;3727;202;673;526;1442;728;2115
421350;202211;2138;5073;1432;3894;272;794;538;1395;810;2189
421360;202211;2749;6895;1672;4750;423;1415;567;1208;990;2623
421370;202211;939;2815;598;1932;103;375;196;512;299;887
421380;202211;1082;2556;946;2353;89;268;654;1539;743;1807
421390;202211;189;500;77;260;22;76;19;55;41;131
421400;202211;794;2026;536;1525;92;298;244;610;336;908
421410;202211;234;654;127;430;36;100;33;143;69;243
421415;202211;251;657;178;478;22;67;70;159;92;226
421420;202211;767;2016;553;1545;65;202;280;710;345;912
421430;202211;117;349;75;243;10;32;14;31;24;63
421440;202211;828;2128;512;1519;103;306;212;592;315;898
421450;202211;580;1634;365;1153;51;166;43;136;94;302
421460;202211;428;1278;239;846;13;44;20;54;33;98
421470;202211;448;1198;312;935;45;143;106;315;151;458
421480;202211;3931;9940;2736;7529;375;1221;1220;2968;1595;4189
421490;202211;145;447;90;303;12;49;22;61;34;110
421500;202211;2929;7904;2046;6061;433;1493;631;1493;1064;2986
421505;202211;397;989;326;879;33;108;202;525;235;633
421507;202211;533;1369;321;914;56;176;142;354;198;530
421510;202211;521;1366;342;968;46;156;153;340;199;496
421520;202211;564;1457;328;900;46;118;117;274;163;392
421530;202211;417;1208;240;804;34;151;51;119;85;270
421535;202211;540;1332;335;908;46;138;188;467;234;605
421540;202211;428;958;251;679;25;80;102;251;127;331
421545;202211;821;2286;625;1921;123;442;298;824;421;1266
421550;202211;2862;7183;2186;5962;363;1073;1164;2988;1527;4061
421555;202211;260;713;77;242;11;38;15;25;26;63
421560;202211;121;376;72;241;13;49;24;61;37;110
421565;202211;1244;3039;903;2482;210;637;369;910;579;1547
421567;202211;627;1816;463;1381;138;447;123;358;261;805
421568;202211;391;1106;213;661;41;150;68;188;109;338
421569;202211;196;535;88;254;10;36;49;125;59;161
421570;202211;1924;5030;1397;3941;262;829;579;1379;841;2208
421575;202211;396;1084;283;783;35;121;151;366;186;487
421580;202211;6013;15332;3935;11020;551;1784;1681;3933;2232;5717
421590;202211;230;619;176;506;39;124;75;198;114;322
421600;202211;734;1845;486;1321;85;259;180;409;265;668
421605;202211;844;2133;610;1745;108;303;256;734;364;1037
421610;202211;1245;3132;860;2414;168;533;328;837;496;1370
421620;202211;4972;12332;3434;9577;660;2109;1468;3607;2128;5716
421625;202211;154;428;81;244;12;33;22;53;34;86
421630;202211;3591;8958;2366;6618;403;1283;833;1976;1236;3259
421635;202211;543;1393;367;1036;30;109;214;509;244;618
421640;202211;874;2171;628;1789;147;433;306;815;453;1248
421650;202211;3371;8495;2287;6554;477;1596;801;1976;1278;3572
421660;202211;15343;39564;11328;31785;1584;5146;5742;14297;7326;19443
421670;202211;1137;2994;791;2156;148;461;360;847;508;1308
421680;202211;2236;4417;1864;3854;106;296;1542;2961;1648;3257
421690;202211;1866;5077;1286;3854;246;811;365;989;611;1800
421700;202211;770;2176;496;1519;94;315;140;344;234;659
421710;202211;267;804;146;459;19;63;65;183;84;246
421715;202211;201;494;149;371;24;76;92;202;116;278
421720;202211;2624;6807;1564;4543;331;1077;478;1159;809;2236
421725;202211;357;846;194;537;29;92;87;195;116;287
421730;202211;665;1853;431;1217;72;214;204;514;276;728
421740;202211;1048;2786;713;2088;123;388;283;699;406;1087
421750;202211;1186;2743;642;1761;135;390;212;533;347;923
421755;202211;213;575;117;344;20;68;44;104;64;172
421760;202211;1335;3298;861;2439;165;531;325;790;490;1321
421770;202211;3140;7755;2237;6188;429;1208;880;2319;1309;3527
421775;202211;262;675;154;445;16;52;50;109;66;161
421780;202211;1183;3144;794;2341;139;440;350;907;489;1347
421790;202211;1114;2871;603;1852;124;394;185;505;309;899
421795;202211;247;687;174;521;27;84;55;141;82;225
421800;202211;4159;10495;3118;8580;487;1481;1606;4064;2093;5545
421810;202211;736;1896;501;1465;61;182;250;712;311;894
421820;202211;1398;3842;931;2751;176;611;314;764;490;1375
421825;202211;2007;4541;1679;4046;120;322;1232;2893;1352;3215
421830;202211;2410;6621;1784;5324;388;1255;421;1154;809;2409
421835;202211;322;740;225;575;33;94;129;317;162;411
421840;202211;418;1263;329;1054;65;238;94;275;159;513
421850;202211;485;1360;273;923;50;179;55;139;105;318
421860;202211;317;824;177;542;23;79;66;152;89;231
421870;202211;6484;15202;4959;12374;548;1711;3039;6637;3587;8348
421875;202211;381;1100;157;490;24;77;31;81;55;158
421880;202211;828;2251;544;1625;114;324;141;396;255;720
421885;202211;338;887;210;601;28;80;98;254;126;334
421890;202211;1290;3342;949;2688;140;504;569;1465;709;1969
421895;202211;529;1278;456;1163;52;115;292;768;344;883
421900;202211;1350;3389;983;2595;119;380;472;1023;591;1403
421910;202211;412;1225;227;763;33;136;46;119;79;255
421915;202211;492;1327;294;860;71;226;59;122;130;348
421917;202211;763;1678;436;1217;113;338;108;300;221;638
421920;202211;509;1462;354;1131;113;373;103;320;216;693
421930;202211;4029;9664;2340;6507;433;1309;815;1939;1248;3248
421935;202211;529;1465;429;1263;98;280;249;727;347;1007
421940;202211;434;1220;205;615;34;110;63;154;97;264
421950;202211;4022;9815;2382;6678;452;1387;705;1632;1157;3019
421960;202211;192;457;107;303;11;33;42;95;53;128
421970;202211;2501;6151;1583;4257;295;923;688;1578;983;2501
421985;202211;405;1079;278;820;32;104;138;376;170;480
422000;202211;2525;5901;2049;5191;167;521;1430;3496;1597;4017
430003;202211;743;1858;521;1477;87;270;260;713;347;983
430005;202211;418;977;306;793;16;47;212;505;228;552
430010;202211;2296;4887;1693;3979;333;760;901;2123;1234;2883
430020;202211;693;1505;508;1239;58;172;324;728;382;900
430030;202211;1302;2818;752;1826;114;301;413;888;527;1189
430040;202211;12233;26953;7864;19773;2044;5516;2181;4944;4225;10460
430045;202211;678;1496;494;1186;26;78;375;860;401;938
430047;202211;292;624;114;294;19;50;38;92;57;142
430050;202211;1025;2390;622;1633;117;321;285;693;402;1014
430055;202211;327;752;157;408;14;41;82;180;96;221
430057;202211;112;243;52;137;17;42;12;33;29;75
430060;202211;25750;61713;20547;53735;3372;9629;11288;28169;14660;37798
430063;202211;904;2317;749;2028;142;386;425;1132;567;1518
430064;202211;1427;3537;1034;2814;182;528;544;1418;726;1946
430066;202211;134;288;103;237;8;23;83;180;91;203
430070;202211;779;1958;172;525;31;101;26;63;57;164
430080;202211;1139;2686;659;1732;92;297;360;809;452;1106
430085;202211;1145;2261;689;1575;107;274;327;711;434;985
430087;202211;1128;2540;925;2271;81;244;624;1458;705;1702
430090;202211;548;1364;212;669;38;130;47;124;85;254
430100;202211;1275;2894;744;1918;123;345;276;604;399;949
430105;202211;1774;4171;1243;3286;182;561;643;1581;825;2142
430107;202211;199;544;100;286;14;36;31;76;45;112
430110;202211;2719;6226;2043;5205;333;919;979;2363;1312;3282
430120;202211;1586;4146;1094;2995;186;502;499;1269;685;1771
430130;202211;4363;9097;3239;7569;1114;2574;670;1859;1784;4433
430140;202211;1270;3060;894;2397;142;418;442;1111;584;1529
430150;202211;673;1659;372;1063;76;236;108;269;184;505
430155;202211;285;683;127;367;21;65;23;45;44;110
430160;202211;27232;55692;21965;48540;1738;4548;15650;32672;17388;37220
430163;202211;4336;8695;3102;6940;74;248;2526;5370;2600;5618
430165;202211;391;960;140;425;11;33;25;59;36;92
430170;202211;1133;2795;396;1245;85;321;69;148;154;469
430175;202211;1042;2415;889;2132;164;389;507;1180;671;1569
430180;202211;828;1938;597;1521;118;293;259;643;377;936
430185;202211;763;1861;376;1048;99;295;75;173;174;468
430187;202211;1045;2010;776;1694;89;186;538;1157;627;1343
430190;202211;1815;4177;1408;3553;261;677;670;1580;931;2257
430192;202211;137;356;57;161;11;30;19;44;30;74
430195;202211;515;1425;82;258;9;29;17;40;26;69
430200;202211;1393;3655;1088;3113;305;905;266;800;571;1705
430205;202211;662;1297;616;1212;9;28;576;1102;585;1130
430210;202211;8590;20972;5225;13874;745;2155;1526;3095;2271;5250
430215;202211;410;941;253;641;38;108;112;260;150;368
430220;202211;703;1674;235;699;29;97;78;183;107;280
430222;202211;294;750;201;575;35;103;71;186;106;289
430223;202211;327;785;246;651;24;70;152;380;176;450
430225;202211;33;72;25;59;2;3;16;36;18;39
430230;202211;2524;6059;2120;5492;111;340;1713;4351;1824;4691
430235;202211;531;1362;333;963;52;159;93;214;145;373
430237;202211;650;1355;488;1105;22;64;392;847;414;911
430240;202211;1653;3669;918;2377;121;365;436;975;557;1340
430245;202211;934;2252;747;1921;139;338;439;1161;578;1499
430250;202211;1259;2833;912;2274;307;820;223;481;530;1301
430258;202211;157;394;118;318;12;35;56;148;68;183
430260;202211;856;2014;581;1519;63;193;332;837;395;1030
430265;202211;279;765;188;599;25;88;70;224;95;312
430270;202211;4157;8605;3367;7458;354;957;2476;5108;2830;6065
430280;202211;6311;13340;4561;10515;745;1783;2370;5130;3115;6913
430290;202211;2718;5587;2209;4976;167;428;1691;3650;1858;4078
430300;202211;13141;29292;10091;24351;1261;3493;6113;13681;7374;17174
430310;202211;16784;38380;12228;30337;1489;4108;7052;16064;8541;20172
430320;202211;1141;2693;651;1757;61;166;364;942;425;1108
430330;202211;787;1822;459;1187;81;216;162;369;243;585
430340;202211;766;1653;526;1280;69;174;340;788;409;962
430350;202211;10723;23853;8293;19888;1046;2725;5078;11432;6124;14157
430355;202211;400;1054;156;488;31;96;18;45;49;141
430360;202211;1057;2391;645;1681;149;433;198;445;347;878
430367;202211;427;878;269;627;37;117;164;332;201;449
430370;202211;578;1502;236;685;49;144;62;138;111;282
430380;202211;769;1806;389;1129;77;234;95;238;172;472
430390;202211;4282;9849;2822;7282;583;1626;379;725;962;2351
430400;202211;1304;2521;959;2057;143;360;532;1031;675;1391
430410;202211;653;1428;472;1151;43;119;342;798;385;917
430420;202211;3788;8665;2938;7031;374;1075;1856;3945;2230;5020
430430;202211;621;1494;273;795;49;157;49;125;98;282
430435;202211;2184;4939;1606;3969;266;696;804;1909;1070;2605
430440;202211;5637;13333;4598;11664;502;1437;3000;7237;3502;8674
430450;202211;9453;20251;7708;17418;1260;3280;4374;9093;5634;12373
430460;202211;49147;111631;36156;90683;4884;13559;20367;47886;25251;61445
430461;202211;255;651;99;284;19;65;40;93;59;158
430462;202211;376;921;193;557;36;104;54;130;90;234
430463;202211;8983;21576;6665;17450;1303;3826;3083;7472;4386;11298
430465;202211;703;1589;468;1168;78;218;262;622;340;840
430466;202211;5973;13456;4820;11759;805;2148;2789;6269;3594;8417
430467;202211;628;1411;459;1154;45;131;283;653;328;784
430468;202211;1772;3931;1447;3478;105;331;1105;2523;1210;2854
430469;202211;709;1913;126;385;12;36;37;79;49;115
430470;202211;7147;17028;4779;12939;1251;3870;1272;2966;2523;6836
430471;202211;925;2222;789;1993;103;314;531;1225;634;1539
430480;202211;741;1956;468;1377;66;209;146;332;212;541
430485;202211;202;496;97;258;22;48;23;60;45;108
430490;202211;520;1252;298;811;37;108;143;323;180;431
430495;202211;463;1214;313;930;48;156;155;432;203;588
430500;202211;1196;2873;842;2299;277;843;232;547;509;1390
430510;202211;34597;83637;25093;66062;4287;12657;11472;26798;15759;39455
430511;202211;397;1061;152;469;22;62;22;54;44;116
430512;202211;1261;2589;1007;2224;225;531;423;910;648;1441
430513;202211;947;2127;478;1189;62;183;274;593;336;776
430515;202211;460;1180;330;923;38;119;155;400;193;519
430517;202211;1698;4294;1294;3461;208;551;739;1933;947;2484
430520;202211;1606;3829;887;2344;137;378;245;571;382;949
430530;202211;1130;2684;475;1349;79;226;131;340;210;566
430535;202211;4458;10489;3201;8314;457;1238;1647;4024;2104;5262
430537;202211;672;1479;596;1339;56;110;464;1018;520;1128
430540;202211;702;1616;422;1157;62;184;237;611;299;795
430543;202211;1298;2201;808;1632;182;345;230;519;412;864
430544;202211;827;2201;547;1602;135;429;183;513;318;942
430545;202211;3170;7297;2405;6188;389;1021;1337;3353;1726;4374
430550;202211;446;1158;329;923;93;252;94;245;187;497
430558;202211;183;399;77;193;3;7;40;93;43;100
430560;202211;351;782;180;514;27;86;61;146;88;232
430570;202211;1030;2324;718;1794;143;447;336;667;479;1114
430580;202211;978;2287;708;1882;170;452;267;757;437;1209
430583;202211;209;510;48;136;4;13;12;23;16;36
430585;202211;249;571;130;340;26;79;44;92;70;171
430587;202211;240;617;178;516;21;67;78;221;99;288
430590;202211;1635;3661;1284;3115;138;362;864;2022;1002;2384
430593;202211;35;96;27;69;6;20;13;25;19;45
430595;202211;493;1214;131;395;19;54;31;67;50;121
430597;202211;535;1273;268;741;22;57;79;161;101;218
430600;202211;2312;5745;1006;2788;156;432;228;559;384;991
430605;202211;1623;3877;1179;3118;171;479;535;1342;706;1821
430607;202211;827;1753;547;1272;32;86;363;786;395;872
430610;202211;7773;16630;5578;13404;1366;3869;2125;4409;3491;8278
430613;202211;305;678;86;238;9;26;25;55;34;81
430620;202211;950;2114;718;1712;138;389;377;755;515;1144
430630;202211;515;1348;161;461;30;91;50;119;80;210
430632;202211;510;1280;215;597;38;104;79;199;117;303
430635;202211;703;1450;514;1130;50;102;371;809;421;911
430637;202211;611;1377;452;1129;43;125;295;688;338;813
430640;202211;1353;3485;910;2596;137;418;347;861;484;1279
430642;202211;432;1150;270;766;43;139;109;274;152;413
430645;202211;193;436;97;239;11;28;33;59;44;87
430650;202211;2257;5529;1666;4594;517;1342;619;1899;1136;3241
430655;202211;373;853;226;566;28;88;128;265;156;353
430660;202211;6485;14865;4952;12438;823;2305;2618;6152;3441;8457
430670;202211;730;1647;519;1284;96;227;230;546;326;773
430673;202211;610;1317;279;741;60;156;105;253;165;409
430675;202211;284;804;70;234;10;32;12;39;22;71
430676;202211;7245;16327;5788;14084;918;2298;3485;8143;4403;10441
430680;202211;1457;3479;945;2510;291;815;322;654;613;1469
430690;202211;3978;9278;3158;7883;956;2480;1248;3019;2204;5499
430692;202211;245;688;197;609;13;40;153;475;166;515
430693;202211;1120;2783;678;1932;149;465;191;497;340;962
430695;202211;466;1053;281;691;53;135;128;282;181;417
430697;202211;616;1388;482;1204;73;193;303;752;376;945
430700;202211;9913;22639;6354;16358;1328;3758;1685;3666;3013;7424
430705;202211;433;960;215;574;26;73;90;214;116;287
430710;202211;2334;4175;1583;3204;85;227;1237;2342;1322;2569
430720;202211;957;2193;504;1392;55;166;276;695;331;861
430730;202211;1134;2892;775;2194;109;309;330;871;439;1180
430740;202211;814;2064;422;1240;78;259;126;327;204;586
430745;202211;576;1266;412;965;50;169;250;466;300;635
430750;202211;2036;4618;1324;3365;341;893;514;1203;855;2096
430755;202211;548;1283;392;983;34;105;237;529;271;634
430760;202211;3047;6881;2386;5891;485;1283;1154;2643;1639;3926
430770;202211;9274;20804;7419;18045;806;2260;4915;11354;5721;13614
430780;202211;2588;5989;1735;4586;296;846;861;2150;1157;2996
430781;202211;737;1739;484;1203;162;431;177;359;339;790
430783;202211;422;913;274;689;55;156;138;330;193;486
430786;202211;40;118;25;86;5;15;4;9;9;24
430790;202211;6012;13578;4440;10949;433;1327;2778;6204;3211;7531
430800;202211;1054;2080;804;1750;52;129;610;1258;662;1387
430805;202211;490;1085;339;799;11;38;265;578;276;616
430807;202211;720;1657;435;1128;64;192;186;399;250;591
430810;202211;915;2075;451;1196;68;212;185;408;253;620
430820;202211;1586;4152;931;2770;149;448;294;774;443;1222
430825;202211;303;700;122;297;17;42;46;95;63;137
430830;202211;2450;5569;2026;4825;126;324;1534;3457;1660;3781
430840;202211;1437;3124;981;2400;125;308;623;1470;748;1778
430843;202211;206;485;94;255;9;22;35;85;44;107
430845;202211;646;1354;436;1005;52;140;281;571;333;711
430850;202211;2890;7104;1992;5468;562;1627;540;1411;1102;3038
430860;202211;1364;3162;696;1875;111;361;305;682;416;1043
430865;202211;685;1630;422;1155;99;307;122;250;221;557
430870;202211;629;1613;268;815;52;164;53;137;105;301
430880;202211;1841;3785;1305;2947;154;417;867;1825;1021;2242
430885;202211;206;521;127;364;11;27;86;244;97;271
430890;202211;1327;3117;855;2319;155;509;113;248;268;757
430900;202211;3980;7577;2804;5976;131;391;2076;4055;2207;4446
430905;202211;1141;2661;773;1998;144;395;307;713;451;1108
430910;202211;2721;6848;2052;5500;308;985;979;2212;1287;3197
430912;202211;617;1623;400;1168;57;156;228;673;285;829
430915;202211;637;1699;409;1216;117;372;105;309;222;681
430920;202211;33743;76848;27033;66101;3174;8694;17578;40777;20752;49471
430925;202211;102;215;48;125;3;10;22;59;25;69
430930;202211;15089;31852;11060;25926;1288;3336;6887;15104;8175;18440
430940;202211;1513;3633;1018;2699;223;628;396;911;619;1539
430950;202211;1090;2132;727;1559;51;150;537;1040;588;1190
430955;202211;501;1243;136;371;23;64;39;88;62;152
430957;202211;239;683;209;616;39;111;121;362;160;473
430960;202211;1693;3821;983;2581;232;645;339;795;571;1440
430965;202211;1900;4026;1517;3465;70;165;1175;2673;1245;2838
430970;202211;455;1051;259;694;39;114;126;309;165;423
430975;202211;606;1597;459;1282;74;239;182;446;256;685
430980;202211;521;1127;294;743;41;114;150;330;191;444
430990;202211;769;1931;526;1432;75;227;255;662;330;889
430995;202211;678;1541;486;1238;74;192;276;657;350;849
431000;202211;1644;3726;701;1954;118;330;65;143;183;473
431010;202211;3231;7847;2307;6273;414;1273;852;1939;1266;3212
431020;202211;10554;21807;6268;15121;980;2833;2996;6113;3976;8946
431030;202211;391;1027;189;604;40;144;28;84;68;228
431033;202211;5121;11204;3481;8630;755;1907;1327;3139;2082;5046
431036;202211;356;767;80;229;3;6;27;63;30;69
431040;202211;1089;2507;707;1884;75;257;405;969;480;1226
431041;202211;514;1114;353;858;63;164;166;347;229;511
431043;202211;517;1225;317;836;29;109;193;437;222;546
431046;202211;120;303;48;141;6;19;9;20;15;39
431050;202211;1566;3448;1128;2771;191;458;627;1523;818;1981
431053;202211;846;2037;456;1297;87;260;155;347;242;607
431055;202211;724;1603;563;1349;57;144;388;933;445;1077
431057;202211;252;704;152;472;31;107;57;155;88;262
431060;202211;7013;15899;4860;12435;1125;3163;1844;4244;2969;7407
431065;202211;562;1282;374;976;53;154;198;490;251;644
431070;202211;501;1271;299;845;62;192;84;225;146;417
431075;202211;315;802;174;493;35;122;75;175;110;297
431080;202211;759;1985;528;1511;79;240;180;445;259;685
431085;202211;946;2287;521;1357;57;169;236;583;293;752
431087;202211;502;1265;400;1065;52;143;245;629;297;772
431090;202211;482;1088;189;555;33;97;41;118;74;215
431100;202211;5366;10305;3908;8471;343;840;2724;5540;3067;6380
431110;202211;1794;3794;1264;2883;174;455;674;1362;848;1817
431112;202211;787;1863;653;1631;78;229;439;1038;517;1267
431113;202211;615;1454;485;1214;111;284;272;641;383;925
431115;202211;1252;3142;972;2640;111;380;658;1662;769;2042
431120;202211;3334;7808;2258;5830;506;1451;864;1965;1370;3416
431123;202211;428;1037;284;754;47;126;143;363;190;489
431125;202211;1434;3379;1025;2634;290;742;511;1308;801;2050
431127;202211;237;624;71;215;7;27;14;31;21;58
431130;202211;4065;9184;3152;7796;507;1374;1654;3859;2161;5233
431140;202211;7199;16303;4428;11216;538;1537;2015;4262;2553;5799
431142;202211;794;1736;597;1430;86;234;394;906;480;1140
431150;202211;1228;2996;886;2404;134;398;466;1186;600;1584
431160;202211;806;2008;530;1461;129;380;171;424;300;804
431162;202211;673;1574;463;1200;41;139;278;647;319;786
431164;202211;202;460;55;164;5;14;11;25;16;39
431170;202211;560;1404;414;1116;114;296;97;240;211;536
431171;202211;1083;2146;908;1933;178;353;633;1342;811;1695
431173;202211;557;1331;396;1101;119;394;127;293;246;687
431175;202211;1569;3441;964;2404;144;342;429;1009;573;1351
431177;202211;1151;2697;865;2255;159;453;487;1213;646;1666
431179;202211;382;828;126;357;26;76;39;104;65;180
431180;202211;2872;6963;1768;4823;400;1097;392;897;792;1994
431190;202211;701;1695;301;848;33;99;69;146;102;245
431198;202211;493;1326;398;1147;87;260;169;492;256;752
431200;202211;385;943;114;307;22;56;17;43;39;99
431205;202211;285;708;160;446;50;138;46;120;96;258
431210;202211;789;1692;627;1448;133;311;308;732;441;1043
431213;202211;332;806;249;651;22;63;128;303;150;366
431215;202211;720;1666;369;1030;40;125;180;461;220;586
431217;202211;207;496;141;368;29;85;60;136;89;221
431220;202211;719;1670;454;1191;92;253;225;526;317;779
431225;202211;1928;3997;1489;3330;151;364;1033;2241;1184;2605
431230;202211;885;2255;661;1756;132;407;326;725;458;1132
431235;202211;201;549;27;92;0;0;6;20;6;20
431237;202211;444;1254;336;1028;50;173;168;487;218;660
431238;202211;43;138;35;120;8;32;15;42;23;74
431240;202211;6522;14447;5259;12476;546;1601;3455;7544;4001;9145
431242;202211;376;841;304;705;41;109;191;418;232;527
431244;202211;465;1072;245;618;32;90;109;239;141;329
431245;202211;1587;3479;1045;2558;101;256;545;1226;646;1482
431247;202211;332;755;212;532;29;89;100;204;129;293
431250;202211;2341;5216;1785;4456;407;974;896;2313;1303;3287
431260;202211;375;972;226;666;24;89;89;235;113;324
431261;202211;336;921;271;809;27;105;154;414;181;519
431262;202211;323;883;168;537;31;111;82;250;113;361
431265;202211;1862;4235;738;2023;123;378;218;485;341;863
431267;202211;294;699;192;501;23;68;118;281;141;349
431270;202211;3432;7097;1843;4466;423;1115;640;1431;1063;2546
431275;202211;186;471;123;329;21;68;69;159;90;227
431280;202211;316;857;142;449;28;88;29;79;57;167
431290;202211;446;1269;288;895;54;182;51;135;105;317
431295;202211;89;220;36;103;10;31;10;25;20;56
431300;202211;349;888;95;272;11;40;34;78;45;118
431301;202211;308;836;86;264;14;46;11;24;25;70
431303;202211;789;1854;473;1245;33;103;209;464;242;567
431306;202211;2787;6255;1729;4456;224;649;752;1653;976;2302
431308;202211;47;134;38;110;14;39;15;44;29;83
431310;202211;642;1553;438;1146;70;176;220;529;290;705
431320;202211;835;2167;506;1490;82;262;172;427;254;689
431330;202211;2293;5114;1283;3338;157;464;654;1488;811;1952
431333;202211;248;632;137;390;21;63;43;110;64;173
431335;202211;42;117;25;82;8;28;1;4;9;32
431337;202211;4932;10322;4135;9173;227;732;3395;7065;3622;7797
431339;202211;542;1282;373;994;93;237;143;385;236;622
431340;202211;23299;53107;16760;42274;2311;6611;8959;20657;11270;27268
431342;202211;485;1049;360;851;50;123;242;561;292;684
431344;202211;420;1024;230;652;37;101;125;336;162;437
431346;202211;249;595;88;266;19;59;17;38;36;97
431349;202211;1174;2487;785;1749;117;294;474;972;591;1266
431350;202211;5992;13626;4650;11523;590;1655;2851;6571;3441;8226
431360;202211;678;1529;343;903;92;269;106;238;198;507
431365;202211;2934;5801;2316;4991;116;317;1915;3942;2031;4259
431370;202211;6185;13368;4603;10956;857;2257;2531;5658;3388;7915
431380;202211;1109;2735;886;2379;185;524;486;1281;671;1805
431390;202211;3294;7610;2125;5612;215;689;1178;2695;1393;3384
431395;202211;2163;4429;1672;3722;166;399;1179;2493;1345;2892
431400;202211;372;997;207;618;40;115;41;101;81;216
431402;202211;1103;2245;817;1828;95;228;551;1166;646;1394
431403;202211;237;637;180;526;47;160;69;175;116;335
431405;202211;6982;16614;5452;14088;898;2677;2740;6395;3638;9072
431406;202211;690;1735;449;1227;119;294;151;449;270;743
431407;202211;636;1598;415;1142;69;178;202;527;271;705
431410;202211;23672;53533;16954;42457;2236;6551;10058;22711;12294;29262
431413;202211;288;785;66;210;7;21;20;51;27;72
431415;202211;886;2057;589;1552;110;333;252;573;362;906
431417;202211;645;1333;414;970;66;183;227;501;293;684
431420;202211;2071;4215;1573;3561;114;313;1072;2272;1186;2585
431430;202211;678;1624;349;986;50;148;119;294;169;442
431440;202211;46381;96478;35266;80188;5404;14120;19544;39410;24948;53530
431442;202211;187;513;86;278;13;44;11;34;24;78
431445;202211;414;1140;128;413;13;44;22;55;35;99
431446;202211;342;922;264;766;30;96;144;399;174;495
431447;202211;914;2215;507;1411;87;237;161;446;248;683
431449;202211;962;2221;639;1631;96;259;330;756;426;1015
431450;202211;3122;5488;2440;4571;198;313;1909;3460;2107;3773
431454;202211;53;169;42;143;10;37;22;68;32;105
431455;202211;655;1475;336;852;30;70;176;404;206;474
431460;202211;3816;8119;2491;5885;509;1284;1030;2268;1539;3552
431470;202211;1683;4238;1212;3315;237;693;462;1179;699;1872
431475;202211;303;798;58;190;3;12;7;13;10;25
431477;202211;556;1315;304;823;75;180;103;260;178;440
431478;202211;252;675;56;176;9;26;7;17;16;43
431480;202211;4151;9839;3257;8426;778;2042;1358;3442;2136;5484
431490;202211;162463;340017;127120;287145;7299;20827;96997;205166;104296;225993
431500;202211;585;1378;440;1121;63;168;230;553;293;721
431505;202211;302;675;204;526;19;47;143;367;162;414
431507;202211;363;831;139;392;39;120;23;52;62;172
431510;202211;2085;4945;1416;3671;455;1182;383;995;838;2177
431513;202211;262;560;139;355;35;110;43;74;78;184
431514;202211;151;358;123;311;4;13;84;190;88;203
431515;202211;663;1432;498;1151;116;284;271;589;387;873
431517;202211;81;229;63;193;8;30;27;77;35;107
431520;202211;446;1055;191;531;25;88;87;192;112;280
431530;202211;6429;13308;3920;9492;845;2147;1678;3801;2523;5948
431531;202211;266;602;157;404;30;75;58;141;88;216
431532;202211;730;1530;419;994;72;182;201;457;273;639
431535;202211;345;872;157;456;27;78;33;86;60;164
431540;202211;2154;5986;1955;5719;100;311;1497;4424;1597;4735
431545;202211;416;978;97;236;16;32;36;81;52;113
431550;202211;2603;6090;1826;4681;257;748;992;2350;1249;3098
431555;202211;841;1759;506;1196;42;112;298;690;340;802
431560;202211;31788;71175;21955;55951;4155;10377;8952;22791;13107;33168
431570;202211;6926;13381;5978;12072;361;922;4974;9443;5335;10365
431575;202211;472;1031;398;909;77;163;240;515;317;678
431580;202211;797;1919;530;1408;65;211;307;731;372;942
431590;202211;904;2298;643;1760;154;439;233;570;387;1009
431595;202211;437;1099;273;768;54;158;97;246;151;404
431600;202211;2219;5024;1580;4034;282;800;698;1621;980;2421
431610;202211;1778;3951;1158;2874;194;483;478;1261;672;1744
431620;202211;562;1333;298;770;62;193;156;326;218;519
431630;202211;1559;3649;725;2003;159;488;234;565;393;1053
431640;202211;8676;17627;7275;15806;858;2103;4918;10247;5776;12350
431642;202211;790;1677;480;1136;97;212;220;482;317;694
431643;202211;425;994;204;548;22;56;76;182;98;238
431645;202211;3008;5281;2394;4513;38;95;2111;3841;2149;3936
431647;202211;364;832;122;339;15;42;30;70;45;112
431650;202211;177;471;129;389;20;71;56;134;76;205
431660;202211;1097;2715;535;1570;89;318;137;340;226;658
431670;202211;1479;3343;886;2283;143;390;420;961;563;1351
431673;202211;259;670;108;345;11;41;35;99;46;140
431675;202211;426;1065;114;381;15;51;20;46;35;97
431680;202211;12106;26961;9136;21834;1756;4750;4692;10056;6448;14806
431690;202211;32944;73703;23969;58378;3495;9986;13660;30476;17155;40462
431695;202211;271;618;162;418;25;99;93;198;118;297
431697;202211;561;1206;434;1018;82;189;243;563;325;752
431700;202211;1815;4020;1422;3366;233;494;754;1807;987;2301
431710;202211;18705;38354;13844;31754;1692;4340;8838;19281;10530;23621
431720;202211;8529;19209;5194;13351;1285;3483;1208;2591;2493;6074
431725;202211;42;101;31;83;9;31;15;33;24;64
431730;202211;5642;12137;3792;9373;690;1890;1914;4358;2604;6248
431740;202211;6484;14451;4365;11026;992;2823;1364;2998;2356;5821
431750;202211;10445;24500;7546;19847;1805;5027;2678;6689;4483;11716
431755;202211;373;984;94;302;10;37;25;66;35;103
431760;202211;6560;13835;4562;10674;500;1405;2786;5922;3286;7327
431770;202211;2546;5244;1922;4412;333;727;1223;2814;1556;3541
431775;202211;254;618;138;389;34;107;34;76;68;183
431780;202211;2609;5867;1706;4291;294;784;610;1448;904;2232
431790;202211;917;2284;625;1718;128;361;274;715;402;1076
431795;202211;318;758;150;420;24;69;45;115;69;184
431800;202211;10365;22877;6680;17191;1856;5635;850;1812;2706;7447
431805;202211;308;772;66;240;2;3;1;2;3;5
431810;202211;3997;8384;2571;5928;381;980;1452;3034;1833;4014
431820;202211;2692;6443;2047;5464;477;1461;911;2254;1388;3715
431830;202211;10850;22462;7845;18390;2300;6129;1298;3050;3598;9179
431840;202211;3560;7967;2856;6906;421;1123;1746;4090;2167;5213
431842;202211;579;1382;205;591;37;119;48;122;85;241
431843;202211;366;940;245;676;55;167;109;273;164;440
431844;202211;206;550;75;243;17;54;18;56;35;110
431845;202211;588;1409;386;1018;37;112;237;592;274;704
431846;202211;369;799;321;732;15;37;285;638;300;675
431848;202211;189;471;102;287;11;36;29;65;40;101
431849;202211;420;1009;79;225;11;32;13;28;24;60
431850;202211;5329;13051;4051;10691;983;2796;1293;3169;2276;5965
431860;202211;797;1743;459;1125;61;172;284;655;345;827
431861;202211;125;318;77;216;14;45;29;68;43;113
431862;202211;592;1735;486;1547;92;346;231;677;323;1023
431870;202211;29369;66194;23593;57533;2251;6388;15649;35737;17900;42125
431880;202211;5004;11644;3667;9394;465;1397;2033;4803;2498;6200
431890;202211;6165;14192;3941;10064;1110;2931;1043;2528;2153;5459
431900;202211;1304;3069;849;2277;140;425;410;971;550;1396
431910;202211;919;2061;364;942;61;164;114;227;175;391
431912;202211;676;1516;548;1310;76;194;367;851;443;1045
431915;202211;1427;2951;1147;2533;70;177;914;1935;984;2112
431920;202211;1608;3136;1324;2786;32;76;1176;2424;1208;2500
431930;202211;896;2113;609;1612;211;547;195;513;406;1060
431935;202211;102;250;73;200;11;29;16;36;27;65
431936;202211;369;940;211;572;42;119;111;286;153;405
431937;202211;190;471;126;353;29;72;42;109;71;181
431940;202211;3682;7905;2399;5703;170;472;1557;3434;1727;3906
431950;202211;2742;6322;2141;5378;516;1344;914;2184;1430;3528
431960;202211;3734;8367;2804;6776;804;2033;750;1717;1554;3750
431970;202211;506;1222;235;632;47;146;68;152;115;298
431971;202211;100;247;53;153;11;35;14;35;25;70
431973;202211;701;1939;474;1480;45;158;335;1032;380;1190
431975;202211;131;263;40;103;8;25;11;19;19;44
431980;202211;1521;3275;1197;2791;128;397;813;1683;941;2080
431990;202211;8416;18186;5906;14708;406;1237;3839;9097;4245;10334
432000;202211;19164;40314;14541;33427;1763;4702;9528;20234;11291;24936
432010;202211;3374;7291;2276;5585;524;1307;767;1724;1291;3031
432020;202211;1946;4851;1223;3370;371;1054;255;664;626;1718
432023;202211;636;1411;309;802;41;107;141;311;182;418
432026;202211;1249;3059;961;2511;276;729;349;954;625;1683
432030;202211;532;1178;309;796;22;57;185;439;207;496
432032;202211;405;974;267;696;24;72;143;327;167;399
432035;202211;872;2212;728;1964;186;474;341;950;527;1424
432040;202211;1322;2982;545;1518;58;186;247;590;305;776
432045;202211;212;548;126;372;19;64;53;144;72;208
432050;202211;682;1550;500;1245;61;188;259;612;320;800
432055;202211;855;1987;574;1486;179;440;150;398;329;838
432057;202211;180;453;151;387;9;25;101;231;110;256
432060;202211;511;1187;150;449;17;58;41;114;58;172
432065;202211;271;677;205;546;50;148;97;236;147;384
432067;202211;1005;2490;837;2137;86;228;565;1400;651;1628
432070;202211;2039;4683;1486;3721;224;629;771;1728;995;2357
432080;202211;6274;13172;4665;10789;766;2130;2315;4836;3081;6966
432085;202211;486;1206;375;1036;77;232;187;475;264;707
432090;202211;3377;7864;2026;5348;495;1173;789;1974;1284;3147
432100;202211;1132;2700;566;1651;101;311;105;228;206;539
432110;202211;2746;6400;1998;5136;456;1282;551;1186;1007;2468
432120;202211;4522;11082;3646;9657;593;1813;1873;4526;2466;6339
432130;202211;3471;7716;2863;6856;502;1217;1490;3552;1992;4769
432132;202211;317;795;173;485;24;77;85;204;109;281
432135;202211;1258;2616;866;1982;98;218;555;1284;653;1502
432140;202211;2382;5872;1893;4987;227;683;1258;3146;1485;3829
432143;202211;1893;4544;1421;3799;117;358;881;2266;998;2624
432145;202211;2143;5332;1403;3868;224;679;467;1033;691;1712
432146;202211;159;412;126;371;42;138;35;95;77;233
432147;202211;669;1737;357;1059;122;376;58;173;180;549
432149;202211;587;1331;270;704;31;77;117;272;148;349
432150;202211;5086;11459;3856;9489;727;2096;1996;4309;2723;6405
432160;202211;8122;18463;6185;15576;1529;4082;2412;5843;3941;9925
432162;202211;228;505;38;114;6;19;9;14;15;33
432163;202211;196;471;40;111;2;6;7;9;9;15
432166;202211;785;2003;636;1724;115;360;241;557;356;917
432170;202211;1892;4768;1299;3699;229;708;526;1324;755;2032
432180;202211;3585;7932;1909;4913;285;837;852;1868;1137;2705
432183;202211;470;1241;356;996;71;245;168;423;239;668
432185;202211;1065;2510;650;1737;131;388;295;709;426;1097
432190;202211;2724;5942;1974;4801;183;552;1322;2918;1505;3470
432195;202211;1207;2918;741;2044;138;394;254;678;392;1072
432200;202211;4661;10252;3572;8629;253;690;2603;6002;2856;6692
432210;202211;517;1213;356;926;47;137;202;463;249;600
432215;202211;789;1958;672;1764;82;192;400;1045;482;1237
432218;202211;271;626;121;320;18;53;41;82;59;135
432220;202211;4483;9622;3222;7600;552;1360;1802;4010;2354;5370
432225;202211;192;476;130;359;19;50;56;155;75;205
432230;202211;918;2086;441;1189;57;190;181;401;238;591
432232;202211;597;1387;372;1003;69;201;171;412;240;613
432234;202211;345;821;177;490;35;85;46;109;81;194
432235;202211;61;151;33;80;6;18;16;30;22;48
432237;202211;372;880;322;799;8;18;272;657;280;675
432240;202211;21724;46661;16158;39349;1498;3595;11106;26605;12604;30200
432250;202211;8473;20867;6390;16893;1157;3409;3408;8325;4565;11734
432252;202211;568;1265;364;884;48;132;191;420;239;552
432253;202211;1129;2976;784;2150;222;663;203;479;425;1142
432254;202211;738;1678;219;629;28;86;37;74;65;160
432255;202211;126;306;75;201;10;29;40;94;50;123
432260;202211;7165;16406;5404;13269;1056;2878;2706;5950;3762;8828
432270;202211;2791;6704;2239;5736;682;1809;762;1880;1444;3689
432280;202211;1547;3698;826;2328;132;421;275;624;407;1045
432285;202211;155;457;32;89;3;9;9;25;12;34
432290;202211;428;1063;272;738;59;182;92;199;151;381
432300;202211;38796;85895;30083;72603;2638;7843;20994;47255;23632;55098
432310;202211;1292;2773;992;2277;121;258;759;1748;880;2006
432320;202211;241;535;114;307;15;43;42;89;57;132
432330;202211;235;518;76;235;16;49;15;47;31;96
432335;202211;191;547;72;251;8;25;10;27;18;52
432340;202211;404;990;185;572;29;95;65;190;94;285
432345;202211;1028;1912;880;1739;14;32;773;1482;787;1514
432350;202211;394;920;199;558;42;135;60;132;102;267
432360;202211;253;727;53;169;4;8;17;45;21;53
432370;202211;421;932;246;638;27;79;137;330;164;409
432375;202211;630;1445;433;1071;127;334;141;348;268;682
432377;202211;182;536;43;152;3;10;10;25;13;35
432380;202211;2458;6299;1726;4959;281;890;883;2416;1164;3306
500020;202211;4226;9478;2973;7550;285;885;2007;4864;2292;5749
500025;202211;1384;3225;881;2310;107;291;493;1229;600;1520
500060;202211;10253;25945;7278;19990;922;2758;4204;11254;5126;14012
500070;202211;6229;14222;4474;11377;805;2228;2191;5373;2996;7601
500080;202211;1898;4346;1163;3039;195;582;452;1016;647;1598
500085;202211;2503;5807;1741;4479;449;1257;658;1517;1107;2774
500090;202211;2513;6091;1706;4751;282;838;507;1507;789;2345
500100;202211;4720;11073;3536;9207;585;1673;1428;3414;2013;5087
500110;202211;13089;29348;9038;23107;1725;4748;4341;10782;6066;15530
500124;202211;2760;7010;2213;6174;346;944;1347;3792;1693;4736
500150;202211;1920;3969;1342;3197;221;599;734;1583;955;2182
500190;202211;6239;14974;4074;10953;858;2427;1422;3428;2280;5855
500200;202211;3358;7152;2252;5381;199;505;1409;3158;1608;3663
500210;202211;6370;13430;4565;11115;1214;3103;2291;5370;3505;8473
500215;202211;1754;4434;1289;3627;140;423;714;1963;854;2386
500220;202211;4132;10135;3049;8344;445;1275;1608;4066;2053;5341
500230;202211;2605;5591;1988;4739;270;708;1264;2854;1534;3562
500240;202211;5140;13815;3727;10963;533;1682;1575;4611;2108;6293
500260;202211;4024;8032;2581;6065;276;723;1555;3404;1831;4127
500270;202211;186679;408738;121208;303956;16454;47144;57020;126960;73474;174104
500280;202211;1691;3932;1114;3062;174;475;618;1696;792;2171
500290;202211;4571;10428;2804;7464;430;1344;1050;2451;1480;3795
500295;202211;5088;11411;3377;8518;578;1686;1461;3157;2039;4843
500310;202211;1285;2401;844;1855;113;197;486;1063;599;1260
500315;202211;6103;12993;5045;11587;305;789;4201;9366;4506;10155
500320;202211;25645;62334;17831;49734;4374;12141;7145;20762;11519;32903
500325;202211;7463;15200;5280;12278;636;1628;3289;7260;3925;8888
500330;202211;8535;17990;5667;13879;542;1399;3239;7838;3781;9237
500345;202211;2702;6218;1820;4791;306;858;674;1644;980;2502
500348;202211;2940;6808;2229;5649;183;526;1529;3766;1712;4292
500350;202211;1464;3782;840;2483;97;309;304;810;401;1119
500370;202211;34574;83603;25243;68552;3325;10279;12696;32821;16021;43100
500375;202211;3181;7783;1992;5444;264;786;762;1806;1026;2592
500380;202211;4408;10271;3075;8098;877;2319;517;1388;1394;3707
500390;202211;801;1579;502;1221;73;202;304;732;377;934
500400;202211;1969;4747;1306;3471;211;639;497;1150;708;1789
500410;202211;2974;6488;2072;5193;240;583;1130;2937;1370;3520
500430;202211;3479;7997;2367;6339;375;1003;942;2711;1317;3714
500440;202211;2003;4504;1108;2971;193;537;423;1134;616;1671
500450;202211;2395;5584;1491;4078;297;819;373;969;670;1788
500460;202211;4743;11624;2892;8121;520;1606;683;1731;1203;3337
500470;202211;3426;8651;2247;6311;532;1642;657;1536;1189;3178
500480;202211;2386;6909;1952;6218;209;708;1368;4386;1577;5094
500490;202211;1433;3160;853;2264;170;526;216;567;386;1093
500500;202211;5028;12410;3333;9784;1039;3467;361;1096;1400;4563
500510;202211;885;2084;586;1545;42;138;378;900;420;1038
500515;202211;2027;4873;1544;4135;220;637;837;2187;1057;2824
500520;202211;4269;11134;3247;9419;721;2072;1583;4713;2304;6785
500525;202211;1214;3245;956;2847;136;424;560;1621;696;2045
500540;202211;6481;15910;3923;11377;1074;3483;641;1542;1715;5025
500560;202211;7013;16735;5641;15007;252;760;4645;12330;4897;13090
500568;202211;5809;11841;3620;8567;736;1823;1557;3285;2293;5108
500570;202211;10911;23459;7537;18050;994;2809;4270;9181;5264;11990
500580;202211;3876;9269;2783;7404;700;1920;1168;3046;1868;4966
500600;202211;4595;10776;3321;8751;768;2141;987;2492;1755;4633
500620;202211;10198;24610;7080;18872;1043;3001;3592;8862;4635;11863
500625;202211;682;1720;468;1306;75;245;203;508;278;753
500627;202211;950;2420;586;1778;95;303;176;487;271;790
500630;202211;9593;20198;5714;14107;1192;3195;1856;4216;3048;7411
500635;202211;3240;9726;2391;8529;277;894;1580;6152;1857;7046
500640;202211;2204;4418;1473;3464;66;170;1026;2286;1092;2456
500660;202211;25716;58839;17813;47610;5301;14673;6107;16262;11408;30935
500690;202211;3385;7939;2328;6280;726;2159;850;2137;1576;4296
500710;202211;4072;9994;2919;8007;697;2104;869;2240;1566;4344
500720;202211;6267;15146;4174;11659;828;2502;1375;3607;2203;6109
500730;202211;1298;2981;723;1968;144;382;225;597;369;979
500740;202211;5747;12842;3671;9682;798;2176;1477;3740;2275;5916
500750;202211;1400;3223;975;2525;132;389;444;1008;576;1397
500755;202211;1394;3372;874;2412;147;446;261;620;408;1066
500769;202211;6436;14964;3614;9848;907;2510;497;1183;1404;3693
500770;202211;1745;4371;1205;3485;227;698;416;1137;643;1835
500780;202211;1565;3658;999;2671;178;537;255;551;433;1088
500790;202211;9209;22947;6585;18283;1307;3964;2411;6493;3718;10457
500793;202211;2610;6138;1865;4873;356;1000;758;1791;1114;2791
500795;202211;3748;7864;3020;6924;174;390;2496;5746;2670;6136
500797;202211;987;2339;660;1748;205;592;200;486;405;1078
500800;202211;4327;9251;2705;6834;707;2016;641;1608;1348;3624
500830;202211;25468;58691;17149;44034;3644;9961;6401;15112;10045;25073
500840;202211;1771;4023;1106;2774;125;337;546;1228;671;1565
510010;202211;2208;4483;1569;3676;197;454;1058;2459;1255;2913
510020;202211;5084;12153;2773;7732;480;1386;783;1922;1263;3308
510025;202211;9280;20901;6035;15846;647;1843;3373;8314;4020;10157
510030;202211;3873;7929;2540;5908;253;643;1304;2928;1557;3571
510035;202211;1364;3435;870;2634;238;732;306;1004;544;1736
510040;202211;2998;6139;2264;5233;276;572;1425;3395;1701;3967
510050;202211;2805;5283;1963;4230;205;549;1426;2915;1631;3464
510060;202211;1906;4527;1296;3426;301;849;287;590;588;1439
510080;202211;1925;4630;1268;3573;216;679;531;1370;747;2049
510100;202211;869;1829;627;1476;71;194;385;827;456;1021
510120;202211;334;563;195;402;10;19;155;305;165;324
510125;202211;2558;6089;1945;5122;240;760;951;2253;1191;3013
510130;202211;2041;4684;1442;3760;294;839;710;1729;1004;2568
510140;202211;3760;9257;2589;7723;978;3149;799;2459;1777;5608
510160;202211;2429;5062;1900;4396;41;117;1725;3950;1766;4067
510170;202211;6269;14890;4743;12500;896;2582;2278;5718;3174;8300
510180;202211;18739;38345;12742;30084;2013;5203;6506;15339;8519;20542
510185;202211;2165;5296;1419;4213;536;1676;381;1312;917;2988
510190;202211;2993;7731;1867;5870;470;1613;395;1242;865;2855
510250;202211;21976;50184;16336;41912;2434;6850;9293;23501;11727;30351
510260;202211;2225;8960;1856;8331;275;1182;1112;5661;1387;6843
510263;202211;4698;12305;3102;9178;550;1781;734;1864;1284;3645
510267;202211;6988;18925;4092;12494;729;2343;797;2047;1526;4390
510268;202211;1637;3987;1142;3164;318;947;270;582;588;1529
510269;202211;1235;3117;798;2334;144;477;334;896;478;1373
510270;202211;3689;9801;2566;7872;395;1346;1084;3209;1479;4555
510279;202211;2214;5431;1273;3723;181;580;385;984;566;1564
510285;202211;1294;3174;830;2360;214;678;267;664;481;1342
510300;202211;5094;11271;3863;9675;275;729;2854;7101;3129;7830
510305;202211;1815;4648;1200;3543;250;750;370;1089;620;1839
510310;202211;1287;2981;907;2389;231;584;337;923;568;1507
510320;202211;5034;11378;3442;8834;768;2211;1080;2406;1848;4617
510325;202211;5420;14877;3674;11462;857;2837;846;2575;1703;5412
510330;202211;3251;8762;2156;6920;518;1786;833;2738;1351;4524
510335;202211;6050;15994;4566;13606;833;2696;2362;6932;3195;9628
510336;202211;630;1639;454;1375;68;193;245;803;313;996
510337;202211;1834;4908;1191;3773;431;1486;294;870;725;2356
510340;202211;122978;257520;85017;204348;17017;47051;37638;81642;54655;128693
510343;202211;1533;3430;1029;2620;136;398;567;1338;703;1736
510345;202211;1638;4035;1233;3296;231;659;642;1530;873;2189
510350;202211;3965;9320;2648;7230;774;2177;645;1697;1419;3874
510360;202211;2447;4515;1469;3392;62;120;1075;2583;1137;2703
510370;202211;2205;5771;1675;4942;277;804;999;3020;1276;3824
510380;202211;670;1530;388;1060;50;166;161;414;211;580
510385;202211;1511;4670;1127;3982;105;440;768;2780;873;3220
510390;202211;1778;3939;1228;3306;266;738;715;1917;981;2655
510395;202211;856;1735;573;1337;34;75;415;975;449;1050
510410;202211;6504;15926;4835;13189;708;1994;3036;8241;3744;10235
510420;202211;3247;5906;2272;4650;74;168;1809;3605;1883;3773
510450;202211;648;1477;382;1026;88;229;129;323;217;552
510452;202211;1121;2921;818;2350;120;362;442;1239;562;1601
510454;202211;1457;3526;1013;2790;167;428;579;1720;746;2148
510455;202211;1127;2829;731;2085;146;461;285;737;431;1198
510460;202211;2415;5709;1711;4643;608;1917;530;1042;1138;2959
510480;202211;6029;13717;3934;9917;692;1942;1742;3926;2434;5868
510490;202211;2146;4897;1616;4232;262;702;1008;2665;1270;3367
510500;202211;1818;4197;1100;3073;267;801;284;753;551;1554
510510;202211;4916;12688;3427;10215;1020;3315;1011;2941;2031;6256
510515;202211;6671;16063;4581;12472;888;2645;1720;4200;2608;6845
510517;202211;1927;4632;1339;3774;510;1592;337;813;847;2405
510520;202211;2812;5469;1531;3808;163;440;671;1720;834;2160
510523;202211;1448;3185;1018;2535;140;366;614;1452;754;1818
510525;202211;10190;26244;7440;20959;1337;4066;3004;7750;4341;11816
510530;202211;676;1616;504;1380;44;139;340;915;384;1054
510550;202211;3191;8442;2407;7146;478;1515;1227;3535;1705;5050
510558;202211;2765;6983;2021;5837;258;686;1046;3224;1304;3910
510560;202211;2299;6108;1460;4486;354;1151;293;938;647;2089
510562;202211;7430;16308;5506;13159;866;2142;2885;6518;3751;8660
510590;202211;3990;8985;2917;7641;272;755;2084;5435;2356;6190
510600;202211;1491;2954;1077;2389;122;324;687;1380;809;1704
510610;202211;3432;7520;2383;6126;331;996;1432;3504;1763;4500
510615;202211;3532;8168;2455;6496;358;991;1443;3772;1801;4763
510617;202211;1307;3553;1045;3169;132;434;740;2304;872;2738
510618;202211;1579;3829;1119;3117;208;684;583;1524;791;2208
510619;202211;901;2194;512;1472;107;324;106;234;213;558
510620;202211;1617;3482;803;2175;300;906;68;135;368;1041
510621;202211;1932;4859;1148;3407;264;829;303;776;567;1605
510622;202211;6810;17587;4313;12495;1283;4012;607;1489;1890;5501
510623;202211;3440;7868;2459;6365;522;1486;962;2388;1484;3874
510624;202211;1996;4963;1049;3216;119;412;206;550;325;962
510625;202211;4380;9915;2692;7018;520;1474;918;2317;1438;3791
510626;202211;1708;4040;1137;3151;275;855;289;778;564;1633
510627;202211;769;1867;427;1230;110;333;114;343;224;676
510628;202211;1836;3814;1170;2980;364;1057;439;1004;803;2061
510629;202211;2133;5527;1387;4138;302;995;369;1040;671;2035
510630;202211;4178;10732;2641;7994;607;1918;649;2087;1256;4005
510631;202211;725;1550;548;1301;20;37;430;1032;450;1069
510637;202211;4468;9748;3147;7904;778;2199;1147;2717;1925;4916
510642;202211;7306;18389;5643;15997;974;3175;3343;9145;4317;12320
510645;202211;1239;2283;750;1670;171;379;344;767;515;1146
510650;202211;9201;20243;7288;18160;936;1523;5280;14476;6216;15999
510665;202211;2094;4291;1323;3121;289;615;528;1345;817;1960
510670;202211;520;1061;311;783;35;86;163;408;198;494
510675;202211;8140;20897;5482;15994;1337;4382;1060;2718;2397;7100
510677;202211;2778;6666;1983;5493;365;1114;1096;2969;1461;4083
510680;202211;863;2078;491;1423;94;303;133;323;227;626
510682;202211;2150;5642;1593;4758;520;1733;535;1507;1055;3240
510685;202211;658;1714;478;1378;49;134;278;807;327;941
510700;202211;5325;11605;3682;9331;357;1051;2535;6202;2892;7253
510704;202211;14011;31110;9408;23599;2237;5998;2888;6464;5125;12462
510706;202211;2983;8111;2037;6520;375;1236;829;2846;1204;4082
510710;202211;3675;8466;2289;5951;586;1498;625;1507;1211;3005
510715;202211;791;1547;520;1196;53;145;315;680;368;825
510718;202211;2787;6105;1697;4640;360;1001;776;2362;1136;3363
510719;202211;582;1173;335;820;37;110;168;348;205;458
510720;202211;1121;2403;740;1868;172;487;310;706;482;1193
510724;202211;1082;2882;721;2182;101;352;329;904;430;1256
510726;202211;1101;1988;643;1443;72;162;356;775;428;937
510729;202211;718;1592;324;867;40;123;95;256;135;379
510730;202211;3647;8229;2498;6498;356;1074;1343;3194;1699;4268
510735;202211;1562;3983;1261;3559;110;276;1013;2892;1123;3168
510740;202211;1206;2714;824;2067;82;248;516;1152;598;1400
510757;202211;650;1945;511;1716;142;542;216;664;358;1206
510760;202211;56252;116436;34956;85244;6824;18981;13658;29322;20482;48303
510770;202211;5175;10472;3635;8546;273;583;2514;6078;2787;6661
510774;202211;492;1195;342;964;67;185;183;540;250;725
510775;202211;820;1963;501;1451;118;358;140;374;258;732
510776;202211;871;2088;588;1550;104;303;277;715;381;1018
510777;202211;1826;4497;1307;3830;240;849;774;2116;1014;2965
510779;202211;971;2446;711;2014;83;213;446;1329;529;1542
510780;202211;5315;12102;3843;9986;713;1763;1950;5414;2663;7177
510785;202211;2545;6217;1464;4292;337;1047;410;1185;747;2232
510787;202211;4196;11060;2812;8355;1012;3111;297;795;1309;3906
510788;202211;658;1438;432;1109;66;157;195;567;261;724
510790;202211;24253;59354;15115;43252;3195;9996;1566;3865;4761;13861
510792;202211;12998;33973;8312;25039;1961;6442;1749;4496;3710;10938
510794;202211;1580;4068;1126;3336;341;1152;221;529;562;1681
510795;202211;13139;31222;9292;24680;2061;6147;3218;7658;5279;13805
510800;202211;1812;4614;1228;3637;352;1145;162;355;514;1500
510805;202211;1862;4821;1178;3555;234;767;460;1254;694;2021
510810;202211;833;1588;539;1210;163;320;262;625;425;945
510820;202211;951;1730;547;1235;28;68;364;786;392;854
510830;202211;1086;2390;819;2048;84;208;556;1426;640;1634
510835;202211;754;1624;483;1248;58;172;298;730;356;902
510840;202211;77911;151205;56446;125293;9016;19618;34020;75808;43036;95426
510850;202211;2198;5308;1428;4119;505;1657;84;123;589;1780
510860;202211;3217;7898;2099;6152;723;2309;401;1172;1124;3481
510880;202211;895;2392;641;1942;169;510;163;492;332;1002
510885;202211;742;1752;480;1341;89;233;116;314;205;547
510890;202211;1016;2650;721;2116;224;716;200;548;424;1264
510895;202211;1855;4318;1255;3333;192;620;642;1492;834;2112
520005;202211;4550;10834;3656;9673;1108;2559;1479;4688;2587;7247
520010;202211;3559;8737;2656;7072;559;1651;1072;2449;1631;4100
520013;202211;4347;10184;2803;7420;715;1884;779;2174;1494;4058
520015;202211;632;1480;455;1214;103;271;158;450;261;721
520017;202211;1484;3476;1024;2751;184;567;438;1041;622;1608
520020;202211;689;1246;534;1068;53;108;406;793;459;901
520025;202211;48514;118295;41361;108260;5937;16264;26513;68216;32450;84480
520030;202211;8770;18494;7301;16564;568;1269;5574;12440;6142;13709
520050;202211;489;1122;279;730;55;131;123;318;178;449
520055;202211;2099;4899;1281;3261;201;505;572;1363;773;1868
520060;202211;2344;5579;1560;4232;293;897;389;1014;682;1911
520080;202211;2316;5396;1773;4677;353;891;864;2383;1217;3274
520082;202211;1002;2386;701;1879;120;340;303;850;423;1190
520085;202211;1257;2903;999;2540;239;615;472;1169;711;1784
520090;202211;1120;2008;819;1686;100;135;639;1378;739;1513
520110;202211;54650;134586;37139;105214;9949;30238;3286;8191;13235;38429
520120;202211;304;675;159;416;20;65;69;159;89;224
520130;202211;4788;10609;3673;8908;716;1826;1517;3497;2233;5323
520140;202211;62724;154070;43347;121342;14320;42750;5734;15956;20054;58706
520145;202211;723;1542;455;1156;100;266;173;393;273;659
520150;202211;850;1889;634;1609;78;197;359;869;437;1066
520160;202211;1072;2410;724;1798;131;304;296;739;427;1043
520170;202211;5772;11251;3823;8935;398;963;2600;5951;2998;6914
520180;202211;3413;7952;2756;7024;359;1068;1776;4328;2135;5396
520215;202211;2194;4868;1602;4022;211;588;942;2256;1153;2844
520235;202211;937;1882;625;1459;102;261;360;805;462;1066
520250;202211;2064;4868;1505;4015;580;1636;262;824;842;2460
520260;202211;919;2032;556;1448;107;278;201;513;308;791
520280;202211;1041;2156;807;1814;160;354;421;938;581;1292
520310;202211;1257;2522;825;1889;191;515;378;822;569;1337
520320;202211;2441;5827;1864;4950;244;630;991;2682;1235;3312
520330;202211;6221;14665;4781;12294;699;2161;2779;6555;3478;8716
520340;202211;2784;5730;1636;4103;165;363;847;2219;1012;2582
520350;202211;3782;8605;2671;6922;864;2316;838;2170;1702;4486
520355;202211;2361;5965;1698;4736;495;1475;278;671;773;2146
520357;202211;1078;2309;780;1889;31;81;626;1486;657;1567
520360;202211;994;2308;772;1959;129;373;363;837;492;1210
520380;202211;1708;4034;1020;2797;164;485;326;765;490;1250
520390;202211;1451;3162;917;2443;239;711;204;565;443;1276
520393;202211;840;1813;565;1396;78;206;252;569;330;775
520396;202211;1099;2509;920;2235;64;163;649;1497;713;1660
520400;202211;1953;4288;1515;3720;99;270;1117;2728;1216;2998
520410;202211;2752;5587;1874;4326;274;731;1061;2258;1335;2989
520420;202211;466;979;362;822;21;60;272;588;293;648
520425;202211;1855;4284;1036;2748;286;823;213;469;499;1292
520430;202211;3022;6586;1824;4656;407;1079;342;789;749;1868
520440;202211;3656;8402;2083;5599;435;1298;458;1138;893;2436
520450;202211;17594;39381;12052;30738;3166;8399;3403;8536;6569;16935
520455;202211;988;2390;689;1937;196;566;203;578;399;1144
520460;202211;1304;2849;1001;2446;202;435;596;1539;798;1974
520465;202211;1118;2436;910;2164;55;169;704;1630;759;1799
520470;202211;2848;6404;2180;5557;581;1552;954;2482;1535;4034
520480;202211;1189;2997;879;2466;200;582;357;952;557;1534
520485;202211;1808;5047;1403;4398;269;888;604;1817;873;2705
520490;202211;5369;12752;4106;10815;635;1840;2450;6198;3085;8038
520495;202211;2041;3910;1540;3246;110;234;1149;2404;1259;2638
520500;202211;2176;4881;1614;3943;196;569;944;2097;1140;2666
520505;202211;1207;2260;947;1949;98;174;718;1461;816;1635
520510;202211;12222;27553;9167;23005;1530;4508;4534;10394;6064;14902
520520;202211;1438;3367;1106;2875;288;810;450;1125;738;1935
520530;202211;3076;7570;2232;6101;412;1109;1076;3102;1488;4211
520540;202211;3772;9218;2492;6801;452;1311;770;1845;1222;3156
520545;202211;1769;3963;1368;3361;326;804;655;1582;981;2386
520547;202211;1643;3917;1257;3263;265;688;634;1615;899;2303
520549;202211;20712;48292;17203;43327;2079;5894;11572;27835;13651;33729
520551;202211;6317;14490;5282;13029;468;1437;3933;9172;4401;10609
520552;202211;1180;2792;916;2407;180;473;474;1287;654;1760
520570;202211;664;1404;421;1032;74;154;178;439;252;593
520580;202211;2671;5515;2021;4759;363;817;1162;2772;1525;3589
520590;202211;1689;3886;1151;3022;281;762;417;1049;698;1811
520620;202211;11983;28126;9627;24799;1775;4938;5193;12963;6968;17901
520630;202211;1094;2531;764;2000;94;262;349;866;443;1128
520640;202211;2984;6711;2197;5361;529;1278;700;1783;1229;3061
520650;202211;1317;2625;952;2128;206;410;480;1133;686;1543
520660;202211;646;1537;362;1035;72;223;103;288;175;511
520670;202211;1193;2831;977;2505;104;243;650;1642;754;1885
520680;202211;1028;2242;820;1951;124;258;507;1217;631;1475
520690;202211;406;948;269;727;82;211;74;195;156;406
520710;202211;549;1214;365;914;20;52;241;564;261;616
520725;202211;1726;3836;1147;2874;186;520;578;1391;764;1911
520735;202211;1131;2480;754;1882;215;491;252;634;467;1125
520740;202211;3130;6552;2266;5416;482;1143;1061;2524;1543;3667
520750;202211;916;1922;653;1546;96;238;369;827;465;1065
520753;202211;1624;3907;1214;3200;218;661;581;1397;799;2058
520760;202211;1802;3446;1513;3108;32;65;1393;2861;1425;2926
520780;202211;1839;4124;1327;3373;176;449;680;1661;856;2110
520790;202211;3925;8711;2678;6728;429;991;1388;3671;1817;4662
520800;202211;22950;52807;18019;45668;3042;7842;10387;26368;13429;34210
520810;202211;1495;2948;1107;2503;263;575;553;1381;816;1956
520815;202211;716;2056;516;1622;98;319;155;469;253;788
520830;202211;2187;4353;1572;3621;103;240;1199;2707;1302;2947
520840;202211;3617;8786;2870;7772;806;2403;1031;2773;1837;5176
520850;202211;1107;2215;841;1852;174;451;434;895;608;1346
520860;202211;11498;27979;8458;22834;1999;5593;3169;8246;5168;13839
520870;202211;187056;398811;135105;321332;25212;63515;62928;139557;88140;203072
520880;202211;11757;30665;9363;26392;1966;5695;3913;10626;5879;16321
520890;202211;6020;12379;4223;9694;648;1766;2288;4842;2936;6608
520910;202211;6013;13925;3903;10391;784;2238;1076;2558;1860;4796
520915;202211;993;2415;652;1742;126;380;266;647;392;1027
520920;202211;5761;11663;4184;9746;792;1706;2290;5502;3082;7208
520929;202211;789;1764;594;1476;102;203;263;700;365;903
520940;202211;1181;2892;920;2505;74;240;698;1844;772;2084
520945;202211;574;1194;411;972;31;75;255;575;286;650
520960;202211;1404;2926;1075;2468;383;839;378;949;761;1788
520970;202211;4377;10433;3290;8716;1139;3052;672;1899;1811;4951
520980;202211;958;2027;690;1681;101;258;336;767;437;1025
520990;202211;3870;8520;3159;7649;512;1097;2145;5333;2657;6430
520993;202211;1504;3449;990;2538;169;470;428;1047;597;1517
520995;202211;3166;7295;2328;6025;526;1326;682;1857;1208;3183
521000;202211;11957;28568;7906;21198;1261;3505;2560;6284;3821;9789
521010;202211;4925;11504;3586;9217;531;1527;1908;4589;2439;6116
521015;202211;957;2192;667;1684;48;134;429;1013;477;1147
521020;202211;5277;12156;3186;8366;723;2023;809;1998;1532;4021
521030;202211;963;1648;749;1358;23;52;656;1148;679;1200
521040;202211;10537;24088;7688;19721;1868;4820;2492;6692;4360;11512
521056;202211;1262;3076;877;2420;260;700;201;594;461;1294
521060;202211;1241;3032;856;2314;170;507;310;799;480;1306
521080;202211;1310;2640;696;1722;123;313;288;661;411;974
521090;202211;3884;9794;2578;7179;627;1893;289;742;916;2635
521100;202211;2436;4978;1819;4156;241;585;1149;2605;1390;3190
521120;202211;6211;13725;4661;11737;948;2116;1734;5128;2682;7244
521130;202211;1216;2697;575;1534;60;164;304;813;364;977
521140;202211;2005;4602;1437;3618;190;488;812;1912;1002;2400
521150;202211;17226;35962;11262;27363;2691;7203;4683;10817;7374;18020
521160;202211;1014;1932;638;1361;74;147;406;829;480;976
521170;202211;1340;2892;963;2319;148;386;450;1002;598;1388
521180;202211;10757;25697;8318;21671;1599;4495;3899;9805;5498;14300
521190;202211;14452;33619;9197;25090;2178;6381;2715;6957;4893;13338
521200;202211;868;1977;580;1511;69;194;278;675;347;869
521205;202211;761;1664;582;1388;26;65;460;1052;486;1117
521210;202211;985;2470;582;1621;122;362;149;317;271;679
521220;202211;4798;10438;3176;7915;837;2318;1172;2638;2009;4956
521225;202211;540;1029;405;880;37;80;314;680;351;760
521230;202211;1778;4084;1472;3675;621;1606;467;1164;1088;2770
521250;202211;47297;107427;38453;95347;8835;23551;21048;49939;29883;73490
521260;202211;649;1373;485;1133;69;187;283;610;352;797
521270;202211;2656;5615;2218;5071;230;454;1594;3728;1824;4182
521280;202211;2276;5623;1706;4707;348;1020;733;1988;1081;3008
521290;202211;711;1487;481;1191;48;127;299;698;347;825
521295;202211;1494;3010;1141;2565;159;311;736;1641;895;1952
521300;202211;2252;5119;1706;4330;330;795;909;2347;1239;3142
521305;202211;812;1760;551;1395;57;162;336;815;393;977
521308;202211;5990;14512;4129;11180;377;1119;2565;6572;2942;7691
521310;202211;13409;31052;9197;23759;1779;5059;3866;9162;5645;14221
521340;202211;494;1045;330;818;29;72;188;440;217;512
521350;202211;2374;5613;1792;4729;132;387;1282;3272;1414;3659
521370;202211;1540;3737;975;2805;305;959;167;503;472;1462
521375;202211;1903;4590;1261;3472;261;710;309;925;570;1635
521377;202211;1688;3324;1223;2745;135;252;892;2123;1027;2375
521380;202211;7815;19435;5005;14355;782;2357;992;2914;1774;5271
521385;202211;855;1885;638;1596;97;221;340;900;437;1121
521390;202211;848;2026;563;1558;137;427;92;249;229;676
521400;202211;3647;7852;2858;6828;338;836;1810;4232;2148;5068
521405;202211;1678;4118;1107;3042;129;370;578;1501;707;1871
521410;202211;1147;2531;902;2165;225;483;464;1165;689;1648
521440;202211;1821;4100;1391;3480;429;1009;583;1537;1012;2546
521450;202211;5159;14025;3800;11398;991;3022;843;2581;1834;5603
521460;202211;7644;18051;5447;14176;1396;3822;1872;4665;3268;8487
521470;202211;1006;2347;688;1772;112;261;315;762;427;1023
521480;202211;632;1340;427;1007;64;161;222;452;286;613
521483;202211;2902;6527;2075;5298;538;1350;801;2077;1339;3427
521486;202211;2178;4833;1658;4081;160;292;1076;2655;1236;2947
521487;202211;582;1250;424;1038;78;184;261;639;339;823
521490;202211;1055;2552;770;2090;34;123;557;1412;591;1535
521500;202211;2564;6117;1939;5243;195;727;1149;2856;1344;3583
521520;202211;1015;2131;799;1839;137;270;452;1083;589;1353
521523;202211;18277;48789;14941;43508;4440;13444;5332;15048;9772;28492
521525;202211;1325;2906;1000;2441;91;274;665;1532;756;1806
521530;202211;2792;6829;1732;4736;326;911;479;1193;805;2104
521540;202211;986;2350;708;1904;153;464;298;756;451;1220
521550;202211;2008;4783;1099;3012;202;596;258;719;460;1315
521560;202211;7015;16334;5132;13778;1433;3853;2094;5869;3527;9722
521565;202211;827;1907;568;1478;102;266;251;643;353;909
521570;202211;4932;12354;3392;9543;680;2118;381;1060;1061;3178
521580;202211;661;1429;428;1054;80;196;169;383;249;579
521590;202211;1059;2136;758;1716;92;222;460;979;552;1201
521600;202211;553;1340;343;949;63;180;167;420;230;600
521630;202211;2104;4262;1299;3123;396;984;344;759;740;1743
521640;202211;2418;5346;1521;3989;327;958;476;1157;803;2115
521645;202211;640;1552;374;1057;158;442;19;32;177;474
521680;202211;1763;4385;1352;3731;350;992;514;1383;864;2375
521690;202211;659;1523;543;1369;86;232;312;763;398;995
521710;202211;4345;9819;2835;7301;501;1453;788;1711;1289;3164
521720;202211;3068;6363;1978;4751;240;627;1146;2667;1386;3294
521730;202211;5041;12657;3736;10481;999;3180;881;2040;1880;5220
521740;202211;5729;13365;4476;11546;1376;3844;1411;3294;2787;7138
521760;202211;23725;54544;19304;48359;3736;10640;10992;25955;14728;36595
521770;202211;4087;8930;2638;6687;571;1509;630;1548;1201;3057
521800;202211;8794;21052;6245;16898;1838;5060;1836;5419;3674;10479
521805;202211;1388;2618;910;2015;190;381;462;1101;652;1482
521810;202211;899;1919;647;1571;126;301;348;863;474;1164
521830;202211;7420;18079;5987;15884;466;1463;4316;11027;4782;12490
521839;202211;1126;2372;850;1940;78;211;605;1272;683;1483
521850;202211;8882;19102;5484;13945;1673;4178;672;1647;2345;5825
521860;202211;2028;5137;1363;3897;234;729;421;1088;655;1817
521870;202211;844;2173;598;1705;120;374;196;470;316;844
521878;202211;1032;2485;663;1778;59;173;338;828;397;1001
521880;202211;29219;66220;20948;53535;4434;12119;9205;22152;13639;34271
521890;202211;4199;9888;2863;7627;745;1996;780;1920;1525;3916
521900;202211;1663;3701;868;2336;220;494;18;45;238;539
521910;202211;1750;3553;1224;2900;268;620;537;1244;805;1864
521920;202211;687;1633;529;1381;67;211;323;779;390;990
521925;202211;959;2312;700;1913;149;447;284;728;433;1175
521930;202211;6758;15246;4499;11856;1316;2899;1740;5090;3056;7989
521935;202211;1244;2820;857;2174;76;209;509;1213;585;1422
521940;202211;1643;3333;1078;2547;183;479;568;1275;751;1754
521945;202211;804;1873;557;1443;84;223;300;755;384;978
521950;202211;911;2011;628;1569;100;258;299;730;399;988
521960;202211;829;2018;562;1524;56;193;332;813;388;1006
521970;202211;3476;7226;2627;6188;248;498;1946;4733;2194;5231
521971;202211;932;2133;640;1675;161;416;173;425;334;841
521973;202211;1944;4637;1484;3913;157;387;967;2520;1124;2907
521975;202211;17276;40265;14011;35634;2434;6721;8208;20149;10642;26870
521980;202211;2856;6101;2150;5182;146;360;1627;3884;1773;4244
521990;202211;1800;3968;1518;3567;261;700;948;2175;1209;2875
522000;202211;3384;8095;2622;7113;622;1761;1275;3626;1897;5387
522005;202211;469;1009;304;762;51;136;113;279;164;415
522010;202211;5779;13270;4066;10466;877;2409;1489;3584;2366;5993
522015;202211;1329;3171;978;2628;259;716;405;1052;664;1768
522020;202211;6764;14723;4538;11371;921;2378;1986;4972;2907;7350
522026;202211;932;2262;583;1653;92;312;172;393;264;705
522028;202211;632;1427;439;1102;75;228;218;476;293;704
522040;202211;4711;9333;3294;7431;342;869;2192;4582;2534;5451
522045;202211;25654;64314;19133;53474;4177;12381;5115;13571;9292;25952
522050;202211;1482;3515;1043;2767;194;577;459;1062;653;1639
522060;202211;3718;9101;2681;7452;469;1248;1235;3483;1704;4731
522068;202211;2304;4965;1845;4425;118;238;1489;3609;1607;3847
522070;202211;1035;1991;843;1720;20;38;742;1477;762;1515
522100;202211;1049;2460;705;1873;103;276;328;829;431;1105
522108;202211;1380;2834;1068;2405;58;142;834;1805;892;1947
522119;202211;2434;5177;1939;4563;389;762;1100;2698;1489;3460
522130;202211;656;1463;495;1248;47;96;373;965;420;1061
522140;202211;30470;72223;21319;56186;4580;12871;6712;16125;11292;28996
522145;202211;972;2162;684;1743;141;399;363;894;504;1293
522150;202211;1352;2971;882;2235;204;533;260;624;464;1157
522155;202211;1267;3017;976;2575;140;333;576;1525;716;1858
522157;202211;900;1805;728;1599;39;82;564;1232;603;1314
522160;202211;7638;18078;4846;13230;1277;3749;515;1482;1792;5231
522170;202211;3357;7949;2577;6799;347;915;1583;4155;1930;5070
522180;202211;919;1977;598;1412;112;273;179;433;291;706
522185;202211;30426;68523;22393;57842;8893;24969;4300;11663;13193;36632
522190;202211;993;2088;672;1600;149;350;281;615;430;965
522200;202211;2520;6392;1855;5221;484;1360;621;1720;1105;3080
522205;202211;1988;4530;1428;3683;428;1149;419;1036;847;2185
522220;202211;1453;3210;1062;2681;136;327;624;1635;760;1962
522230;202211;1666;3704;1296;3164;193;532;791;1864;984;2396
530010;202211;307946;736766;258692;663131;35451;99193;158900;388746;194351;487939
110001;202210;4783;12492;3181;9526;748;2490;1102;3187;1850;5677
110002;202210;17166;41008;12444;33269;3184;9164;3597;9361;6781;18525
110003;202210;908;2503;653;1999;161;519;170;454;331;973
110004;202210;16763;39755;11529;30900;2522;7075;4127;10621;6649;17696
110005;202210;3077;7523;2172;6074;487;1371;678;1986;1165;3357
110006;202210;1760;4699;1068;3277;194;648;230;627;424;1275
110007;202210;1509;3668;978;2773;278;791;252;823;530;1614
110008;202210;4244;10004;3160;8503;628;1445;1771;5363;2399;6808
110009;202210;5445;14149;3500;10667;781;2622;1323;3818;2104;6440
110010;202210;9934;27676;7581;23526;1717;4848;3657;12837;5374;17685
110011;202210;9175;22554;6282;17495;1804;5233;1369;3677;3173;8910
110012;202210;20725;48524;13574;36698;3505;9633;2936;7570;6441;17203
110013;202210;7137;18853;4933;14655;1820;5757;834;2490;2654;8247
110014;202210;4678;11339;3173;8573;466;1400;1618;4162;2084;5562
110015;202210;7327;17386;4718;12673;982;2955;1509;3454;2491;6409
110018;202210;5327;12601;3377;9303;698;2046;883;2239;1581;4285
110020;202210;110483;233884;84045;198638;17995;43135;43099;102875;61094;146010
110025;202210;6140;13860;4220;10648;648;1827;2259;5413;2907;7240
110026;202210;688;1727;485;1389;119;367;148;435;267;802
110028;202210;8958;21366;5629;15613;1377;4278;688;1848;2065;6126
110029;202210;1862;4358;1138;3138;211;581;456;1253;667;1834
110030;202210;16635;36716;10437;27504;2937;8399;1475;4054;4412;12453
110032;202210;4450;11475;2672;7914;840;2473;494;1544;1334;4017
110033;202210;5454;15098;4097;12601;1332;4208;1293;4225;2625;8433
110034;202210;3789;8473;2563;6775;918;2684;632;1838;1550;4522
110037;202210;1918;5336;1339;4247;349;1129;443;1404;792;2533
110040;202210;3545;9195;2575;7484;658;2097;752;2039;1410;4136
110045;202210;5762;15333;4132;12433;1152;3713;1420;4237;2572;7950
110050;202210;2072;5284;1366;4045;433;1458;192;469;625;1927
110060;202210;1131;3139;747;2258;188;592;190;556;378;1148
110070;202210;1856;5332;1306;4140;351;1217;330;915;681;2132
110080;202210;7891;17551;5917;14996;1230;3159;2989;7896;4219;11055
110090;202210;687;1794;470;1390;119;395;125;350;244;745
110092;202210;1608;4310;1132;3439;240;751;562;1727;802;2478
110094;202210;3453;9426;2568;7770;1001;3194;352;1114;1353;4308
110100;202210;2128;5685;1660;4851;580;1752;545;1634;1125;3386
110110;202210;2168;5452;1541;4458;458;1425;323;1004;781;2429
110120;202210;1573;4156;1111;3272;275;840;328;949;603;1789
110130;202210;3298;7701;1992;5388;383;1038;255;658;638;1696
110140;202210;2934;7695;2141;6171;417;1342;1003;2718;1420;4060
110143;202210;1721;4349;1232;3478;344;1071;394;1043;738;2114
110145;202210;1159;2812;698;1964;164;454;285;821;449;1275
110146;202210;628;1547;426;1212;119;318;157;499;276;817
110147;202210;954;2288;632;1695;93;287;316;742;409;1029
110148;202210;1155;2973;587;1750;150;497;63;137;213;634
110149;202210;4141;9948;2815;7891;985;2855;672;2007;1657;4862
110150;202210;3054;7351;1967;5657;624;1961;379;1187;1003;3148
110155;202210;1018;2742;700;2008;145;478;288;734;433;1212
110160;202210;1719;4776;1249;3796;433;1364;240;732;673;2096
110170;202210;2513;5966;1616;4352;236;718;938;2333;1174;3051
110175;202210;2559;6681;1738;4981;316;970;752;2041;1068;3011
110180;202210;1659;4158;1168;3228;160;474;595;1594;755;2068
120001;202210;4253;10788;3437;9583;474;1573;2290;6204;2764;7777
120005;202210;2381;8135;2156;7793;229;864;1640;6046;1869;6910
120010;202210;7368;17892;6355;16461;515;1251;4976;12979;5491;14230
120013;202210;3024;8682;2595;8103;763;2285;1177;4135;1940;6420
120017;202210;3700;9048;3150;8284;451;1121;2053;5731;2504;6852
120020;202210;18771;59845;17276;57196;1151;4329;13846;45667;14997;49996
120025;202210;4620;10475;3789;9521;529;1314;2555;6723;3084;8037
120030;202210;7544;27116;6957;26114;452;2092;5300;20285;5752;22377
120032;202210;2087;8268;1961;8025;100;616;1672;6699;1772;7315
120033;202210;5230;16063;4888;15478;107;532;4324;13475;4431;14007
120034;202210;3501;10485;3024;9735;142;614;2547;8042;2689;8656
120035;202210;5102;15763;4737;15155;275;1024;4050;12833;4325;13857
120038;202210;3718;9908;3194;9118;449;1348;2047;5906;2496;7254
120039;202210;2421;9219;2247;8886;141;715;1813;7114;1954;7829
120040;202210;74233;180973;64200;166359;8018;22139;43104;110061;51122;132200
120042;202210;4288;13022;3951;12447;259;846;3244;10167;3503;11013
120043;202210;1753;6373;1524;6044;55;359;1284;5003;1339;5362
120045;202210;7314;16743;6149;15359;522;1364;4758;11917;5280;13281
120050;202210;12052;36082;11090;34746;518;1941;9408;29430;9926;31371
120060;202210;11887;39921;10860;38444;496;2334;9365;32935;9861;35269
120070;202210;4182;11597;3596;10802;562;1539;2273;7321;2835;8860
120080;202210;6759;15739;6072;14788;739;1725;4612;11342;5351;13067
130002;202210;4087;13166;3608;12518;441;1123;2877;10604;3318;11727
130006;202210;3067;9744;2538;8915;621;1970;1331;5307;1952;7277
130008;202210;3244;9873;2801;9247;175;577;2252;7646;2427;8223
130010;202210;5240;12572;4500;11720;155;364;4043;10579;4198;10943
130014;202210;4724;11983;3566;10254;650;1896;2064;6203;2714;8099
130020;202210;3324;11837;2914;11241;133;740;2400;9165;2533;9905
130030;202210;19256;40269;17974;38836;203;526;17154;36741;17357;37267
130040;202210;4890;13201;4036;12110;556;1560;2924;9100;3480;10660
130050;202210;8754;28808;7377;27026;363;1273;6397;23953;6760;25226
130060;202210;8672;31560;7372;29878;410;2259;6108;24434;6518;26693
130063;202210;7654;22662;6755;21647;195;840;6142;19629;6337;20469
130068;202210;4645;13415;3897;12426;217;873;3109;9850;3326;10723
130070;202210;9142;23205;7509;21418;627;1511;5896;17446;6523;18957
130080;202210;9246;27869;7984;26441;404;1215;6914;23396;7318;24611
130083;202210;3350;9816;2934;9298;299;897;2277;7511;2576;8408
130090;202210;5038;12303;4499;11687;84;196;4008;10666;4092;10862
130100;202210;8997;25190;7541;23654;162;391;6958;22208;7120;22599
130110;202210;10630;26035;8685;23634;1610;3882;5505;16445;7115;20327
130115;202210;6209;17263;5329;16232;156;463;4657;14364;4813;14827
130120;202210;19669;55157;17524;52425;1423;4626;14639;43603;16062;48229
130130;202210;7264;19047;5640;17027;608;1708;4087;13103;4695;14811
130140;202210;8603;26642;7536;25436;346;1438;6489;21970;6835;23408
130150;202210;4738;14322;4459;14012;76;390;4140;12973;4216;13363
130160;202210;7919;20887;6852;19597;365;886;6017;17471;6382;18357
130165;202210;3993;13252;3761;12988;163;614;3354;11660;3517;12274
130170;202210;16520;38747;13678;35594;451;1446;12195;31549;12646;32995
130180;202210;5274;15021;5036;14762;40;228;4870;14207;4910;14435
130185;202210;24422;51977;20147;47402;1552;2040;17159;42510;18711;44550
130190;202210;24158;69706;19690;63373;1658;5314;15105;49246;16763;54560
130195;202210;2949;9635;2475;9052;108;440;2089;7735;2197;8175
130200;202210;3661;8536;3005;7693;190;596;2459;6181;2649;6777
130210;202210;1826;6100;1636;5867;139;636;1315;4656;1454;5292
130220;202210;3040;8579;2494;7928;75;255;2235;7238;2310;7493
130230;202210;6084;21374;5311;20345;203;1054;4695;18003;4898;19057
130240;202210;17807;39881;14918;36306;157;725;13978;33491;14135;34216
130250;202210;31721;84360;27101;79028;1655;4163;22237;67024;23892;71187
130255;202210;6077;16499;5186;14993;241;676;4283;12328;4524;13004
130260;202210;425956;957989;361243;872889;70144;178165;230137;546779;300281;724944
130270;202210;11672;36403;9647;33389;1748;5551;6152;22431;7900;27982
130280;202210;4447;14976;4050;14527;146;562;3732;13463;3878;14025
130290;202210;20719;50350;18609;47823;682;1882;17039;43646;17721;45528
130300;202210;6069;17503;5391;16600;163;692;4657;14232;4820;14924
130310;202210;10422;24422;9253;23026;428;1108;8155;20218;8583;21326
130320;202210;4157;12458;3454;11502;439;1366;2479;8570;2918;9936
130330;202210;5577;15636;4501;14365;220;788;3788;12334;4008;13122
130340;202210;30455;78740;26261;74075;1416;3638;22392;64844;23808;68482
130350;202210;4559;15086;4062;14444;148;745;3543;12550;3691;13295
130353;202210;9838;23502;7997;21172;1222;2988;5446;15051;6668;18039
130356;202210;6855;18895;5809;17338;1091;3155;3506;10989;4597;14144
130360;202210;3613;10764;2914;9908;79;341;2604;8869;2683;9210
130370;202210;6052;24106;5087;22698;706;3758;3191;14375;3897;18133
130380;202210;9124;36298;8516;35381;719;3460;6848;28440;7567;31900
130390;202210;8584;29499;7496;27907;410;1898;6589;24378;6999;26276
130395;202210;3027;8500;2520;7712;181;625;2041;6130;2222;6755
130400;202210;3427;9353;2899;8647;101;303;2564;7698;2665;8001
130406;202210;13848;43487;11755;40928;2123;6741;7994;29346;10117;36087
130410;202210;5368;16574;4626;15438;1235;4240;2496;8653;3731;12893
130420;202210;18010;54465;15124;50846;1693;5805;11065;37992;12758;43797
130423;202210;5152;14814;4475;14015;226;896;3922;12178;4148;13074
130426;202210;3846;12076;3462;11642;60;186;3077;10881;3137;11067
130430;202210;6001;13386;5168;12342;204;492;4613;10911;4817;11403
130440;202210;7262;17315;6256;16131;125;400;5887;15119;6012;15519
140002;202210;3013;7941;2601;7454;181;461;2114;6250;2295;6711
140005;202210;3971;10356;3456;9752;742;1940;2292;6831;3034;8771
140010;202210;62612;160206;50213;142149;12046;35859;21434;61830;33480;97689
140015;202210;5904;13389;4975;12375;340;711;4281;10974;4621;11685
140017;202210;7214;16343;6364;15300;398;889;5367;13079;5765;13968
140020;202210;6973;17131;5996;15930;427;1168;4747;12723;5174;13891
140023;202210;3382;8684;2712;7778;350;1039;1998;5810;2348;6849
140028;202210;2482;5795;2080;5296;132;351;1629;4153;1761;4504
140030;202210;7879;16183;7145;15350;340;492;6489;14249;6829;14741
140040;202210;3473;12109;3193;11747;102;520;2941;10771;3043;11291
140045;202210;4164;13525;3594;12755;906;2541;2023;8278;2929;10819
140047;202210;7419;19279;6187;17489;765;2241;4337;12475;5102;14716
140050;202210;2068;5362;1757;4929;285;703;1167;3429;1452;4132
140060;202210;2711;5777;2417;5389;247;467;1997;4535;2244;5002
140070;202210;2402;11408;2321;11262;141;922;2007;9581;2148;10503
150010;202210;63118;130877;56879;123039;1545;2914;51161;109756;52706;112670
150013;202210;2698;5667;2273;5207;143;244;1923;4506;2066;4750
150020;202210;18660;47225;17125;45170;1778;3638;13732;37641;15510;41279
150030;202210;11263;35622;10131;34305;715;1982;8341;30020;9056;32002
150034;202210;5421;11564;4392;10312;249;568;3717;8814;3966;9382
150040;202210;19847;45866;17410;43182;1184;1534;15310;39969;16494;41503
150050;202210;9707;26404;8828;25272;232;662;8062;23311;8294;23973
150060;202210;28593;69616;23074;61567;3164;8540;15067;40709;18231;49249
150070;202210;10942;30074;9753;28698;208;772;9101;26688;9309;27460
150080;202210;111959;237704;92326;211824;25073;57523;30538;80612;55611;138135
150085;202210;11890;26605;10817;25358;140;348;10250;24036;10390;24384
150090;202210;15149;39414;14112;37739;574;1586;12469;32930;13043;34516
150095;202210;9052;19345;7973;18059;859;1097;6603;15767;7462;16864
150100;202210;3493;11005;3064;10317;242;751;2444;8426;2686;9177
150110;202210;5453;19254;5047;18801;166;660;4654;17615;4820;18275
150120;202210;9776;26488;9053;25626;377;702;8050;23298;8427;24000
150125;202210;1077;2501;780;2084;99;297;497;1296;596;1593
150130;202210;29619;74830;25328;68495;4877;11589;15470;44732;20347;56321
150140;202210;362289;708868;309623;641667;31891;64943;219780;446746;251671;511689
150145;202210;5005;14454;4103;13057;1452;4469;1528;5684;2980;10153
150150;202210;22135;48435;18906;44431;1441;3154;14655;34505;16096;37659
150157;202210;4426;10896;3487;9635;435;1177;2285;6528;2720;7705
150160;202210;5072;10650;4722;10186;391;908;3867;8101;4258;9009
150170;202210;34785;88786;30910;82685;5280;12212;20065;57203;25345;69415
150172;202210;7056;15741;5748;13996;318;772;4567;11091;4885;11863
150175;202210;2222;5746;1851;5142;187;657;1349;3583;1536;4240
150178;202210;15470;32538;11757;28302;1158;1575;9254;24187;10412;25762
150180;202210;35026;89590;31776;85984;2794;4718;25752;75430;28546;80148
150190;202210;9537;23306;8825;22458;143;495;8252;20820;8395;21315
150195;202210;6374;17450;5904;16797;193;677;5369;15142;5562;15819
150200;202210;7094;18135;6384;17329;44;154;5939;16136;5983;16290
150210;202210;39442;103663;37160;100911;1267;3413;33287;91128;34554;94541
150215;202210;12400;31936;10612;29120;1816;5091;6349;17449;8165;22540
150220;202210;16636;40021;14539;37211;819;2075;11247;28431;12066;30506
150230;202210;17243;40905;15320;38375;1349;2873;11461;29386;12810;32259
150240;202210;44279;107686;37039;95985;7761;20690;17728;44016;25489;64706
150250;202210;5063;17124;4729;16761;448;1633;4042;14512;4490;16145
150260;202210;3514;9458;3084;8828;97;326;2665;7553;2762;7879
150270;202210;10832;28141;7606;22450;2135;6557;2116;6433;4251;12990
150275;202210;9326;23839;8533;22787;205;728;7636;19976;7841;20704
150276;202210;2803;6877;2420;6412;302;697;1686;4871;1988;5568
150277;202210;6869;14828;5481;13257;661;1635;4001;9858;4662;11493
150280;202210;8758;29230;8415;28713;543;1562;7173;25197;7716;26759
150285;202210;4222;12520;3630;11575;229;702;2863;9159;3092;9861
150290;202210;13623;31705;12312;30316;524;768;11149;28139;11673;28907
150293;202210;12122;26277;9489;22896;1046;2542;6598;15908;7644;18450
150295;202210;8961;21842;6328;18175;2072;5901;2156;7139;4228;13040
150300;202210;3906;8263;3575;7869;30;81;3386;7391;3416;7472
150304;202210;5368;13929;4470;12582;641;1603;3080;9020;3721;10623
150307;202210;6968;19753;6265;18619;307;888;5016;14929;5323;15817
150309;202210;7934;20363;6426;17948;829;2251;4109;11700;4938;13951
150310;202210;8698;30579;8161;29914;244;1134;7252;26908;7496;28042
150320;202210;11356;27009;10273;25499;792;1844;7825;19429;8617;21273
150330;202210;18100;48948;16648;46960;2163;4724;11805;36105;13968;40829
150340;202210;2921;7812;2547;7285;308;833;1881;5415;2189;6248
150345;202210;11158;26601;9875;24958;360;1023;8758;21918;9118;22941
150350;202210;12254;25516;11044;23992;759;1279;9462;20727;10221;22006
150360;202210;30610;75226;24514;67662;2488;4771;18461;53640;20949;58411
150370;202210;14046;36339;11472;32944;1456;3462;8234;25300;9690;28762
150375;202210;4680;17067;4218;16433;250;970;3684;14506;3934;15476
150380;202210;13039;29087;10547;25845;222;679;9197;22251;9419;22930
150390;202210;8644;31865;7649;30292;1471;4946;4981;21081;6452;26027
150400;202210;8084;25076;7649;24382;142;497;6510;21387;6652;21884
150405;202210;10829;25145;9326;23379;686;1200;7438;19330;8124;20530
150410;202210;2365;6413;1992;5829;190;483;1408;4179;1598;4662
150420;202210;56280;136632;44172;119360;10151;28564;21004;58671;31155;87235
150430;202210;9919;25422;8998;24285;681;1336;7567;20909;8248;22245
150440;202210;7736;19314;6997;18356;548;1332;5696;15017;6244;16349
150442;202210;38131;76899;32223;69915;2075;4514;25682;54604;27757;59118
150445;202210;9700;22756;8663;21315;155;433;7952;19372;8107;19805
150450;202210;7728;23528;7198;22843;337;1563;6543;20261;6880;21824
150460;202210;10468;29090;9475;27869;456;1115;7989;24343;8445;25458
150470;202210;25475;60293;22741;57051;375;1302;21101;52359;21476;53661
150475;202210;6755;18383;5714;16775;916;2339;3791;11738;4707;14077
150480;202210;17333;46603;15554;44112;3103;7235;10263;31708;13366;38943
150490;202210;9951;31015;8958;29665;658;1852;7277;24890;7935;26742
150495;202210;6934;18958;6521;18423;171;667;5956;16659;6127;17326
150497;202210;3229;9259;2553;8086;521;1673;1387;4625;1908;6298
150500;202210;3833;8961;3356;8274;212;531;2691;6487;2903;7018
150503;202210;6712;16086;4831;13694;1556;3988;1862;5935;3418;9923
150506;202210;16190;39980;13842;36845;2384;5757;9287;26345;11671;32102
150510;202210;15016;40326;13072;37168;1118;2992;10200;29121;11318;32113
150520;202210;9945;30778;9498;30242;157;890;8950;28244;9107;29134
150530;202210;14682;45062;12704;42275;1075;3042;9929;34000;11004;37042
150540;202210;6491;14697;5588;13376;294;645;4714;11202;5008;11847
150543;202210;8996;22492;7440;20538;627;1765;5682;16062;6309;17827
150548;202210;12863;34663;11413;32654;498;1373;9944;28627;10442;30000
150549;202210;2371;6027;1981;5472;79;251;1617;4442;1696;4693
150550;202210;25075;66760;20323;59135;5260;15593;8164;24744;13424;40337
150553;202210;46805;117259;35766;98712;8937;25343;15619;43162;24556;68505
150555;202210;2459;5867;1904;5035;170;394;1270;3490;1440;3884
150560;202210;2367;5980;2098;5522;251;621;1381;3643;1632;4264
150563;202210;3231;8636;2608;7543;529;1582;1417;4074;1946;5656
150565;202210;5364;15556;4729;14577;131;468;3808;11873;3939;12341
150570;202210;9634;22900;8838;21858;308;894;7883;19258;8191;20152
150580;202210;13722;46610;11756;44446;1387;4092;9267;37284;10654;41376
150590;202210;10032;29793;8585;28080;208;912;7840;25604;8048;26516
150600;202210;12885;33988;11925;32822;387;983;10835;30092;11222;31075
150610;202210;3929;9019;3494;8371;138;411;3030;7080;3168;7491
150611;202210;3979;9577;3435;8830;85;286;3020;7601;3105;7887
150613;202210;17835;44784;13571;37836;2555;7613;6938;18728;9493;26341
150616;202210;4608;11741;3307;9496;663;2039;1543;4263;2206;6302
150618;202210;8729;22416;7086;19911;974;2899;4396;12406;5370;15305
150619;202210;8137;20608;6649;18569;671;1539;4970;14354;5641;15893
150620;202210;8792;25857;7628;23902;1356;3834;4477;14870;5833;18704
150630;202210;8457;18429;7716;17549;176;426;7012;15727;7188;16153
150635;202210;6651;15925;5560;14200;687;1605;3703;9529;4390;11134
150640;202210;2530;6832;2290;6529;48;136;2080;5968;2128;6104
150650;202210;14834;35892;12840;32893;3377;8243;5979;16346;9356;24589
150655;202210;6789;17038;6114;16072;106;378;5502;14248;5608;14626
150658;202210;5403;14402;3938;11942;946;2982;1768;5513;2714;8495
150660;202210;6856;17565;5979;16299;1136;2974;3538;9690;4674;12664
150670;202210;12314;23958;9807;21102;811;1622;7863;17283;8674;18905
150680;202210;95019;238040;75597;209030;16417;42805;39653;117027;56070;159832
150690;202210;3247;7077;2796;6561;127;235;2426;5773;2553;6008
150700;202210;8309;21047;7393;19906;880;1780;5531;15716;6411;17496
150710;202210;4626;13382;4137;12637;441;1299;3001;9354;3442;10653
150715;202210;6766;16076;5552;14353;329;817;4584;11825;4913;12642
150720;202210;10367;25995;9552;24898;353;1112;8458;21772;8811;22884
150730;202210;16174;43558;13733;40019;1836;5489;9675;28778;11511;34267
150740;202210;4824;12005;4169;11025;433;898;3076;8401;3509;9299
150745;202210;6837;16878;5543;15063;709;2008;3937;10895;4646;12903
150746;202210;2143;5456;1889;5089;59;177;1599;4229;1658;4406
150747;202210;6308;16254;5586;15217;421;990;4408;12158;4829;13148
150750;202210;4557;12383;3704;11144;416;1254;2568;8090;2984;9344
150760;202210;14139;36771;12691;34792;2177;5352;8354;24008;10531;29360
150770;202210;8648;25588;7932;24785;252;557;7234;23270;7486;23827
150775;202210;1449;3423;1132;3020;142;421;793;2096;935;2517
150780;202210;6016;15880;5332;15080;318;841;4696;13546;5014;14387
150790;202210;7458;17847;6252;16532;544;1078;4184;13160;4728;14238
150795;202210;19819;51456;17088;47552;3131;8601;10696;30603;13827;39204
150796;202210;5160;10338;4432;9515;190;353;3887;8347;4077;8700
150797;202210;5533;14265;4691;13084;477;1204;3722;10484;4199;11688
150800;202210;17292;47185;15458;44822;2383;6327;10591;32057;12974;38384
150803;202210;10614;24873;9767;23750;289;818;8853;21220;9142;22038
150805;202210;4386;11958;3704;11032;340;945;2791;8534;3131;9479
150808;202210;7995;21427;5852;17893;2039;6830;972;3257;3011;10087
150810;202210;25825;58952;19541;51442;4256;10762;10209;29728;14465;40490
150812;202210;8019;18389;7107;17036;416;1280;5751;13104;6167;14384
150815;202210;11719;30958;9783;28658;1293;3729;7455;22285;8748;26014
150820;202210;18727;38133;16444;35440;1992;3004;12567;29036;14559;32040
150830;202210;15846;45673;14709;44298;679;1728;13018;40117;13697;41845
150835;202210;4312;11229;3721;10360;417;1175;2676;7441;3093;8616
150840;202210;10272;25668;8334;22705;1162;3558;5102;13376;6264;16934
160005;202210;1720;3720;1508;3480;82;208;1291;2958;1373;3166
160010;202210;2636;6534;2434;6319;24;103;2344;6033;2368;6136
160015;202210;4858;10105;4391;9569;78;192;4163;9017;4241;9209
160020;202210;3121;7975;2702;7437;331;764;1999;5793;2330;6557
160021;202210;1527;5003;1355;4793;66;277;1013;3710;1079;3987
160023;202210;1683;5093;1496;4788;274;809;927;3120;1201;3929
160025;202210;2433;6159;2265;5975;58;95;2160;5749;2218;5844
160027;202210;14373;29174;13032;27557;747;1642;11334;23728;12081;25370
160030;202210;105739;252675;88100;230117;16489;40544;52433;144707;68922;185251
160040;202210;7467;21285;6567;20070;454;1275;5622;17423;6076;18698
160050;202210;7399;18165;6156;16595;2308;5172;2817;9215;5125;14387
160053;202210;5241;13599;4621;12757;271;670;3842;10878;4113;11548
160055;202210;2049;3805;1975;3726;30;79;1908;3560;1938;3639
160060;202210;37875;80333;32036;73764;2888;5413;25623;60999;28511;66412
160070;202210;3702;11495;3225;10778;377;1026;2354;8459;2731;9485
160080;202210;4041;10635;3528;10074;54;165;3266;9433;3320;9598
170025;202210;780;1924;482;1371;87;241;150;414;237;655
170030;202210;1352;3772;992;3106;195;595;382;1243;577;1838
170035;202210;1748;4161;1271;3412;112;331;771;1964;883;2295
170040;202210;2238;5521;1744;4839;214;598;1018;2919;1232;3517
170070;202210;2296;4888;1628;4047;90;242;984;2480;1074;2722
170100;202210;2922;7356;2376;6481;319;826;1523;4204;1842;5030
170105;202210;779;2083;513;1564;120;359;157;435;277;794
170110;202210;1206;3213;921;2743;68;269;572;1612;640;1881
170130;202210;1706;4348;1282;3655;131;425;793;2204;924;2629
170190;202210;1909;4437;1472;3771;200;636;892;2140;1092;2776
170200;202210;2431;5339;1583;3999;280;745;647;1547;927;2292
170210;202210;32996;82409;24812;69244;6980;20936;4845;13790;11825;34726
170215;202210;1522;3722;1202;3288;57;208;922;2476;979;2684
170220;202210;6846;19463;5569;17257;2067;6415;1511;5376;3578;11791
170230;202210;1466;3905;1096;3243;282;834;323;956;605;1790
170240;202210;3455;8086;2779;7054;176;531;2084;5132;2260;5663
170255;202210;4481;11955;3263;9893;596;1871;1547;4712;2143;6583
170270;202210;1016;2322;685;1822;73;194;385;990;458;1184
170290;202210;3719;9256;3190;8555;288;563;2442;6825;2730;7388
170300;202210;2628;5954;2129;5228;166;397;1602;3830;1768;4227
170305;202210;797;1993;645;1732;75;197;352;948;427;1145
170307;202210;1275;3583;1046;3176;127;436;659;1912;786;2348
170310;202210;1884;4315;1341;3498;172;480;707;1827;879;2307
170320;202210;1236;3070;932;2578;116;360;565;1544;681;1904
170330;202210;1161;3178;1056;3024;30;132;918;2557;948;2689
170360;202210;692;1643;502;1354;26;88;336;845;362;933
170370;202210;1551;3612;1100;2899;193;524;545;1340;738;1864
170380;202210;2151;5614;1619;4797;131;417;968;2936;1099;3353
170382;202210;610;1622;492;1434;18;68;359;1005;377;1073
170384;202210;2004;6177;1651;5546;331;1090;889;2965;1220;4055
170386;202210;1101;2842;661;2005;73;265;244;666;317;931
170388;202210;864;2116;618;1710;87;261;327;845;414;1106
170389;202210;1025;2933;809;2557;86;305;508;1622;594;1927
170390;202210;2181;4315;1647;3691;38;100;1424;3200;1462;3300
170410;202210;742;1711;542;1390;27;88;375;895;402;983
170460;202210;473;1210;376;1059;51;153;238;673;289;826
170510;202210;1072;2734;755;2203;31;124;490;1309;521;1433
170550;202210;8061;19588;6066;16543;1614;4847;1963;5104;3577;9951
170555;202210;1626;3920;1286;3413;145;322;630;1751;775;2073
170560;202210;1178;3009;889;2610;101;290;533;1623;634;1913
170600;202210;1643;4029;1275;3482;235;600;712;1997;947;2597
170610;202210;1971;4565;1457;3817;118;375;968;2420;1086;2795
170625;202210;515;1237;335;918;41;98;138;346;179;444
170650;202210;1777;4396;1447;3896;133;432;974;2501;1107;2933
170700;202210;4220;11338;3181;9383;644;1962;1400;3956;2044;5918
170710;202210;1951;4302;1479;3634;176;444;997;2403;1173;2847
170720;202210;2137;4782;1624;4002;154;464;1115;2626;1269;3090
170730;202210;1287;3104;968;2632;116;272;590;1634;706;1906
170740;202210;2378;7052;2014;6408;151;565;1507;4677;1658;5242
170755;202210;1003;2471;704;1987;124;380;331;877;455;1257
170765;202210;1358;3201;952;2568;156;410;488;1304;644;1714
170770;202210;2179;5608;1746;4952;182;530;1219;3407;1401;3937
170820;202210;4651;12161;3571;10351;660;1954;1840;5270;2500;7224
170825;202210;1268;2566;1031;2264;96;198;788;1720;884;1918
170830;202210;1597;3803;1192;3159;287;882;572;1348;859;2230
170900;202210;3395;9426;2904;8735;299;825;2281;7000;2580;7825
170930;202210;4729;11813;3561;9705;807;2333;1160;2950;1967;5283
170950;202210;13717;35614;9668;28538;2849;9036;1330;4009;4179;13045
170980;202210;598;1405;422;1117;46;141;241;599;287;740
171050;202210;1964;5559;1686;5091;119;385;1303;3953;1422;4338
171070;202210;1588;4025;1345;3682;292;689;676;2152;968;2841
171090;202210;1182;2865;922;2489;149;421;473;1276;622;1697
171110;202210;665;1689;451;1297;69;209;208;542;277;751
171150;202210;1170;2699;722;1964;65;201;440;1155;505;1356
171180;202210;882;2264;564;1668;98;276;229;690;327;966
171190;202210;2347;6740;1966;6082;313;1001;1184;3668;1497;4669
171195;202210;986;2792;772;2399;110;437;476;1364;586;1801
171200;202210;724;1879;529;1548;132;440;171;444;303;884
171215;202210;451;1103;348;939;37;108;195;506;232;614
171240;202210;889;2626;686;2274;20;123;474;1498;494;1621
171245;202210;897;2363;683;1950;51;168;417;1095;468;1263
171250;202210;1130;2886;791;2327;137;440;349;1003;486;1443
171270;202210;558;1812;431;1536;75;317;210;731;285;1048
171280;202210;1042;2796;831;2451;63;195;542;1600;605;1795
171320;202210;4604;11963;3541;10147;707;2020;1416;4119;2123;6139
171330;202210;3351;8505;2569;7177;649;1876;1147;3144;1796;5020
171360;202210;1789;4504;1345;3881;139;377;863;2673;1002;3050
171370;202210;851;1968;642;1673;71;188;406;1030;477;1218
171380;202210;1738;4424;1421;3992;164;413;986;2925;1150;3338
171395;202210;1191;2852;798;2193;91;286;504;1331;595;1617
171420;202210;2354;5943;1775;4910;317;934;921;2444;1238;3378
171430;202210;1304;3426;1069;3003;70;225;711;1872;781;2097
171488;202210;2956;7484;2279;6393;418;1158;1185;3313;1603;4471
171500;202210;1048;2474;735;1961;81;249;449;1145;530;1394
171510;202210;979;2782;828;2519;76;262;554;1646;630;1908
171515;202210;584;1332;415;1071;30;95;274;643;304;738
171525;202210;850;2079;641;1739;73;217;405;1029;478;1246
171550;202210;385;1022;293;894;39;151;154;425;193;576
171570;202210;1273;3354;1054;2977;154;442;621;1763;775;2205
171575;202210;1990;4868;1293;3687;133;380;662;1833;795;2213
171610;202210;7100;18563;5215;15413;1267;4113;1197;3741;2464;7854
171620;202210;3499;8025;2976;7309;172;452;2462;6027;2634;6479
171630;202210;1300;3079;982;2636;141;392;632;1714;773;2106
171650;202210;2675;6964;2042;5932;500;1590;618;1805;1118;3395
171660;202210;2731;6316;1910;5020;176;482;1243;3198;1419;3680
171665;202210;1478;3807;1154;3294;241;730;513;1454;754;2184
171670;202210;2215;5446;1619;4462;249;724;736;1956;985;2680
171700;202210;1347;3437;979;2779;119;353;572;1578;691;1931
171720;202210;904;2134;692;1819;60;171;495;1276;555;1447
171750;202210;1626;4473;1135;3566;266;830;289;1077;555;1907
171780;202210;1544;3511;1089;2825;95;284;730;1818;825;2102
171790;202210;1632;4888;1286;4184;190;622;661;2103;851;2725
171800;202210;847;2087;643;1792;64;196;369;980;433;1176
171820;202210;14035;36412;10335;30305;2454;7729;2749;8330;5203;16059
171830;202210;1816;5202;1543;4755;275;816;818;2673;1093;3489
171840;202210;843;2046;621;1700;22;76;380;984;402;1060
171845;202210;801;1764;604;1481;50;163;426;978;476;1141
171850;202210;1152;3203;968;2837;43;187;758;2132;801;2319
171855;202210;1209;3377;995;3000;96;289;596;1743;692;2032
171865;202210;585;1523;490;1379;55;173;305;807;360;980
171870;202210;937;2386;651;1892;106;328;316;901;422;1229
171875;202210;1726;4169;1412;3705;50;205;1118;2804;1168;3009
171880;202210;1728;4092;1496;3786;47;148;1213;3023;1260;3171
171884;202210;1297;3121;986;2616;242;592;464;1266;706;1858
171886;202210;1770;4478;1283;3773;328;1065;337;1043;665;2108
171888;202210;686;1856;471;1452;34;126;273;802;307;928
171889;202210;508;1427;336;1077;77;272;115;332;192;604
171890;202210;1429;3828;1052;3209;140;461;641;1896;781;2357
171900;202210;669;2054;513;1748;79;223;233;808;312;1031
172000;202210;669;1841;514;1563;101;312;198;587;299;899
172010;202210;1462;4078;1220;3697;117;328;761;2320;878;2648
172015;202210;428;1356;325;1157;58;197;142;503;200;700
172020;202210;3417;8524;2973;7974;221;627;2189;5989;2410;6616
172025;202210;833;2092;598;1729;44;140;422;1202;466;1342
172030;202210;1445;3930;1180;3501;88;302;873;2540;961;2842
172049;202210;1446;3351;949;2645;129;350;493;1420;622;1770
172065;202210;1725;3973;1359;3503;150;296;964;2747;1114;3043
172080;202210;2819;7459;2257;6496;125;410;1514;4253;1639;4663
172085;202210;522;1333;328;932;58;173;121;311;179;484
172090;202210;4870;10576;3810;9203;143;381;3091;7308;3234;7689
172093;202210;526;1475;373;1200;26;114;221;664;247;778
172097;202210;812;1956;540;1503;85;255;205;530;290;785
172100;202210;60349;138272;44669;114573;8246;23335;19150;47536;27396;70871
172110;202210;1951;6215;1665;5792;106;442;1304;4550;1410;4992
172120;202210;6066;15999;4746;13939;483;1555;2911;8388;3394;9943
172125;202210;480;1190;363;1007;29;95;206;520;235;615
172130;202210;697;1645;521;1355;23;86;344;813;367;899
172208;202210;3057;6685;2382;5824;210;456;1734;4248;1944;4704
172210;202210;3121;7015;2405;6146;256;648;1576;4149;1832;4797
210005;202210;22762;59660;17109;50681;4371;13566;7301;21933;11672;35499
210010;202210;2601;6445;2386;6198;45;214;2197;5597;2242;5811
210015;202210;3681;10103;3145;9385;155;463;2592;7763;2747;8226
210020;202210;9539;18866;8246;17368;439;630;7353;15723;7792;16353
210030;202210;5221;15970;4728;15214;486;1584;3736;12141;4222;13725
210040;202210;2579;4990;2256;4608;60;165;2034;4055;2094;4220
210043;202210;6830;17660;5707;16149;368;1112;4529;12837;4897;13949
210047;202210;8022;21681;6311;19459;155;669;5458;16760;5613;17429
210050;202210;2879;7995;2297;7002;159;652;1748;5105;1907;5757
210055;202210;2451;6446;2167;6065;57;176;1887;5337;1944;5513
210060;202210;8679;28878;7644;27049;769;2828;5333;19292;6102;22120
210070;202210;7932;19122;7311;18341;82;229;6868;17155;6950;17384
210080;202210;5177;14548;4863;14198;46;236;4537;13189;4583;13425
210083;202210;7176;16603;6042;15364;98;322;5715;14468;5813;14790
210087;202210;3180;8289;2679;7629;156;494;2134;6027;2290;6521
210090;202210;10670;29697;9817;28316;439;1167;8479;24408;8918;25575
210095;202210;7369;22327;6650;21390;485;1534;5298;17691;5783;19225
210100;202210;7445;21036;6410;19259;827;2450;4283;13026;5110;15476
210110;202210;3527;9305;3222;8925;54;253;2924;8004;2978;8257
210120;202210;34222;73828;29211;67634;1635;3155;23405;54524;25040;57679
210125;202210;5180;12644;4490;11863;770;1529;3174;9023;3944;10552
210130;202210;4913;11342;3972;10180;92;203;3498;8942;3590;9145
210135;202210;2120;4710;1765;4213;55;130;1538;3637;1593;3767
210140;202210;24724;58984;19306;52026;2816;7497;12197;33189;15013;40686
210150;202210;5543;11759;4853;10840;120;323;4228;9238;4348;9561
210160;202210;25704;57912;22066;53380;1771;3790;17313;42483;19084;46273
210170;202210;20462;51934;18727;49673;1583;3388;15166;41516;16749;44904
210173;202210;2633;9090;2461;8815;97;502;2165;7651;2262;8153
210177;202210;3715;9481;3178;8792;443;1097;2354;6741;2797;7838
210180;202210;1788;4081;1559;3804;41;95;1403;3423;1444;3518
210190;202210;6524;14904;5388;13359;88;276;4715;11477;4803;11753
210193;202210;1595;4014;1365;3662;52;142;1060;2823;1112;2965
210197;202210;2297;6539;2064;6221;151;416;1658;5105;1809;5521
210200;202210;9305;26250;8156;24548;496;1639;6486;19447;6982;21086
210203;202210;8395;22113;7030;20337;546;1536;5539;16415;6085;17951
210207;202210;4445;9870;3616;8918;139;306;3030;7511;3169;7817
210210;202210;8654;25033;7748;23784;140;734;6673;20251;6813;20985
210215;202210;2814;8023;2428;7469;136;604;1983;5983;2119;6587
210220;202210;8077;22792;7587;22094;144;856;6890;19514;7034;20370
210230;202210;6721;17118;6069;16145;162;425;5522;14673;5684;15098
210232;202210;13684;37842;11202;34188;1605;4843;7424;23602;9029;28445
210235;202210;4022;10876;3487;10109;159;553;2925;8437;3084;8990
210237;202210;4870;10561;4181;9786;24;127;3992;9211;4016;9338
210240;202210;2927;8161;2625;7693;84;270;2167;6270;2251;6540
210250;202210;7015;17878;6331;17020;149;456;5706;15348;5855;15804
210255;202210;3098;8534;2632;7729;325;1029;1639;4667;1964;5696
210260;202210;6115;16715;5245;15460;389;1229;4208;12339;4597;13568
210270;202210;5754;13949;5067;13097;80;372;4598;11715;4678;12087
210275;202210;3951;9038;3344;8305;179;401;2744;6864;2923;7265
210280;202210;7288;17098;6013;15283;165;699;4973;12105;5138;12804
210290;202210;9861;21522;8837;20299;119;318;8356;19088;8475;19406
210300;202210;38030;96347;30686;85930;5708;15144;15929;49263;21637;64407
210310;202210;3537;8016;3051;7351;44;126;2796;6679;2840;6805
210312;202210;3299;7110;2932;6712;17;76;2742;6160;2759;6236
210315;202210;4275;9255;3804;8728;133;285;3501;8056;3634;8341
210317;202210;5109;14163;4633;13600;104;461;4227;12316;4331;12777
210320;202210;30520;66631;28356;63977;247;1152;26707;59153;26954;60305
210325;202210;4094;10546;3393;9615;405;1158;2526;7219;2931;8377
210330;202210;30572;73904;24596;66645;3953;8751;16071;47999;20024;56750
210340;202210;14601;32584;13103;30733;713;1390;10900;26134;11613;27524
210350;202210;11294;27460;9923;25786;123;411;9016;23240;9139;23651
210355;202210;4476;13808;3915;12927;108;493;3310;10896;3418;11389
210360;202210;14447;41758;12945;39393;537;2323;9780;28703;10317;31026
210370;202210;14235;26803;10714;23093;361;536;9815;21535;10176;22071
210375;202210;3816;9606;2783;8071;924;2862;681;2084;1605;4946
210380;202210;6470;14827;5560;13740;252;687;4798;11735;5050;12422
210390;202210;3722;9670;3454;9266;73;308;3156;8331;3229;8639
210400;202210;5425;13975;4781;13224;244;483;4229;12003;4473;12486
210405;202210;8826;20609;7168;18401;1223;2790;4331;11771;5554;14561
210407;202210;2388;6901;1978;6190;130;406;1525;4781;1655;5187
210408;202210;3152;10286;2903;9956;183;754;2323;8004;2506;8758
210409;202210;4389;13504;3914;12841;224;796;3154;10596;3378;11392
210410;202210;4233;11119;3564;9972;88;367;2951;8030;3039;8397
210420;202210;4351;12664;3832;11760;224;644;3147;9711;3371;10355
210430;202210;2554;6877;2203;6398;185;502;1766;5217;1951;5719
210440;202210;4995;12203;4312;11366;214;419;3811;10156;4025;10575
210450;202210;2635;7033;2258;6486;236;569;1684;5004;1920;5573
210455;202210;5675;13118;4388;11505;1027;2810;2212;5829;3239;8639
210460;202210;4138;11010;3448;10082;121;415;2907;8432;3028;8847
210462;202210;1910;5276;1590;4791;65;184;1247;3779;1312;3963
210465;202210;3094;7999;2666;7418;131;498;2223;6033;2354;6531
210467;202210;7312;19352;6291;18033;498;1261;5049;14862;5547;16123
210470;202210;2129;5455;1574;4673;149;421;1137;3423;1286;3844
210480;202210;19693;52845;16240;48656;2027;4355;11487;37902;13514;42257
210490;202210;3887;8925;3079;7848;82;207;2617;6625;2699;6832
210500;202210;7351;24819;6761;23864;351;1544;5708;19942;6059;21486
210510;202210;7748;20687;6868;19751;168;459;6312;18322;6480;18781
210515;202210;4366;11639;3711;10862;187;581;3109;9228;3296;9809
210520;202210;2982;7924;2652;7484;137;437;2215;6166;2352;6603
210530;202210;65046;147891;50700;127439;9544;25507;21030;56573;30574;82080
210535;202210;4270;11889;3867;11317;129;464;3400;9915;3529;10379
210540;202210;17613;46127;14642;41853;1937;4925;9843;29765;11780;34690
210542;202210;7560;16380;5847;14433;522;1182;4584;11480;5106;12662
210545;202210;2506;7108;2292;6759;47;182;1983;5766;2030;5948
210547;202210;4243;13741;3722;12829;209;752;2920;10251;3129;11003
210550;202210;6764;19060;5159;16494;595;2047;3254;10633;3849;12680
210560;202210;4256;11972;3732;11150;92;348;3202;9401;3294;9749
210565;202210;1736;4695;1419;4264;98;358;1076;3257;1174;3615
210570;202210;12588;31459;11105;29636;270;760;9927;26583;10197;27343
210580;202210;3406;8113;2684;7228;202;474;1943;5500;2145;5974
210590;202210;4769;13036;4057;12150;81;408;3600;10725;3681;11133
210592;202210;3219;8084;2971;7707;30;143;2624;6651;2654;6794
210594;202210;2823;7238;2194;6275;202;536;1536;4568;1738;5104
210596;202210;3355;10183;2964;9517;344;1104;2177;7189;2521;8293
210598;202210;2350;5757;2101;5428;89;259;1844;4731;1933;4990
210600;202210;3397;8664;2728;7711;316;822;1791;5092;2107;5914
210610;202210;3582;8292;3052;7657;57;224;2681;6612;2738;6836
210620;202210;3502;7694;2856;6888;152;299;2428;5803;2580;6102
210630;202210;3631;10581;3207;9874;170;626;2563;7805;2733;8431
210632;202210;7212;16304;6443;15302;194;670;5768;13342;5962;14012
210635;202210;1883;6208;1759;5986;177;560;1341;4691;1518;5251
210637;202210;3037;8739;2544;8050;159;577;1945;6219;2104;6796
210640;202210;5816;16939;5403;16467;60;308;5038;15276;5098;15584
210650;202210;8053;20791;7176;19674;103;351;6440;17595;6543;17946
210660;202210;9398;24604;8374;22981;184;814;7308;19444;7492;20258
210663;202210;3564;8140;3136;7625;311;499;2340;6193;2651;6692
210667;202210;2245;6543;1991;6159;53;185;1708;5398;1761;5583
210670;202210;6410;16701;5774;15739;118;482;5193;13915;5311;14397
210675;202210;6393;14429;5365;13159;584;1202;4175;10522;4759;11724
210680;202210;5692;11728;4812;10710;99;167;4495;10008;4594;10175
210690;202210;10864;24669;9223;22842;264;802;8411;20558;8675;21360
210700;202210;3229;8035;2555;7071;171;428;1959;5483;2130;5911
210710;202210;6150;16257;5391;15269;101;437;4862;13627;4963;14064
210720;202210;3550;10138;3078;9556;92;405;2712;8366;2804;8771
210725;202210;1532;4457;1306;4115;52;170;935;3046;987;3216
210730;202210;1692;3475;1413;3104;69;125;1226;2698;1295;2823
210735;202210;5320;13704;4489;12661;297;708;3671;10750;3968;11458
210740;202210;6042;13971;5112;12910;126;272;4353;10934;4479;11206
210745;202210;4907;12129;4426;11535;60;197;3993;10342;4053;10539
210750;202210;29591;70719;25619;65685;3639;8147;16852;45539;20491;53686
210760;202210;7341;15428;6190;14210;138;251;5714;13366;5852;13617
210770;202210;7231;16164;6176;14967;56;230;5774;13825;5830;14055
210780;202210;8573;24164;7364;22214;501;1526;5741;17315;6242;18841
210790;202210;5154;14065;4540;13256;267;702;3743;11201;4010;11903
210800;202210;5749;13687;4918;12569;76;293;4460;11176;4536;11469
210805;202210;4747;15129;4369;14580;200;706;3712;12481;3912;13187
210810;202210;5670;14895;5107;14183;430;1030;4139;11846;4569;12876
210820;202210;8321;21723;6927;19539;995;2627;4154;12135;5149;14762
210825;202210;9554;22914;8661;21779;236;687;7899;19673;8135;20360
210830;202210;10409;24216;9433;23038;884;1485;7696;19709;8580;21194
210840;202210;5705;10005;5243;9459;32;119;4977;8736;5009;8855
210845;202210;7204;17438;6326;16465;52;153;6049;15778;6101;15931
210850;202210;8058;21668;6685;19667;493;1381;5292;15733;5785;17114
210860;202210;24877;55342;20574;50208;971;2144;17091;42679;18062;44823
210870;202210;8788;19505;6973;17460;160;395;6249;15582;6409;15977
210880;202210;4809;13006;4261;12292;217;678;3377;9658;3594;10336
210890;202210;5858;12857;5364;12290;217;540;4785;10792;5002;11332
210900;202210;5654;15003;4375;12747;1590;4698;889;2936;2479;7634
210905;202210;2634;5634;2241;5148;45;80;2095;4825;2140;4905
210910;202210;8523;24176;7019;21763;891;2710;4571;14262;5462;16972
210920;202210;3627;10373;3163;9756;70;314;2865;8735;2935;9049
210923;202210;2279;5141;1972;4700;91;225;1623;3770;1714;3995
210927;202210;5324;16129;4590;15220;614;1967;3101;10748;3715;12715
210930;202210;3456;8950;3034;8208;87;352;2639;6877;2726;7229
210940;202210;4227;11113;3818;10612;339;1491;3138;8028;3477;9519
210945;202210;9268;21727;8247;20554;552;1044;6758;17491;7310;18535
210950;202210;6312;15676;4865;13667;607;1321;3302;9985;3909;11306
210955;202210;1749;4919;1456;4453;289;845;850;2671;1139;3516
210960;202210;10646;28875;9098;26522;2772;7969;3920;12464;6692;20433
210970;202210;1991;4667;1641;4104;90;273;1374;3294;1464;3567
210975;202210;2018;5589;1814;5282;187;544;1333;3878;1520;4422
210980;202210;12436;24363;11034;22904;157;277;10443;21675;10600;21952
210990;202210;20562;51054;15957;45227;1642;3961;11272;33440;12914;37401
211000;202210;17120;43816;14062;40040;2441;6045;9438;28667;11879;34712
211003;202210;7366;17615;6172;16215;118;447;5483;14398;5601;14845
211010;202210;8164;23354;7373;22380;81;370;6772;20616;6853;20986
211020;202210;10278;25257;8995;23834;217;693;7928;21369;8145;22062
211023;202210;2403;6949;2198;6683;128;379;1806;5489;1934;5868
211027;202210;4480;10951;4251;10611;101;340;3945;9677;4046;10017
211030;202210;4501;11260;3973;10599;375;937;2953;8044;3328;8981
211040;202210;5149;16606;4709;15863;116;606;4199;14011;4315;14617
211050;202210;10904;24560;9747;23119;130;404;8937;21037;9067;21441
211060;202210;8883;22170;8052;21083;167;611;7244;18695;7411;19306
211065;202210;2900;6602;2417;5997;121;245;2083;5247;2204;5492
211070;202210;9745;26464;8247;24288;334;1067;7003;20541;7337;21608
211080;202210;1567;3778;1232;3276;33;171;959;2360;992;2531
211085;202210;2535;6325;2093;5761;201;388;1620;4736;1821;5124
211090;202210;3598;8990;3232;8570;26;118;3005;7910;3031;8028
211100;202210;8248;17884;7576;17109;35;109;7149;16095;7184;16204
211102;202210;3935;11095;3555;10551;336;1000;2830;8434;3166;9434
211105;202210;2688;7659;2249;6908;122;385;1725;5201;1847;5586
211107;202210;5458;15643;4599;14386;183;611;3676;11971;3859;12582
211110;202210;7565;17594;6010;15344;262;772;4910;12192;5172;12964
211120;202210;57495;126797;47088;114610;7794;17316;30117;76382;37911;93698
211125;202210;2233;6163;1875;5624;39;179;1599;4753;1638;4932
211130;202210;223834;484097;192324;443589;26979;55299;122048;292095;149027;347394
211140;202210;5447;14801;4694;13827;176;543;3961;11749;4137;12292
211150;202210;11241;26724;9399;24437;509;1068;7669;20410;8178;21478
211153;202210;3438;8386;2388;7076;425;1121;1467;4627;1892;5748
211157;202210;1452;4043;1225;3617;82;247;881;2588;963;2835
211160;202210;6151;13725;4994;12145;132;465;4130;9507;4262;9972
211163;202210;1714;5046;1537;4797;56;197;1328;4171;1384;4368
211167;202210;1993;5158;1843;4954;26;95;1713;4575;1739;4670
211170;202210;8454;16916;7795;16153;53;143;7443;15243;7496;15386
211172;202210;2952;7495;2462;6755;88;296;1996;5235;2084;5531
211174;202210;3345;8439;3023;8079;32;161;2866;7579;2898;7740
211176;202210;4917;12685;3831;11116;316;983;2975;8570;3291;9553
211178;202210;6241;11984;5403;11093;26;108;5237;10643;5263;10751
211180;202210;4856;14282;4425;13671;176;719;3672;11207;3848;11926
211190;202210;3843;9452;3247;8600;32;167;2967;7729;2999;7896
211195;202210;1894;4354;1648;4000;63;154;1446;3491;1509;3645
211200;202210;2470;6663;1928;5815;186;592;1352;4018;1538;4610
211210;202210;7097;19823;6324;18755;474;1456;5101;15145;5575;16601
211220;202210;50545;109114;42102;98944;4028;8749;31670;74861;35698;83610
211223;202210;6190;15016;5013;13448;650;1757;3264;8791;3914;10548
211227;202210;1962;5630;1681;5232;67;262;1376;4288;1443;4550
211230;202210;10056;24551;8604;22520;330;699;7397;19482;7727;20181
211240;202210;10961;26782;10313;25985;173;642;9727;24139;9900;24781
211245;202210;9214;22552;8109;21385;166;397;7704;20351;7870;20748
211250;202210;17933;46233;16193;43668;1349;3620;12724;34185;14073;37805
211260;202210;9397;26594;8111;25084;187;759;7287;22632;7474;23391
211270;202210;11786;33383;10026;31121;405;1568;8205;25618;8610;27186
211280;202210;18432;39231;16530;36904;431;944;15134;33651;15565;34595
211285;202210;2363;6571;2101;6239;164;540;1598;4742;1762;5282
211290;202210;8251;22500;7353;21286;305;956;6071;17495;6376;18451
211300;202210;8374;22639;7254;20802;468;1425;5553;15652;6021;17077
211400;202210;13903;34448;11286;30875;1478;3853;7479;21397;8957;25250
220005;202210;2316;5203;2084;4884;50;113;1760;3999;1810;4112
220010;202210;1720;4432;1381;3868;49;138;1078;2991;1127;3129
220020;202210;5292;11418;4592;10500;160;412;4024;8994;4184;9406
220025;202210;2764;5397;2363;4818;73;123;1980;3893;2053;4016
220027;202210;1633;3519;1400;3205;30;92;1231;2746;1261;2838
220030;202210;4572;9569;4227;9125;103;262;3770;7955;3873;8217
220040;202210;9347;25385;8076;23056;1517;4004;4624;13647;6141;17651
220045;202210;1862;4787;1551;4308;24;122;1336;3593;1360;3715
220050;202210;6410;13860;5555;12807;68;227;5216;11827;5284;12054
220060;202210;3494;5828;3020;5288;56;77;2867;4998;2923;5075
220070;202210;2812;6504;2325;5809;71;150;1950;4797;2021;4947
220080;202210;855;2227;736;2059;16;63;622;1699;638;1762
220090;202210;2013;4365;1624;3798;66;94;1346;3174;1412;3268
220095;202210;1177;2079;1118;2016;22;39;1044;1866;1066;1905
220100;202210;1675;4024;1324;3494;31;123;1081;2716;1112;2839
220105;202210;2418;6584;2077;6011;147;460;1553;4457;1700;4917
220110;202210;4208;9962;3648;9066;41;165;3261;7970;3302;8135
220115;202210;3361;8466;3076;8110;147;422;2690;7010;2837;7432
220117;202210;1636;3495;1282;3015;15;54;1078;2444;1093;2498
220120;202210;20518;39172;18955;37228;81;277;18124;35000;18205;35277
220130;202210;1330;3155;1099;2846;24;106;987;2480;1011;2586
220140;202210;2789;5007;2379;4540;81;151;2137;4098;2218;4249
220150;202210;7611;19423;6860;18192;144;540;5829;15043;5973;15583
220155;202210;1380;3613;1094;3102;23;81;789;2153;812;2234
220157;202210;1312;2741;1099;2434;30;67;884;1922;914;1989
220160;202210;3324;8174;2824;7303;58;198;2309;5773;2367;5971
220170;202210;1825;4424;1520;3984;31;116;1315;3390;1346;3506
220173;202210;2475;6267;1968;5395;46;177;1564;4156;1610;4333
220177;202210;2810;6085;2667;5931;7;24;2626;5817;2633;5841
220180;202210;1415;2872;1159;2469;5;27;978;1935;983;1962
220190;202210;9860;19771;8406;17928;625;1141;6519;14219;7144;15360
220191;202210;1938;5095;1747;4786;123;375;1286;3415;1409;3790
220192;202210;2400;5675;1729;4537;43;135;1411;3615;1454;3750
220194;202210;2181;5269;1904;4828;42;154;1605;3887;1647;4041
220196;202210;2560;5782;2322;5442;20;87;2030;4638;2050;4725
220198;202210;1568;3540;1326;3247;17;38;1206;2967;1223;3005
220200;202210;5929;15660;5161;14631;134;474;4364;12278;4498;12752
220202;202210;2547;6252;2143;5612;32;128;1844;4721;1876;4849
220205;202210;3185;7542;2830;6941;83;242;2415;5761;2498;6003
220207;202210;899;2409;756;2171;78;199;480;1424;558;1623
220208;202210;2109;5834;1702;5095;284;885;896;2653;1180;3538
220209;202210;1800;4764;1512;4255;28;97;1213;3363;1241;3460
220210;202210;2305;4626;2012;4202;21;58;1783;3593;1804;3651
220211;202210;2042;4185;1866;3960;20;67;1653;3430;1673;3497
220213;202210;2134;5013;1796;4444;32;112;1464;3437;1496;3549
220217;202210;2877;6763;2656;6510;175;244;2337;5959;2512;6203
220220;202210;16009;32172;13815;29086;490;1083;11591;23777;12081;24860
220225;202210;1204;2704;981;2425;2;12;920;2247;922;2259
220230;202210;6948;15188;5982;13885;290;568;5133;11948;5423;12516
220240;202210;3762;9518;3078;8373;101;396;2513;6624;2614;7020
220245;202210;2431;4325;1880;3686;11;43;1750;3371;1761;3414
220250;202210;3611;8718;3158;8160;28;103;2953;7560;2981;7663
220253;202210;1926;4691;1618;4221;37;114;1382;3528;1419;3642
220255;202210;2335;4834;1970;4328;38;130;1706;3590;1744;3720
220260;202210;6024;14923;5229;13570;280;690;4192;10836;4472;11526
220265;202210;1807;4715;1634;4491;80;288;1377;3677;1457;3965
220270;202210;7126;20729;6642;19867;177;883;5635;16164;5812;17047
220271;202210;1790;4007;1560;3695;44;110;1350;3162;1394;3272
220272;202210;2011;5283;1742;4798;53;179;1320;3468;1373;3647
220273;202210;1496;3843;1240;3398;62;206;945;2539;1007;2745
220275;202210;3142;5907;2519;5070;52;81;2295;4567;2347;4648
220277;202210;2825;5884;2378;5270;106;193;1976;4311;2082;4504
220280;202210;2363;4307;1991;3853;27;50;1814;3435;1841;3485
220285;202210;2006;4002;1730;3677;11;47;1652;3452;1663;3499
220290;202210;8288;20379;6581;18055;559;1357;4639;13233;5198;14590
220300;202210;2322;6012;1809;5351;35;174;1483;4322;1518;4496
220310;202210;3820;8871;3005;7927;46;171;2626;6855;2672;7026
220320;202210;3609;9284;2768;7839;73;318;2186;5938;2259;6256
220323;202210;1994;5008;1528;4274;47;174;1276;3438;1323;3612
220325;202210;1407;3897;1170;3492;36;147;943;2755;979;2902
220327;202210;1961;4775;1710;4378;67;222;1430;3529;1497;3751
220330;202210;6353;12341;5468;11309;62;188;5055;10228;5117;10416
220335;202210;2218;5470;2010;5191;130;218;1690;4464;1820;4682
220340;202210;2099;5209;1577;4344;76;242;1007;2663;1083;2905
220342;202210;1465;3698;1304;3472;107;208;996;2724;1103;2932
220345;202210;3657;7335;2779;6149;17;52;2490;5401;2507;5453
220350;202210;3885;9041;3103;7900;223;516;2184;5532;2407;6048
220360;202210;1557;3526;1200;2966;18;58;980;2338;998;2396
220370;202210;10628;26525;9567;24912;401;1057;8076;20804;8477;21861
220375;202210;2033;4806;1796;4519;18;24;1728;4372;1746;4396
220380;202210;1881;3766;1500;3238;24;49;1322;2819;1346;2868
220385;202210;1115;2230;907;1885;7;13;814;1651;821;1664
220390;202210;15003;32242;12004;27978;1987;4718;6603;15146;8590;19864
220400;202210;1787;3826;1356;3169;18;62;1061;2333;1079;2395
220410;202210;1410;3473;1133;3018;29;101;936;2420;965;2521
220415;202210;998;2335;800;2005;23;49;632;1550;655;1599
220420;202210;2212;5794;1755;4912;78;259;1279;3485;1357;3744
220430;202210;3460;7370;3080;6878;48;125;2796;6109;2844;6234
220435;202210;2448;5221;2128;4742;26;83;1836;3938;1862;4021
220440;202210;3841;8778;3258;7954;51;238;2922;6826;2973;7064
220450;202210;3262;7249;2708;6564;52;173;2409;5733;2461;5906
220455;202210;1643;4100;1558;3997;16;59;1425;3657;1441;3716
220460;202210;1388;2763;1278;2613;27;60;1144;2257;1171;2317
220465;202210;2868;7795;2520;7271;169;493;1980;5724;2149;6217
220470;202210;4597;10964;4059;10124;202;423;3147;7750;3349;8173
220480;202210;3138;7449;2487;6456;235;445;1668;4350;1903;4795
220490;202210;2883;6438;2451;5905;25;120;2162;5076;2187;5196
220500;202210;3951;8489;3291;7496;139;253;2567;5717;2706;5970
220510;202210;3217;7669;2579;6599;106;257;2040;5249;2146;5506
220515;202210;2124;4392;1946;4144;78;101;1658;3516;1736;3617
220520;202210;6145;13819;5512;12933;120;247;4708;11005;4828;11252
220525;202210;1675;3604;1398;3274;22;55;1271;2968;1293;3023
220527;202210;1954;4169;1626;3697;54;117;1440;3276;1494;3393
220530;202210;1975;4009;1657;3605;173;362;1270;2843;1443;3205
220535;202210;1026;2436;947;2318;30;106;779;1821;809;1927
220540;202210;3797;10708;3468;10076;221;625;2799;8097;3020;8722
220545;202210;1754;4596;1585;4335;83;303;1337;3570;1420;3873
220550;202210;10328;29252;9039;26884;519;1714;6700;19405;7219;21119
220551;202210;1723;4127;1483;3729;27;92;1257;3074;1284;3166
220552;202210;1914;5039;1540;4399;23;113;1241;3393;1264;3506
220553;202210;2519;4932;2121;4420;27;50;1926;3961;1953;4011
220554;202210;1155;2549;886;2147;82;158;630;1502;712;1660
220555;202210;4668;8365;4145;7743;32;86;3767;6943;3799;7029
220556;202210;1544;3897;1311;3490;41;176;972;2413;1013;2589
220557;202210;1969;5441;1614;4703;103;379;1151;3203;1254;3582
220558;202210;1738;3977;1385;3494;25;91;1189;2900;1214;2991
220559;202210;2219;4727;1877;4211;51;87;1564;3475;1615;3562
220560;202210;2354;4373;1978;3923;22;43;1857;3640;1879;3683
220570;202210;9672;24673;8660;23214;674;1648;6777;18135;7451;19783
220580;202210;8037;19380;7236;18192;105;289;6448;16105;6553;16394
220585;202210;2430;6813;1988;5997;65;164;1581;4767;1646;4931
220590;202210;1876;4098;1550;3645;108;217;1229;2860;1337;3077
220595;202210;3295;7747;2951;7290;86;273;2541;6138;2627;6411
220600;202210;2220;3740;1946;3431;19;35;1838;3199;1857;3234
220605;202210;1731;4646;1478;4207;23;119;1191;3264;1214;3383
220610;202210;3416;8289;3177;7952;16;92;3009;7440;3025;7532
220620;202210;10474;25646;9539;24403;139;649;8787;22023;8926;22672
220630;202210;418;1133;321;963;28;89;197;556;225;645
220635;202210;2114;5623;1861;5129;71;221;1491;3984;1562;4205
220640;202210;2815;7013;2375;6378;89;310;1919;5064;2008;5374
220650;202210;2943;6464;2515;5840;88;179;2079;4795;2167;4974
220660;202210;3083;8596;2580;7767;77;343;2128;6215;2205;6558
220665;202210;1572;4026;1340;3662;32;147;1155;3049;1187;3196
220667;202210;1919;5096;1731;4782;86;275;1403;3816;1489;4091
220669;202210;1951;5098;1849;4952;39;157;1656;4317;1695;4474
220670;202210;2781;5947;2229;5188;29;79;1976;4518;2005;4597
220672;202210;4098;8899;3378;8040;105;347;2997;6940;3102;7287
220675;202210;1524;3760;1348;3456;85;240;1017;2551;1102;2791
220680;202210;3668;7837;3487;7611;217;321;3090;6898;3307;7219
220690;202210;1857;4392;1588;3986;107;299;1204;2944;1311;3243
220695;202210;1101;2755;989;2562;23;65;833;2120;856;2185
220700;202210;14731;28677;12088;25285;456;1022;9952;20071;10408;21093
220710;202210;1040;2531;755;2051;22;78;579;1509;601;1587
220720;202210;2738;5435;2444;5064;29;77;2194;4437;2223;4514
220730;202210;1645;3907;1407;3543;15;65;1232;3007;1247;3072
220735;202210;1225;2443;940;2022;42;82;729;1525;771;1607
220740;202210;1626;3738;1299;3304;59;143;1064;2722;1123;2865
220750;202210;5213;10807;4600;9998;249;396;4077;8922;4326;9318
220755;202210;1787;3644;1483;3218;39;80;1239;2629;1278;2709
220760;202210;4261;8981;3728;8293;43;144;3514;7744;3557;7888
220770;202210;32812;82860;28234;75533;7146;20429;12756;33470;19902;53899
220775;202210;1650;3383;1472;3168;5;23;1438;3061;1443;3084
220777;202210;1852;4255;1445;3647;57;108;1000;2660;1057;2768
220779;202210;1439;3462;1230;3142;38;121;1023;2548;1061;2669
220780;202210;7011;15194;6278;14167;386;890;4928;11028;5314;11918
220785;202210;1739;3370;1528;3108;21;48;1439;2896;1460;2944
220790;202210;12519;30546;11180;28704;243;871;9633;24300;9876;25171
220793;202210;1179;2604;949;2230;14;33;808;1861;822;1894
220795;202210;1658;3781;1444;3479;28;83;1281;3058;1309;3141
220800;202210;25946;48594;22353;44005;1009;1888;18343;35099;19352;36987
220810;202210;3675;8955;3089;8000;76;168;2507;6568;2583;6736
220820;202210;7221;15017;6360;13827;302;497;5347;11574;5649;12071
220830;202210;9157;20497;8090;18993;461;1032;6546;15065;7007;16097
220840;202210;15659;40364;13253;36005;1971;5206;8245;21895;10216;27101
220850;202210;3586;9827;3179;9320;59;269;2850;8337;2909;8606
220855;202210;1036;1960;905;1798;18;51;831;1625;849;1676
220860;202210;1425;2822;1222;2545;22;63;1136;2317;1158;2380
220865;202210;2671;6675;2027;5559;46;191;1532;4021;1578;4212
220870;202210;3952;8784;3274;7929;36;154;3003;7150;3039;7304
220880;202210;7984;14357;6895;13060;145;314;6345;11887;6490;12201
220885;202210;1798;4375;1498;3933;90;269;1191;3070;1281;3339
220887;202210;1916;3572;1607;3169;42;62;1484;2912;1526;2974
220890;202210;1684;4467;1439;4121;55;193;1170;3331;1225;3524
220900;202210;2610;5162;2198;4624;24;51;1987;4088;2011;4139
220910;202210;2113;4609;1802;4155;326;517;1245;3096;1571;3613
220915;202210;1079;2684;835;2256;8;31;632;1601;640;1632
220920;202210;1868;4840;1608;4502;104;291;1328;3742;1432;4033
220930;202210;2405;5058;2031;4567;22;58;1830;4170;1852;4228
220935;202210;1240;3283;968;2716;20;86;656;1712;676;1798
220937;202210;1724;4091;1446;3649;38;118;1157;2840;1195;2958
220940;202210;2251;4780;1841;4119;41;118;1576;3373;1617;3491
220945;202210;582;1763;458;1540;23;120;313;1018;336;1138
220950;202210;1593;3390;1065;2591;15;45;859;1981;874;2026
220955;202210;1972;4296;1625;3736;18;42;1427;3226;1445;3268
220960;202210;874;2093;631;1692;34;110;400;983;434;1093
220965;202210;2188;5014;1898;4608;23;106;1676;3942;1699;4048
220970;202210;2608;5048;1954;4134;9;32;1733;3538;1742;3570
220975;202210;902;2075;772;1914;11;51;695;1660;706;1711
220980;202210;1484;3485;1320;3272;33;102;1145;2770;1178;2872
220985;202210;1745;3699;1505;3339;99;167;1168;2563;1267;2730
220987;202210;1788;4595;1578;4255;52;172;1315;3492;1367;3664
220990;202210;1941;4856;1685;4472;25;97;1424;3716;1449;3813
220995;202210;1669;3757;1372;3271;13;42;1175;2737;1188;2779
220997;202210;2886;7483;2610;7034;47;184;2327;6097;2374;6281
221000;202210;5746;13289;4989;12243;167;498;4233;10209;4400;10707
221005;202210;1967;4277;1788;3990;25;101;1553;3295;1578;3396
221010;202210;1550;2941;1229;2554;41;57;1084;2229;1125;2286
221020;202210;1757;4919;1576;4621;23;91;1231;3579;1254;3670
221030;202210;2041;4155;1741;3789;22;57;1561;3403;1583;3460
221035;202210;1905;4152;1613;3758;42;64;1415;3318;1457;3382
221037;202210;829;1994;691;1763;12;44;523;1245;535;1289
221038;202210;606;1539;469;1311;26;82;333;903;359;985
221039;202210;990;2459;810;2173;30;115;653;1697;683;1812
221040;202210;5206;13396;4446;12154;231;631;3556;9674;3787;10305
221050;202210;5597;10918;5026;10215;81;204;4610;9248;4691;9452
221060;202210;11615;27557;9539;24260;496;1106;7641;19225;8137;20331
221062;202210;1608;3985;1379;3643;120;242;1080;2903;1200;3145
221063;202210;1451;3355;1263;3094;62;175;1039;2470;1101;2645
221065;202210;3524;7392;3069;6659;15;49;2791;5929;2806;5978
221070;202210;3938;10918;3138;9318;464;1360;1872;5630;2336;6990
221080;202210;4315;9318;3517;8149;51;178;2974;6600;3025;6778
221090;202210;1666;3696;1372;3260;18;45;1196;2780;1214;2825
221093;202210;2022;4491;1829;4178;183;356;1334;2980;1517;3336
221095;202210;1074;2476;887;2211;36;100;708;1742;744;1842
221097;202210;982;2268;734;1852;17;53;574;1362;591;1415
221100;202210;171978;386032;146090;345750;9932;27080;108114;242140;118046;269220
221110;202210;13428;32459;12235;30969;409;934;10745;27146;11154;28080
221120;202210;5776;14856;5116;13892;179;554;4405;11872;4584;12426
221130;202210;7115;15378;5592;12743;859;1808;3619;7927;4478;9735
221135;202210;2417;4958;2093;4548;85;155;1801;3969;1886;4124
221140;202210;1900;3511;1577;3121;61;101;1387;2721;1448;2822
221150;202210;1328;2959;1004;2430;26;111;802;1816;828;1927
221160;202210;883;1959;779;1828;41;53;609;1441;650;1494
221170;202210;1224;2945;1131;2788;5;16;1032;2488;1037;2504
230010;202210;3562;8504;2906;7414;48;155;2392;5904;2440;6059
230015;202210;4315;11343;3722;10182;223;641;2671;7188;2894;7829
230020;202210;18528;46827;17119;44702;915;2301;14185;37066;15100;39367
230030;202210;15458;34186;12913;30815;509;1083;10620;25568;11129;26651
230040;202210;5263;11905;4353;10515;49;198;3780;8902;3829;9100
230050;202210;3049;8728;2322;7121;289;967;1166;3234;1455;4201
230060;202210;2907;6919;2272;5873;39;143;1824;4575;1863;4718
230070;202210;5293;11844;4223;10022;571;1227;2709;6481;3280;7708
230075;202210;11850;31580;10703;29686;535;1791;8725;23602;9260;25393
230080;202210;3719;6828;2853;5766;11;27;2667;5338;2678;5365
230090;202210;5543;11613;4630;10232;157;335;3886;8325;4043;8660
230100;202210;26699;57209;23246;52785;2053;4702;16581;37138;18634;41840
230110;202210;16227;43497;13598;38589;2055;6069;7599;20869;9654;26938
230120;202210;9832;22802;8436;20666;650;1635;6144;14865;6794;16500
230125;202210;3729;8698;3079;7679;68;243;2529;6038;2597;6281
230130;202210;6733;18377;5448;15741;354;1008;3805;10807;4159;11815
230140;202210;4265;11139;3545;9771;106;422;2794;7343;2900;7765
230150;202210;1916;5083;1568;4381;191;505;951;2646;1142;3151
230160;202210;8894;17958;7702;16268;244;466;6627;13690;6871;14156
230170;202210;7409;19251;5969;16444;434;1156;4156;11194;4590;12350
230180;202210;1927;4751;1587;4143;14;58;1296;3239;1310;3297
230185;202210;5594;13335;4622;11817;467;1159;3251;8387;3718;9546
230190;202210;17351;46939;14222;41179;1766;5255;8154;22969;9920;28224
230195;202210;6911;17545;6164;16340;353;950;4747;12493;5100;13443
230200;202210;5754;14583;4703;12690;296;820;3454;9054;3750;9874
230205;202210;5271;12873;4603;11950;331;796;3610;9249;3941;10045
230210;202210;13308;26829;11325;24251;483;1015;9212;19190;9695;20205
230220;202210;18709;40120;16384;36917;947;2142;13430;29634;14377;31776
230230;202210;8650;21773;7760;20129;505;1236;5968;15265;6473;16501
230240;202210;16735;37629;14181;33556;895;1791;11030;25918;11925;27709
230250;202210;11103;27279;10256;26045;490;1294;7779;19113;8269;20407
230260;202210;18305;46449;15678;42091;2253;5822;9480;25211;11733;31033
230270;202210;8877;21320;6796;17669;934;2217;3876;10478;4810;12695
230280;202210;24686;56231;20343;49300;426;1655;16813;38399;17239;40054
230290;202210;6337;14398;5350;12671;226;531;4331;9905;4557;10436
230300;202210;6061;13790;5406;12902;72;206;4779;11371;4851;11577
230310;202210;5565;14330;4634;12690;173;590;3363;8874;3536;9464
230320;202210;9090;23734;7506;21003;251;992;5859;15839;6110;16831
230330;202210;5766;13948;4461;11577;144;458;3367;8419;3511;8877
230340;202210;4602;12828;3932;11517;255;807;2800;7939;3055;8746
230350;202210;23145;53813;20199;49701;977;2913;14975;35670;15952;38583
230360;202210;3656;8434;2855;7104;156;372;2086;5163;2242;5535
230365;202210;3751;7874;3103;6961;87;247;2713;5959;2800;6206
230370;202210;94515;204645;82938;189055;4734;12853;65943;143068;70677;155921
230380;202210;7502;18535;5857;15573;142;506;4457;11294;4599;11800
230390;202210;4082;10431;3481;9505;78;321;2782;7354;2860;7675
230393;202210;4064;10231;3234;8648;89;432;2598;6551;2687;6983
230395;202210;6761;16745;5739;15048;540;1401;3836;9865;4376;11266
230400;202210;6674;16084;5825;14782;77;367;4740;11411;4817;11778
230410;202210;15572;42354;12792;37494;996;3062;8808;25591;9804;28653
230420;202210;36141;87708;29583;77032;2917;7979;18724;46605;21641;54584
230423;202210;5409;14522;4714;13256;310;952;3397;9269;3707;10221
230425;202210;7347;19523;6717;18355;713;1862;4689;12698;5402;14560
230426;202210;3237;7566;2338;5936;48;177;1793;4347;1841;4524
230427;202210;2107;5438;1472;4173;152;457;816;2111;968;2568
230428;202210;11742;28881;10013;26423;1444;3814;5907;15089;7351;18903
230430;202210;5772;14873;4495;12656;173;556;3421;9373;3594;9929
230435;202210;7713;17382;6244;14967;875;2029;3672;8674;4547;10703
230440;202210;589008;1224077;502495;1105657;32748;80531;376744;792140;409492;872671
230445;202210;4897;12223;3943;10611;246;675;2684;6902;2930;7577
230450;202210;4507;11175;3907;10314;190;692;3007;7511;3197;8203
230460;202210;2696;6308;2313;5711;68;240;1950;4681;2018;4921
230465;202210;5071;12357;4230;10830;137;413;3298;8073;3435;8486
230470;202210;13632;39246;12192;36664;770;2756;9034;26198;9804;28954
230480;202210;1810;4467;1509;3966;58;243;1185;2893;1243;3136
230490;202210;3296;8141;2720;7069;211;643;1836;4402;2047;5045
230495;202210;7272;18017;6343;16470;767;2105;4054;10149;4821;12254
230500;202210;10990;31828;9639;29466;384;1306;7690;23453;8074;24759
230510;202210;2098;5140;1643;4269;168;438;1025;2543;1193;2981
230520;202210;5687;13788;4875;12441;387;948;3561;8873;3948;9821
230523;202210;19588;52284;15339;43866;3477;9644;4299;12639;7776;22283
230526;202210;4719;11360;3955;10157;332;672;2790;7397;3122;8069
230530;202210;6456;18529;5371;16519;1081;3405;3039;9313;4120;12718
230533;202210;5927;11420;4708;9645;64;182;4075;7951;4139;8133
230535;202210;5910;15408;4948;13840;348;1083;3303;9104;3651;10187
230540;202210;18036;45396;15313;41330;290;1046;12693;33657;12983;34703
230550;202210;27745;62925;22760;55045;1888;4676;15860;36933;17748;41609
230560;202210;9107;19461;7193;16593;175;361;6116;14027;6291;14388
230565;202210;3711;9070;3067;7932;95;308;2454;6135;2549;6443
230570;202210;3983;9202;3333;8300;69;216;2775;6759;2844;6975
230580;202210;14808;32036;12729;29143;518;1116;10723;24218;11241;25334
230590;202210;11464;28481;9505;25168;726;1825;6929;18056;7655;19881
230600;202210;4511;10071;3534;8477;143;338;2481;5909;2624;6247
230610;202210;8001;19332;7021;17739;482;1219;5539;13860;6021;15079
230620;202210;2473;5995;1908;4960;96;301;1278;3086;1374;3387
230625;202210;11911;28635;10194;25792;2022;5416;4903;11775;6925;17191
230630;202210;14025;34887;12259;31801;1379;3300;8141;21079;9520;24379
230640;202210;32158;88195;28931;83031;1410;4822;23137;64858;24547;69680
230650;202210;6271;14965;5259;13319;165;610;4329;10479;4494;11089
230655;202210;11819;33387;11091;32221;869;2291;8869;26136;9738;28427
230660;202210;7122;18881;5715;16462;173;751;4601;12908;4774;13659
230670;202210;7089;15209;5091;12152;149;418;4101;9414;4250;9832
230680;202210;3267;7943;2701;7018;181;363;1872;4860;2053;5223
230690;202210;8291;22156;6951;19630;516;1553;4379;12233;4895;13786
230700;202210;12874;27959;10266;23437;430;1052;8008;17556;8438;18608
230710;202210;7894;22708;6868;20649;670;2037;4613;13597;5283;15634
230720;202210;2273;6045;1871;5337;134;366;1274;3537;1408;3903
230725;202210;5610;14512;5023;13527;365;1149;3469;8902;3834;10051
230730;202210;72167;171760;56623;149856;12334;32903;22576;61494;34910;94397
230740;202210;7098;18051;5924;16199;183;528;4686;12719;4869;13247
230750;202210;9849;23777;8034;20866;139;498;6525;16331;6664;16829
230760;202210;13822;32436;11893;29613;481;1525;9155;21820;9636;23345
230763;202210;5730;13887;4685;12162;92;377;3752;9314;3844;9691
230765;202210;53306;127176;44853;114319;4698;12891;28553;69161;33251;82052
230770;202210;35705;71062;30465;64544;2033;4430;23768;48701;25801;53131
230780;202210;7840;24117;6996;22221;936;2849;4240;13541;5176;16390
230790;202210;3784;9269;3363;8629;128;419;2656;6470;2784;6889
230800;202210;10501;28934;9103;26274;1154;3442;5463;15083;6617;18525
230810;202210;12509;34680;11030;32296;515;1686;8559;24478;9074;26164
230820;202210;4146;12179;3408;10648;330;1203;2127;6297;2457;7500
230830;202210;9356;22050;7875;19693;305;700;6334;15471;6639;16171
230835;202210;4950;10535;3832;8861;124;272;3149;7069;3273;7341
230837;202210;4496;10480;4033;9749;79;290;3516;8134;3595;8424
230840;202210;11362;29910;9709;27140;789;2205;7129;19727;7918;21932
230850;202210;12313;30150;10392;26769;585;1451;7760;19699;8345;21150
230860;202210;7779;14828;6523;13108;204;324;5814;11527;6018;11851
230870;202210;21991;43998;18870;39153;814;1593;15513;31338;16327;32931
230880;202210;2378;6503;2159;6151;71;306;1694;4631;1765;4937
230890;202210;5327;15084;4777;14125;236;834;3573;10287;3809;11121
230900;202210;3866;9776;3242;8600;129;458;2394;6017;2523;6475
230910;202210;4113;9161;3230;7872;65;256;2709;6439;2774;6695
230920;202210;5519;13916;4412;12111;113;413;3413;9017;3526;9430
230930;202210;8193;20624;6695;18047;337;994;4696;12298;5033;13292
230940;202210;9966;21919;8637;19989;195;436;7435;16970;7630;17406
230945;202210;7826;19766;6622;17596;319;959;4866;12417;5185;13376
230950;202210;7538;16539;6638;15341;130;316;5701;13089;5831;13405
230960;202210;15537;40526;13321;36504;2079;5850;6930;18237;9009;24087
230970;202210;18917;44078;15976;39705;1531;3986;10730;25708;12261;29694
230980;202210;4097;9011;3541;8121;323;727;2602;5847;2925;6574
230990;202210;2004;5036;1649;4370;70;253;1206;3009;1276;3262
231000;202210;3284;7627;2567;6309;74;219;1973;4572;2047;4791
231010;202210;4593;8965;3582;7387;27;105;3233;6425;3260;6530
231020;202210;10599;27447;9382;25295;1432;3534;5825;15967;7257;19501
231025;202210;10241;23227;9063;21451;632;1393;7098;16578;7730;17971
231030;202210;8542;23269;6493;19183;835;2436;3820;11111;4655;13547
231040;202210;3777;8852;3221;7915;84;237;2717;6407;2801;6644
231050;202210;14581;32263;11834;27724;492;1274;9441;21229;9933;22503
231060;202210;3454;8495;3052;7889;116;335;2415;6301;2531;6636
231070;202210;9676;24959;8312;22614;748;2055;5681;15149;6429;17204
231080;202210;4565;11659;3762;10353;219;672;2670;7241;2889;7913
231085;202210;8911;18776;7138;16665;225;558;5717;13018;5942;13576
231090;202210;5140;12233;3751;9643;121;451;2693;6498;2814;6949
231095;202210;2591;7179;2043;6046;187;554;1353;3943;1540;4497
231100;202210;3558;9287;2875;8074;136;443;2180;5932;2316;6375
231110;202210;4353;11570;4006;10944;348;1084;2836;7392;3184;8476
231120;202210;2877;7278;2408;6515;113;314;1797;4750;1910;5064
231123;202210;2304;5408;1780;4499;113;265;1262;3138;1375;3403
231126;202210;6548;16135;5278;13834;306;752;3925;10100;4231;10852
231130;202210;30170;61761;25294;55746;1293;3562;20011;41850;21304;45412
231135;202210;4971;12570;4088;10931;159;461;2980;7771;3139;8232
231140;202210;20755;50940;16827;44651;762;2585;12547;31778;13309;34363
231150;202210;7029;17384;4988;13471;832;2279;1868;4965;2700;7244
231160;202210;8504;21648;7544;19946;758;1950;5010;13043;5768;14993
231170;202210;5553;14195;4566;12413;290;841;3298;8532;3588;9373
231180;202210;18217;45532;14790;38931;2321;6109;7810;19877;10131;25986
231190;202210;4912;12154;3824;10248;97;342;2973;7670;3070;8012
231195;202210;5936;16128;4834;14046;301;977;3483;10003;3784;10980
231200;202210;10149;25167;8750;22590;144;654;7477;18325;7621;18979
231210;202210;5742;14882;4806;13335;144;568;3858;10309;4002;10877
231220;202210;16049;34870;12611;28989;647;1376;9487;20858;10134;22234
231230;202210;11734;33191;10309;30651;737;2337;7707;22594;8444;24931
231240;202210;14260;37823;12453;34601;1692;4571;7775;21312;9467;25883
231250;202210;2485;5503;1634;3813;71;166;1129;2458;1200;2624
231260;202210;3943;9482;3342;8560;329;739;2311;5981;2640;6720
231270;202210;7737;17630;6260;15274;149;546;4868;11260;5017;11806
231280;202210;2105;5854;1816;5354;173;493;1236;3639;1409;4132
231290;202210;43650;118089;36544;105206;4885;14193;19607;54181;24492;68374
231300;202210;4934;12200;3827;10104;158;512;2684;6743;2842;7255
231310;202210;9982;21431;7932;17966;606;1529;5830;12512;6436;14041
231320;202210;8343;21255;6376;17763;164;457;4966;13673;5130;14130
231325;202210;2893;6745;2263;5747;154;288;1637;4136;1791;4424
231330;202210;12966;32980;10742;28936;1377;3558;6919;18568;8296;22126
231335;202210;6686;15770;5553;14044;157;461;4735;11815;4892;12276
231340;202210;22223;60443;19820;56537;1478;4184;14953;42846;16431;47030
231350;202210;19225;46285;17405;43731;294;922;15640;38756;15934;39678
231355;202210;5231;13679;4606;12569;217;658;3640;9705;3857;10363
231360;202210;9401;25332;8069;23157;400;1246;6359;17962;6759;19208
231370;202210;2417;6110;1919;5232;43;138;1476;3952;1519;4090
231375;202210;4789;13342;4251;12460;124;431;3486;10132;3610;10563
231380;202210;7276;16746;6407;15609;203;435;5339;12979;5542;13414
231390;202210;4007;10554;3558;9826;122;485;2699;7147;2821;7632
231395;202210;5156;13147;4297;11791;298;808;3024;8091;3322;8899
231400;202210;11875;29790;9914;26335;301;1215;7763;19699;8064;20914
231410;202210;19544;49146;17641;46295;971;2313;14498;37976;15469;40289
240010;202210;3044;7236;2364;6070;360;928;1206;2960;1566;3888
240020;202210;17007;40031;14120;35220;836;2487;9986;23665;10822;26152
240030;202210;4682;8641;4225;8010;91;260;3842;6990;3933;7250
240040;202210;921;2451;760;2161;21;82;512;1375;533;1457
240050;202210;4054;9763;3170;8199;66;174;2431;6119;2497;6293
240060;202210;1743;4096;1370;3441;46;126;1083;2654;1129;2780
240070;202210;3170;7771;2792;7002;210;589;2032;4791;2242;5380
240080;202210;3455;8445;2708;7186;123;356;1930;4983;2053;5339
240090;202210;2773;5859;2271;5077;37;80;1961;4284;1998;4364
240100;202210;13360;27921;10712;23603;218;663;8797;18254;9015;18917
240110;202210;5722;14376;4732;12608;169;585;3611;9168;3780;9753
240120;202210;3984;10251;3307;9333;242;830;2380;6511;2622;7341
240130;202210;4802;8345;3934;7243;30;74;3600;6498;3630;6572
240140;202210;2098;5823;1754;5203;206;703;1098;3128;1304;3831
240145;202210;8103;20659;6476;17924;724;2074;4171;11314;4895;13388
240150;202210;1276;3006;1069;2624;50;155;844;1980;894;2135
240160;202210;1726;4555;1408;3982;40;167;1039;2819;1079;2986
240165;202210;1154;2785;952;2430;27;92;791;1948;818;2040
240170;202210;3393;7886;2847;6972;302;736;1878;4514;2180;5250
240180;202210;3603;9686;2888;8258;617;1731;1316;3874;1933;5605
240185;202210;1619;4419;1446;4121;50;194;1142;3113;1192;3307
240190;202210;1353;3284;1135;2952;28;98;922;2350;950;2448
240200;202210;15609;33525;12600;28753;1450;3402;7821;16992;9271;20394
240210;202210;4218;8601;3492;7468;36;145;3066;6240;3102;6385
240220;202210;8645;23699;7667;22198;498;1725;5865;16677;6363;18402
240230;202210;7036;15886;5517;13482;301;606;4060;10051;4361;10657
240240;202210;2083;5595;1411;4142;186;591;500;1247;686;1838
240250;202210;3789;8396;3267;7647;54;194;2786;6275;2840;6469
240260;202210;19487;49603;16892;45429;4867;12660;7168;21342;12035;34002
240270;202210;2971;7588;2436;6752;111;336;1709;4836;1820;5172
240280;202210;1918;4515;1585;3985;65;158;1240;3066;1305;3224
240290;202210;1364;3562;1093;3018;29;122;755;1889;784;2011
240300;202210;2647;6221;1919;4981;103;264;1206;3026;1309;3290
240310;202210;10118;24608;7977;20909;1069;2806;4137;10562;5206;13368
240320;202210;2261;5700;1555;4324;103;321;1061;2783;1164;3104
240325;202210;43516;100763;35737;88330;4287;11935;21673;50127;25960;62062
240330;202210;2142;5290;1655;4428;72;238;1152;2894;1224;3132
240340;202210;2519;4889;2033;4195;59;143;1707;3348;1766;3491
240350;202210;3026;6206;2688;5814;94;162;2412;5233;2506;5395
240360;202210;14828;34924;13219;32523;2063;4774;8432;20818;10495;25592
240370;202210;2646;5682;2041;4619;87;238;1554;3280;1641;3518
240375;202210;1114;2476;911;2151;36;109;709;1563;745;1672
240380;202210;2717;6886;2094;5633;216;540;1209;3178;1425;3718
240390;202210;1167;2600;797;1944;26;56;525;1186;551;1242
240400;202210;1726;3855;1290;3143;42;153;932;2111;974;2264
240410;202210;698;1913;560;1646;60;216;318;870;378;1086
240420;202210;6129;18007;5464;16713;466;1761;3784;11021;4250;12782
240430;202210;4242;9597;3546;8468;115;360;2778;6285;2893;6645
240440;202210;3358;6724;2855;6017;297;538;2152;4503;2449;5041
240450;202210;5234;12942;4081;10888;333;1072;2554;6230;2887;7302
240460;202210;4179;9628;3735;8947;324;686;2964;7161;3288;7847
240470;202210;4030;11306;3066;9367;652;1802;1402;4538;2054;6340
240480;202210;678;1685;413;1127;29;73;202;519;231;592
240485;202210;2509;6425;1997;5541;162;480;1296;3583;1458;4063
240490;202210;1956;4318;1493;3536;89;173;1092;2517;1181;2690
240500;202210;2557;6162;2192;5557;107;273;1774;4418;1881;4691
240510;202210;1950;4773;1665;4353;71;222;1336;3385;1407;3607
240520;202210;1933;3906;1480;3310;103;214;1173;2607;1276;2821
240530;202210;2852;6708;2505;6159;145;277;2057;5009;2202;5286
240540;202210;2751;6034;2452;5589;48;124;2196;4956;2244;5080
240550;202210;1053;2282;933;2087;14;49;834;1805;848;1854
240560;202210;4763;9733;4112;8896;175;305;3441;7402;3616;7707
240570;202210;3217;7964;2153;5746;296;798;812;1956;1108;2754
240580;202210;10402;26276;9167;24187;524;1481;7461;19360;7985;20841
240590;202210;1078;2138;917;1900;22;32;754;1509;776;1541
240600;202210;2092;5108;1499;3976;56;158;1054;2634;1110;2792
240610;202210;5511;12610;4687;11217;226;583;3483;7989;3709;8572
240615;202210;1518;3474;1214;2980;97;264;892;2069;989;2333
240620;202210;2329;5572;1986;5017;75;227;1648;4035;1723;4262
240630;202210;2608;6063;2345;5653;242;402;1717;4252;1959;4654
240640;202210;1098;2608;856;2204;34;99;651;1620;685;1719
240650;202210;4762;12625;3967;11074;311;827;2716;7515;3027;8342
240660;202210;5139;9151;4704;8585;55;119;4442;7997;4497;8116
240670;202210;3028;7454;2391;6227;198;555;1595;3956;1793;4511
240680;202210;1914;4437;1516;3780;46;148;1202;2849;1248;2997
240690;202210;1413;2994;1100;2480;24;87;930;1967;954;2054
240700;202210;2813;7519;2247;6512;112;346;1669;4755;1781;5101
240710;202210;23666;49721;20266;44585;1722;3896;15189;32088;16911;35984
240720;202210;6187;14044;5194;12638;610;1509;3426;8196;4036;9705
240725;202210;1289;3363;972;2791;44;121;624;1722;668;1843
240730;202210;2704;6726;2113;5655;63;205;1622;4196;1685;4401
240740;202210;2227;5566;1768;4675;75;243;1260;3129;1335;3372
240750;202210;2712;7856;2273;6956;285;931;1317;3895;1602;4826
240760;202210;2047;4149;1486;3335;113;161;1103;2576;1216;2737
240770;202210;3930;9469;3318;8638;140;470;2745;6956;2885;7426
240780;202210;6362;15325;5301;13602;716;1805;3452;8701;4168;10506
240790;202210;1049;2626;855;2295;24;109;632;1592;656;1701
240800;202210;69918;142653;56317;123185;5217;12174;37469;76556;42686;88730
240810;202210;126962;279309;110409;254060;9993;23934;79887;177404;89880;201338
240820;202210;7529;19791;6584;18124;924;2563;4066;11175;4990;13738
240830;202210;10204;26167;8824;24153;332;1146;7100;19078;7432;20224
240840;202210;1281;2916;1015;2501;46;100;719;1716;765;1816
240850;202210;1637;4124;1104;3026;89;233;636;1653;725;1886
240860;202210;1747;3873;1324;3169;36;131;1088;2474;1124;2605
240870;202210;1236;2865;932;2367;159;386;473;1230;632;1616
240880;202210;1488;4354;1288;3967;114;435;913;2733;1027;3168
240890;202210;6388;14360;5040;12085;469;1291;3333;7230;3802;8521
240895;202210;3506;9451;3157;8897;414;1108;2251;6460;2665;7568
240910;202210;4140;10051;3406;8791;56;194;2778;6930;2834;7124
240920;202210;1242;2762;1001;2418;112;189;622;1547;734;1736
240930;202210;4348;8861;3507;7827;258;388;2333;5709;2591;6097
240933;202210;1895;4310;1578;3858;37;149;1339;3143;1376;3292
240940;202210;8705;18101;6933;15330;636;1409;4726;9913;5362;11322
240950;202210;1313;3521;1114;3131;36;143;886;2367;922;2510
240960;202210;847;2163;756;1982;16;59;602;1506;618;1565
240970;202210;2366;5052;1922;4359;66;200;1615;3520;1681;3720
240980;202210;4715;10910;4228;10143;68;287;3742;8630;3810;8917
240990;202210;3509;8118;3081;7387;232;671;2295;5141;2527;5812
241000;202210;1204;2677;931;2206;15;49;750;1676;765;1725
241010;202210;3738;9828;3373;9132;142;493;2736;7110;2878;7603
241020;202210;2499;6010;1889;4854;98;306;1364;3288;1462;3594
241025;202210;1914;5086;1534;4430;44;166;1106;3084;1150;3250
241030;202210;2916;8289;2320;7089;267;771;1509;4552;1776;5323
241040;202210;2527;7142;2150;6522;97;416;1641;4892;1738;5308
241050;202210;1693;4238;1348;3628;41;134;1006;2619;1047;2753
241060;202210;978;2400;823;2095;46;114;577;1388;623;1502
241070;202210;835;2006;696;1788;16;41;542;1331;558;1372
241080;202210;1350;3437;1037;2816;32;110;736;1909;768;2019
241090;202210;2440;6246;1939;5416;82;313;1442;3861;1524;4174
241100;202210;1381;3499;1038;2828;56;128;688;1826;744;1954
241105;202210;1254;3317;1011;2873;191;568;468;1283;659;1851
241110;202210;1076;2791;798;2224;49;131;507;1350;556;1481
241120;202210;8876;22904;7489;20607;787;2236;4880;13339;5667;15575
241140;202210;3915;9531;2969;7695;135;401;2170;5428;2305;5829
241142;202210;893;2223;678;1835;59;144;403;1019;462;1163
241150;202210;7000;16264;6112;14924;246;590;4816;11555;5062;12145
241160;202210;1387;3536;1055;2927;173;520;567;1462;740;1982
241170;202210;1566;3628;1320;3198;28;90;1100;2556;1128;2646
241180;202210;1219;2822;900;2266;84;223;512;1214;596;1437
241190;202210;1403;3215;1156;2763;17;63;873;1982;890;2045
241200;202210;30852;65984;27275;60564;2924;6867;19013;39967;21937;46834
241210;202210;1906;4378;1393;3465;101;279;898;2130;999;2409
241220;202210;11995;29923;10540;27596;2342;6117;5225;13825;7567;19942
241230;202210;3482;8204;2990;7484;107;261;2474;6116;2581;6377
241240;202210;1413;3708;840;2490;99;306;279;773;378;1079
241250;202210;7312;17516;5903;15082;144;616;4650;11178;4794;11794
241255;202210;3229;8457;2759;7591;156;504;2036;5385;2192;5889
241260;202210;5919;13712;4725;11797;168;507;3641;8697;3809;9204
241270;202210;1879;5025;1554;4416;122;381;1097;3035;1219;3416
241280;202210;3088;6154;2682;5465;88;181;2321;4607;2409;4788
241290;202210;3832;8469;2791;6846;98;273;2222;5265;2320;5538
241300;202210;1838;4357;1489;3791;39;137;1055;2538;1094;2675
241310;202210;2820;5770;2432;5234;61;115;2112;4475;2173;4590
241320;202210;1129;3336;955;3009;102;348;579;1769;681;2117
241330;202210;2068;4715;1637;4148;23;73;1455;3639;1478;3712
241335;202210;4434;10834;3856;9840;127;422;3171;7797;3298;8219
241340;202210;2067;4935;1623;4110;200;612;933;2138;1133;2750
241350;202210;2596;6250;2240;5642;111;287;1737;4263;1848;4550
241355;202210;1624;3897;1295;3293;50;102;965;2413;1015;2515
241360;202210;2432;5637;1752;4344;66;181;1300;3059;1366;3240
241370;202210;1590;3870;1213;3151;56;175;894;2142;950;2317
241380;202210;835;1999;653;1694;73;184;378;961;451;1145
241390;202210;3183;8345;2787;7758;152;472;2158;5961;2310;6433
241400;202210;4330;10815;3789;10001;217;683;2923;7508;3140;8191
241410;202210;2915;7851;2347;6733;242;762;1513;4216;1755;4978
241415;202210;2260;5377;1911;4761;44;166;1580;3731;1624;3897
241420;202210;3652;9433;3267;8820;557;1563;2021;5441;2578;7004
241430;202210;836;1900;534;1342;16;47;365;850;381;897
241440;202210;10109;26723;9045;24972;304;979;7393;19959;7697;20938
241445;202210;1651;3369;1430;3081;33;68;1277;2730;1310;2798
241450;202210;3544;7476;2877;6472;221;439;2209;4921;2430;5360
241460;202210;4633;11289;3665;9393;308;822;2467;6023;2775;6845
241470;202210;1696;4050;1347;3540;44;151;1120;2871;1164;3022
241475;202210;1441;3563;1120;2992;23;82;844;2118;867;2200
241480;202210;3676;10177;3010;8831;830;2445;1076;3371;1906;5816
241490;202210;886;1790;627;1411;17;46;508;1103;525;1149
241500;202210;942;2277;841;2159;8;20;756;1941;764;1961
250010;202210;3203;8314;2622;7177;79;250;1979;5226;2058;5476
250020;202210;1911;4528;1422;3654;87;154;1062;2712;1149;2866
250030;202210;8463;20466;7372;18839;875;2293;5158;13048;6033;15341
250040;202210;5588;14266;4868;13052;724;1893;3030;8044;3754;9937
250050;202210;4448;10374;3952;9754;183;464;3266;8141;3449;8605
250053;202210;1522;3837;1376;3623;140;308;952;2513;1092;2821
250057;202210;877;2461;802;2353;7;33;738;2154;745;2187
250060;202210;7255;16318;6404;15158;438;1033;5021;11798;5459;12831
250070;202210;4796;11857;3992;10519;46;198;3220;8142;3266;8340
250073;202210;959;2246;756;1924;7;21;613;1521;620;1542
250077;202210;3210;6804;2478;5694;33;104;2113;4673;2146;4777
250080;202210;7180;13946;5985;12516;71;206;5470;11208;5541;11414
250090;202210;4675;8878;4117;8178;57;132;3692;7107;3749;7239
250100;202210;3998;11137;3572;10388;183;603;2762;7794;2945;8397
250110;202210;5999;14708;5433;13933;333;984;4199;10508;4532;11492
250115;202210;910;1907;689;1590;8;31;556;1231;564;1262
250120;202210;2215;5801;1878;5270;26;126;1498;4064;1524;4190
250130;202210;7536;15843;6452;14406;51;224;5758;12449;5809;12673
250135;202210;1674;3815;1451;3442;57;136;1224;2858;1281;2994
250140;202210;2632;6904;2412;6637;163;482;1970;5491;2133;5973
250150;202210;5622;15757;5041;14819;179;657;4060;11617;4239;12274
250153;202210;1670;3959;1360;3504;79;168;1070;2725;1149;2893
250157;202210;2563;5974;2274;5518;47;156;1925;4509;1972;4665
250160;202210;4609;10061;3695;8839;84;210;3177;7502;3261;7712
250170;202210;2248;5230;2001;4876;40;141;1713;4058;1753;4199
250180;202210;29212;58211;25223;53280;1116;2905;20616;41590;21732;44495
250190;202210;5157;11864;4336;10713;405;955;3097;7407;3502;8362
250200;202210;3196;5971;2746;5411;38;88;2483;4730;2521;4818
250205;202210;975;2805;822;2567;21;90;639;1976;660;2066
250210;202210;1700;4658;1503;4341;68;252;1159;3256;1227;3508
250215;202210;1902;4758;1599;4341;101;292;909;2476;1010;2768
250220;202210;799;1980;626;1705;34;125;441;1133;475;1258
250230;202210;1940;3997;1367;3185;21;57;1070;2404;1091;2461
250240;202210;3682;8043;3293;7426;40;164;2959;6466;2999;6630
250250;202210;5891;13787;5196;12845;455;744;3973;10414;4428;11158
250260;202210;1852;4831;1547;4293;60;170;1196;3320;1256;3490
250270;202210;1449;3892;1324;3742;97;289;930;2776;1027;3065
250280;202210;4821;10373;4304;9708;276;480;3375;7730;3651;8210
250290;202210;2186;4635;1823;4123;19;60;1516;3281;1535;3341
250300;202210;7400;15867;6641;14969;220;713;5613;12186;5833;12899
250310;202210;1448;3698;1173;3238;57;141;850;2313;907;2454
250320;202210;17491;32585;15377;30228;187;515;14236;27297;14423;27812
250330;202210;3231;7207;2756;6577;76;250;2408;5520;2484;5770
250340;202210;1514;3148;1306;2876;18;44;1180;2568;1198;2612
250350;202210;4562;11889;3938;10817;333;708;2966;8390;3299;9098
250355;202210;2639;6378;2332;6000;18;77;2160;5524;2178;5601
250360;202210;2171;5064;1933;4750;60;187;1628;3863;1688;4050
250370;202210;19247;39977;16339;35804;247;778;14444;30545;14691;31323
250375;202210;1567;3285;1273;2945;5;13;1180;2754;1185;2767
250380;202210;2161;4586;1989;4384;47;151;1786;3789;1833;3940
250390;202210;2338;5143;1975;4600;149;340;1520;3515;1669;3855
250400;202210;87473;199211;66613;168103;19120;50644;20749;52573;39869;103217
250403;202210;2909;5836;2594;5491;52;253;2256;4441;2308;4694
250407;202210;1837;3684;1304;2934;142;252;829;1998;971;2250
250410;202210;843;1986;719;1785;18;53;601;1430;619;1483
250415;202210;2392;5662;2090;5221;31;113;1842;4494;1873;4607
250420;202210;1667;3558;1513;3352;13;31;1410;3077;1423;3108
250430;202210;9275;18266;8009;16638;300;589;6803;13658;7103;14247
250435;202210;1901;4874;1487;4174;26;102;1125;3027;1151;3129
250440;202210;5252;12816;4539;11896;106;255;3936;10223;4042;10478
250450;202210;2176;5036;1781;4503;97;180;1375;3581;1472;3761
250460;202210;9032;21951;7912;20387;557;1537;6151;15624;6708;17161
250470;202210;2059;4530;1693;3965;88;164;1328;3049;1416;3213
250480;202210;4569;11327;3831;10415;67;162;3292;8997;3359;9159
250485;202210;825;1730;615;1438;67;98;409;943;476;1041
250490;202210;6981;13510;6190;12618;109;323;5604;11084;5713;11407
250500;202210;2390;5958;2103;5481;56;166;1719;4388;1775;4554
250510;202210;7024;14672;6027;13346;234;326;5081;11393;5315;11719
250520;202210;2189;5354;1864;4933;86;272;1459;3748;1545;4020
250523;202210;2769;5755;2416;5287;189;441;1883;3996;2072;4437
250527;202210;2047;4464;1848;4242;18;58;1687;3823;1705;3881
250530;202210;794;1818;679;1655;18;45;558;1311;576;1356
250535;202210;1595;4203;1413;3882;27;121;1135;3010;1162;3131
250540;202210;4129;7513;3498;6826;457;495;2784;5789;3241;6284
250550;202210;894;2663;783;2457;54;172;534;1654;588;1826
250560;202210;2022;5026;1733;4611;49;186;1440;3711;1489;3897
250570;202210;3274;8551;2819;7763;168;484;2107;5746;2275;6230
250580;202210;1234;2919;1088;2725;56;200;892;2150;948;2350
250590;202210;1257;2596;1136;2431;29;74;1019;2108;1048;2182
250600;202210;9033;22178;7455;20031;263;768;5810;15319;6073;16087
250610;202210;3430;8797;3041;8230;123;398;2459;6606;2582;7004
250620;202210;1084;2329;924;2078;46;129;730;1564;776;1693
250625;202210;2768;7302;2452;6798;48;221;2103;5672;2151;5893
250630;202210;14955;33485;12610;29761;1168;2964;8937;20132;10105;23096
250640;202210;4508;10327;4023;9698;81;295;3526;8287;3607;8582
250650;202210;1303;2690;1032;2339;14;56;898;1979;912;2035
250660;202210;1848;4125;1448;3552;37;94;1203;2826;1240;2920
250670;202210;2769;7613;2494;7138;46;188;2164;6034;2210;6222
250680;202210;7346;14421;6611;13595;40;168;6201;12412;6241;12580
250690;202210;8748;17129;7351;15446;180;335;6367;13169;6547;13504
250700;202210;5481;13967;4764;12863;708;1928;3063;8155;3771;10083
250710;202210;5184;13531;4496;12570;362;1067;3239;9033;3601;10100
250720;202210;3364;8129;2971;7570;74;277;2598;6492;2672;6769
250730;202210;5431;12191;4775;11329;197;557;4071;9344;4268;9901
250740;202210;2467;5399;2023;4818;131;285;1533;3650;1664;3935
250750;202210;146333;315717;125584;287428;8816;22348;95101;209287;103917;231635
250760;202210;3637;6802;3261;6258;50;161;2998;5558;3048;5719
250770;202210;4842;13042;4314;12340;687;1690;2779;8391;3466;10081
250780;202210;2261;5179;1902;4570;64;179;1558;3620;1622;3799
250790;202210;3103;8016;2699;7434;97;385;2154;5699;2251;6084
250800;202210;2902;6883;2509;6268;118;236;2015;4994;2133;5230
250810;202210;1736;3804;1440;3400;150;225;1082;2702;1232;2927
250820;202210;2502;5788;2287;5542;42;145;2072;4945;2114;5090
250830;202210;7344;19662;6057;17182;219;796;4383;11779;4602;12575
250840;202210;875;2575;757;2359;37;135;559;1741;596;1876
250850;202210;2133;5549;1879;5118;32;140;1560;4120;1592;4260
250855;202210;1352;3270;1196;3048;45;132;990;2452;1035;2584
250860;202210;4179;10805;3458;9660;481;1384;1998;5440;2479;6824
250870;202210;1262;3004;1057;2688;62;146;811;2058;873;2204
250880;202210;1937;4468;1583;3948;128;303;1171;2888;1299;3191
250890;202210;14564;29616;12872;27521;280;1148;11322;22836;11602;23984
250900;202210;4003;8968;3506;8160;73;206;3055;6885;3128;7091
250905;202210;2944;7357;2701;7043;45;166;2445;6325;2490;6491
250910;202210;9157;17452;7860;16028;84;255;7157;14326;7241;14581
250915;202210;2627;5269;1920;4504;30;58;1696;3986;1726;4044
250920;202210;4688;10014;4206;9327;285;541;3484;7615;3769;8156
250930;202210;2835;6767;2521;6375;111;331;2060;5061;2171;5392
250933;202210;1485;3845;1287;3510;53;187;1010;2672;1063;2859
250937;202210;963;2281;807;2045;20;71;664;1656;684;1727
250939;202210;2474;5427;2167;5032;49;122;1824;4129;1873;4251
250940;202210;4683;10929;4064;10111;59;163;3590;8838;3649;9001
250950;202210;2002;4779;1607;4246;42;145;1278;3284;1320;3429
250960;202210;1354;3491;1184;3215;30;134;975;2536;1005;2670
250970;202210;10714;23987;9292;21739;313;729;7617;17375;7930;18104
250980;202210;2873;6718;2586;6326;20;89;2274;5381;2294;5470
250990;202210;2554;6799;2170;6156;108;369;1640;4497;1748;4866
251000;202210;2353;6035;1886;5259;47;171;1526;4196;1573;4367
251010;202210;3039;7444;2678;6912;30;133;2342;5913;2372;6046
251020;202210;1875;4647;1682;4353;31;135;1463;3669;1494;3804
251030;202210;1219;2953;998;2565;69;164;672;1702;741;1866
251040;202210;2191;5421;1863;4893;24;108;1592;4104;1616;4212
251050;202210;1176;3079;974;2693;44;157;695;1817;739;1974
251060;202210;1307;2542;987;2144;39;82;744;1604;783;1686
251065;202210;552;1406;400;1118;10;34;287;756;297;790
251070;202210;902;2027;751;1814;14;44;637;1488;651;1532
251080;202210;25948;56070;21342;49472;3576;8195;12222;28672;15798;36867
251090;202210;3373;8723;2821;7794;70;203;2315;6270;2385;6473
251100;202210;939;2726;803;2457;29;93;600;1733;629;1826
251110;202210;2218;5151;1824;4452;121;263;1365;3264;1486;3527
251120;202210;9551;22355;8045;20536;548;1523;6037;15051;6585;16574
251130;202210;5888;9988;5156;9185;80;150;4815;8443;4895;8593
251140;202210;4819;12464;4242;11653;119;380;3390;9227;3509;9607
251150;202210;3351;8511;3048;8039;62;302;2633;6724;2695;7026
251160;202210;2947;6878;2570;6327;28;137;2325;5564;2353;5701
251170;202210;2226;4851;1967;4529;35;106;1780;3973;1815;4079
251180;202210;3375;7621;2795;6835;279;527;1904;4831;2183;5358
251190;202210;6406;13119;5757;12387;60;259;5184;10686;5244;10945
251200;202210;5537;13553;4860;12691;157;354;4109;10804;4266;11158
251203;202210;1162;3387;1027;3076;56;168;662;1911;718;2079
251207;202210;1322;3233;988;2688;21;93;679;1779;700;1872
251210;202210;9731;21538;7920;19073;630;1186;5608;13986;6238;15172
251220;202210;1574;3245;1185;2739;104;212;893;2085;997;2297
251230;202210;5607;14067;4814;12693;120;408;3863;9778;3983;10186
251240;202210;4412;11327;3700;10120;296;732;2471;6799;2767;7531
251250;202210;14612;33032;12865;30211;738;1859;10019;22577;10757;24436
251260;202210;653;1517;584;1407;14;62;478;1079;492;1141
251270;202210;5485;14308;4874;13470;284;729;3818;10833;4102;11562
251272;202210;1710;3908;1568;3736;48;183;1378;3153;1426;3336
251274;202210;995;2571;789;2211;68;184;490;1343;558;1527
251275;202210;1873;3976;1587;3534;76;180;1298;2772;1374;2952
251276;202210;1613;3927;1378;3606;38;149;1110;2784;1148;2933
251278;202210;784;1835;691;1693;31;100;558;1319;589;1419
251280;202210;3374;6966;3066;6549;46;158;2761;5683;2807;5841
251290;202210;9974;17433;9130;16466;289;547;8158;14367;8447;14914
251300;202210;1034;2684;908;2493;14;62;768;2073;782;2135
251310;202210;3393;8485;2910;7739;57;254;2444;6305;2501;6559
251315;202210;2168;6050;1941;5628;104;295;1509;4336;1613;4631
251320;202210;2002;4701;1509;3856;38;137;1162;2851;1200;2988
251330;202210;2570;5235;2064;4631;28;75;1822;4030;1850;4105
251335;202210;1291;3239;1157;3043;22;97;1042;2663;1064;2760
251340;202210;4667;9642;3727;8437;139;336;2981;6599;3120;6935
251350;202210;1283;3233;1161;3043;38;107;962;2479;1000;2586
251360;202210;2220;5387;1745;4703;29;87;1385;3633;1414;3720
251365;202210;944;2224;686;1743;21;49;539;1352;560;1401
251370;202210;31890;74555;27352;68388;3728;9140;17489;43449;21217;52589
251380;202210;1845;4006;1601;3642;50;132;1388;3086;1438;3218
251385;202210;906;2155;694;1793;29;80;480;1187;509;1267
251390;202210;9342;21788;8304;20246;686;1714;6089;14531;6775;16245
251392;202210;1239;2991;1040;2685;41;109;813;2074;854;2183
251394;202210;808;2058;654;1792;63;182;444;1158;507;1340
251396;202210;852;2098;714;1861;27;79;490;1212;517;1291
251398;202210;1204;2851;845;2215;22;81;621;1547;643;1628
251400;202210;1772;3432;1418;2969;44;112;1184;2341;1228;2453
251410;202210;1915;3882;1516;3318;13;49;1297;2692;1310;2741
251420;202210;2489;5587;2039;5072;53;176;1654;3979;1707;4155
251430;202210;1802;4864;1619;4555;52;173;1365;3780;1417;3953
251440;202210;1288;3182;1042;2756;68;157;771;2062;839;2219
251445;202210;2061;4814;1890;4588;24;88;1663;3905;1687;3993
251450;202210;5598;14034;4986;13110;59;235;4338;11165;4397;11400
251455;202210;1052;2802;945;2616;33;104;746;2003;779;2107
251460;202210;1162;2869;932;2495;66;186;687;1819;753;2005
251465;202210;567;1446;481;1293;14;62;371;936;385;998
251470;202210;1378;3523;1018;2815;124;395;542;1339;666;1734
251480;202210;1199;2847;925;2382;19;59;692;1682;711;1741
251490;202210;2423;5586;1967;4966;136;282;1482;3720;1618;4002
251500;202210;2643;5974;2401;5657;66;181;2076;4738;2142;4919
251510;202210;3129;8590;2586;7538;116;390;1793;5003;1909;5393
251520;202210;1203;2858;897;2327;84;173;557;1420;641;1593
251530;202210;19118;38570;15748;34465;162;703;14130;29985;14292;30688
251540;202210;3566;9174;3175;8507;78;292;2607;6742;2685;7034
251550;202210;5273;10001;4309;8846;135;225;3631;7402;3766;7627
251560;202210;656;1821;585;1720;43;161;429;1192;472;1353
251570;202210;1110;2863;912;2472;20;97;716;1863;736;1960
251580;202210;2708;5316;2419;4900;28;106;2122;4059;2150;4165
251590;202210;1988;4184;1691;3831;57;128;1455;3194;1512;3322
251593;202210;1146;3075;1016;2854;88;294;702;1904;790;2198
251597;202210;2719;6227;2451;5882;15;67;2263;5328;2278;5395
251600;202210;7633;18668;6618;17131;258;738;5421;13747;5679;14485
251610;202210;3971;9718;3466;8854;293;726;2555;6404;2848;7130
251615;202210;1659;3476;1319;2989;21;63;1120;2432;1141;2495
251620;202210;24461;47715;19158;41337;222;461;16770;36000;16992;36461
251630;202210;6345;12576;5149;10929;284;622;4074;8239;4358;8861
251640;202210;2624;6315;2328;5884;21;96;2107;5210;2128;5306
251650;202210;5097;11359;4382;10437;142;329;3735;8744;3877;9073
251660;202210;4354;11222;3822;10329;62;272;3218;8407;3280;8679
251670;202210;5713;12486;5099;11683;53;215;4684;10454;4737;10669
251675;202210;1078;2236;975;2107;47;120;850;1793;897;1913
251680;202210;3184;7271;2673;6613;107;196;2176;5419;2283;5615
251690;202210;3849;9746;3254;8747;131;370;2454;6534;2585;6904
251700;202210;2707;6680;2235;6037;39;156;1866;4837;1905;4993
251710;202210;949;2221;680;1715;44;119;421;979;465;1098
251720;202210;1574;4001;1250;3458;21;103;981;2592;1002;2695
251740;202210;792;1962;630;1687;33;102;468;1203;501;1305
260005;202210;37943;71667;31798;64024;1785;3729;25691;49897;27476;53626
260010;202210;12508;29309;10309;25875;629;1743;6590;15891;7219;17634
260020;202210;8565;16770;7067;14734;79;295;6116;12288;6195;12583
260030;202210;9653;19381;8247;17443;83;310;7281;14820;7364;15130
260040;202210;8922;20314;7482;18355;487;1236;5547;13551;6034;14787
260050;202210;18183;38071;15689;35278;253;688;14659;32701;14912;33389
260060;202210;5159;10924;4382;9761;380;660;3279;7519;3659;8179
260070;202210;14449;29251;12537;26632;205;728;10930;22208;11135;22936
260080;202210;8652;16092;7554;14725;138;334;6587;12416;6725;12750
260090;202210;6831;14423;6073;13444;422;826;4854;10744;5276;11570
260100;202210;3960;8629;3392;7842;38;172;3026;6782;3064;6954
260105;202210;6009;14376;5377;13543;103;393;4591;11210;4694;11603
260110;202210;26334;66451;23253;62012;1108;3389;18912;49316;20020;52705
260120;202210;18798;42124;15951;38142;1781;3946;11133;26524;12914;30470
260130;202210;4072;8677;3512;7924;97;230;2878;6238;2975;6468
260140;202210;16873;31772;14697;29220;406;905;12891;24961;13297;25866
260150;202210;4730;8944;4156;8252;112;228;3753;7369;3865;7597
260160;202210;9296;17927;8062;16450;129;259;7461;15148;7590;15407
260170;202210;27537;55001;23697;49972;1145;2514;19497;40123;20642;42637
260180;202210;4318;9910;3658;8987;83;287;3109;7495;3192;7782
260190;202210;26368;43377;22712;39189;172;360;20986;35278;21158;35638
260200;202210;13504;28652;11660;26301;513;982;10156;22886;10669;23868
260210;202210;13574;34071;11386;30648;397;1216;9120;24258;9517;25474
260220;202210;15244;28280;14153;26972;376;615;12693;23826;13069;24441
260230;202210;16078;30267;14088;27806;348;650;12183;23565;12531;24215
260240;202210;3342;8760;2875;7911;69;301;2303;6124;2372;6425
260250;202210;2845;6293;2405;5640;93;236;1943;4404;2036;4640
260260;202210;17187;37976;15248;35289;1127;2381;11674;27340;12801;29721
260270;202210;6318;11576;5638;10812;74;239;5125;9528;5199;9767
260280;202210;15786;39083;14298;36999;348;1369;12691;31838;13039;33207
260290;202210;52316;117618;45104;107673;3940;9865;32697;75921;36637;85786
260300;202210;12990;28167;11191;25665;286;814;9627;21531;9913;22345
260310;202210;8087;16123;7280;15149;395;662;6126;12777;6521;13439
260320;202210;8839;23386;7408;21083;159;581;6138;17256;6297;17837
260330;202210;2898;8061;2460;7189;64;222;1971;5587;2035;5809
260340;202210;2728;6080;2378;5586;33;118;2105;4775;2138;4893
260345;202210;35456;78743;30131;71453;2936;7621;20199;45271;23135;52892
260350;202210;7682;14064;6704;12985;28;97;6250;11845;6278;11942
260360;202210;2915;6804;2538;6125;102;273;1799;4202;1901;4475
260370;202210;6748;16486;5731;14824;171;592;4612;11390;4783;11982
260380;202210;6048;15593;5157;14170;243;599;3950;10797;4193;11396
260390;202210;5511;14990;4399;12837;205;596;2956;8407;3161;9003
260392;202210;4889;11879;4424;11295;57;329;3920;9793;3977;10122
260400;202210;27471;51426;24086;47102;348;1012;20796;38341;21144;39353
260410;202210;99406;213009;79916;186502;14276;35365;40264;93078;54540;128443
260415;202210;5800;12399;5032;11281;35;144;4440;9621;4475;9765
260420;202210;17150;28618;14799;26069;76;235;14162;24551;14238;24786
260430;202210;3194;9159;2665;8130;173;563;1796;5392;1969;5955
260440;202210;5320;10736;4724;9975;34;126;4358;9010;4392;9136
260450;202210;6818;15262;6068;14282;351;655;5088;12119;5439;12774
260460;202210;6793;16861;5810;15250;445;1381;4038;10065;4483;11446
260470;202210;6204;13150;5226;12039;133;284;4616;10890;4749;11174
260480;202210;4654;10724;3916;9718;316;839;2819;6930;3135;7769
260490;202210;7011;13118;6192;12023;30;112;5762;10923;5792;11035
260500;202210;7402;16377;6332;14900;463;1044;4547;10643;5010;11687
260510;202210;13887;27268;11876;24555;137;449;10746;21571;10883;22020
260515;202210;5592;12790;4404;10699;110;319;3312;7487;3422;7806
260520;202210;19941;41150;17377;37923;1050;2242;14150;30297;15200;32539
260530;202210;12239;29301;10482;26755;114;507;9361;23296;9475;23803
260540;202210;9663;17211;8640;15982;116;252;8041;14612;8157;14864
260545;202210;134;367;89;271;15;56;30;74;45;130
260550;202210;3771;9178;3025;7970;186;629;2057;5021;2243;5650
260560;202210;6974;15794;5783;14061;137;459;4948;11676;5085;12135
260570;202210;11470;23195;10145;21523;210;580;9086;18733;9296;19313
260580;202210;6355;11839;5779;11107;26;63;5406;10235;5432;10298
260590;202210;10089;17336;8735;15861;98;227;8044;14289;8142;14516
260600;202210;42688;93324;35690;83171;1173;3301;28936;64375;30109;67676
260610;202210;9365;21547;8179;19974;402;1081;6299;15045;6701;16126
260620;202210;26659;53760;23785;49997;1162;3197;19556;38819;20718;42016
260630;202210;2825;6801;2303;5994;57;158;1901;4826;1958;4984
260640;202210;32121;59090;27637;54028;928;1858;23854;45734;24782;47592
260650;202210;7625;17104;6111;15236;489;911;5009;12620;5498;13531
260660;202210;9496;19803;8369;18410;280;761;7542;16239;7822;17000
260670;202210;2753;6348;2242;5535;70;204;1736;4078;1806;4282
260680;202210;38140;79026;32323;71175;2106;4948;24406;51429;26512;56377
260690;202210;4108;9566;3382;8471;92;317;2679;6523;2771;6840
260700;202210;8945;18558;8356;17918;42;182;8137;17351;8179;17533
260710;202210;1627;3812;1355;3411;62;199;1085;2667;1147;2866
260720;202210;36939;73333;32164;67588;1787;4172;26430;53999;28217;58171
260730;202210;10090;24707;8728;22822;196;745;7627;19440;7823;20185
260740;202210;1575;3921;1285;3459;22;83;1046;2795;1068;2878
260750;202210;9645;21077;7589;18601;194;377;6663;16720;6857;17097
260760;202210;8259;16031;7233;14855;115;317;6524;13125;6639;13442
260765;202210;10617;25806;9340;24099;644;1885;6838;17116;7482;19001
260770;202210;4659;10494;3792;9116;93;286;3091;7201;3184;7487
260775;202210;7245;16206;6371;14926;156;530;5257;11600;5413;12130
260780;202210;4610;11785;4078;10941;368;1193;2690;6667;3058;7860
260790;202210;178000;342395;150559;307756;18400;38130;105338;208484;123738;246614
260795;202210;4647;8719;4003;7926;150;328;3454;6715;3604;7043
260800;202210;7949;14210;7184;13204;259;421;6403;11520;6662;11941
260805;202210;4672;10864;4011;9809;154;487;3242;7565;3396;8052
260810;202210;8297;19139;7266;17319;295;779;5866;13357;6161;14136
260820;202210;5946;11337;5256;10571;82;223;4588;9147;4670;9370
260825;202210;3536;9337;3084;8590;113;357;2406;6575;2519;6932
260830;202210;5314;13413;4424;11935;508;1132;2975;8203;3483;9335
260840;202210;5773;11881;5137;11051;251;486;4479;9523;4730;10009
260845;202210;5656;12811;4990;11752;210;605;3989;8946;4199;9551
260850;202210;6133;14496;5118;12704;373;998;3523;8219;3896;9217
260860;202210;4099;10468;3492;9413;142;418;2806;7357;2948;7775
260870;202210;5609;11146;4839;10219;114;255;4324;9036;4438;9291
260875;202210;10530;20598;8695;18087;711;1411;6302;13051;7013;14462
260880;202210;13799;30993;12135;28418;267;780;10532;23943;10799;24723
260890;202210;16630;36410;14321;33083;1062;2507;9937;22517;10999;25024
260900;202210;6853;16977;5668;15324;528;1409;3653;9829;4181;11238
260910;202210;4251;9532;3717;8770;139;345;2973;6860;3112;7205
260915;202210;7342;15354;6634;14510;29;115;6316;13625;6345;13740
260920;202210;4317;8368;3685;7702;100;178;3260;6756;3360;6934
260930;202210;4913;12730;4182;11511;159;583;3324;8792;3483;9375
260940;202210;19249;39033;16747;35629;1163;2575;13012;26788;14175;29363
260950;202210;9444;21271;7647;18421;359;1068;5431;12070;5790;13138
260960;202210;111376;204440;93974;183152;7558;15318;70869;131859;78427;147177
260970;202210;6862;15765;6028;14667;387;719;4580;11286;4967;12005
260980;202210;5813;14133;5061;13203;71;199;4611;12031;4682;12230
260990;202210;20881;51130;17545;46586;750;2295;13977;36236;14727;38531
261000;202210;21476;41982;18114;37832;575;1397;15181;30594;15756;31991
261010;202210;2737;6140;2340;5611;100;262;1999;4745;2099;5007
261020;202210;8445;18726;7398;17058;343;831;6093;13531;6436;14362
261030;202210;5029;12691;4416;11674;118;431;3605;9112;3723;9543
261040;202210;6543;16310;5359;14272;163;588;4262;10841;4425;11429
261050;202210;9601;21496;8673;20183;200;462;7364;16828;7564;17290
261060;202210;18455;39365;16107;36601;379;975;13741;30473;14120;31448
261070;202210;90747;175650;76308;157025;7137;14477;55766;111669;62903;126146
261080;202210;8485;17468;7642;16457;108;214;7181;15362;7289;15576
261090;202210;25955;49961;23136;46382;726;1372;20241;39891;20967;41263
261100;202210;10866;25296;9450;23316;650;1565;7159;17406;7809;18971
261110;202210;93317;223350;79043;198888;9679;26292;49958;120656;59637;146948
261120;202210;4966;9955;4346;9123;106;241;3828;7810;3934;8051
261130;202210;9631;19452;8468;17917;156;336;7511;15594;7667;15930
261140;202210;4954;9480;4382;8745;312;567;3416;6764;3728;7331
261150;202210;7167;14984;6322;13815;241;467;5382;11617;5623;12084
261153;202210;2290;6165;1870;5393;70;226;1324;3759;1394;3985
261160;202210;304990;616950;252698;548294;60214;131499;114897;252394;175111;383893
261170;202210;9643;18388;8439;16830;266;515;7435;14391;7701;14906
261180;202210;11792;25359;10349;23558;493;1052;8099;18183;8592;19235
261190;202210;6543;14864;5880;13864;131;550;5025;11269;5156;11819
261200;202210;4365;8464;3805;7749;140;303;3213;6355;3353;6658
261210;202210;2246;4896;1918;4444;110;190;1587;3657;1697;3847
261220;202210;18480;43106;15768;38695;1449;3755;11046;25751;12495;29506
261230;202210;4681;11782;3860;10716;49;187;3251;9013;3300;9200
261240;202210;7759;15070;6891;13857;228;460;6026;11831;6254;12291
261245;202210;4635;11058;3761;9619;66;292;3116;7563;3182;7855
261247;202210;3705;9726;3056;8602;348;949;1943;5514;2291;6463
261250;202210;37019;68115;32932;63486;3352;6712;26133;49701;29485;56413
261255;202210;4871;12684;3909;10900;173;585;2990;8065;3163;8650
261260;202210;19971;39072;17808;36379;250;903;16704;33144;16954;34047
261270;202210;6626;12277;5878;11402;214;414;5258;9976;5472;10390
261280;202210;3113;7584;2689;6924;99;323;2164;5338;2263;5661
261290;202210;3624;7913;3027;7252;91;276;2482;5963;2573;6239
261300;202210;17216;38407;14785;34703;385;1310;12146;26972;12531;28282
261310;202210;12430;26172;10739;23947;873;1993;8100;17579;8973;19572
261320;202210;7425;18208;6419;16640;79;279;5515;13978;5594;14257
261330;202210;8083;15688;7336;14752;192;462;6586;12912;6778;13374
261340;202210;7433;14858;6679;13947;97;309;6156;12506;6253;12815
261350;202210;10068;27020;8733;24777;275;767;6876;19330;7151;20097
261360;202210;11003;21732;9354;19467;410;864;7649;15386;8059;16250
261370;202210;29855;66055;25269;60083;2153;5254;18130;42069;20283;47323
261380;202210;5413;13059;4641;11818;471;1186;3250;8226;3721;9412
261390;202210;20677;52406;17258;47168;1210;3750;12013;31760;13223;35510
261400;202210;6218;15252;5440;13829;249;805;4345;10433;4594;11238
261410;202210;12141;25921;10062;22886;307;899;8508;18516;8815;19415
261420;202210;10311;24896;9311;23721;606;1890;7387;18339;7993;20229
261430;202210;5535;10995;4822;9976;44;168;4385;8717;4429;8885
261440;202210;1642;4495;1340;3927;52;224;968;2702;1020;2926
261450;202210;18656;42242;16451;39063;630;1487;13314;31254;13944;32741
261460;202210;9427;22179;8040;20111;251;682;6597;16263;6848;16945
261470;202210;4670;10449;3996;9517;46;185;3424;7970;3470;8155
261480;202210;6786;17411;5785;15782;251;882;4601;12056;4852;12938
261485;202210;6669;16220;5823;14983;412;1235;4406;10936;4818;12171
261500;202210;8494;18254;7393;16803;672;1249;5155;12158;5827;13407
261510;202210;2166;5793;1861;5306;70;255;1450;4075;1520;4330
261520;202210;2886;7526;2564;6924;135;379;1897;4983;2032;5362
261530;202210;15339;38119;12565;33504;713;2597;8093;19597;8806;22194
261540;202210;12060;29231;11044;27870;2667;6052;5545;15602;8212;21654
261550;202210;4634;10600;4030;9688;211;592;3089;7081;3300;7673
261560;202210;11784;26278;10402;24359;353;988;8758;19936;9111;20924
261570;202210;4333;10451;3400;8929;257;731;2358;5962;2615;6693
261580;202210;8588;19107;7506;17683;66;301;6955;16088;7021;16389
261590;202210;3474;7406;2833;6509;72;232;2314;5073;2386;5305
261600;202210;7640;14695;6594;13283;188;385;5606;10838;5794;11223
261610;202210;2666;6936;2131;5979;222;620;1258;3573;1480;4193
261618;202210;3602;6786;3199;6250;79;241;2822;5264;2901;5505
261620;202210;5888;13758;5416;13093;631;1362;3928;9846;4559;11208
261630;202210;7262;18660;6161;16602;470;1411;4028;10252;4498;11663
261640;202210;49049;93150;42040;84863;2211;3579;33561;68246;35772;71825
261650;202210;5507;10949;4688;9975;226;459;3828;8036;4054;8495
270010;202210;5065;15230;4349;14051;156;784;3496;10940;3652;11724
270020;202210;5128;10548;4478;9761;113;443;3979;8209;4092;8652
270030;202210;40327;101002;33898;91059;2416;6911;25586;67324;28002;74235
270040;202210;12496;29433;10613;27199;664;1838;8556;21729;9220;23567
270050;202210;6476;13401;5516;12327;163;374;5050;11227;5213;11601
270060;202210;2672;6181;2267;5696;148;391;1821;4489;1969;4880
270070;202210;6299;14124;5514;13060;88;381;4910;11159;4998;11540
270080;202210;1688;4135;1400;3680;78;207;1072;2752;1150;2959
270090;202210;2159;5705;1955;5347;34;151;1721;4595;1755;4746
270100;202210;8586;16222;7542;14844;168;406;6772;12944;6940;13350
270110;202210;4012;8436;3265;7577;210;356;2604;6298;2814;6654
270120;202210;2989;7497;2608;6987;73;243;2174;5697;2247;5940
270130;202210;6055;13857;5193;12832;150;490;4481;10881;4631;11371
270135;202210;2338;5033;1979;4642;28;125;1828;4224;1856;4349
270140;202210;10531;23479;8402;20603;335;1044;6532;15175;6867;16219
270150;202210;3617;8480;3332;8099;14;65;3193;7693;3207;7758
270160;202210;6306;16058;5409;14964;161;554;4872;13356;5033;13910
270170;202210;3812;10198;3176;9290;206;865;2316;6427;2522;7292
270180;202210;2725;7367;2458;7032;38;205;2190;6125;2228;6330
270190;202210;2977;5924;2724;5636;32;100;2572;5232;2604;5332
270200;202210;3116;8272;2688;7661;347;860;1818;5329;2165;6189
270210;202210;7171;14465;6162;13323;71;237;5759;12229;5830;12466
270220;202210;2065;4533;1681;4007;108;314;1286;2884;1394;3198
270230;202210;11847;28872;9969;26095;894;2500;7409;18959;8303;21459
270235;202210;7129;19812;6218;18389;245;798;5133;14983;5378;15781
270240;202210;14157;33521;11813;30378;966;2602;8960;22761;9926;25363
270250;202210;3955;7977;3558;7446;141;303;3169;6511;3310;6814
270255;202210;5200;13466;4111;11609;147;506;3228;8840;3375;9346
270260;202210;6259;17487;5658;16496;90;442;4928;14078;5018;14520
270270;202210;1203;2859;996;2607;115;281;738;1919;853;2200
270280;202210;4554;9719;3626;8591;263;559;2725;6612;2988;7171
270290;202210;9429;26568;8497;25152;160;741;7596;22180;7756;22921
270300;202210;4848;11475;3772;10297;173;416;3030;8406;3203;8822
270310;202210;8100;20455;6913;18729;161;577;5881;15687;6042;16264
270320;202210;6415;17315;5469;15580;236;826;4144;11243;4380;12069
270330;202210;5137;14185;4516;13284;193;836;3789;10901;3982;11737
270340;202210;1953;4598;1656;4197;77;147;1400;3544;1477;3691
270350;202210;2283;4625;1849;4118;156;294;1364;3098;1520;3392
270360;202210;4091;7781;3718;7365;45;116;3571;7014;3616;7130
270370;202210;1583;4439;1432;4175;31;147;1222;3507;1253;3654
270375;202210;4716;8519;4107;7857;17;49;3979;7553;3996;7602
270380;202210;6696;15838;5690;14629;604;1418;4257;11157;4861;12575
270390;202210;1482;3246;1184;2897;12;62;1018;2458;1030;2520
270400;202210;7804;18170;6511;16295;236;621;5178;12656;5414;13277
270410;202210;5781;14596;5020;13489;134;452;4294;11394;4428;11846
270420;202210;8146;19178;7414;18134;182;689;6646;15754;6828;16443
270430;202210;189060;395725;150322;347050;19624;47243;91846;206058;111470;253301
270440;202210;5558;13470;4847;12579;147;455;4253;10970;4400;11425
270450;202210;10890;22969;9692;21553;509;923;8179;18468;8688;19391
270460;202210;4677;9151;4002;8340;234;373;3557;7486;3791;7859
270470;202210;14158;34505;12315;31963;627;1875;9960;25369;10587;27244
270480;202210;3626;8392;3042;7590;159;485;2524;6103;2683;6588
270490;202210;1072;2685;929;2511;37;122;772;2038;809;2160
270500;202210;5886;15620;5235;14569;260;820;4250;11656;4510;12476
270510;202210;7769;16881;6548;15363;326;938;5296;11883;5622;12821
270520;202210;4802;12083;3818;10564;716;2069;1846;5121;2562;7190
270530;202210;1564;4125;1330;3756;87;220;924;2646;1011;2866
270540;202210;2710;6555;2283;6007;69;224;1987;5143;2056;5367
270550;202210;7820;18250;6175;16423;599;1490;4559;12364;5158;13854
270560;202210;3504;8017;2912;7240;159;471;2326;5592;2485;6063
270570;202210;6757;14075;5917;12928;433;1087;4943;10373;5376;11460
270580;202210;2858;6959;2576;6579;111;309;2246;5663;2357;5972
270590;202210;1719;4767;1584;4585;17;74;1491;4299;1508;4373
270600;202210;3291;8939;2987;8491;63;226;2653;7458;2716;7684
270610;202210;4336;10197;3797;9500;122;252;3369;8390;3491;8642
270620;202210;1439;3932;1307;3702;28;108;1132;3111;1160;3219
270630;202210;22970;47888;20009;43939;742;2017;17337;36895;18079;38912
270640;202210;6501;16376;5413;14655;149;550;4447;11804;4596;12354
270642;202210;2995;8569;2631;7997;199;666;1980;5909;2179;6575
270644;202210;4756;10414;3971;9434;243;588;3230;7555;3473;8143
270650;202210;4441;10438;3898;9748;267;810;3251;7946;3518;8756
270660;202210;2364;5280;2027;4834;87;205;1586;3695;1673;3900
270670;202210;23099;44457;19695;40373;663;1399;17140;34203;17803;35602
270680;202210;7929;14454;7201;13658;329;425;6611;12733;6940;13158
270690;202210;12301;26578;10326;24078;270;798;8712;19747;8982;20545
270700;202210;660;1757;570;1618;63;194;385;1050;448;1244
270710;202210;6763;18009;5929;16756;371;1115;4648;12963;5019;14078
270720;202210;4492;11083;3986;10271;93;302;3553;8963;3646;9265
270730;202210;9629;19105;8325;17734;1039;1316;6257;14701;7296;16017
270740;202210;2722;6643;2385;6253;80;250;2004;5177;2084;5427
270750;202210;6735;15592;5923;14573;104;411;5318;12804;5422;13215
270760;202210;3985;9815;3305;8881;56;248;2820;7424;2876;7672
270770;202210;27881;62084;22807;55738;3407;8268;14534;35474;17941;43742
270780;202210;2475;5369;2286;5123;49;162;2097;4605;2146;4767
270790;202210;2066;4863;1757;4463;145;360;1379;3473;1524;3833
270800;202210;14516;32585;13101;30660;579;1392;11039;25546;11618;26938
270810;202210;4013;9854;3177;8608;178;574;2402;6309;2580;6883
270820;202210;1890;5159;1601;4704;58;235;1298;3743;1356;3978
270830;202210;6197;13465;5032;12054;175;530;4171;9750;4346;10280
270840;202210;9727;26358;8440;24423;337;1453;6857;19087;7194;20540
270850;202210;10817;22161;9515;20675;621;1513;8144;17451;8765;18964
270860;202210;17433;34883;14030;31078;588;1439;11686;25272;12274;26711
270870;202210;2703;6976;2189;6133;212;577;1477;4116;1689;4693
270880;202210;9226;25273;8220;23763;200;817;6900;19446;7100;20263
270890;202210;4128;10076;3475;9147;427;1113;2129;5540;2556;6653
270895;202210;4572;10800;4089;10195;122;354;3650;8941;3772;9295
270900;202210;1914;4468;1476;3805;22;72;1221;3053;1243;3125
270910;202210;5002;12775;4335;11810;197;455;3601;9736;3798;10191
270915;202210;11311;28742;9165;25392;797;2643;6364;16795;7161;19438
270920;202210;7251;18133;6353;16882;115;476;5549;14369;5664;14845
270930;202210;21833;44781;17221;39528;1967;3936;12451;29521;14418;33457
270940;202210;7323;17560;6122;16179;195;819;4985;12678;5180;13497
280010;202210;706;1855;546;1529;20;84;393;1002;413;1086
280020;202210;6474;13761;5476;12247;388;886;4251;9146;4639;10032
280030;202210;119044;234778;99252;208043;15600;33454;59637;121368;75237;154822
280040;202210;3717;8588;3230;7904;171;543;2515;5862;2686;6405
280050;202210;5038;12936;4213;11621;897;2456;2152;5882;3049;8338
280060;202210;8969;19566;7309;17164;1005;2646;4583;10395;5588;13041
280067;202210;8918;18357;7611;16437;633;1034;5605;12076;6238;13110
280070;202210;2021;5638;1844;5367;121;418;1473;4167;1594;4585
280100;202210;5261;11797;4439;10571;545;1157;2866;7058;3411;8215
280110;202210;1955;4117;1677;3726;25;74;1544;3351;1569;3425
280120;202210;9599;23301;8503;21612;1114;2460;6019;15625;7133;18085
280130;202210;10576;22182;9199;20319;594;1336;7343;15953;7937;17289
280140;202210;7632;14746;6758;13572;683;1120;5121;10515;5804;11635
280150;202210;4804;11009;4150;10096;479;1059;2972;7166;3451;8225
280160;202210;1594;3847;1356;3468;135;377;949;2292;1084;2669
280170;202210;7198;14929;6468;14021;223;525;5569;11786;5792;12311
280190;202210;2069;3376;1881;3139;36;96;1757;2845;1793;2941
280200;202210;1474;3545;1213;3170;77;235;890;2227;967;2462
280210;202210;21857;46179;19012;42280;2106;4607;12966;28078;15072;32685
280220;202210;2107;4784;1797;4387;109;252;1440;3527;1549;3779
280230;202210;4994;11421;4044;10009;272;541;2785;6900;3057;7441
280240;202210;3883;9184;3420;8518;37;185;2998;7218;3035;7403
280250;202210;1198;2351;1014;2099;59;129;794;1570;853;1699
280260;202210;3025;5850;2675;5418;36;87;2489;4982;2525;5069
280270;202210;2906;6900;2543;6377;120;374;2187;5327;2307;5701
280280;202210;4679;12420;4121;11615;573;1347;2850;8313;3423;9660
280290;202210;26994;57648;23257;52649;2072;4833;15272;34849;17344;39682
280300;202210;16417;31355;14334;29134;1315;1745;11153;23962;12468;25707
280310;202210;1636;3798;1363;3367;49;134;1072;2562;1121;2696
280320;202210;11265;25764;9757;23557;992;2450;7068;16425;8060;18875
280330;202210;5528;12291;4584;10970;327;749;3385;7924;3712;8673
280340;202210;6379;11952;5334;10788;199;310;4712;9541;4911;9851
280350;202210;39974;72368;35564;66695;1026;2314;30971;55861;31997;58175
280360;202210;6721;16943;5819;15553;648;1898;3715;9698;4363;11596
280370;202210;2881;5939;2313;5025;130;232;1775;3779;1905;4011
280380;202210;1256;2930;1054;2660;93;198;745;1905;838;2103
280390;202210;5138;10068;4351;8907;285;460;3555;7232;3840;7692
280400;202210;5054;10574;4415;9745;428;853;3324;7320;3752;8173
280410;202210;3370;7891;2822;7056;278;746;1860;4395;2138;5141
280420;202210;5392;12124;4871;11487;119;279;4416;10416;4535;10695
280430;202210;2871;5764;2543;5342;61;167;2233;4511;2294;4678
280440;202210;5424;12148;4802;11237;182;495;4115;9311;4297;9806
280445;202210;2661;6326;2389;5894;53;165;1927;4563;1980;4728
280450;202210;11836;26264;10221;24086;2340;5542;5093;12289;7433;17831
280460;202210;8711;17822;7889;16739;418;953;6754;14002;7172;14955
280470;202210;1982;4992;1655;4403;117;332;1216;3119;1333;3451
280480;202210;62065;126663;53939;115744;5134;11725;38713;80080;43847;91805
280490;202210;4202;11104;3508;9915;135;550;2666;7151;2801;7701
280500;202210;1279;2598;1056;2324;25;74;882;1926;907;2000
280510;202210;4373;7421;3883;6807;49;135;3576;6013;3625;6148
280520;202210;2334;4761;2039;4368;177;291;1551;3330;1728;3621
280530;202210;2782;6370;2413;5868;125;300;1910;4579;2035;4879
280540;202210;10073;24391;9056;22974;402;1042;7749;19486;8151;20528
280550;202210;8272;16738;6910;14860;116;435;5946;12182;6062;12617
280560;202210;9054;21325;8460;20481;127;412;7638;18117;7765;18529
280570;202210;8675;17496;7198;15703;305;716;5778;12235;6083;12951
280580;202210;7675;16139;6783;14915;467;919;5501;11906;5968;12825
280590;202210;3309;7001;2787;6382;159;427;2115;4609;2274;5036
280600;202210;5176;11076;4570;10227;160;392;3610;7866;3770;8258
280610;202210;3475;6910;3100;6440;126;301;2684;5372;2810;5673
280620;202210;7634;15462;6529;14077;580;868;4753;10702;5333;11570
280630;202210;4956;11325;4534;10784;332;712;3595;8640;3927;9352
280640;202210;2954;6549;2568;6113;112;229;2262;5409;2374;5638
280650;202210;1442;3423;1188;3058;111;276;841;2079;952;2355
280660;202210;4824;8939;4225;8246;140;236;3762;7248;3902;7484
280670;202210;25011;51610;21562;47207;2889;6081;14526;31704;17415;37785
280680;202210;3531;7440;3035;6743;304;551;2065;4761;2369;5312
280690;202210;1266;2574;1067;2326;56;146;895;1875;951;2021
280700;202210;1425;3007;1215;2713;34;85;1001;2168;1035;2253
280710;202210;18756;36474;15956;33314;1113;1671;13558;28717;14671;30388
280720;202210;3213;6363;2652;5712;54;119;2207;4743;2261;4862
280730;202210;1215;2858;1034;2585;79;212;741;1760;820;1972
280740;202210;21151;39828;18335;35911;983;2161;15010;28106;15993;30267
280750;202210;4022;10260;3440;9268;225;640;2477;6534;2702;7174
280760;202210;9005;19078;7704;17325;781;1585;5487;12362;6268;13947
290010;202210;3846;7048;2545;5134;17;50;2228;4282;2245;4332
290020;202210;7631;15303;6963;14502;544;848;5826;12376;6370;13224
290030;202210;5744;11227;4717;10090;331;582;3738;8221;4069;8803
290035;202210;6535;12066;5247;10406;256;432;4210;8238;4466;8670
290040;202210;7159;12137;6196;11019;361;469;5327;9524;5688;9993
290050;202210;2453;7152;2066;6370;142;461;1417;4246;1559;4707
290060;202210;1849;3628;1353;2954;158;375;974;2049;1132;2424
290070;202210;52423;98496;45298;89694;2872;5468;35769;69042;38641;74510
290080;202210;8036;18798;6990;17307;742;1795;5013;12412;5755;14207
290090;202210;2775;4479;2031;3687;18;50;1896;3384;1914;3434
290100;202210;11954;27458;9622;24116;1661;3830;5100;13248;6761;17078
290110;202210;6868;15580;5943;14161;786;1736;3694;8802;4480;10538
290115;202210;4830;12800;4082;11515;350;1017;3168;8837;3518;9854
290120;202210;8188;17408;6858;15588;209;570;5880;13003;6089;13573
290130;202210;5523;11685;4290;10079;272;541;3084;7462;3356;8003
290135;202210;5520;11302;4478;9629;166;411;3655;7437;3821;7848
290140;202210;5393;12320;4160;10706;228;528;3386;8801;3614;9329
290150;202210;4161;7635;3656;7061;148;366;3149;5853;3297;6219
290160;202210;4267;8370;3785;7721;188;330;3214;6465;3402;6795
290170;202210;4518;9188;4010;8644;133;281;3605;7766;3738;8047
290180;202210;3673;8672;3074;7747;72;263;2633;6441;2705;6704
290190;202210;6207;13085;5551;12248;122;354;4860;10486;4982;10840
290195;202210;3361;6725;2673;5874;166;301;2211;4880;2377;5181
290200;202210;4907;12306;3849;10533;241;569;2756;7574;2997;8143
290205;202210;4411;9687;3883;8912;182;460;3159;7055;3341;7515
290210;202210;17839;39493;15776;36477;1550;3005;12076;28317;13626;31322
290220;202210;4143;7698;3665;7131;96;227;3243;6128;3339;6355
290225;202210;4039;6977;3135;6051;47;132;2917;5494;2964;5626
290230;202210;3947;7509;3621;7143;193;257;2962;6044;3155;6301
290240;202210;5263;10365;4302;9219;74;241;3836;8016;3910;8257
290250;202210;4868;12037;3962;10741;150;371;3279;9019;3429;9390
290260;202210;6642;14105;5631;12649;269;667;4766;10382;5035;11049
290265;202210;3974;10683;3189;9250;287;868;2116;6018;2403;6886
290270;202210;12898;39123;11764;37210;817;2726;9102;28755;9919;31481
290280;202210;7271;19987;6223;17949;488;1603;4308;11993;4796;13596
290290;202210;11600;30919;9239;26729;949;2945;5939;16818;6888;19763
290300;202210;5041;12217;3651;9689;199;583;2603;6657;2802;7240
290310;202210;2825;4893;2325;4322;24;81;2178;3945;2202;4026
290320;202210;35537;79869;28874;70247;4825;11882;17016;40851;21841;52733
290323;202210;4601;11154;3892;10032;101;280;3071;7836;3172;8116
290327;202210;5073;12844;4262;11368;427;1039;2862;7569;3289;8608
290330;202210;3023;5053;2443;4436;27;43;2269;4115;2296;4158
290340;202210;7813;16141;6120;14155;528;1160;4800;11081;5328;12241
290350;202210;5605;14303;4638;12665;255;778;3361;8989;3616;9767
290360;202210;6745;13925;5885;12785;110;283;5247;11211;5357;11494
290370;202210;5752;12663;4176;10586;168;425;2991;7494;3159;7919
290380;202210;7146;15515;5948;13924;183;320;5057;11924;5240;12244
290390;202210;18735;46712;15427;41464;1476;3970;10723;28536;12199;32506
290395;202210;3533;8780;2784;7541;70;264;2192;5776;2262;6040
290400;202210;4551;11094;3617;9595;177;534;2737;7029;2914;7563
290405;202210;5330;13905;4473;12466;434;1204;2979;8406;3413;9610
290410;202210;6574;16009;4985;13578;183;677;3780;9962;3963;10639
290420;202210;3742;9043;3036;7971;101;267;2386;6224;2487;6491
290430;202210;4451;9573;3708;8504;168;499;2979;6457;3147;6956
290440;202210;3479;7706;2487;6174;172;369;1770;4421;1942;4790
290450;202210;5198;9902;4187;8518;97;238;3713;7254;3810;7492
290460;202210;15201;39224;12577;34455;2587;7241;5224;14111;7811;21352
290470;202210;6143;12113;4686;10204;430;975;3185;6671;3615;7646
290475;202210;7869;19972;6526;17763;92;440;5522;14665;5614;15105
290480;202210;2267;4937;1846;4339;72;225;1421;3129;1493;3354
290485;202210;5610;14191;4874;13154;220;681;3950;10620;4170;11301
290490;202210;11935;23415;10811;21952;443;926;9092;18241;9535;19167
290500;202210;4955;13509;3802;11192;669;2099;1570;4399;2239;6498
290510;202210;4479;9212;3746;8287;101;227;3293;7292;3394;7519
290515;202210;4151;10385;3582;9590;29;92;3258;8766;3287;8858
290520;202210;14842;37139;11463;30834;547;1780;7768;19430;8315;21210
290530;202210;5783;15014;4822;13490;99;389;4085;11256;4184;11645
290540;202210;4637;10470;4187;9977;155;429;3721;8818;3876;9247
290550;202210;5094;11519;4428;10739;39;101;4043;9866;4082;9967
290560;202210;7703;17706;5903;15132;529;1545;3896;9458;4425;11003
290570;202210;66622;142630;59620;133841;3694;8914;48529;106281;52223;115195
290580;202210;11146;25854;9688;23867;950;2007;7134;18072;8084;20079
290590;202210;8162;22929;6792;20568;163;585;5606;16999;5769;17584
290600;202210;22664;56726;19539;51768;1052;2849;15524;40602;16576;43451
290610;202210;2905;8294;2249;7014;105;343;1576;4853;1681;5196
290620;202210;7216;18834;6195;17184;451;1137;4938;13751;5389;14888
290630;202210;12729;24858;10508;22093;812;1658;8347;17474;9159;19132
290640;202210;3343;7369;2568;6294;265;495;1740;4533;2005;5028
290650;202210;22275;42483;20374;40397;1039;2386;18097;35118;19136;37504
290660;202210;4552;10580;3572;8998;175;490;2559;6390;2734;6880
290670;202210;10537;21049;9224;19210;232;622;8133;16498;8365;17120
290680;202210;13441;31958;11062;28561;242;971;9307;23422;9549;24393
290682;202210;6782;13718;5883;12557;520;717;4354;10087;4874;10804
290685;202210;4300;8709;3104;7022;492;998;1749;4146;2241;5144
290687;202210;9876;21233;8213;18709;1173;2460;5159;12037;6332;14497
290689;202210;3358;8371;2504;6889;302;836;1612;4428;1914;5264
290690;202210;7011;16014;5758;14279;377;956;4248;10310;4625;11266
290700;202210;3917;7834;3488;7321;64;171;3159;6497;3223;6668
290710;202210;11195;25366;9470;23054;232;769;8323;19875;8555;20644
290720;202210;25693;57398;22958;53378;1659;3399;18105;41451;19764;44850
290730;202210;8567;18140;7205;16546;470;885;5253;12384;5723;13269
290740;202210;1299;2981;993;2505;21;44;880;2189;901;2233
290750;202210;16808;33507;14447;30041;353;934;12135;23777;12488;24711
290755;202210;2366;6161;1900;5352;114;307;1311;3695;1425;4002
290760;202210;4424;11654;3626;10253;224;534;2565;7361;2789;7895
290770;202210;3707;8733;3421;8397;92;215;3033;7428;3125;7643
290780;202210;9368;21255;7969;19388;339;659;6154;15124;6493;15783
290790;202210;6215;14716;5311;13432;285;688;4370;11063;4655;11751
290800;202210;8584;15122;6224;12436;395;628;4635;9402;5030;10030
290810;202210;7017;14952;5688;13081;228;526;4438;10169;4666;10695
290820;202210;6474;14563;5655;13395;353;725;4051;9492;4404;10217
290830;202210;5173;11484;4535;10498;103;333;3670;7975;3773;8308
290840;202210;22003;51379;18587;46229;2062;4285;12331;32138;14393;36423
290850;202210;11270;20281;9818;18719;502;742;8277;15674;8779;16416
290860;202210;7783;18562;6776;17404;376;842;5667;14874;6043;15716
290870;202210;5733;14091;4338;11539;347;847;2908;7635;3255;8482
290880;202210;1678;3686;1329;3250;197;436;757;1999;954;2435
290890;202210;11927;20732;10531;19177;430;666;9398;17120;9828;17786
290900;202210;2738;6695;2082;5568;173;448;1279;3361;1452;3809
290910;202210;6207;12910;4742;10764;50;127;4142;9257;4192;9384
290920;202210;6451;13781;5575;12737;167;239;4771;11463;4938;11702
290930;202210;8672;22191;6877;19102;275;959;5193;13955;5468;14914
290940;202210;4072;10545;3350;9467;162;556;2630;7277;2792;7833
290950;202210;1692;3866;1353;3362;119;292;890;2226;1009;2518
290960;202210;7388;15896;6566;14907;314;606;5511;12460;5825;13066
290970;202210;3653;10168;2955;8872;117;396;2269;6737;2386;7133
290980;202210;17305;35786;15007;32453;813;1983;10852;22140;11665;24123
290990;202210;11918;27523;10560;25454;321;1083;8982;20789;9303;21872
291000;202210;3939;9026;3023;7902;152;399;2442;6417;2594;6816
291005;202210;20890;44776;18462;41769;929;2150;15404;34202;16333;36352
291010;202210;3509;9989;2739;8338;148;499;1787;5243;1935;5742
291020;202210;1525;3436;1226;2943;31;87;897;1993;928;2080
291030;202210;3052;6518;2224;5204;198;409;1420;3225;1618;3634
291040;202210;6312;15390;5128;13734;252;751;3967;10641;4219;11392
291050;202210;14052;27483;12458;25379;1480;2879;9146;18364;10626;21243
291060;202210;10687;23520;9393;21867;923;1990;7117;16528;8040;18518
291070;202210;21974;48155;18611;43056;356;1183;16152;36105;16508;37288
291072;202210;35113;75338;26858;62603;3853;9191;15557;34705;19410;43896
291075;202210;6399;14234;5715;13193;104;285;4760;10542;4864;10827
291077;202210;1988;4707;1540;3950;87;159;1086;2779;1173;2938
291080;202210;164284;345069;133318;303978;28050;63762;64697;145424;92747;209186
291085;202210;6539;15037;5264;13081;195;523;4316;10506;4511;11029
291090;202210;2611;4317;1947;3591;54;97;1688;3033;1742;3130
291100;202210;4056;7444;2886;6081;134;261;2286;4765;2420;5026
291110;202210;7011;19232;5856;17323;337;1206;4464;12799;4801;14005
291120;202210;10503;20973;9045;19197;596;1197;7105;14974;7701;16171
291125;202210;2876;4384;2213;3651;106;142;1918;3135;2024;3277
291130;202210;3756;9630;2796;7827;82;310;2173;5816;2255;6126
291140;202210;5814;13841;4197;11020;654;1527;2492;6528;3146;8055
291150;202210;3420;5931;2711;5160;39;61;2547;4815;2586;4876
291160;202210;6069;15035;4980;13468;545;1492;3192;8427;3737;9919
291165;202210;2445;6252;1753;4941;27;121;1229;3321;1256;3442
291170;202210;26773;60806;22323;53619;1625;3972;14766;33781;16391;37753
291180;202210;9899;16970;7834;14358;224;466;6982;12414;7206;12880
291185;202210;4302;9114;3822;8415;223;462;3056;6656;3279;7118
291190;202210;9273;20053;7661;18057;279;661;6033;14419;6312;15080
291200;202210;3234;8125;2361;6518;89;323;1588;4089;1677;4412
291210;202210;9359;16878;6977;14200;395;682;5371;10912;5766;11594
291220;202210;5975;13947;5302;12991;490;1133;3676;8903;4166;10036
291230;202210;6073;10485;4830;9136;58;89;4513;8493;4571;8582
291240;202210;4934;11488;4173;10256;82;235;3600;8677;3682;8912
291250;202210;3807;10345;2916;8749;196;568;1796;5457;1992;6025
291260;202210;1746;3602;1426;3196;45;95;1173;2652;1218;2747
291270;202210;6689;14897;5225;12899;475;1077;3757;9423;4232;10500
291280;202210;3437;7426;2554;6150;151;372;1815;4151;1966;4523
291290;202210;6748;16066;5129;13588;502;1381;3402;8781;3904;10162
291300;202210;4728;11172;3758;9601;192;484;2789;7011;2981;7495
291310;202210;6322;14708;5408;13165;132;385;4674;11105;4806;11490
291320;202210;7949;19064;6176;16108;1286;3186;3250;8702;4536;11888
291330;202210;2224;5120;1815;4443;70;190;1387;3294;1457;3484
291340;202210;5051;11693;4009;10022;233;450;2718;6778;2951;7228
291345;202210;3613;9032;3225;8457;194;507;2591;6805;2785;7312
291350;202210;8795;18230;6911;15939;171;398;5879;13397;6050;13795
291360;202210;53842;102946;43293;90760;5154;10437;28914;61271;34068;71708
291370;202210;9885;23844;8684;22032;595;1736;6626;16086;7221;17822
291380;202210;5717;11293;5124;10521;120;328;4584;9165;4704;9493
291390;202210;16527;30557;12795;26453;614;1129;10870;22239;11484;23368
291400;202210;20141;41253;16927;36652;1599;3269;11982;25947;13581;29216
291410;202210;3528;8380;2745;7079;58;186;2061;5149;2119;5335
291420;202210;2248;4895;1742;4266;22;76;1547;3724;1569;3800
291430;202210;3096;7814;2622;7033;93;337;2082;5370;2175;5707
291440;202210;7854;19752;6701;17977;526;1338;4890;13377;5416;14715
291450;202210;13498;24913;11216;22318;338;462;10013;20171;10351;20633
291460;202210;22089;47726;19373;43880;1574;3301;14500;32239;16074;35540
291465;202210;10751;23303;8522;20760;259;926;7318;17307;7577;18233
291470;202210;25441;46098;21778;41969;1178;2096;17395;33255;18573;35351
291480;202210;58908;113311;45317;95595;4989;10520;27586;56049;32575;66569
291490;202210;8998;17310;8032;16240;233;509;7368;14759;7601;15268
291500;202210;6493;12863;5446;11557;144;357;4983;10503;5127;10860
291510;202210;5823;11422;4453;9697;67;210;3922;8347;3989;8557
291520;202210;5511;11184;4213;9547;295;669;3360;7517;3655;8186
291530;202210;2877;5779;2093;4786;228;511;1424;3281;1652;3792
291535;202210;4590;11245;3840;9980;202;476;3072;8026;3274;8502
291540;202210;2669;5155;1879;4212;59;152;1601;3548;1660;3700
291550;202210;8232;15014;6486;12914;554;960;4771;9380;5325;10340
291560;202210;21838;47146;16264;39966;3337;7773;8098;20577;11435;28350
291570;202210;2925;5761;2257;5003;75;164;1980;4389;2055;4553
291580;202210;7752;17391;6105;15275;311;899;4672;11261;4983;12160
291590;202210;3370;6240;3000;5819;82;197;2720;5153;2802;5350
291600;202210;6817;13887;5252;11617;486;1169;3553;7596;4039;8765
291610;202210;8748;16727;7806;15692;726;987;6174;12993;6900;13980
291620;202210;3662;7214;2786;6263;232;431;2081;4813;2313;5244
291630;202210;4317;8002;3311;6777;532;791;2372;5101;2904;5892
291640;202210;22233;45438;17269;38699;1619;3737;10775;22960;12394;26697
291650;202210;12688;25260;11254;23605;930;1306;9198;19985;10128;21291
291660;202210;2386;5286;1749;4340;138;400;1174;2701;1312;3101
291670;202210;2388;5734;1952;5106;211;487;1317;3554;1528;4041
291680;202210;4944;10754;4003;9461;486;1144;2536;6060;3022;7204
291685;202210;5653;12618;4515;11067;175;363;3535;8630;3710;8993
291690;202210;5540;9853;3976;7778;149;315;3471;6582;3620;6897
291700;202210;11665;27435;10276;25235;336;1049;8837;20983;9173;22032
291710;202210;6733;13499;5160;11402;356;782;3904;8347;4260;9129
291720;202210;5170;14245;4247;12486;880;2654;2196;6395;3076;9049
291730;202210;9800;18295;8471;16624;417;807;7204;14002;7621;14809
291733;202210;3510;7967;2889;7135;115;225;2133;5464;2248;5689
291735;202210;3170;8047;2430;6748;83;195;1722;4789;1805;4984
291740;202210;4611;11001;3207;8428;124;269;2237;5811;2361;6080
291750;202210;27061;55464;22461;48818;3070;5860;14720;32357;17790;38217
291760;202210;13695;34227;10717;29766;3247;10429;2930;7638;6177;18067
291770;202210;9172;21687;7638;19112;370;1168;5880;13908;6250;15076
291780;202210;6312;14531;5666;13678;150;432;4903;11580;5053;12012
291790;202210;3730;8152;3395;7748;384;613;2516;6027;2900;6640
291800;202210;43970;91760;35237;79755;4224;10151;22427;48192;26651;58343
291810;202210;13182;27289;11228;24962;474;893;9388;21005;9862;21898
291820;202210;4737;10921;4097;10102;133;339;3339;8129;3472;8468
291830;202210;5882;11365;4794;9975;333;476;3739;7886;4072;8362
291835;202210;7729;21003;6127;18130;682;2047;3991;11874;4673;13921
291840;202210;61845;147124;53927;135414;5552;14777;38946;95954;44498;110731
291845;202210;4205;8045;3519;7225;269;425;2865;6060;3134;6485
291850;202210;5422;12840;4554;11508;138;343;3896;9798;4034;10141
291855;202210;2960;4736;2402;4130;31;57;2275;3883;2306;3940
291860;202210;2500;6190;1695;4659;44;115;1139;3020;1183;3135
291870;202210;1479;3439;990;2599;41;127;684;1751;725;1878
291875;202210;3408;9483;2904;8473;65;271;2143;6001;2208;6272
291880;202210;6621;16295;5533;14556;345;828;4186;11124;4531;11952
291890;202210;2073;3811;1382;3011;207;447;871;1861;1078;2308
291900;202210;1624;3404;1249;2852;30;81;1002;2199;1032;2280
291905;202210;2741;6466;2224;5661;109;330;1697;4128;1806;4458
291910;202210;4465;8375;3846;7656;83;168;3443;6809;3526;6977
291915;202210;8855;22248;7130;19436;286;736;5227;14566;5513;15302
291920;202210;42235;90703;37008;83978;1955;5472;29883;64836;31838;70308
291930;202210;3349;7367;2839;6685;303;661;2065;4916;2368;5577
291940;202210;4481;10329;3000;7947;264;654;1806;4714;2070;5368
291950;202210;10898;30517;9068;27196;497;1543;6064;18040;6561;19583
291955;202210;23868;51155;21381;48013;1385;3308;17399;38566;18784;41874
291960;202210;4685;9330;3950;8403;305;480;3163;6915;3468;7395
291970;202210;6113;12534;5169;11416;186;443;4198;9100;4384;9543
291980;202210;12175;30599;9829;26809;930;2344;6618;18255;7548;20599
291990;202210;2732;6204;2277;5653;25;91;2107;5178;2132;5269
291992;202210;5689;11437;4829;10376;249;530;3982;8320;4231;8850
291995;202210;2803;6245;2314;5520;79;259;1917;4387;1996;4646
292000;202210;3257;6665;2687;5993;85;226;2250;4930;2335;5156
292010;202210;7053;14178;5755;12336;104;363;4949;10215;5053;10578
292020;202210;5782;13992;4882;12531;151;551;4008;9853;4159;10404
292030;202210;2519;6527;2174;5940;143;416;1450;3843;1593;4259
292040;202210;5775;12250;4615;10625;170;412;3841;8701;4011;9113
292045;202210;5734;11104;4570;9466;22;69;4305;8849;4327;8918
292050;202210;7675;19130;6184;16656;276;871;4231;11033;4507;11904
292060;202210;16081;30429;14909;29032;517;889;13321;25491;13838;26380
292070;202210;8413;16878;7407;15708;496;980;6300;13289;6796;14269
292080;202210;4630;8723;3859;7769;40;129;3597;7126;3637;7255
292090;202210;5277;10259;3768;8431;215;519;2979;6624;3194;7143
292100;202210;15972;33734;13658;30873;2092;4626;8340;19119;10432;23745
292105;202210;4000;9267;3457;8533;49;165;2913;7109;2962;7274
292110;202210;8232;16320;5986;13253;723;1735;4001;8533;4724;10268
292120;202210;8634;19438;7067;16915;730;1526;4919;11733;5649;13259
292130;202210;4104;8747;3334;7784;194;497;2500;5736;2694;6233
292140;202210;7111;13675;6024;12183;187;371;5358;10642;5545;11013
292145;202210;3153;7538;2625;6701;138;265;2006;5217;2144;5482
292150;202210;19457;42777;16753;38563;415;1099;14366;32082;14781;33181
292160;202210;3535;7522;2691;6464;35;103;2104;5335;2139;5438
292170;202210;10657;25296;8833;22433;489;1455;6738;16530;7227;17985
292180;202210;3457;8659;2564;7043;202;575;1606;4247;1808;4822
292190;202210;3648;8361;3058;7517;280;731;2144;5226;2424;5957
292200;202210;11458;25157;8649;21259;1742;4334;4246;10618;5988;14952
292205;202210;4657;11230;4007;10270;108;303;3460;8831;3568;9134
292210;202210;8202;15838;6798;14114;78;278;6336;12896;6414;13174
292220;202210;2731;5550;2328;4959;157;314;1760;3605;1917;3919
292225;202210;3802;9826;3292;9081;64;257;2858;7746;2922;8003
292230;202210;10600;22232;9319;20615;277;752;7913;17054;8190;17806
292240;202210;6048;15332;5193;13792;306;779;3766;9940;4072;10719
292250;202210;7623;16705;6784;15538;305;780;5501;12203;5806;12983
292260;202210;4027;9418;3554;8827;64;194;3151;7760;3215;7954
292265;202210;4479;10307;3701;9124;66;266;3158;7519;3224;7785
292270;202210;6171;11161;5049;9848;203;307;4237;8177;4440;8484
292273;202210;3418;6525;2715;5675;158;255;1966;4341;2124;4596
292275;202210;2330;5064;1899;4506;53;159;1582;3668;1635;3827
292280;202210;3371;6778;2695;6000;131;227;2250;5120;2381;5347
292285;202210;3128;6506;2450;5625;109;198;1987;4620;2096;4818
292290;202210;9147;20581;7297;18019;203;514;6135;14941;6338;15455
292300;202210;12811;28571;10091;24914;1381;3396;6325;15767;7706;19163
292303;202210;4154;9245;3608;8436;65;155;3232;7436;3297;7591
292305;202210;2764;6656;2503;6303;54;177;2246;5572;2300;5749
292310;202210;8540;18281;7379;16865;131;413;6503;14497;6634;14910
292320;202210;6892;16799;5473;14384;182;555;4259;10886;4441;11441
292330;202210;4006;6699;3367;5995;169;249;2842;5093;3011;5342
292335;202210;6067;13970;5317;12876;257;576;4439;10802;4696;11378
292340;202210;6453;16497;5163;14108;359;885;3600;9779;3959;10664
292350;202210;3299;7641;2763;6934;144;387;2275;5646;2419;6033
292360;202210;5966;14154;4947;12517;268;722;3646;9023;3914;9745
292370;202210;13512;26829;11626;24391;91;346;11000;22653;11091;22999
292380;202210;8367;20514;7400;18856;438;1181;5810;14462;6248;15643
292390;202210;6145;9672;4737;8091;116;192;4299;7292;4415;7484
292400;202210;27694;68837;23767;62950;2222;5841;16729;43957;18951;49798
292405;202210;5557;11806;4612;10377;139;323;3631;8281;3770;8604
292410;202210;2966;5601;2549;5097;99;170;2254;4511;2353;4681
292420;202210;6170;11905;5565;11099;120;270;5071;9844;5191;10114
292430;202210;5911;15867;4424;13167;346;1088;2957;8637;3303;9725
292440;202210;11242;29095;10298;27759;125;593;9364;24848;9489;25441
292450;202210;4840;12335;3639;10101;94;302;2843;7736;2937;8038
292460;202210;7703;15905;6538;14192;164;459;5698;11926;5862;12385
292465;202210;3136;7056;2631;6421;134;271;1773;4623;1907;4894
292467;202210;2567;6031;2272;5648;328;661;1550;4130;1878;4791
292470;202210;3382;7996;2537;6688;150;346;1798;4767;1948;5113
292480;202210;8370;15520;6937;13827;176;343;6284;12414;6460;12757
292490;202210;3415;6550;2829;5797;89;175;2271;4643;2360;4818
292500;202210;8878;19844;7082;17072;424;928;5206;12256;5630;13184
292510;202210;17431;39171;13725;33602;1055;2512;9722;23619;10777;26131
292520;202210;9129;20324;8037;18746;405;1100;6531;14846;6936;15946
292525;202210;8147;16014;6728;14406;135;308;6071;12925;6206;13233
292530;202210;42515;97068;34085;84052;6600;17308;17856;42584;24456;59892
292540;202210;5480;8858;4394;7715;133;208;4015;7051;4148;7259
292550;202210;10256;24458;7973;21705;616;1558;5543;15813;6159;17371
292560;202210;5446;12149;4529;10891;163;494;3494;8049;3657;8543
292570;202210;4534;10360;3773;9082;51;184;3244;7517;3295;7701
292575;202210;8174;21124;7424;20104;867;2221;5397;14890;6264;17111
292580;202210;9961;20337;8273;17974;561;776;6801;14924;7362;15700
292590;202210;8748;20967;7321;18474;316;1011;6032;14713;6348;15724
292593;202210;3524;7805;2788;6590;79;192;2339;5426;2418;5618
292595;202210;6969;15773;6034;14632;326;681;4963;12231;5289;12912
292600;202210;13892;32421;11949;29637;665;1484;9454;23458;10119;24942
292610;202210;5588;12087;4709;10688;164;366;3855;8539;4019;8905
292620;202210;8465;18800;7004;17049;117;287;6451;15697;6568;15984
292630;202210;11436;23842;9217;20464;949;2271;6367;13523;7316;15794
292640;202210;9640;24927;8056;22372;484;1331;5566;15475;6050;16806
292650;202210;5049;11441;4461;10675;60;184;4096;9662;4156;9846
292660;202210;12925;32531;10956;29612;646;1607;8269;22564;8915;24171
292665;202210;2421;6461;2025;5926;104;260;1592;4780;1696;5040
292670;202210;4068;10391;3143;8692;256;810;2032;5389;2288;6199
292680;202210;4737;11143;3745;9474;114;299;2897;7057;3011;7356
292690;202210;2984;7173;2039;5656;214;534;1260;3588;1474;4122
292700;202210;12760;29591;11004;26978;669;1458;8282;20094;8951;21552
292710;202210;4100;8765;3834;8445;78;171;3612;7922;3690;8093
292720;202210;10802;22124;9094;20159;495;923;6975;15965;7470;16888
292730;202210;6801;12900;6148;11982;409;630;5103;9960;5512;10590
292740;202210;482421;979822;428196;906582;45588;99664;308907;632726;354495;732390
292750;202210;8550;18089;7508;16732;319;663;6374;14089;6693;14752
292760;202210;4752;11958;4086;10850;204;592;3116;8098;3320;8690
292770;202210;9463;20412;7842;18243;963;2255;5505;12920;6468;15175
292780;202210;2628;4449;1963;3671;45;108;1688;2972;1733;3080
292790;202210;4716;8734;3575;7510;314;558;2779;5964;3093;6522
292800;202210;14821;31282;12704;28162;936;1814;9895;22010;10831;23824
292805;202210;4613;9319;3685;8172;151;358;3073;6676;3224;7034
292810;202210;16692;32281;13743;28005;528;1329;11611;22392;12139;23721
292820;202210;8183;21050;5964;17327;442;1449;4145;11763;4587;13212
292830;202210;3565;7352;3039;6741;148;305;2486;5611;2634;5916
292840;202210;12428;25344;10681;23065;162;484;9748;20506;9910;20990
292850;202210;3084;7188;2591;6506;230;553;1820;4504;2050;5057
292860;202210;22841;42489;20555;39803;412;1000;18360;34546;18772;35546
292870;202210;28066;57870;24306;52730;1634;3447;17675;36922;19309;40369
292880;202210;13448;33689;11242;30270;423;1477;8295;21235;8718;22712
292890;202210;10593;22975;9385;21316;189;603;8317;18369;8506;18972
292895;202210;4244;7535;3292;6179;257;396;2606;4900;2863;5296
292900;202210;3695;8036;3333;7539;55;198;2846;6173;2901;6371
292905;202210;5457;12208;4334;10549;142;399;3407;7977;3549;8376
292910;202210;6701;14901;5893;13855;185;415;4791;10968;4976;11383
292920;202210;12111;28810;11158;27512;315;993;9701;23400;10016;24393
292925;202210;6239;16209;5082;14051;432;1003;3512;9748;3944;10751
292930;202210;8254;21299;7121;19317;927;2594;4157;10924;5084;13518
292935;202210;3500;6445;2842;5727;22;59;2624;5251;2646;5310
292937;202210;3369;7732;2866;7092;281;614;2003;5073;2284;5687
292940;202210;3630;8082;2887;6988;489;1006;1736;4412;2225;5418
292950;202210;11058;26020;9587;23934;515;1258;7298;17862;7813;19120
292960;202210;6650;13987;5579;12523;218;387;4499;9999;4717;10386
292970;202210;4821;11806;4240;10996;113;317;3522;9201;3635;9518
292975;202210;5277;10266;4694;9612;109;254;4320;8753;4429;9007
292980;202210;4821;9077;4038;8007;62;185;3627;6983;3689;7168
292990;202210;13810;34070;11463;30131;426;1309;9039;22908;9465;24217
293000;202210;3309;7083;2785;6282;160;313;2110;4775;2270;5088
293010;202210;23040;51155;18684;44802;2287;5668;12121;28609;14408;34277
293015;202210;10366;28074;8096;23865;688;2058;5502;16219;6190;18277
293020;202210;12547;30079;11343;28404;161;568;10327;25607;10488;26175
293030;202210;6189;14659;4790;12538;405;738;3140;8659;3545;9397
293040;202210;5282;11968;4274;10592;141;371;3616;8889;3757;9260
293050;202210;31471;61979;27673;56639;1950;3803;21290;42424;23240;46227
293060;202210;4550;10743;3631;9089;240;606;2659;6413;2899;7019
293070;202210;40678;78339;36370;73040;2266;4762;29431;57323;31697;62085
293075;202210;4369;11789;3766;10834;70;351;3237;9230;3307;9581
293076;202210;4175;8983;3770;8519;115;209;3325;7578;3440;7787
293077;202210;7892;18841;6352;16478;915;2163;3646;10099;4561;12262
293080;202210;5468;14389;4583;12876;85;360;3767;10321;3852;10681
293090;202210;3648;9909;2792;8448;197;591;1963;5879;2160;6470
293100;202210;7001;16653;5626;14326;317;699;4327;10991;4644;11690
293105;202210;4512;12993;3803;11594;242;754;2628;7996;2870;8750
293110;202210;3153;6462;2642;5748;132;281;2106;4516;2238;4797
293120;202210;6606;13562;6024;12756;555;757;4816;10645;5371;11402
293130;202210;4367;10512;3752;9727;132;404;3226;8231;3358;8635
293135;202210;38786;83514;28698;70006;5213;13700;11917;28567;17130;42267
293140;202210;3596;6017;3163;5515;96;134;2843;4875;2939;5009
293150;202210;6150;16433;5041;14430;408;1282;3460;9586;3868;10868
293160;202210;5222;10466;4602;9770;554;735;3580;8240;4134;8975
293170;202210;6814;11068;5823;9934;117;256;5159;8572;5276;8828
293180;202210;5532;13486;4569;11821;105;359;3720;9315;3825;9674
293190;202210;20455;42009;18078;38752;126;506;16622;34740;16748;35246
293200;202210;11779;23108;9718;20061;559;873;7997;16481;8556;17354
293210;202210;6530;14603;5498;13127;495;1065;4063;9795;4558;10860
293220;202210;7504;15126;5689;12328;784;1649;3736;7761;4520;9410
293230;202210;5892;11580;4473;9814;334;649;3394;7483;3728;8132
293240;202210;5500;12419;4411;10761;216;376;3256;8309;3472;8685
293245;202210;4908;11440;4427;10766;242;580;3679;8818;3921;9398
293250;202210;7081;15130;5685;13241;387;921;4359;10011;4746;10932
293260;202210;5896;13187;4779;11531;194;371;3475;8421;3669;8792
293270;202210;9484;17667;7590;15659;637;779;6061;13305;6698;14084
293280;202210;5479;12398;4755;11392;299;650;3778;9016;4077;9666
293290;202210;20568;49624;18084;45850;1670;4359;13143;32695;14813;37054
293300;202210;8390;16646;7188;14919;555;1110;5518;11099;6073;12209
293305;202210;5343;10892;4514;9850;43;121;4140;8967;4183;9088
293310;202210;2672;5979;2250;5335;31;114;1869;4284;1900;4398
293315;202210;5757;11082;4789;9744;471;655;3772;7850;4243;8505
293317;202210;3493;7061;3100;6511;319;476;2280;4885;2599;5361
293320;202210;17279;33446;15465;31466;246;594;14174;28295;14420;28889
293325;202210;2265;4897;1779;4290;209;490;1174;2817;1383;3307
293330;202210;96024;218614;79673;192450;9562;26061;48796;109120;58358;135181
293340;202210;2543;6471;2063;5637;150;417;1400;3768;1550;4185
293345;202210;4699;10732;3784;9383;479;873;2465;6741;2944;7614
293350;202210;7095;17819;6031;16480;161;461;5263;14415;5424;14876
293360;202210;19426;40446;16796;37053;571;1199;14582;32396;15153;33595
310010;202210;1173;2456;790;1956;98;271;330;724;428;995
310020;202210;3759;9083;2847;7501;480;1343;1173;2822;1653;4165
310030;202210;2385;6084;1857;5174;257;772;1207;3233;1464;4005
310040;202210;981;2349;758;1975;69;232;437;990;506;1222
310050;202210;1971;4988;1667;4526;148;487;1137;2951;1285;3438
310060;202210;3889;9526;3280;8723;137;438;2508;6740;2645;7178
310070;202210;426;924;321;777;13;44;247;573;260;617
310080;202210;906;2291;665;1870;93;292;337;883;430;1175
310090;202210;6419;13779;5313;12089;203;594;4317;9409;4520;10003
310100;202210;4535;10303;3797;9194;105;362;3226;7520;3331;7882
310110;202210;5855;13899;4574;11784;619;1843;2763;6657;3382;8500
310120;202210;794;1789;516;1380;88;297;259;585;347;882
310130;202210;526;1185;449;1071;26;85;352;783;378;868
310140;202210;400;1025;304;892;56;189;160;412;216;601
310150;202210;7700;17351;5858;14226;511;1541;3504;7615;4015;9156
310160;202210;12412;27579;9571;23253;1467;4119;4806;10689;6273;14808
310163;202210;1406;3851;1081;3209;241;805;308;778;549;1583
310170;202210;11991;26397;9743;23057;968;2249;6889;16042;7857;18291
310180;202210;2465;5342;1789;4302;187;526;1172;2653;1359;3179
310190;202210;3234;8584;2610;7531;605;1869;550;1475;1155;3344
310200;202210;2432;6319;1833;5274;350;1177;821;2113;1171;3290
310205;202210;1386;3448;1110;3025;144;416;711;1952;855;2368
310210;202210;2884;7135;2336;6157;125;314;1647;4184;1772;4498
310220;202210;1383;3490;1023;2812;78;242;651;1691;729;1933
310230;202210;2791;6688;2276;5783;257;783;1470;3436;1727;4219
310240;202210;1226;3171;1041;2866;52;176;722;1874;774;2050
310250;202210;1495;3193;1250;2834;35;95;1033;2249;1068;2344
310260;202210;4499;10831;3043;8192;758;2404;1086;2359;1844;4763
310270;202210;3631;7079;2945;6187;103;238;2468;5142;2571;5380
310280;202210;3476;6832;2742;5872;126;353;2101;4177;2227;4530
310285;202210;2221;6269;1816;5549;178;601;1121;3379;1299;3980
310290;202210;1937;4599;1634;4056;185;547;1054;2359;1239;2906
310300;202210;2005;5089;1587;4375;170;584;878;2166;1048;2750
310310;202210;397;863;267;654;44;115;143;326;187;441
310320;202210;585;1373;406;1086;18;67;237;589;255;656
310330;202210;592;1317;347;878;54;143;150;341;204;484
310340;202210;10034;23189;7803;19458;922;2348;4213;10211;5135;12559
310350;202210;16606;37283;11909;29856;1717;4820;6389;14831;8106;19651
310360;202210;717;1437;583;1268;27;70;377;785;404;855
310370;202210;1448;4224;1254;3892;234;808;425;1369;659;2177
310375;202210;1054;2385;730;1920;208;544;238;592;446;1136
310380;202210;447;987;253;687;25;69;135;343;160;412
310390;202210;705;1907;565;1644;99;317;249;652;348;969
310400;202210;15210;34149;11516;28645;798;2419;7830;18259;8628;20678
310410;202210;1267;3416;756;2334;85;291;323;867;408;1158
310420;202210;6109;14676;4551;11943;548;1645;2425;5751;2973;7396
310430;202210;2061;5231;1443;4130;241;717;620;1530;861;2247
310440;202210;770;1859;532;1446;64;185;266;667;330;852
310445;202210;1616;4142;1210;3368;90;235;842;2275;932;2510
310450;202210;5825;12456;4463;10392;261;787;3430;7517;3691;8304
310460;202210;2085;5240;1562;4300;198;593;516;1196;714;1789
310470;202210;4163;8660;3204;7396;447;944;2020;4761;2467;5705
310480;202210;1211;2862;911;2368;112;373;540;1250;652;1623
310490;202210;3684;8951;2897;7683;381;1163;1614;3873;1995;5036
310500;202210;1871;4380;1477;3771;198;544;937;2260;1135;2804
310510;202210;2882;6770;2099;5384;353;995;962;2330;1315;3325
310520;202210;1346;3212;952;2497;138;387;460;1173;598;1560
310530;202210;986;2372;719;1928;108;340;286;624;394;964
310540;202210;3644;9636;2936;8314;518;1604;1358;3520;1876;5124
310550;202210;1549;3428;1106;2701;75;243;719;1562;794;1805
310560;202210;20659;49227;15183;39497;1709;5193;7940;17928;9649;23121
310570;202210;1469;3194;1155;2769;54;172;965;2229;1019;2401
310590;202210;5228;12291;4164;10396;260;759;2586;5898;2846;6657
310600;202210;1700;4461;1378;3813;174;526;732;1863;906;2389
310610;202210;590;1524;359;1111;97;315;73;203;170;518
310620;202210;278316;632855;213441;519241;21529;63055;128100;277009;149629;340064
310630;202210;5669;14186;4343;11648;540;1484;2541;6468;3081;7952
310640;202210;1845;4300;1504;3730;124;395;1039;2315;1163;2710
310650;202210;2852;7060;2087;5676;146;476;1279;3271;1425;3747
310660;202210;1773;4049;1454;3618;27;72;1280;3135;1307;3207
310665;202210;1727;3766;1436;3383;44;141;1165;2701;1209;2842
310670;202210;81742;184899;68756;163940;6073;16619;48376;107734;54449;124353
310680;202210;955;2008;785;1770;20;71;656;1410;676;1481
310690;202210;3046;6478;2275;5364;220;534;1535;3375;1755;3909
310700;202210;649;1209;509;1043;11;27;427;842;438;869
310710;202210;7547;19511;5496;16390;1220;4148;959;2522;2179;6670
310720;202210;1389;2846;1101;2478;41;127;834;1793;875;1920
310730;202210;12612;29235;10738;26419;461;1421;8112;18944;8573;20365
310740;202210;8425;20813;6407;17030;769;2465;3260;7576;4029;10041
310750;202210;1644;3506;1256;2950;93;256;788;1665;881;1921
310760;202210;864;1967;620;1592;46;115;407;1013;453;1128
310770;202210;1304;3257;906;2636;128;433;431;1072;559;1505
310780;202210;5130;10628;4162;9315;274;644;3050;6722;3324;7366
310790;202210;2241;6486;1919;5836;419;1468;482;1191;901;2659
310800;202210;2787;7821;2025;6304;467;1632;137;356;604;1988
310810;202210;1804;3849;1501;3387;60;180;1160;2444;1220;2624
310820;202210;1382;3267;849;2394;162;466;229;619;391;1085
310825;202210;3233;8061;2565;7042;53;252;2125;5572;2178;5824
310830;202210;2570;6375;1952;5297;352;1073;956;2313;1308;3386
310840;202210;2724;6832;2055;5712;420;1316;705;1683;1125;2999
310850;202210;1602;4001;1307;3565;44;183;952;2458;996;2641
310855;202210;3975;9330;3138;8040;212;585;2298;5668;2510;6253
310860;202210;8255;21382;6700;18571;802;2014;4007;11240;4809;13254
310870;202210;1092;2449;861;2129;62;170;621;1477;683;1647
310880;202210;1075;2975;809;2402;95;295;463;1332;558;1627
310890;202210;2688;7190;1757;5335;353;1170;282;721;635;1891
310900;202210;5100;13141;3757;10451;691;2185;1632;3994;2323;6179
310910;202210;2632;6000;1845;4770;268;750;501;1158;769;1908
310920;202210;2300;5367;1738;4550;210;628;1103;2740;1313;3368
310925;202210;1335;3011;1059;2602;48;158;815;1873;863;2031
310930;202210;6642;15596;4638;12495;873;2432;2207;6086;3080;8518
310940;202210;8561;17409;6963;15223;256;722;5592;11668;5848;12390
310945;202210;1622;3767;1255;3171;148;417;758;1765;906;2182
310950;202210;2200;6121;1406;4349;235;829;396;983;631;1812
310960;202210;845;2148;499;1455;79;240;131;354;210;594
310970;202210;1384;3916;975;3067;246;793;185;541;431;1334
310980;202210;403;874;224;572;22;64;113;261;135;325
310990;202210;1826;4333;1484;3775;168;491;912;2108;1080;2599
311000;202210;5211;12829;3964;10815;652;2018;2210;5510;2862;7528
311010;202210;1214;2933;993;2561;222;595;517;1307;739;1902
311020;202210;1413;3303;936;2489;73;223;514;1277;587;1500
311030;202210;2247;5183;1627;4169;376;1095;686;1608;1062;2703
311040;202210;349;1009;268;834;74;255;63;176;137;431
311050;202210;3742;8583;2843;7239;427;1261;1444;3354;1871;4615
311060;202210;4318;10030;3217;8122;390;1137;1515;3378;1905;4515
311070;202210;3036;6729;2200;5492;303;949;1161;2574;1464;3523
311080;202210;1394;2804;1103;2377;38;118;870;1749;908;1867
311090;202210;2789;7939;2270;7017;487;1604;735;2210;1222;3814
311100;202210;2955;7720;1916;5727;371;1236;555;1390;926;2626
311110;202210;4555;8997;2439;5899;549;1293;534;1257;1083;2550
311115;202210;1758;3320;1473;2962;42;95;1279;2490;1321;2585
311120;202210;8715;21056;6658;17458;1014;2960;2786;6237;3800;9197
311130;202210;2267;5487;1742;4765;163;549;1025;2629;1188;3178
311140;202210;1887;4338;1468;3772;147;430;962;2403;1109;2833
311150;202210;1736;5097;1374;4410;185;672;733;2210;918;2882
311160;202210;4974;12932;3666;10633;636;2131;1577;4155;2213;6286
311170;202210;1109;2630;911;2376;57;167;574;1565;631;1732
311180;202210;1862;3822;1263;2969;187;434;709;1575;896;2009
311190;202210;1025;2705;761;2180;116;368;315;755;431;1123
311200;202210;2697;6639;2013;5372;358;1082;871;1939;1229;3021
311205;202210;1117;2917;900;2526;35;122;602;1574;637;1696
311210;202210;1257;3311;1110;3108;128;316;779;2270;907;2586
311220;202210;1055;2412;915;2170;28;100;713;1540;741;1640
311230;202210;9497;26070;7116;21309;1330;4095;2687;7985;4017;12080
311240;202210;1354;3116;1064;2713;163;493;597;1384;760;1877
311250;202210;1605;4073;1240;3449;237;710;488;1224;725;1934
311260;202210;3210;7322;2105;5482;266;791;1050;2359;1316;3150
311265;202210;1666;3613;1202;2904;47;142;920;2108;967;2250
311270;202210;3640;9697;3121;8887;192;753;2183;5887;2375;6640
311280;202210;1417;3530;834;2418;196;617;199;496;395;1113
311290;202210;2145;6010;1923;5583;117;376;1298;3687;1415;4063
311300;202210;5449;13357;4494;11807;194;639;3662;9350;3856;9989
311310;202210;668;1692;559;1506;44;116;357;916;401;1032
311320;202210;3784;10533;3278;9446;300;1032;1747;4491;2047;5523
311330;202210;7634;16594;5977;14116;574;1467;3315;7741;3889;9208
311340;202210;13183;33438;10422;28704;2248;6621;3435;8802;5683;15423
311350;202210;2807;6341;2033;5003;240;655;1011;2158;1251;2813
311360;202210;1371;3056;983;2524;253;708;428;1075;681;1783
311370;202210;5680;12660;4156;10281;485;1403;2358;5374;2843;6777
311380;202210;472;1351;351;1112;56;183;178;550;234;733
311390;202210;2083;5834;1667;5275;703;2453;399;1069;1102;3522
311400;202210;1969;4905;1408;3885;238;705;447;978;685;1683
311410;202210;2301;6203;1843;5449;282;953;940;2610;1222;3563
311420;202210;1968;5235;1467;4329;298;952;487;1196;785;2148
311430;202210;5529;13388;3713;9968;531;1513;1568;3911;2099;5424
311440;202210;3711;9421;2881;8087;888;2825;612;1482;1500;4307
311450;202210;2880;7797;1829;5608;468;1622;403;957;871;2579
311455;202210;1306;2737;923;2194;97;239;567;1292;664;1531
311460;202210;718;1993;465;1449;90;322;106;260;196;582
311470;202210;597;1703;404;1293;97;363;61;173;158;536
311480;202210;1366;2892;1127;2546;78;188;900;1990;978;2178
311490;202210;324;898;249;752;42;153;112;292;154;445
311500;202210;592;1352;468;1171;47;141;290;678;337;819
311510;202210;4238;9630;3037;7697;334;977;1607;3615;1941;4592
311520;202210;786;1948;681;1758;58;179;433;1090;491;1269
311530;202210;11291;24096;7870;18924;1658;4603;2918;6245;4576;10848
311535;202210;1070;2654;764;2041;118;344;366;911;484;1255
311540;202210;637;1720;552;1574;72;226;393;1092;465;1318
311545;202210;2349;6098;2027;5607;98;303;1575;4291;1673;4594
311547;202210;2162;4202;1893;3836;38;79;1645;3218;1683;3297
311550;202210;3636;8942;2978;7836;436;1306;1376;3224;1812;4530
311560;202210;365;723;223;503;34;84;92;175;126;259
311570;202210;1744;3803;1217;3082;50;138;893;2304;943;2442
311580;202210;2745;4842;1933;3875;172;326;1359;2625;1531;2951
311590;202210;746;1756;623;1585;67;200;409;991;476;1191
311600;202210;1847;4113;1489;3632;180;525;1035;2413;1215;2938
311610;202210;2768;7497;2204;6489;165;556;1408;3948;1573;4504
311615;202210;4379;10139;3530;8806;134;441;2860;6844;2994;7285
311620;202210;691;1716;524;1440;67;200;308;798;375;998
311630;202210;1536;3924;1223;3289;104;303;746;1957;850;2260
311640;202210;937;2267;742;1961;104;304;417;1011;521;1315
311650;202210;2260;5076;1814;4415;216;552;1106;2545;1322;3097
311660;202210;3728;9806;2732;7874;390;1282;812;1780;1202;3062
311670;202210;1954;4469;1454;3625;150;438;763;1791;913;2229
311680;202210;2750;6624;2116;5575;171;397;1455;3908;1626;4305
311690;202210;746;1420;543;1169;36;84;382;824;418;908
311700;202210;2440;5339;1866;4515;28;108;1559;3618;1587;3726
311710;202210;1854;4976;1372;4169;345;1143;463;1349;808;2492
311720;202210;509;1397;415;1224;48;164;234;666;282;830
311730;202210;5479;12493;3900;9644;842;2335;1840;4033;2682;6368
311740;202210;1167;2812;953;2509;74;148;740;1992;814;2140
311750;202210;4826;12854;3890;11215;318;1141;2589;6913;2907;8054
311760;202210;870;2207;675;1843;101;354;287;584;388;938
311770;202210;2665;6909;2083;5904;445;1370;811;2081;1256;3451
311780;202210;1812;4668;1350;3842;260;796;492;1222;752;2018
311783;202210;2820;6494;2308;5699;50;202;1909;4483;1959;4685
311787;202210;957;2551;730;2069;126;398;288;677;414;1075
311790;202210;1844;4788;1259;3700;249;854;372;934;621;1788
311800;202210;6019;16553;4724;13847;1010;3035;844;1944;1854;4979
311810;202210;1217;3027;996;2657;57;185;748;1873;805;2058
311820;202210;1162;2471;893;2081;72;181;618;1348;690;1529
311830;202210;10671;27898;7748;21926;2169;6441;1519;4035;3688;10476
311840;202210;4706;10530;3763;9222;284;744;2750;6696;3034;7440
311850;202210;421;976;331;824;13;49;238;549;251;598
311860;202210;91495;204102;72670;173038;7617;20970;46922;103050;54539;124020
311870;202210;2225;5472;1567;4362;263;875;691;1688;954;2563
311880;202210;7589;17713;6303;15932;450;1089;4633;11780;5083;12869
311890;202210;2309;4650;1842;4020;46;159;1498;3043;1544;3202
311900;202210;804;1861;604;1599;107;254;316;853;423;1107
311910;202210;5219;11873;4066;10357;694;1878;2218;5421;2912;7299
311920;202210;2694;6041;2170;5299;133;303;1528;3683;1661;3986
311930;202210;5861;11735;4483;9929;743;1966;2604;5079;3347;7045
311940;202210;19032;45715;13738;36088;1869;5359;6264;14958;8133;20317
311950;202210;2839;6717;2101;5445;178;527;1277;3258;1455;3785
311960;202210;583;1363;453;1163;54;163;220;495;274;658
311970;202210;497;1495;373;1199;75;273;95;252;170;525
311980;202210;546;1366;292;871;32;102;117;312;149;414
311990;202210;630;1416;410;1082;63;216;179;387;242;603
311995;202210;1125;3017;595;1823;38;134;92;179;130;313
312000;202210;972;2046;739;1719;32;86;557;1253;589;1339
312010;202210;1334;3066;1072;2679;71;189;759;1812;830;2001
312015;202210;1561;4022;1369;3717;56;242;1108;2886;1164;3128
312020;202210;2144;5989;1480;4498;269;894;349;894;618;1788
312030;202210;2653;5227;2261;4782;64;178;2059;4268;2123;4446
312040;202210;1001;2722;712;2154;115;345;316;894;431;1239
312050;202210;1421;4018;1153;3531;218;829;421;1124;639;1953
312060;202210;1178;2667;746;2075;168;494;302;806;470;1300
312070;202210;1083;2831;755;2149;37;141;480;1240;517;1381
312080;202210;3502;7812;2733;6688;148;419;1887;4224;2035;4643
312083;202210;1334;2777;1043;2358;58;181;839;1786;897;1967
312087;202210;3071;6804;2494;5961;87;227;2021;4752;2108;4979
312090;202210;14044;32814;11119;28256;1155;3546;6750;15750;7905;19296
312100;202210;2002;4973;1549;4217;121;398;965;2403;1086;2801
312110;202210;1167;3361;957;2924;164;613;450;1225;614;1838
312120;202210;1239;3177;853;2500;214;734;275;660;489;1394
312125;202210;2399;5311;2057;4847;97;277;1687;3816;1784;4093
312130;202210;1429;3054;1060;2464;75;227;635;1273;710;1500
312140;202210;895;2397;735;2083;170;514;321;826;491;1340
312150;202210;620;1482;528;1319;33;91;369;847;402;938
312160;202210;11742;27779;9097;23353;947;2883;4989;11538;5936;14421
312170;202210;1063;2461;813;2010;49;140;553;1303;602;1443
312180;202210;1677;4006;1362;3470;148;429;812;1926;960;2355
312190;202210;985;2368;773;2009;66;222;462;1069;528;1291
312200;202210;5755;13934;4491;11953;515;1408;2749;7031;3264;8439
312210;202210;1742;3319;1330;2765;45;116;1102;2197;1147;2313
312220;202210;2001;5466;1710;4955;179;549;1112;3215;1291;3764
312230;202210;23895;55066;17326;43804;3378;9745;6268;13003;9646;22748
312235;202210;2628;5511;2138;4850;127;343;1663;3569;1790;3912
312240;202210;947;2771;728;2333;148;495;221;673;369;1168
312245;202210;4014;7474;3441;6688;39;98;3187;6045;3226;6143
312247;202210;1270;2649;886;2081;111;277;551;1218;662;1495
312250;202210;1096;2712;692;1947;91;277;252;656;343;933
312260;202210;1228;2875;992;2513;61;202;777;1858;838;2060
312270;202210;879;2218;674;1808;31;110;411;976;442;1086
312280;202210;506;1391;407;1220;89;298;147;391;236;689
312290;202210;1136;2978;951;2685;155;494;369;939;524;1433
312300;202210;1348;3717;980;2864;221;713;236;540;457;1253
312310;202210;1211;3292;934;2724;125;444;478;1282;603;1726
312320;202210;2522;5885;1833;4727;385;976;537;1302;922;2278
312330;202210;1097;2841;897;2474;111;342;535;1395;646;1737
312340;202210;299;703;214;573;31;108;119;272;150;380
312350;202210;302;578;217;483;14;36;147;291;161;327
312352;202210;1791;5131;1571;4722;285;917;742;2383;1027;3300
312360;202210;4093;10604;3099;8802;640;1958;1265;3236;1905;5194
312370;202210;2510;5747;2014;4997;232;668;1267;2938;1499;3606
312380;202210;2624;5302;2167;4726;18;46;1886;3978;1904;4024
312385;202210;1516;3713;1179;3137;381;1040;299;834;680;1874
312390;202210;2258;5889;1698;4840;256;807;516;1254;772;2061
312400;202210;3678;9652;3118;8764;980;2970;806;2282;1786;5252
312410;202210;18096;42622;14947;37701;1783;4877;9773;23416;11556;28293
312420;202210;4842;11747;3925;10295;749;2238;1970;4834;2719;7072
312430;202210;10979;23892;9041;20710;282;849;7101;15351;7383;16200
312440;202210;1237;3577;1034;3178;505;1632;200;583;705;2215
312450;202210;1628;4355;1247;3674;325;1035;487;1406;812;2441
312460;202210;594;1304;433;1076;25;68;291;695;316;763
312470;202210;549;1286;336;922;49;141;100;229;149;370
312480;202210;1278;2944;925;2424;85;262;515;1249;600;1511
312490;202210;3160;6335;2511;5452;206;503;1589;3246;1795;3749
312500;202210;1308;2781;1103;2512;43;135;873;1927;916;2062
312510;202210;5951;14580;4023;10953;803;2171;1153;2885;1956;5056
312520;202210;443;1008;349;867;62;186;215;499;277;685
312530;202210;831;1734;697;1575;38;94;529;1188;567;1282
312540;202210;1865;4648;1270;3525;152;407;694;1836;846;2243
312550;202210;981;2287;718;1807;39;108;461;1048;500;1156
312560;202210;2147;5158;1647;4379;107;315;1164;3031;1271;3346
312570;202210;3235;6867;2437;5872;411;975;1264;3049;1675;4024
312580;202210;768;1927;521;1427;46;151;266;654;312;805
312590;202210;1821;4787;1400;3967;152;517;817;2103;969;2620
312595;202210;2539;6557;2083;5862;294;765;1189;3579;1483;4344
312600;202210;1625;3685;1060;2542;148;447;358;821;506;1268
312610;202210;8561;20325;5835;15404;905;2704;2112;4743;3017;7447
312620;202210;3007;6781;2302;5806;60;249;1897;4688;1957;4937
312630;202210;394;1020;289;838;48;178;134;335;182;513
312640;202210;638;1642;472;1371;58;201;234;614;292;815
312650;202210;2491;5568;1732;4219;51;174;1316;2948;1367;3122
312660;202210;1586;3461;1224;2876;91;223;860;1899;951;2122
312670;202210;7380;15448;6216;13694;129;537;5133;10464;5262;11001
312675;202210;1443;3341;1181;2972;55;163;956;2338;1011;2501
312680;202210;1914;4213;1719;3935;39;148;1555;3441;1594;3589
312690;202210;3574;6781;2699;5699;113;235;2164;4481;2277;4716
312695;202210;1235;2870;1038;2560;48;89;860;2093;908;2182
312700;202210;2443;6115;1759;4909;183;584;963;2511;1146;3095
312705;202210;2014;3780;1762;3445;13;46;1670;3224;1683;3270
312707;202210;1621;4177;1137;3320;52;222;760;2039;812;2261
312710;202210;9003;19486;5861;14711;1492;3726;1821;4658;3313;8384
312720;202210;1326;3175;1038;2733;101;309;698;1711;799;2020
312730;202210;1881;4151;1357;3448;120;311;863;2121;983;2432
312733;202210;1546;3838;1157;3131;49;177;786;1957;835;2134
312735;202210;940;2222;722;1820;53;150;482;1113;535;1263
312737;202210;994;1992;717;1608;72;173;498;1070;570;1243
312738;202210;970;2207;696;1745;68;204;449;1016;517;1220
312740;202210;529;1296;333;963;68;207;88;187;156;394
312750;202210;1749;4556;1265;3673;160;545;603;1596;763;2141
312760;202210;2188;5936;1589;4750;237;739;628;1742;865;2481
312770;202210;55163;123726;35891;91292;6049;17178;14673;34191;20722;51369
312780;202210;3147;8043;2643;7219;323;891;1639;4391;1962;5282
312790;202210;279;634;139;399;3;10;33;55;36;65
312800;202210;6912;16871;5499;14357;561;1803;3354;7992;3915;9795
312810;202210;1953;4927;1285;3813;362;1168;398;1053;760;2221
312820;202210;2100;5047;1683;4350;107;286;1202;3045;1309;3331
312825;202210;1861;3579;1569;3209;37;84;1361;2727;1398;2811
312830;202210;3299;8540;2169;6353;494;1550;693;1804;1187;3354
312840;202210;1763;4162;1368;3523;141;425;740;1745;881;2170
312850;202210;1359;2643;1018;2177;21;78;759;1438;780;1516
312860;202210;1275;3075;877;2455;221;662;277;673;498;1335
312870;202210;7112;17931;4557;13143;772;2357;1354;3486;2126;5843
312880;202210;1809;4073;1423;3460;228;495;704;1719;932;2214
312890;202210;2807;6189;2069;5024;139;338;1243;2853;1382;3191
312900;202210;1575;3655;1286;3273;159;435;771;1959;930;2394
312910;202210;1766;3115;1055;2204;152;306;585;1180;737;1486
312920;202210;1113;2804;787;2285;126;432;286;692;412;1124
312930;202210;2914;6453;2136;5316;364;948;1068;2655;1432;3603
312940;202210;1196;2956;942;2598;94;307;512;1305;606;1612
312950;202210;4069;8923;2929;7195;428;1245;1640;3630;2068;4875
312960;202210;2068;4959;1711;4428;107;243;1232;3292;1339;3535
312965;202210;1996;4825;1611;4227;158;397;1046;2744;1204;3141
312970;202210;1905;4835;1531;4268;147;524;922;2356;1069;2880
312980;202210;31477;78892;25409;68218;4712;13435;11658;29174;16370;42609
312990;202210;630;1447;426;1114;74;229;209;487;283;716
313000;202210;569;1490;432;1246;30;131;270;700;300;831
313005;202210;2926;7651;2428;6844;120;360;1765;4793;1885;5153
313010;202210;7071;17306;5696;15096;866;2597;3469;8692;4335;11289
313020;202210;1221;3474;931;2878;172;577;197;511;369;1088
313030;202210;1451;3003;1026;2413;66;195;751;1654;817;1849
313040;202210;1040;2892;866;2565;33;142;555;1549;588;1691
313050;202210;2177;5530;1524;4545;249;840;439;1128;688;1968
313055;202210;2262;5473;1938;4976;588;1685;1033;2488;1621;4173
313060;202210;1276;2894;933;2306;203;598;228;502;431;1100
313065;202210;2031;5072;1786;4672;34;140;1518;3827;1552;3967
313070;202210;1056;2628;822;2241;91;266;423;1082;514;1348
313080;202210;465;1193;342;977;60;207;138;319;198;526
313090;202210;6654;15329;5520;13570;271;764;3977;9475;4248;10239
313100;202210;1596;3779;1265;3309;58;207;920;2288;978;2495
313110;202210;1811;4419;1290;3503;120;378;686;1669;806;2047
313115;202210;3530;8958;2808;7625;281;923;1663;4028;1944;4951
313120;202210;4450;9877;3239;8264;204;537;2225;5653;2429;6190
313130;202210;39519;92562;30046;76028;2986;8708;17875;41536;20861;50244
313140;202210;938;1815;640;1441;33;92;495;1081;528;1173
313150;202210;1676;4427;1213;3596;338;1143;205;487;543;1630
313160;202210;1703;3826;1304;3237;24;73;1007;2377;1031;2450
313170;202210;13988;36400;10446;29753;1709;5303;4154;10457;5863;15760
313180;202210;3053;7164;2302;5678;165;446;1588;3705;1753;4151
313190;202210;5536;14382;4097;11590;708;2217;1680;4181;2388;6398
313200;202210;1383;3235;1168;2867;32;98;959;2260;991;2358
313210;202210;5000;11978;4135;10639;453;1288;2703;6580;3156;7868
313220;202210;2327;5624;1537;4108;200;599;732;1669;932;2268
313230;202210;3398;8324;2748;7502;62;211;2254;6131;2316;6342
313240;202210;13830;30869;9860;24751;988;3099;5790;13097;6778;16196
313250;202210;7463;20023;5715;16394;1071;3234;2643;7083;3714;10317
313260;202210;961;2185;686;1760;74;264;399;864;473;1128
313270;202210;8506;16544;7186;14839;462;942;5949;12151;6411;13093
313280;202210;551;1381;369;1034;47;156;173;450;220;606
313290;202210;1214;3623;940;3122;242;908;317;990;559;1898
313300;202210;2236;5579;1694;4642;370;1074;591;1447;961;2521
313310;202210;1779;4830;1422;4094;234;760;488;1111;722;1871
313320;202210;2404;5909;1736;4851;373;1117;613;1726;986;2843
313330;202210;5077;11714;3834;9903;276;813;2537;6385;2813;7198
313340;202210;2035;4128;1581;3513;100;263;1187;2524;1287;2787
313350;202210;3584;9122;2433;6687;272;880;1128;2615;1400;3495
313360;202210;2045;4561;1405;3551;234;707;745;1659;979;2366
313370;202210;1972;4937;1517;4074;306;868;604;1431;910;2299
313375;202210;2267;5567;1467;4117;268;871;426;1012;694;1883
313380;202210;8480;19545;6169;15415;909;2668;3152;6793;4061;9461
313390;202210;950;2681;810;2432;54;221;546;1549;600;1770
313400;202210;4529;9946;3449;8388;151;439;2628;6153;2779;6592
313410;202210;1704;3994;1273;3275;360;894;630;1587;990;2481
313420;202210;19013;40113;10790;26828;2562;7130;2689;5894;5251;13024
313430;202210;1509;3427;1270;3004;72;275;974;2072;1046;2347
313440;202210;8807;16549;6463;13680;197;522;5154;10439;5351;10961
313450;202210;879;2180;627;1722;103;311;226;507;329;818
313460;202210;2836;7314;2271;6406;403;1262;1080;2925;1483;4187
313470;202210;3373;7679;2705;6717;146;410;2093;5085;2239;5495
313480;202210;1345;3566;839;2499;84;285;355;921;439;1206
313490;202210;3772;9009;2096;5970;385;1206;606;1561;991;2767
313500;202210;676;1607;463;1211;59;149;214;510;273;659
313505;202210;12716;29169;10836;26604;467;1208;8732;21077;9199;22285
313507;202210;1664;3840;1314;3309;49;153;1016;2455;1065;2608
313510;202210;18699;44627;14674;37167;1342;3700;8553;19710;9895;23410
313520;202210;19101;44795;15494;39004;686;2130;12099;29104;12785;31234
313530;202210;696;1931;513;1543;70;254;223;569;293;823
313535;202210;2746;7028;2181;5962;247;648;1318;3519;1565;4167
313540;202210;1042;2738;810;2220;111;347;386;914;497;1261
313545;202210;1341;4021;1123;3616;161;539;548;1703;709;2242
313550;202210;2498;6522;2066;5571;237;680;1372;3601;1609;4281
313560;202210;3730;5992;2839;4954;40;70;2547;4370;2587;4440
313570;202210;1201;3144;960;2728;182;543;461;1212;643;1755
313580;202210;7530;16067;5979;13646;348;970;4358;9350;4706;10320
313590;202210;1373;3332;1105;2958;226;625;575;1591;801;2216
313600;202210;5484;11585;4676;10406;82;286;4224;9097;4306;9383
313610;202210;1208;2784;989;2413;81;230;654;1465;735;1695
313620;202210;6901;16795;5617;14560;531;1673;3672;8963;4203;10636
313630;202210;10926;24395;7896;19915;789;2381;4869;11587;5658;13968
313640;202210;1611;3010;1102;2365;89;219;808;1680;897;1899
313650;202210;1958;5443;1524;4708;130;436;926;2872;1056;3308
313652;202210;1076;2713;948;2492;66;217;707;1747;773;1964
313655;202210;1440;3124;1122;2727;81;201;837;1993;918;2194
313657;202210;1351;3226;1048;2742;34;135;769;1845;803;1980
313660;202210;1410;3282;1173;2907;72;266;896;2044;968;2310
313665;202210;6975;16357;5546;13898;442;1341;3746;8652;4188;9993
313670;202210;68199;154228;47180;119666;6064;16984;24375;57056;30439;74040
313680;202210;1292;3004;1041;2612;48;118;704;1668;752;1786
313690;202210;1177;3277;852;2636;162;559;224;624;386;1183
313695;202210;2157;5208;1595;4294;115;295;1055;2892;1170;3187
313700;202210;3413;9548;2944;8955;233;735;2348;7172;2581;7907
313710;202210;1748;3649;1250;3004;98;274;835;1942;933;2216
313720;202210;7666;19296;5598;15179;739;2250;2690;6425;3429;8675
313730;202210;1708;3303;1281;2755;84;161;852;1804;936;1965
313740;202210;1974;6633;1657;5869;364;1461;428;1312;792;2773
313750;202210;2844;6596;2293;5714;339;990;1372;3085;1711;4075
313753;202210;2533;5820;1689;4470;305;900;667;1657;972;2557
313760;202210;7286;18484;5788;15751;866;2687;2935;7161;3801;9848
313770;202210;4851;12530;3850;10978;191;524;2928;8459;3119;8983
313780;202210;4870;11652;3603;9702;500;1338;1250;3301;1750;4639
313790;202210;703;1844;595;1635;71;226;369;949;440;1175
313800;202210;1648;3413;1200;2791;112;304;710;1508;822;1812
313810;202210;2189;4662;1767;4071;71;232;1429;3134;1500;3366
313820;202210;21036;50312;13921;35862;2286;6173;4313;10006;6599;16179
313830;202210;477;1296;352;1040;70;238;144;385;214;623
313835;202210;1148;2879;863;2426;84;289;457;1147;541;1436
313840;202210;9804;23378;7759;20194;1794;4899;2225;5579;4019;10478
313850;202210;1207;2635;961;2298;161;418;515;1117;676;1535
313860;202210;3442;8183;2613;6753;353;999;1338;3111;1691;4110
313862;202210;1441;2972;759;1972;48;136;386;972;434;1108
313865;202210;3163;7329;2608;6480;83;253;2022;4784;2105;5037
313867;202210;1660;4671;1319;4010;261;827;670;2099;931;2926
313868;202210;2022;5502;1632;4797;56;215;1228;3432;1284;3647
313870;202210;1294;3042;866;2286;108;308;391;910;499;1218
313880;202210;2660;6237;2029;5180;255;797;1131;2484;1386;3281
313890;202210;2950;5242;2172;4258;70;144;1711;3237;1781;3381
313900;202210;6412;16499;4510;12757;1119;3376;1356;3261;2475;6637
313910;202210;911;2483;694;2065;140;429;170;493;310;922
313920;202210;3397;9148;2792;7979;479;1435;1460;4123;1939;5558
313925;202210;2015;4545;1556;3766;194;426;964;2271;1158;2697
313930;202210;6135;15158;4907;13126;409;1079;3275;8680;3684;9759
313940;202210;12231;32719;9402;28043;1948;6280;2313;7347;4261;13627
313950;202210;6878;13350;5340;11452;260;619;3958;8260;4218;8879
313960;202210;7074;15562;4775;11813;714;2063;2083;4460;2797;6523
313970;202210;1931;4525;1633;4051;54;145;1125;2625;1179;2770
313980;202210;1770;4244;1248;3462;225;690;549;1408;774;2098
313990;202210;2589;6924;2017;5786;304;1078;1181;2931;1485;4009
314000;202210;12950;29364;10345;25027;711;2112;6783;15804;7494;17916
314010;202210;1648;3573;1290;3086;56;180;972;2201;1028;2381
314015;202210;2860;7015;2276;6010;242;779;1393;3321;1635;4100
314020;202210;606;1519;402;1177;145;509;35;91;180;600
314030;202210;987;2562;744;2104;105;302;330;901;435;1203
314040;202210;769;1953;645;1736;88;288;359;902;447;1190
314050;202210;2401;5677;1794;4622;103;332;1164;2719;1267;3051
314053;202210;2491;6442;1997;5528;300;774;1190;3382;1490;4156
314055;202210;2802;6228;2345;5591;86;232;1927;4585;2013;4817
314060;202210;1548;3724;1149;3089;43;137;817;2129;860;2266
314070;202210;6141;14812;4966;12804;700;1914;2793;6784;3493;8698
314080;202210;2392;5807;1730;4711;151;485;844;2030;995;2515
314085;202210;2873;6882;2285;6033;230;652;1483;3861;1713;4513
314090;202210;6116;14352;5231;13105;467;1181;3425;8737;3892;9918
314100;202210;3611;8039;2775;6889;78;199;2044;5033;2122;5232
314110;202210;6092;15552;4968;13504;585;1767;2716;6676;3301;8443
314120;202210;828;1826;397;1070;76;238;147;348;223;586
314130;202210;826;1973;584;1532;24;89;400;970;424;1059
314140;202210;5601;13694;4435;11632;455;1312;2561;6358;3016;7670
314150;202210;1717;4002;1228;3173;107;307;786;1957;893;2264
314160;202210;2866;6576;2041;5210;208;545;925;2276;1133;2821
314170;202210;1146;2819;901;2355;40;149;629;1482;669;1631
314180;202210;6703;16415;5244;14142;574;1560;2820;7514;3394;9074
314190;202210;754;1716;566;1448;69;226;341;782;410;1008
314200;202210;3576;9051;2949;8043;278;731;1903;5094;2181;5825
314210;202210;2365;5695;1820;4731;289;776;672;1618;961;2394
314220;202210;2014;5004;1605;4369;242;771;755;1855;997;2626
314225;202210;1258;3339;990;2840;103;324;627;1717;730;2041
314230;202210;1062;2518;850;2221;87;255;547;1379;634;1634
314240;202210;1297;3266;1013;2852;224;651;420;1165;644;1816
314250;202210;503;1369;319;967;41;132;131;349;172;481
314260;202210;1339;3156;1057;2784;314;832;403;997;717;1829
314270;202210;4007;9868;3306;8762;93;294;2546;6559;2639;6853
314280;202210;4318;9322;3002;7418;309;871;1807;4130;2116;5001
314290;202210;5558;12663;4678;11192;247;663;3492;7968;3739;8631
314300;202210;2401;6304;1543;4504;335;1055;481;1206;816;2261
314310;202210;4612;11455;3193;9076;888;2829;472;1128;1360;3957
314315;202210;1190;3329;951;2849;66;250;652;1844;718;2094
314320;202210;4011;9826;2722;7457;418;1367;1168;2815;1586;4182
314330;202210;67286;174755;51589;147385;12159;35600;14554;40343;26713;75943
314340;202210;3177;7428;2131;5615;394;1256;809;1721;1203;2977
314345;202210;1958;4744;1585;4111;119;304;1147;2854;1266;3158
314350;202210;1085;2791;721;2112;131;413;153;316;284;729
314360;202210;638;1725;433;1294;60;183;137;360;197;543
314370;202210;904;2105;729;1845;72;195;492;1184;564;1379
314380;202210;1481;3717;1047;2981;233;756;338;882;571;1638
314390;202210;18973;43018;13417;33716;1860;5386;6013;12923;7873;18309
314400;202210;4758;13213;3661;11115;1157;3722;1161;3641;2318;7363
314410;202210;3576;9413;2469;7273;512;1720;568;1545;1080;3265
314420;202210;923;2092;674;1712;25;88;445;1059;470;1147
314430;202210;9733;21158;6972;16835;971;2447;3480;7915;4451;10362
314435;202210;2233;5487;1748;4735;281;787;950;2428;1231;3215
314437;202210;1079;2455;793;2005;71;196;502;1209;573;1405
314440;202210;712;1930;513;1543;131;449;142;344;273;793
314450;202210;1781;4260;1454;3721;187;535;819;1891;1006;2426
314460;202210;4162;11423;3167;9454;751;2453;1161;3028;1912;5481
314465;202210;2795;7007;2244;5999;47;185;1759;4452;1806;4637
314467;202210;1180;2734;960;2382;103;291;639;1526;742;1817
314470;202210;2751;7144;2274;6254;388;1148;1093;2762;1481;3910
314480;202210;10485;26446;7950;21379;1170;3512;3669;8666;4839;12178
314490;202210;1267;3004;911;2340;75;222;593;1448;668;1670
314500;202210;2263;5009;1601;4123;412;1052;471;1219;883;2271
314505;202210;2789;5564;2280;4881;145;270;1773;3699;1918;3969
314510;202210;2542;6235;1851;5227;504;1627;678;1764;1182;3391
314520;202210;8809;24186;7001;20724;1504;4749;1715;4569;3219;9318
314530;202210;6710;18101;5943;16767;330;1183;4496;12160;4826;13343
314535;202210;3472;7481;2794;6513;153;395;2240;5123;2393;5518
314537;202210;1460;3695;1103;3123;77;206;751;2059;828;2265
314540;202210;506;1160;365;942;17;54;215;498;232;552
314545;202210;2316;4839;2052;4532;67;177;1680;3731;1747;3908
314550;202210;898;2003;597;1509;45;145;331;734;376;879
314560;202210;5869;15613;4425;12628;579;1986;2047;4986;2626;6972
314570;202210;375;978;270;790;26;81;136;393;162;474
314580;202210;578;1566;454;1320;100;299;162;453;262;752
314585;202210;869;2377;659;1942;58;206;326;877;384;1083
314587;202210;2695;6566;2102;5644;566;1486;1063;2831;1629;4317
314590;202210;5344;13094;4108;10967;497;1510;2102;5102;2599;6612
314600;202210;2171;5610;1403;4193;316;1048;185;479;501;1527
314610;202210;11645;26846;8993;22740;1038;3168;4520;11291;5558;14459
314620;202210;3052;6034;2458;5300;158;270;1944;4270;2102;4540
314625;202210;1924;4370;1631;3970;36;165;1399;3277;1435;3442
314630;202210;6092;13893;4876;12227;186;543;3893;9604;4079;10147
314640;202210;1020;1997;790;1652;37;106;606;1157;643;1263
314650;202210;1021;2228;679;1694;63;200;413;909;476;1109
314655;202210;1779;4466;1245;3562;160;453;674;1900;834;2353
314660;202210;429;845;322;680;13;30;245;482;258;512
314670;202210;1946;3983;1354;3172;31;86;962;2137;993;2223
314675;202210;2028;4674;1715;4185;97;241;1338;3194;1435;3435
314690;202210;2463;6223;1880;5344;481;1397;747;2034;1228;3431
314700;202210;14239;35624;9881;27859;1572;4892;4520;11731;6092;16623
314710;202210;10209;26481;7557;21098;1133;3483;3031;7304;4164;10787
314720;202210;2816;7806;1959;6032;376;1264;396;1021;772;2285
314730;202210;3000;7315;2094;5688;387;1181;725;1708;1112;2889
314740;202210;3895;9891;3076;8490;502;1518;1606;4103;2108;5621
314750;202210;361;869;283;716;27;94;171;366;198;460
314760;202210;2194;6018;1412;4306;219;810;422;959;641;1769
314770;202210;1203;3316;705;2148;121;364;185;511;306;875
314780;202210;430;1002;301;794;29;98;178;427;207;525
314790;202210;14527;35724;10442;28457;1741;5296;4540;11546;6281;16842
314795;202210;1799;4208;1517;3755;61;191;1187;2791;1248;2982
314800;202210;14105;33776;9518;25630;1613;4750;3495;8174;5108;12924
314810;202210;12855;30886;9725;25737;2396;6743;3760;9221;6156;15964
314820;202210;1542;3419;1205;2921;77;238;786;1799;863;2037
314830;202210;2112;5338;1734;4705;156;431;1081;2762;1237;3193
314840;202210;1056;2913;819;2484;75;296;560;1575;635;1871
314850;202210;3285;5675;2716;4994;32;74;2522;4558;2554;4632
314860;202210;4047;10147;3371;8994;142;508;2513;6415;2655;6923
314870;202210;8487;16727;6563;14422;297;625;5025;11148;5322;11773
314875;202210;2183;5949;1914;5569;201;508;1421;4186;1622;4694
314880;202210;939;2153;717;1810;44;127;451;1086;495;1213
314890;202210;605;1693;446;1349;61;211;216;568;277;779
314900;202210;1079;2406;827;2007;91;256;460;1040;551;1296
314910;202210;2015;5333;1500;4491;273;991;682;1827;955;2818
314915;202210;2511;6672;2031;5851;198;573;1273;3636;1471;4209
314920;202210;696;1570;500;1299;23;69;363;929;386;998
314930;202210;7608;19436;5915;16311;960;3008;2735;6657;3695;9665
314940;202210;503;1077;414;940;25;64;295;633;320;697
314950;202210;801;1842;556;1454;57;197;305;713;362;910
314960;202210;1159;2469;909;2075;72;164;629;1395;701;1559
314970;202210;1327;3653;1025;3065;176;586;448;1213;624;1799
314980;202210;2437;5622;1953;4927;190;532;1355;3330;1545;3862
314990;202210;3269;8825;2366;6861;384;1155;668;1682;1052;2837
314995;202210;2022;5083;1576;4303;56;202;1024;2594;1080;2796
315000;202210;1324;3071;949;2490;86;250;613;1541;699;1791
315010;202210;491;1204;398;1065;37;130;252;620;289;750
315015;202210;3036;7459;2650;6851;250;796;1888;4629;2138;5425
315020;202210;943;2522;668;1984;62;228;327;874;389;1102
315030;202210;808;1921;556;1489;187;471;129;315;316;786
315040;202210;1186;2828;993;2531;160;461;638;1498;798;1959
315050;202210;1398;3315;1031;2761;81;247;529;1342;610;1589
315053;202210;1484;3418;1094;2760;108;303;649;1538;757;1841
315057;202210;2181;5635;1721;4868;145;344;1109;3332;1254;3676
315060;202210;832;2298;604;1832;116;384;162;452;278;836
315070;202210;1040;2078;813;1751;81;225;579;1102;660;1327
315080;202210;3988;9564;3025;7864;138;420;2205;5422;2343;5842
315090;202210;989;2684;749;2262;97;325;350;958;447;1283
315100;202210;1716;4644;1142;3412;147;505;495;1291;642;1796
315110;202210;2722;5816;1982;4737;152;349;1164;2703;1316;3052
315120;202210;15573;32902;11447;26827;1187;2756;6924;15869;8111;18625
315130;202210;2130;5289;1817;4765;200;608;953;2235;1153;2843
315140;202210;3881;9731;3110;8410;586;1748;1661;4168;2247;5916
315150;202210;5384;12681;3892;10274;618;1839;1831;4602;2449;6441
315160;202210;2388;5261;1668;4149;248;648;927;2194;1175;2842
315170;202210;1699;5025;1191;3824;229;775;347;1048;576;1823
315180;202210;21569;49705;12787;34034;1749;5315;4892;11113;6641;16428
315190;202210;2727;5523;2076;4671;198;435;1547;3485;1745;3920
315200;202210;5631;13988;4257;11751;1176;3556;1517;3709;2693;7265
315210;202210;10676;25695;7588;19634;776;2258;3828;8601;4604;10859
315213;202210;1251;3066;1088;2835;24;95;895;2256;919;2351
315217;202210;3248;8393;2440;7058;96;409;1722;4708;1818;5117
315220;202210;10248;25557;7984;21801;650;1602;4495;12348;5145;13950
315230;202210;3636;7270;2988;6425;194;352;2103;4545;2297;4897
315240;202210;3021;7825;2478;6909;567;1671;1144;3101;1711;4772
315250;202210;18200;44906;13663;36624;2045;6093;6396;15452;8441;21545
315260;202210;1163;2921;693;1986;140;409;112;249;252;658
315270;202210;1155;3021;869;2491;124;425;393;941;517;1366
315280;202210;3848;9032;2563;6775;693;1913;656;1651;1349;3564
315290;202210;1453;3327;921;2507;202;602;366;910;568;1512
315300;202210;806;1815;593;1503;32;94;427;1052;459;1146
315310;202210;1580;3573;1197;2948;78;252;832;1838;910;2090
315320;202210;768;2088;542;1641;77;266;212;591;289;857
315330;202210;880;2621;527;1753;64;241;219;625;283;866
315340;202210;3426;7840;2365;6235;546;1446;942;2401;1488;3847
315350;202210;2283;5183;1921;4647;159;450;1438;3306;1597;3756
315360;202210;2034;5417;1608;4609;205;639;797;2102;1002;2741
315370;202210;680;1732;553;1504;76;210;246;607;322;817
315380;202210;298;774;203;575;41;114;28;52;69;166
315390;202210;1531;3938;1247;3452;124;431;731;1793;855;2224
315400;202210;5066;12196;4028;10441;483;1371;2424;5896;2907;7267
315410;202210;2860;5991;2062;4830;369;1020;597;1257;966;2277
315415;202210;1776;4480;1440;3948;386;1253;344;830;730;2083
315420;202210;1810;4706;1288;3766;297;949;352;879;649;1828
315430;202210;4296;9770;3002;7878;494;1465;1458;3635;1952;5100
315440;202210;1245;2918;970;2498;93;274;606;1429;699;1703
315445;202210;2773;5442;2053;4467;119;260;1614;3460;1733;3720
315450;202210;2654;6542;2142;5715;198;555;1444;3685;1642;4240
315460;202210;56566;136486;47792;121692;4708;14493;31655;73994;36363;88487
315470;202210;802;2072;566;1530;53;151;286;701;339;852
315480;202210;1761;4501;1285;3516;182;530;597;1463;779;1993
315490;202210;3456;8005;2420;6362;346;997;996;2383;1342;3380
315500;202210;619;1545;382;1073;28;89;216;537;244;626
315510;202210;1679;3691;1381;3281;15;64;1205;2745;1220;2809
315520;202210;1320;3034;1107;2722;38;107;925;2193;963;2300
315530;202210;954;2142;804;1892;63;197;622;1348;685;1545
315540;202210;2016;4870;1342;3633;120;401;604;1475;724;1876
315550;202210;2182;5538;1501;4295;265;905;493;1368;758;2273
315560;202210;7938;20799;6834;18918;411;1082;5015;13701;5426;14783
315570;202210;3003;7003;2147;5513;299;927;1132;2482;1431;3409
315580;202210;3950;8332;3102;7062;415;1051;1402;2917;1817;3968
315590;202210;1553;2957;1297;2590;43;161;1072;1918;1115;2079
315600;202210;2936;8173;2059;6499;460;1383;874;2945;1334;4328
315610;202210;1168;2713;885;2238;116;383;462;972;578;1355
315620;202210;633;1543;471;1294;38;113;248;674;286;787
315630;202210;1419;3496;1082;2871;156;450;543;1292;699;1742
315640;202210;485;1078;380;948;31;86;251;585;282;671
315645;202210;1167;2835;815;2285;137;408;225;588;362;996
315650;202210;2147;4402;1737;3839;66;159;1399;3007;1465;3166
315660;202210;2456;5874;1846;4789;190;500;1094;2746;1284;3246
315670;202210;19952;48089;15628;40446;2598;7252;8120;19372;10718;26624
315680;202210;3789;9658;2839;7978;374;1148;1476;3913;1850;5061
315690;202210;4510;10428;2726;7403;542;1419;789;2228;1331;3647
315700;202210;10537;25726;8064;21042;761;2265;4650;11045;5411;13310
315710;202210;2162;4817;1548;3927;71;210;1071;2581;1142;2791
315720;202210;5358;13219;4387;11564;207;792;3157;7772;3364;8564
315725;202210;2756;6337;2169;5450;201;488;1445;3752;1646;4240
315727;202210;733;1698;538;1378;65;202;285;657;350;859
315730;202210;731;2020;617;1798;126;391;233;602;359;993
315733;202210;1784;4089;1379;3460;212;585;659;1486;871;2071
315737;202210;1389;3461;1016;2760;31;114;723;1850;754;1964
315740;202210;1021;2615;834;2249;76;252;556;1371;632;1623
315750;202210;1584;3641;1209;3091;91;234;789;2023;880;2257
315760;202210;1481;2988;1221;2647;28;99;1041;2146;1069;2245
315765;202210;2467;5355;2018;4791;26;91;1813;4293;1839;4384
315770;202210;1491;3809;1198;3405;423;1287;293;803;716;2090
315780;202210;38149;94511;31878;83551;2055;6615;21593;52709;23648;59324
315790;202210;4180;11855;3540;10675;346;1030;2086;6582;2432;7612
315800;202210;1591;4737;1210;3879;160;617;525;1425;685;2042
315810;202210;1661;3595;1385;3167;61;172;1118;2444;1179;2616
315820;202210;3567;7813;2911;6958;268;595;2094;4967;2362;5562
315830;202210;1489;4123;1013;3074;109;362;293;717;402;1079
315840;202210;1037;2311;745;1830;45;123;421;926;466;1049
315850;202210;1422;3738;1119;3237;152;475;612;1668;764;2143
315860;202210;679;1731;505;1439;98;305;175;405;273;710
315870;202210;534;1370;423;1193;24;77;302;812;326;889
315880;202210;1369;3101;1000;2497;122;371;468;970;590;1341
315890;202210;2171;5549;1771;5007;491;1506;735;2068;1226;3574
315895;202210;7703;19271;5708;15533;627;1958;2815;6869;3442;8827
315900;202210;1010;2471;830;2208;126;386;480;1197;606;1583
315910;202210;754;1716;652;1574;51;146;513;1203;564;1349
315920;202210;1697;4010;990;2714;159;558;368;834;527;1392
315930;202210;1386;2817;961;2235;87;219;550;1207;637;1426
315935;202210;1337;3569;1062;3072;207;617;473;1324;680;1941
315940;202210;734;1788;576;1559;84;254;307;764;391;1018
315950;202210;1485;3667;1248;3309;115;342;948;2478;1063;2820
315960;202210;6782;17472;4682;13340;1123;3520;1089;2252;2212;5772
315970;202210;678;1698;548;1523;67;208;367;1026;434;1234
315980;202210;5239;10532;3090;7142;518;1289;1560;3191;2078;4480
315990;202210;4164;9930;3260;8409;397;1083;1764;4268;2161;5351
316000;202210;944;1999;755;1734;63;178;497;1060;560;1238
316010;202210;869;2282;643;1875;78;246;283;682;361;928
316020;202210;1106;2836;883;2427;88;298;551;1400;639;1698
316030;202210;3318;8153;2520;6779;370;1026;1503;4076;1873;5102
316040;202210;3210;8689;2247;6875;407;1424;585;1483;992;2907
316045;202210;2776;5645;2552;5367;161;224;2224;4786;2385;5010
316050;202210;493;1223;373;1031;30;90;232;567;262;657
316060;202210;881;1877;646;1569;31;93;468;1074;499;1167
316070;202210;7135;17648;5795;15185;886;2350;2979;7342;3865;9692
316080;202210;951;2690;753;2292;168;578;216;535;384;1113
316090;202210;612;1511;509;1323;45;147;328;752;373;899
316095;202210;1514;4326;1159;3472;266;871;446;1223;712;2094
316100;202210;2922;7663;2141;6073;321;1061;929;2337;1250;3398
316105;202210;849;2043;673;1758;50;132;438;1157;488;1289
316110;202210;17934;42330;14907;37534;880;2750;11156;26535;12036;29285
316120;202210;1478;3719;952;2636;151;475;350;760;501;1235
316130;202210;1554;3229;1034;2414;81;220;640;1387;721;1607
316140;202210;1294;3246;785;2293;142;422;281;776;423;1198
316150;202210;2661;5502;2123;4729;144;413;1281;2617;1425;3030
316160;202210;1199;2898;953;2476;41;143;695;1736;736;1879
316165;202210;1067;2315;842;1996;80;205;568;1276;648;1481
316170;202210;1686;3453;1318;2939;70;221;995;2019;1065;2240
316180;202210;1928;5005;1359;3930;264;816;388;972;652;1788
316190;202210;3213;8534;1857;5395;227;716;801;1951;1028;2667
316200;202210;4452;11202;3541;9703;624;1925;1665;4188;2289;6113
316210;202210;6575;17860;4700;13620;1504;4764;505;1240;2009;6004
316220;202210;849;2378;586;1870;118;395;129;391;247;786
316225;202210;1979;4013;1506;3304;48;186;1198;2376;1246;2562
316230;202210;594;1437;460;1222;99;291;229;576;328;867
316240;202210;6852;17599;5944;16006;447;1307;4387;11454;4834;12761
316245;202210;3852;10704;3457;10082;191;840;2668;7344;2859;8184
316250;202210;13591;30213;10296;24926;1897;4931;4292;9966;6189;14897
316255;202210;3546;9159;3049;8354;155;436;2237;6133;2392;6569
316257;202210;1859;3855;1394;3138;133;285;956;2068;1089;2353
316260;202210;3276;6422;2556;5352;270;519;1679;3443;1949;3962
316265;202210;1314;3269;1035;2798;33;92;754;1954;787;2046
316270;202210;4529;12523;3832;11092;465;1456;2152;5782;2617;7238
316280;202210;3618;8905;3016;7853;378;1036;1731;4319;2109;5355
316290;202210;4857;11868;3747;9837;456;1292;1593;3809;2049;5101
316292;202210;7390;17774;5965;15514;656;1924;3964;9732;4620;11656
316294;202210;1106;3054;848;2624;168;606;266;710;434;1316
316295;202210;4298;10934;3520;9650;280;896;2269;5842;2549;6738
316300;202210;1325;3192;1048;2776;60;174;765;1951;825;2125
316310;202210;956;2407;669;1909;140;465;216;556;356;1021
316320;202210;800;2082;603;1766;113;354;133;335;246;689
316330;202210;1251;2934;961;2457;55;152;734;1823;789;1975
316340;202210;1240;2985;963;2517;77;279;646;1537;723;1816
316350;202210;1687;4068;1429;3643;150;423;1018;2477;1168;2900
316360;202210;783;1887;662;1699;62;147;507;1337;569;1484
316370;202210;7188;16620;5544;13896;616;1924;3099;6665;3715;8589
316380;202210;2108;4473;1687;3889;92;191;1236;2799;1328;2990
316390;202210;898;2289;671;1912;252;820;144;345;396;1165
316400;202210;1433;3773;915;2763;105;353;338;876;443;1229
316410;202210;1505;3440;1261;3069;39;129;1070;2500;1109;2629
316420;202210;2319;5654;1955;5138;33;139;1589;3995;1622;4134
316430;202210;1070;2609;736;2041;111;349;304;738;415;1087
316440;202210;1021;2923;819;2571;154;552;235;662;389;1214
316443;202210;680;1748;481;1378;104;348;153;399;257;747
316447;202210;2673;5932;2291;5371;34;96;2046;4679;2080;4775
316450;202210;2533;6753;1903;5526;223;698;1136;3183;1359;3881
316460;202210;1620;3899;1322;3412;124;353;857;2051;981;2404
316470;202210;9012;23433;6794;19138;920;2995;3180;7860;4100;10855
316480;202210;254;610;215;560;34;99;125;299;159;398
316490;202210;401;1054;287;835;55;190;97;232;152;422
316500;202210;1554;4428;1065;3293;201;651;292;791;493;1442
316510;202210;954;2834;770;2477;129;419;385;1218;514;1637
316520;202210;1642;3719;1236;3010;189;527;547;1147;736;1674
316530;202210;1340;3128;1007;2563;102;367;556;1214;658;1581
316540;202210;1280;2902;1019;2539;160;453;490;1097;650;1550
316550;202210;1770;4367;1493;3896;50;168;1242;3154;1292;3322
316553;202210;5818;15411;4293;12041;536;1695;2039;4909;2575;6604
316555;202210;3318;8613;2893;8065;84;311;2466;6747;2550;7058
316556;202210;662;1434;491;1144;34;97;301;586;335;683
316557;202210;1461;4001;1256;3685;440;1419;462;1276;902;2695
316560;202210;500;1386;356;1107;57;204;130;365;187;569
316570;202210;1708;4418;1428;3929;352;884;475;1421;827;2305
316580;202210;490;949;343;727;25;58;222;440;247;498
316590;202210;1565;3639;1076;2740;152;362;609;1459;761;1821
316600;202210;1181;3101;1018;2798;137;428;635;1637;772;2065
316610;202210;759;2042;609;1803;62;216;368;1040;430;1256
316620;202210;2724;6155;2382;5653;174;369;1880;4430;2054;4799
316630;202210;1847;5062;1549;4517;417;1167;610;2025;1027;3192
316640;202210;201;504;157;431;29;93;62;141;91;234
316650;202210;1344;3435;1090;3055;77;224;740;2001;817;2225
316660;202210;218;504;105;277;13;39;35;70;48;109
316670;202210;1967;4584;1476;3852;395;1071;477;1127;872;2198
316680;202210;2813;6658;2105;5359;169;484;1446;3530;1615;4014
316690;202210;1617;4323;1175;3512;212;697;251;583;463;1280
316695;202210;1142;3094;924;2705;22;80;620;1747;642;1827
316700;202210;612;1063;525;969;9;21;476;845;485;866
316710;202210;4265;11810;3436;10205;419;1473;1980;5331;2399;6804
316720;202210;26708;66473;20729;55570;3078;9022;10596;26004;13674;35026
316730;202210;648;1413;520;1208;55;140;303;623;358;763
316740;202210;1040;2608;909;2417;135;388;625;1637;760;2025
316750;202210;481;1238;356;1035;63;205;157;408;220;613
316760;202210;4791;13402;4067;12093;1334;4440;1561;4483;2895;8923
316770;202210;1911;3875;1428;3249;45;115;1133;2591;1178;2706
316780;202210;726;1937;596;1710;204;664;133;277;337;941
316790;202210;893;2197;659;1754;94;271;196;496;290;767
316800;202210;8052;20300;6407;17531;810;2403;3329;8632;4139;11035
316805;202210;1458;2640;1195;2342;30;79;1036;1974;1066;2053
316810;202210;904;2229;687;1851;83;245;468;1236;551;1481
316820;202210;466;933;288;655;18;63;194;382;212;445
316830;202210;1071;2503;830;2120;88;225;516;1289;604;1514
316840;202210;3650;8136;2956;7069;159;492;2320;5256;2479;5748
316850;202210;2732;6089;2087;5040;186;535;1345;2937;1531;3472
316860;202210;28126;63164;21550;53421;2759;8145;11805;27068;14564;35213
316870;202210;10772;25997;8168;21277;939;2851;4490;10403;5429;13254
316880;202210;1349;3166;1137;2878;124;394;732;1692;856;2086
316890;202210;1383;2977;868;2298;101;340;549;1353;650;1693
316900;202210;3168;7596;2533;6483;415;1160;1179;2656;1594;3816
316905;202210;577;1590;466;1381;206;610;121;379;327;989
316910;202210;1228;2954;850;2329;212;619;226;574;438;1193
316920;202210;2355;4931;1779;4101;191;549;1230;2557;1421;3106
316930;202210;11488;29307;9097;25300;1794;5526;3848;9510;5642;15036
316935;202210;5336;12895;3995;10475;668;1947;1896;4464;2564;6411
316940;202210;7587;20388;5972;17271;935;2952;2721;7062;3656;10014
316950;202210;2450;4942;1904;4220;73;147;1611;3511;1684;3658
316960;202210;6492;13047;4767;10806;382;966;3407;7462;3789;8428
316970;202210;5070;12414;4274;11085;559;1577;2196;5150;2755;6727
316980;202210;1024;2625;796;2272;237;753;303;785;540;1538
316990;202210;15944;38914;12055;31540;2759;7691;2865;6482;5624;14173
317000;202210;3115;7847;2721;7328;210;457;2088;5707;2298;6164
317005;202210;3142;7998;2454;6683;364;1098;1315;3360;1679;4458
317010;202210;34860;76706;24476;61079;3828;10556;13115;31006;16943;41562
317020;202210;89585;200128;57206;145281;10626;29486;21515;48667;32141;78153
317030;202210;808;1966;646;1740;17;67;489;1277;506;1344
317040;202210;14005;32943;9656;25722;2296;6613;2849;7610;5145;14223
317043;202210;1111;2186;818;1802;36;89;656;1407;692;1496
317047;202210;1367;2941;955;2296;50;145;684;1563;734;1708
317050;202210;1452;4229;1036;3274;157;568;400;1032;557;1600
317052;202210;3051;7178;2434;6248;199;556;1705;4189;1904;4745
317057;202210;2726;5123;2123;4267;36;106;1738;3253;1774;3359
317060;202210;598;1530;366;1058;49;157;148;368;197;525
317065;202210;1323;3538;1081;3065;80;266;680;1748;760;2014
317070;202210;9579;25114;7522;21276;1156;3738;3470;8865;4626;12603
317075;202210;1328;3044;1021;2558;132;349;609;1404;741;1753
317080;202210;8120;17418;6181;14380;1127;2819;3104;6884;4231;9703
317090;202210;5670;14547;4956;13443;292;803;3729;9964;4021;10767
317100;202210;3165;7038;2151;5419;410;1096;960;2252;1370;3348
317103;202210;3013;6368;2576;5758;136;416;2127;4515;2263;4931
317107;202210;1843;4209;1379;3374;48;153;939;1968;987;2121
317110;202210;818;1804;465;1255;71;228;185;471;256;699
317115;202210;1329;3493;1091;3063;145;418;648;1789;793;2207
317120;202210;23533;55475;19398;48988;1282;4030;13269;30990;14551;35020
317130;202210;13979;30354;9728;23508;1345;3580;3925;9144;5270;12724
317140;202210;1157;2524;894;2123;64;153;641;1497;705;1650
317150;202210;1273;2649;988;2282;35;112;846;1876;881;1988
317160;202210;4116;9221;2689;6958;280;670;1351;3704;1631;4374
317170;202210;2487;5652;1917;4664;93;287;1322;2873;1415;3160
317180;202210;2233;6449;1627;5073;329;1078;391;1115;720;2193
317190;202210;1317;3323;974;2752;192;580;453;1185;645;1765
317200;202210;7701;18926;5736;15217;1208;3364;1482;3486;2690;6850
317210;202210;1512;3217;1175;2779;45;156;840;1945;885;2101
317220;202210;388;1016;333;921;57;175;198;500;255;675
320010;202210;5762;15748;4377;12936;625;2035;2267;6402;2892;8437
320013;202210;2548;6394;1806;5012;295;866;841;2356;1136;3222
320016;202210;3463;8238;2648;6977;216;585;1798;4657;2014;5242
320020;202210;5912;13621;4547;11305;643;1880;2444;5675;3087;7555
320030;202210;2165;5527;1413;4035;201;631;633;1624;834;2255
320035;202210;2381;5779;1969;5127;343;1029;1141;2833;1484;3862
320040;202210;5532;14193;4588;12537;626;1831;2569;6589;3195;8420
320050;202210;2322;4750;2012;4306;209;588;1380;2678;1589;3266
320060;202210;17816;44754;13325;36108;2258;6595;6115;15066;8373;21661
320070;202210;2424;5748;1840;4678;212;702;1071;2346;1283;3048
320080;202210;6897;16294;4850;12401;843;2327;2095;4830;2938;7157
320090;202210;10240;25613;6907;19072;1445;4346;2554;6298;3999;10644
320100;202210;4172;9868;3397;8566;465;1281;2016;4864;2481;6145
320110;202210;2921;6024;2148;4880;247;656;1351;2767;1598;3423
320115;202210;2646;7619;2264;7002;710;2259;936;3016;1646;5275
320120;202210;32563;75653;23652;60339;3123;8769;12259;28500;15382;37269
320130;202210;71167;171864;58732;150614;7175;20020;36383;88192;43558;108212
320140;202210;5031;12469;3672;9870;504;1608;1877;4560;2381;6168
320150;202210;18019;43110;12988;34152;3036;9021;2312;4795;5348;13816
320160;202210;7971;20061;5926;16433;761;2337;3005;7910;3766;10247
320170;202210;2229;5826;1577;4581;411;1209;537;1622;948;2831
320180;202210;902;2640;701;2230;217;772;179;515;396;1287
320190;202210;3803;11028;2823;8944;602;2156;611;1672;1213;3828
320200;202210;1608;4096;1093;3165;220;694;306;852;526;1546
320210;202210;5743;13290;4427;11085;673;1849;2474;5728;3147;7577
320220;202210;4437;10317;3374;8609;679;1781;1507;3620;2186;5401
320225;202210;1836;5227;1258;3947;371;1291;282;856;653;2147
320230;202210;6890;16839;5220;14087;1182;3392;1526;4217;2708;7609
320240;202210;21872;51183;16455;42806;4079;11628;5177;12682;9256;24310
320245;202210;4002;10961;2888;8588;810;2568;436;1179;1246;3747
320250;202210;3529;8456;2410;6080;392;1091;1137;2467;1529;3558
320255;202210;2534;6959;2202;6384;388;1196;1385;4026;1773;5222
320260;202210;1766;4645;1133;3339;270;829;297;731;567;1560
320265;202210;2820;8155;2143;6778;844;2914;296;868;1140;3782
320270;202210;2746;7138;2082;5892;522;1679;668;1804;1190;3483
320280;202210;10544;24436;8692;21479;1064;3141;5742;13148;6806;16289
320290;202210;1608;4504;1042;3216;267;916;287;804;554;1720
320300;202210;5466;14629;4377;12582;1151;3665;1515;4145;2666;7810
320305;202210;6567;16771;4958;13817;891;2781;2367;6146;3258;8927
320310;202210;2649;6641;1859;5047;317;950;845;2033;1162;2983
320313;202210;3083;7018;2117;5309;407;1135;791;1655;1198;2790
320316;202210;1904;5007;1458;4262;223;654;796;2327;1019;2981
320320;202210;27267;66909;19846;54496;4686;13545;7078;18856;11764;32401
320330;202210;3587;8787;2799;7459;431;1180;1600;4236;2031;5416
320332;202210;10728;25734;8616;22116;1595;4477;4579;11095;6174;15572
320334;202210;2375;6178;1629;4725;298;1025;415;926;713;1951
320335;202210;2201;5892;1480;4320;290;995;479;1243;769;2238
320340;202210;6986;14762;5878;13215;441;1134;4115;8970;4556;10104
320350;202210;6587;14618;4647;11334;468;1328;2629;5808;3097;7136
320360;202210;1694;4039;1213;3153;135;374;606;1447;741;1821
320370;202210;3510;9624;2711;7973;758;2487;981;2654;1739;5141
320380;202210;3793;8443;3176;7445;256;788;2282;4891;2538;5679
320390;202210;9887;23850;7271;18854;1457;4054;3040;7240;4497;11294
320400;202210;4049;10640;3003;8478;797;2459;1129;2934;1926;5393
320405;202210;6636;15498;5019;12816;704;1909;2781;6702;3485;8611
320410;202210;5899;14213;4441;11926;754;2048;2187;5867;2941;7915
320420;202210;5085;11524;3914;9724;836;2220;1557;3640;2393;5860
320425;202210;2691;5769;2050;4762;153;375;1410;3073;1563;3448
320430;202210;3879;9076;3077;7727;423;1117;1891;4546;2314;5663
320435;202210;2879;8265;2274;7030;685;2297;822;2585;1507;4882
320440;202210;1870;4765;1401;3888;239;731;631;1562;870;2293
320450;202210;2638;6471;2135;5594;321;1063;1229;2836;1550;3899
320455;202210;5375;15321;3682;11511;866;3037;891;2358;1757;5395
320460;202210;2598;7233;1894;5819;536;1844;521;1418;1057;3262
320465;202210;1918;4961;1380;3943;305;948;595;1679;900;2627
320470;202210;5172;12646;3816;10046;718;2143;1415;3222;2133;5365
320480;202210;2989;6557;2420;5628;284;656;1642;3675;1926;4331
320490;202210;31953;73684;24032;60560;4359;11154;10948;27061;15307;38215
320495;202210;1770;4434;1285;3507;309;978;258;540;567;1518
320500;202210;82843;196467;66953;169926;7783;22423;42169;99424;49952;121847
320501;202210;6163;16272;4633;13580;1319;4270;1224;3437;2543;7707
320503;202210;3133;8309;2120;6268;588;1908;571;1529;1159;3437
320506;202210;3369;9315;2509;7511;726;2404;482;1194;1208;3598
320510;202210;15249;36500;12333;31648;1567;4253;7215;17665;8782;21918
320515;202210;2211;5681;1650;4528;457;1352;533;1371;990;2723
320517;202210;2708;7312;2162;6217;624;1939;808;2221;1432;4160
320520;202210;58219;134906;45496;114019;6696;18669;22679;52788;29375;71457
320530;202210;45123;105283;36177;90377;2667;8287;24438;55861;27105;64148
330010;202210;35453;79230;29750;70359;2298;6294;22302;50163;24600;56457
330015;202210;2183;4571;1721;3879;219;617;1113;2279;1332;2896
330020;202210;26846;59903;22685;54018;2332;6276;16677;38340;19009;44616
330022;202210;2514;6248;1937;5312;371;1065;854;2277;1225;3342
330023;202210;9090;19287;7265;16583;989;2511;4717;10147;5706;12658
330025;202210;9886;20266;6764;15336;1147;2870;3074;6276;4221;9146
330030;202210;14987;34175;11830;29284;816;2612;8368;19012;9184;21624
330040;202210;23818;53961;19926;47769;915;2866;15385;34495;16300;37361
330045;202210;144065;274103;123745;249097;5501;12408;106456;208572;111957;220980
330050;202210;4447;10021;3587;8704;551;1648;2228;4766;2779;6414
330060;202210;7664;17449;5936;14571;1082;3051;2536;5601;3618;8652
330070;202210;40741;86742;34371;78024;4097;10024;23438;51764;27535;61788
330080;202210;14115;29343;11990;26446;1434;3302;8264;17912;9698;21214
330090;202210;4470;8317;3285;6750;264;477;2280;4741;2544;5218
330093;202210;3823;7988;2992;6901;158;429;2456;5477;2614;5906
330095;202210;1878;4628;1471;3915;154;461;884;2173;1038;2634
330100;202210;100467;224128;87819;206516;3694;10890;71720;163054;75414;173944
330110;202210;3140;7401;2584;6519;273;838;1753;4054;2026;4892
330115;202210;3648;7879;2643;6338;426;1151;1517;3318;1943;4469
330120;202210;4736;9031;3689;7746;169;444;2983;5930;3152;6374
330130;202210;6847;16225;5670;14498;752;2014;3694;9152;4446;11166
330140;202210;5692;11652;4779;10452;200;625;4007;8307;4207;8932
330150;202210;3378;7786;2702;6722;435;1198;1574;3673;2009;4871
330160;202210;2087;4891;1643;4161;294;865;952;2142;1246;3007
330170;202210;213041;417123;182824;377931;20184;43975;137012;276101;157196;320076
330180;202210;2883;5800;2353;5087;103;304;1889;3852;1992;4156
330185;202210;16518;32749;14186;29735;468;1351;12376;24917;12844;26268
330187;202210;7672;16250;6076;13795;745;1964;4036;8439;4781;10403
330190;202210;64243;125447;56129;114636;2409;5882;47372;93378;49781;99260
330200;202210;25827;54806;21619;49597;2739;6478;15575;35197;18314;41675
330205;202210;2917;6507;2223;5410;144;415;1544;3462;1688;3877
330210;202210;4306;9450;3235;7752;404;1063;1866;4080;2270;5143
330220;202210;19374;41829;14645;34337;2201;5912;7613;15861;9814;21773
330225;202210;5719;12742;4480;10920;302;872;3183;7415;3485;8287
330227;202210;26697;54120;23297;50062;518;1471;21096;44079;21614;45550
330230;202210;2413;5119;1636;4059;143;385;791;1933;934;2318
330240;202210;36919;81700;31549;73742;2588;7003;23773;52999;26361;60002
330245;202210;2165;4936;1355;3554;259;738;603;1401;862;2139
330250;202210;62947;132187;53785;119472;6143;14665;38792;83697;44935;98362
330260;202210;7733;16081;6151;14031;298;827;4983;10927;5281;11754
330270;202210;44943;96318;29002;70525;3691;10052;15066;33634;18757;43686
330280;202210;3771;8113;2997;6913;180;528;2160;4540;2340;5068
330285;202210;41658;81387;34751;71912;1309;3595;29323;57618;30632;61213
330290;202210;6443;12548;5327;11110;302;888;4380;8531;4682;9419
330300;202210;8083;16328;6034;13516;405;1069;4567;9658;4972;10727
330310;202210;3749;7775;2857;6409;146;372;2160;4593;2306;4965
330320;202210;24699;50291;19742;44164;2117;4327;14823;32787;16940;37114
330330;202210;69543;134184;57261;118207;3950;9135;45269;89798;49219;98933
330340;202210;26173;55451;19964;46263;2576;7195;11795;24582;14371;31777
330350;202210;233628;444258;200435;404813;7665;17300;177010;349381;184675;366681
330360;202210;10590;21491;9229;19855;327;704;8118;17177;8445;17881
330370;202210;7622;18309;6107;15882;1041;3066;3280;7971;4321;11037
330380;202210;9788;21415;7987;18428;589;1740;5913;12652;6502;14392
330385;202210;5815;13945;4768;12444;760;2252;2642;6497;3402;8749
330390;202210;47593;106139;37271;89180;3600;10605;25396;55552;28996;66157
330395;202210;4745;9941;3955;8957;146;458;3207;6913;3353;7371
330400;202210;4893;11185;4114;9965;196;658;3210;7176;3406;7834
330410;202210;4619;10170;3485;8350;430;1316;2344;5054;2774;6370
330411;202210;3736;9141;2993;7871;181;608;2090;5101;2271;5709
330412;202210;2324;5531;1917;4895;143;441;1351;3195;1494;3636
330414;202210;34235;74532;28604;67011;1750;4691;22592;51225;24342;55916
330415;202210;6127;14922;4553;12241;426;1258;2713;6908;3139;8166
330420;202210;17389;39057;13090;32249;1317;3812;8017;17996;9334;21808
330430;202210;15652;29841;13480;27047;394;1052;11614;22341;12008;23393
330440;202210;3951;9008;3080;7584;307;955;2165;4891;2472;5846
330450;202210;1971;4782;1568;4130;132;393;1004;2470;1136;2863
330452;202210;26644;58878;22025;52162;1846;5349;16392;36574;18238;41923
330455;202210;977044;1920374;818806;1705699;80103;180506;608852;1223556;688955;1404062
330460;202210;1655;3929;1291;3404;216;599;700;1789;916;2388
330470;202210;7897;16962;5864;13990;1268;3366;2495;5558;3763;8924
330475;202210;13022;28808;10637;25759;1347;3789;7242;16795;8589;20584
330480;202210;7674;17563;6521;15910;504;1341;4681;10845;5185;12186
330490;202210;162838;328199;135889;292855;11462;26369;103498;216626;114960;242995
330500;202210;11410;24387;9680;22105;567;1492;7660;16917;8227;18409
330510;202210;65928;140095;52801;122305;5010;12918;39174;86973;44184;99891
330513;202210;1721;3891;1392;3449;193;517;832;2030;1025;2547
330515;202210;4004;9167;3283;8177;383;1114;2088;4877;2471;5991
330520;202210;19698;43424;16734;39135;1412;3931;12175;26951;13587;30882
330530;202210;2211;4829;1594;3916;291;778;766;1824;1057;2602
330540;202210;4116;9581;3189;8068;697;1877;1498;3577;2195;5454
330550;202210;20017;40991;15782;35148;2155;5482;10441;21821;12596;27303
330555;202210;29990;52232;25592;47078;944;1976;22081;39998;23025;41974
330560;202210;5305;12068;4313;10535;574;1480;2861;6668;3435;8148
330570;202210;4235;9546;3726;8837;512;1422;2637;6021;3149;7443
330575;202210;8919;18900;7808;17067;306;866;6650;13725;6956;14591
330580;202210;31460;70185;26340;61617;3766;9289;16245;35274;20011;44563
330590;202210;2176;4807;1825;4372;226;533;1230;2955;1456;3488
330600;202210;17996;40145;14973;35481;844;2522;11018;24378;11862;26900
330610;202210;13804;30697;11444;27121;987;2739;8080;18022;9067;20761
330615;202210;2910;6734;2397;6062;412;933;1556;4061;1968;4994
330620;202210;5906;14451;4800;12668;782;2330;2679;6550;3461;8880
330630;202210;41974;89546;33024;75706;1376;4273;25553;54737;26929;59010
350010;202210;2869;7091;1779;4911;328;968;484;1095;812;2063
350020;202210;872;2111;534;1471;73;211;193;467;266;678
350030;202210;4559;11518;3567;9856;702;2198;1848;4702;2550;6900
350040;202210;950;2521;571;1745;81;303;181;422;262;725
350050;202210;1860;4261;1285;3317;209;639;488;992;697;1631
350055;202210;1186;2665;935;2291;141;379;522;1122;663;1501
350060;202210;378;841;207;500;31;86;97;206;128;292
350070;202210;4558;10961;3164;8518;461;1380;1434;3380;1895;4760
350075;202210;843;2208;629;1819;206;602;132;388;338;990
350080;202210;820;2022;551;1514;53;163;282;673;335;836
350090;202210;810;1639;530;1221;68;193;327;667;395;860
350100;202210;3314;7728;2428;6288;137;470;1641;3858;1778;4328
350110;202210;627;1387;476;1133;16;49;344;767;360;816
350115;202210;1475;4003;1205;3478;197;639;609;1586;806;2225
350120;202210;797;1770;471;1210;41;129;264;607;305;736
350130;202210;4287;10269;3403;8714;426;1253;1968;4440;2394;5693
350140;202210;882;2261;628;1793;44;156;367;944;411;1100
350150;202210;570;1621;461;1409;87;295;153;392;240;687
350160;202210;15929;37712;11430;29478;1561;4466;6761;16089;8322;20555
350170;202210;3433;8661;2877;7510;417;1201;1607;3804;2024;5005
350180;202210;1246;2810;764;1968;100;269;410;961;510;1230
350190;202210;4605;11978;3378;9253;442;1494;1880;4316;2322;5810
350200;202210;688;1583;531;1303;39;107;356;798;395;905
350210;202210;8286;17451;5955;13832;458;1322;4179;8944;4637;10266
350220;202210;3892;9903;2800;7822;504;1511;1203;2978;1707;4489
350230;202210;1381;3178;1107;2808;157;461;635;1515;792;1976
350240;202210;742;1965;457;1321;79;230;133;325;212;555
350250;202210;4483;11210;3420;9506;869;2536;1140;3018;2009;5554
350260;202210;1075;2294;681;1645;78;211;414;905;492;1116
350270;202210;5612;13510;4491;11479;573;1644;2659;6208;3232;7852
350275;202210;3615;8608;3001;7719;228;754;2255;5437;2483;6191
350280;202210;24045;51619;15908;38730;2231;5888;8272;18372;10503;24260
350290;202210;4384;11110;3200;8799;501;1575;1539;3751;2040;5326
350300;202210;871;2047;669;1684;85;234;432;995;517;1229
350310;202210;1195;3067;919;2555;123;398;443;1093;566;1491
350315;202210;761;1713;540;1376;29;103;329;729;358;832
350320;202210;21238;50750;16295;42206;2711;7870;8065;18822;10776;26692
350330;202210;17980;40598;13537;32650;1182;3310;9196;20535;10378;23845
350335;202210;444;1167;323;933;34;105;145;399;179;504
350340;202210;1685;4068;1048;2897;150;470;478;1153;628;1623
350350;202210;898;2066;708;1860;114;301;421;1105;535;1406
350360;202210;1465;3866;1179;3308;212;634;528;1409;740;2043
350370;202210;893;2016;645;1568;184;435;236;529;420;964
350380;202210;6123;15722;4445;12283;1002;2902;1586;4017;2588;6919
350390;202210;14316;34136;11280;29194;1429;4026;6861;16500;8290;20526
350395;202210;528;1262;265;768;30;93;98;249;128;342
350400;202210;10744;24855;7688;19831;1945;5403;2400;5822;4345;11225
350410;202210;13923;35745;10493;29398;1975;6098;4540;11634;6515;17732
350420;202210;1405;3326;976;2539;178;468;335;715;513;1183
350430;202210;810;1933;628;1652;89;274;351;823;440;1097
350440;202210;2722;5986;2201;5223;113;349;1555;3398;1668;3747
350450;202210;8953;22700;7054;19455;1377;4301;3397;8455;4774;12756
350460;202210;2730;6547;1727;4678;257;749;803;1922;1060;2671
350470;202210;314;718;245;609;9;25;184;437;193;462
350480;202210;1199;2863;788;2136;180;554;192;443;372;997
350490;202210;2501;5807;1828;4775;302;890;880;1986;1182;2876
350500;202210;772;1924;550;1541;73;219;221;572;294;791
350510;202210;1511;3492;1160;2890;106;293;735;1683;841;1976
350520;202210;2959;8067;2343;6940;341;1112;1120;2994;1461;4106
350530;202210;3955;9244;3028;7532;239;703;1902;4296;2141;4999
350535;202210;1899;4610;1591;4169;225;659;1013;2530;1238;3189
350540;202210;2572;5089;1976;4261;189;493;1458;2889;1647;3382
350550;202210;11548;26345;8212;20879;777;2386;5074;11636;5851;14022
350560;202210;5759;13396;4836;11961;235;771;3743;8680;3978;9451
350570;202210;39152;97768;32143;85305;4936;14427;17617;43539;22553;57966
350580;202210;2770;6787;1800;4950;490;1549;561;1173;1051;2722
350590;202210;6376;15855;4802;12542;600;1770;2944;7014;3544;8784
350600;202210;41777;92814;27002;67894;3990;11455;12996;29197;16986;40652
350610;202210;9310;23050;6859;18427;812;2549;3967;9644;4779;12193
350620;202210;492;1207;322;935;35;117;187;501;222;618
350630;202210;2154;4652;1589;3738;105;319;1154;2453;1259;2772
350635;202210;13920;30307;10783;25556;1139;3019;7481;16702;8620;19721
350640;202210;1123;2841;617;1780;102;305;191;458;293;763
350650;202210;10892;27258;7945;21625;1312;3962;3582;8788;4894;12750
350660;202210;6412;14770;5033;12610;577;1426;3228;7839;3805;9265
350670;202210;2328;5786;1747;4789;276;800;901;2392;1177;3192
350680;202210;1402;3492;948;2674;154;452;411;1052;565;1504
350690;202210;1837;4401;1349;3562;239;692;708;1769;947;2461
350700;202210;6272;14458;4846;12289;897;2672;2718;6243;3615;8915
350710;202210;3841;9242;3225;8235;558;1689;1792;4130;2350;5819
350715;202210;910;2424;759;2159;158;532;368;884;526;1416
350720;202210;206;481;147;396;20;64;44;92;64;156
350730;202210;776;2081;585;1713;52;174;327;842;379;1016
350740;202210;2090;5083;1434;3766;227;665;545;1237;772;1902
350745;202210;752;1818;434;1210;44;149;212;530;256;679
350750;202210;14518;34836;11602;29994;1873;5655;5998;13924;7871;19579
350760;202210;22813;50165;17549;41521;2225;6503;10802;22397;13027;28900
350770;202210;1321;2988;851;2202;92;263;510;1217;602;1480
350775;202210;889;1894;596;1458;82;204;321;734;403;938
350780;202210;2961;6659;2178;5597;563;1317;878;2490;1441;3807
350790;202210;2667;6709;1714;4961;367;1080;478;1146;845;2226
350800;202210;4621;11767;3926;10629;306;975;2716;6934;3022;7909
350810;202210;3657;8113;2732;6755;598;1496;1253;2951;1851;4447
350820;202210;1160;2534;720;1755;63;187;433;957;496;1144
350830;202210;1065;2657;621;1738;106;330;217;470;323;800
350840;202210;4518;12249;3497;10383;648;2151;1603;4293;2251;6444
350850;202210;10488;26248;8272;22402;1283;3832;4705;11776;5988;15608
350860;202210;4907;11487;4263;10616;289;829;3140;7648;3429;8477
350870;202210;3454;8594;2528;7147;388;1151;1312;3539;1700;4690
350880;202210;1977;4934;1622;4272;413;1143;632;1457;1045;2600
350890;202210;618;1525;411;1111;63;171;144;336;207;507
350900;202210;12141;29320;8881;22927;1306;3834;4965;11380;6271;15214
350910;202210;1209;2578;1014;2299;81;207;788;1737;869;1944
350920;202210;16119;36550;13656;32715;514;1564;11174;25475;11688;27039
350925;202210;5460;13273;4035;10888;659;2017;2161;5153;2820;7170
350930;202210;1812;4453;1240;3364;97;290;685;1766;782;2056
350940;202210;3375;7756;2733;6759;230;683;1984;4545;2214;5228
350945;202210;1180;2989;871;2402;156;432;384;967;540;1399
350950;202210;124191;291063;97074;242194;11578;31811;61198;142694;72776;174505
350960;202210;8579;21334;6668;17752;976;2889;3622;8906;4598;11795
350970;202210;4864;12522;3618;10229;931;2974;1209;2712;2140;5686
350980;202210;959;2245;796;1972;123;344;486;1101;609;1445
350990;202210;2639;6331;2037;5383;484;1437;890;2132;1374;3569
350995;202210;1086;3022;983;2824;79;287;675;1808;754;2095
351000;202210;3894;9666;2549;7022;559;1623;804;2077;1363;3700
351010;202210;489;1155;304;818;49;156;143;354;192;510
351015;202210;1238;3376;1010;2924;197;625;431;1066;628;1691
351020;202210;10683;26064;8130;21653;1502;4332;4214;10279;5716;14611
351030;202210;3901;10350;3131;8866;480;1554;1718;4544;2198;6098
351040;202210;7232;15582;6076;13872;224;636;5052;11017;5276;11653
351050;202210;22682;51499;17415;43623;2795;7596;9751;23059;12546;30655
351060;202210;63044;145495;48831;121983;4142;11869;34098;80667;38240;92536
351070;202210;1815;4229;1084;3007;288;855;214;508;502;1363
351080;202210;3636;8022;2766;6967;321;942;1822;4293;2143;5235
351090;202210;420;1060;320;883;61;174;121;314;182;488
351100;202210;3640;9001;2356;6461;468;1418;843;2131;1311;3549
351110;202210;7264;17817;5308;14312;822;2534;2857;7115;3679;9649
351120;202210;916;2195;631;1682;110;316;227;520;337;836
351130;202210;1384;3598;663;1973;120;404;167;409;287;813
351140;202210;2858;7285;2168;6044;448;1405;955;2327;1403;3732
351150;202210;3828;9851;2729;7650;412;1344;1123;2740;1535;4084
351160;202210;1631;4638;1170;3630;244;824;270;703;514;1527
351170;202210;2015;4849;1728;4334;134;418;1247;2874;1381;3292
351190;202210;1227;3203;843;2439;195;561;261;711;456;1272
351200;202210;2002;4549;1487;3794;138;394;1007;2403;1145;2797
351210;202210;1894;4301;1263;3216;85;283;774;1762;859;2045
351220;202210;4825;11471;4136;10383;430;1068;2808;6806;3238;7874
351230;202210;2817;6652;2186;5596;391;1108;1040;2305;1431;3413
351240;202210;2896;7107;1842;5003;479;1308;483;1141;962;2449
351250;202210;1268;3208;755;2153;93;279;274;727;367;1006
351260;202210;1047;2430;739;1896;154;393;283;666;437;1059
351270;202210;658;1678;464;1295;51;155;226;509;277;664
351280;202210;4962;12273;3767;10107;800;2232;1543;3782;2343;6014
351290;202210;1881;4159;1267;3126;122;342;890;2083;1012;2425
351300;202210;27498;67797;20320;54770;3600;10632;10066;24968;13666;35600
351310;202210;4680;10457;3642;8786;163;548;2753;6189;2916;6737
351320;202210;1005;2752;703;2172;117;382;199;530;316;912
351330;202210;463;1093;336;843;18;59;214;457;232;516
351340;202210;10269;23489;8692;20811;1443;4086;5475;11645;6918;15731
351350;202210;16441;37610;13640;33066;922;2649;10576;24216;11498;26865
351360;202210;5106;11960;4187;10635;753;2215;2225;5073;2978;7288
351370;202210;2578;6670;1714;4966;410;1278;421;982;831;2260
351380;202210;60130;133210;43751;106200;4556;12230;28137;64142;32693;76372
351385;202210;468;1157;202;575;34;99;86;223;120;322
351390;202210;1759;3913;1217;3156;66;211;964;2402;1030;2613
351400;202210;1435;3594;1150;3041;170;435;625;1582;795;2017
351410;202210;3319;8449;2492;6931;413;1250;1130;2887;1543;4137
351420;202210;623;1390;383;991;42;108;247;577;289;685
351430;202210;1310;3051;1075;2680;67;201;819;1932;886;2133
351440;202210;4408;10789;2984;8018;554;1579;929;2092;1483;3671
351450;202210;2123;5235;1475;4101;305;1009;411;875;716;1884
351460;202210;1267;3009;1042;2667;144;397;660;1607;804;2004
351470;202210;1539;3612;1206;3070;77;240;803;1906;880;2146
351480;202210;3123;8099;2488;7096;387;1308;1285;3262;1672;4570
351490;202210;2833;7119;2445;6438;78;304;1979;4978;2057;5282
351492;202210;451;1067;383;934;8;26;300;697;308;723
351495;202210;277;674;223;578;26;57;127;314;153;371
351500;202210;56237;122289;44123;103327;5428;14022;29648;64981;35076;79003
351510;202210;17492;38147;13174;31184;1416;3788;8728;19478;10144;23266
351512;202210;585;1464;412;1100;82;220;133;323;215;543
351515;202210;4134;9020;2616;6462;511;1318;668;1706;1179;3024
351518;202210;2810;6806;1841;5075;277;856;784;1811;1061;2667
351519;202210;747;1947;469;1401;106;350;104;255;210;605
351520;202210;1514;3556;726;2048;82;280;357;883;439;1163
351530;202210;423;1048;257;721;49;137;107;253;156;390
351535;202210;2088;4828;1465;3758;229;619;685;1648;914;2267
351540;202210;3321;7515;2278;5750;224;695;1226;2684;1450;3379
351550;202210;9396;21736;6616;16892;684;1972;3793;8810;4477;10782
351560;202210;625;1690;492;1419;101;325;171;451;272;776
351565;202210;310;807;246;699;41;145;92;208;133;353
351570;202210;28551;68946;22523;57739;1863;5481;15360;36993;17223;42474
351580;202210;269;673;160;476;17;50;70;208;87;258
351590;202210;554;1222;292;764;24;69;163;390;187;459
351600;202210;1660;4156;1272;3414;208;592;609;1465;817;2057
351610;202210;841;1855;538;1337;59;159;296;671;355;830
351620;202210;30039;74449;22336;61890;3288;10619;10942;27374;14230;37993
351630;202210;36699;85893;29903;75047;2523;7483;21517;50762;24040;58245
351640;202210;25674;58735;20740;50553;1309;3918;15342;35015;16651;38933
351650;202210;461;1211;210;629;40;126;50;127;90;253
351660;202210;774;2060;524;1536;92;293;148;356;240;649
351670;202210;7716;19365;5110;13799;1072;2874;2168;5275;3240;8149
351680;202210;510;1330;344;993;73;212;103;252;176;464
351685;202210;576;1494;453;1296;84;246;193;480;277;726
351690;202210;1458;3490;853;2352;93;305;383;942;476;1247
351700;202210;1671;3837;1228;3093;214;612;667;1512;881;2124
351710;202210;973;2318;740;1914;58;180;436;991;494;1171
351720;202210;1933;4623;1369;3666;246;656;648;1610;894;2266
351730;202210;1274;2943;1037;2577;66;194;666;1496;732;1690
351740;202210;4198;9803;3423;8447;447;1249;2025;4552;2472;5801
351750;202210;2156;5208;1358;3789;194;584;668;1715;862;2299
351760;202210;4129;10456;3166;8666;549;1762;1563;3779;2112;5541
351770;202210;2595;6372;2134;5558;535;1329;1126;2815;1661;4144
351780;202210;1397;3339;820;2269;111;343;348;882;459;1225
351790;202210;1924;4175;1493;3578;241;559;910;2109;1151;2668
351800;202210;568;1250;287;745;36;101;116;250;152;351
351810;202210;1409;3361;1157;2996;252;715;564;1345;816;2060
351820;202210;3836;9482;2864;7676;624;1817;1049;2494;1673;4311
351830;202210;6345;14729;4860;12308;389;1192;3287;7659;3676;8851
351840;202210;11750;29461;9209;24984;968;2984;5775;14349;6743;17333
351850;202210;1860;4844;1210;3553;200;666;400;924;600;1590
351860;202210;3372;8932;2619;7614;499;1628;1411;3883;1910;5511
351870;202210;33311;78241;25853;66237;5453;14545;12186;30430;17639;44975
351880;202210;212471;473947;167949;401629;23995;67963;106612;232584;130607;300547
351885;202210;1289;2981;1055;2630;56;188;781;1820;837;2008
351890;202210;1030;2514;664;1912;120;382;162;388;282;770
351900;202210;1549;3821;1182;3277;100;280;775;2081;875;2361
351905;202210;734;1928;545;1556;69;212;250;608;319;820
351907;202210;28814;69415;22816;59153;2389;7080;15038;36478;17427;43558
351910;202210;2100;4913;1530;3821;145;431;919;1970;1064;2401
351920;202210;1087;2686;831;2218;116;353;359;848;475;1201
351925;202210;1234;2997;971;2555;96;319;566;1356;662;1675
351930;202210;5419;12245;4923;11411;470;1318;3961;8761;4431;10079
351940;202210;1373;3309;992;2643;170;500;427;1115;597;1615
351950;202210;2055;4078;1576;3424;75;211;1166;2381;1241;2592
351960;202210;6828;15922;5171;13140;1256;3351;2227;5114;3483;8465
351970;202210;13227;31911;11045;28427;1325;4212;7436;17569;8761;21781
351980;202210;1332;2977;883;2258;123;370;475;1100;598;1470
351990;202210;1782;3921;1320;3264;55;188;726;1576;781;1764
352000;202210;3458;8653;2974;7695;261;806;2071;4935;2332;5741
352010;202210;2969;7137;2362;6186;690;1842;685;1794;1375;3636
352020;202210;2152;5107;1716;4370;245;742;1010;2297;1255;3039
352030;202210;7781;17904;6296;15588;721;2145;4203;9712;4924;11857
352040;202210;5496;12933;3983;10179;664;1880;1560;3496;2224;5376
352042;202210;4540;9923;3194;7865;358;1022;2073;4890;2431;5912
352044;202210;2537;6272;1528;4393;240;793;379;865;619;1658
352050;202210;17634;43824;12036;33083;3257;9597;2753;6117;6010;15714
352060;202210;936;2303;709;1911;126;367;327;806;453;1173
352070;202210;1198;2369;812;1849;64;160;452;939;516;1099
352080;202210;559;1366;350;967;45;111;115;282;160;393
352090;202210;1927;5178;1596;4575;190;630;812;2072;1002;2702
352100;202210;4757;12280;3696;10287;640;2050;1705;4390;2345;6440
352110;202210;888;2308;657;1871;135;393;270;675;405;1068
352115;202210;643;1620;534;1464;130;411;269;651;399;1062
352120;202210;1060;2759;834;2317;78;227;523;1327;601;1554
352130;202210;2390;6268;1528;4218;210;613;708;1764;918;2377
352140;202210;1610;4027;1168;3142;233;623;483;1265;716;1888
352150;202210;1054;2571;773;2101;94;294;485;1234;579;1528
352160;202210;1180;2694;849;2156;88;250;425;1004;513;1254
352170;202210;3698;9221;2876;7624;433;1343;1444;3364;1877;4707
352180;202210;3431;8646;2651;7280;532;1568;1091;2737;1623;4305
352190;202210;2057;4679;1653;4075;298;775;882;2134;1180;2909
352200;202210;420;1235;306;994;42;144;114;355;156;499
352210;202210;29424;60125;23559;52283;1277;3293;18941;40513;20218;43806
352215;202210;767;1879;582;1556;96;278;309;777;405;1055
352220;202210;35091;76042;26871;62678;3570;9608;16916;35538;20486;45146
352230;202210;19899;51675;15715;44189;3861;12029;6190;15326;10051;27355
352240;202210;13494;31731;10520;26974;1884;5407;5606;12936;7490;18343
352250;202210;30972;79806;25649;71099;3106;9501;17212;45779;20318;55280
352260;202210;6415;15017;4570;11483;661;1919;2677;5952;3338;7871
352265;202210;1077;2848;948;2661;155;468;543;1461;698;1929
352270;202210;2563;6703;2020;5618;377;1173;859;2123;1236;3296
352280;202210;3021;6791;2319;5763;304;847;1344;3057;1648;3904
352290;202210;1892;4883;1517;4164;187;565;823;2009;1010;2574
352300;202210;1188;2849;766;2011;81;226;408;971;489;1197
352310;202210;50977;124991;39430;106320;6408;18307;23214;60460;29622;78767
352320;202210;8846;20275;6989;17072;839;2478;4389;9377;5228;11855
352330;202210;3348;7533;2653;6576;281;902;1787;4014;2068;4916
352340;202210;9308;22724;7089;18680;1128;3308;3775;8963;4903;12271
352350;202210;3158;7780;2554;6562;136;428;1898;4622;2034;5050
352360;202210;1912;4522;1529;3856;134;366;1064;2534;1198;2900
352370;202210;1307;3379;1103;3045;40;129;835;2222;875;2351
352380;202210;1169;2816;875;2323;180;501;327;795;507;1296
352390;202210;19238;44388;13542;34524;2071;6010;7808;18153;9879;24163
352400;202210;4498;11850;3497;9931;856;2634;1238;3105;2094;5739
352410;202210;4724;10814;3718;9187;415;1086;2341;5425;2756;6511
352420;202210;1038;2455;703;1907;138;413;244;590;382;1003
352430;202210;11307;24652;8532;20127;1161;3059;4895;10673;6056;13732
352440;202210;24664;61886;18897;51169;4218;12027;7238;18552;11456;30579
352450;202210;961;2252;533;1504;80;246;210;513;290;759
352460;202210;3713;9313;2660;7485;497;1531;1178;3030;1675;4561
352470;202210;3947;9619;3094;8235;265;854;2008;4888;2273;5742
352480;202210;5543;12217;3773;9221;476;1409;2012;4274;2488;5683
352490;202210;1044;2678;827;2301;171;516;355;927;526;1443
352500;202210;13952;33572;9767;26083;3546;11092;2192;3676;5738;14768
352510;202210;5460;13356;4338;11429;473;1457;2894;7091;3367;8548
352520;202210;3770;9217;2900;7761;479;1480;1612;3807;2091;5287
352530;202210;14896;35203;10550;27355;2045;6022;4007;8536;6052;14558
352540;202210;675;1782;502;1442;71;214;236;604;307;818
352550;202210;1189;3020;806;2351;159;545;306;769;465;1314
352560;202210;810;1973;671;1729;49;169;477;1126;526;1295
352570;202210;2629;6875;1751;5165;408;1400;252;416;660;1816
352580;202210;921;2094;768;1841;112;281;478;1078;590;1359
352585;202210;449;1170;321;942;36;126;167;436;203;562
352590;202210;16605;41171;12262;33308;2289;7054;6719;16589;9008;23643
352600;202210;2516;6084;2062;5308;200;580;1394;3302;1594;3882
352610;202210;3529;8699;2694;7336;443;1423;1331;3298;1774;4721
352620;202210;7573;16955;5816;14502;1309;3403;2803;6760;4112;10163
352630;202210;1052;2407;790;2052;141;406;387;933;528;1339
352640;202210;4074;9516;2989;7605;298;838;1850;4316;2148;5154
352650;202210;698;1838;473;1371;74;219;184;492;258;711
352660;202210;1365;3591;1119;3130;100;350;755;1927;855;2277
352670;202210;13845;33295;10092;26274;1740;5040;4908;11326;6648;16366
352680;202210;4059;10957;3004;8637;568;1930;1473;3475;2041;5405
352690;202210;33308;78205;26419;67095;1165;3725;19647;47208;20812;50933
352700;202210;944;2256;719;1889;115;321;346;853;461;1174
352710;202210;6943;16542;5128;13373;1226;3638;2224;5118;3450;8756
352720;202210;12841;29611;10456;25494;1699;4634;5877;13117;7576;17751
352725;202210;648;1427;372;962;19;52;225;528;244;580
352730;202210;5715;16147;5114;14798;648;2112;2513;6118;3161;8230
352740;202210;2925;6629;2225;5598;269;769;1220;2854;1489;3623
352750;202210;510;1207;336;916;43;127;160;387;203;514
352760;202210;2048;5204;1611;4408;199;548;894;2318;1093;2866
352770;202210;1141;2801;813;2210;119;341;420;1055;539;1396
352780;202210;788;2073;555;1598;129;358;170;476;299;834
352790;202210;502;1221;372;964;46;120;165;368;211;488
352800;202210;1655;4572;1153;3481;246;772;222;493;468;1265
352810;202210;1425;3223;957;2409;160;394;505;1218;665;1612
352820;202210;534;1423;397;1190;87;268;102;269;189;537
352830;202210;674;1625;337;952;26;73;117;275;143;348
352840;202210;4941;12876;4028;11292;943;2877;1797;4755;2740;7632
352850;202210;16496;35732;12222;29152;2338;6274;6531;13915;8869;20189
352860;202210;1422;3656;1062;3019;187;582;410;1063;597;1645
352870;202210;1035;2506;710;1857;75;223;442;1085;517;1308
352880;202210;2081;4708;1466;3625;233;603;606;1342;839;1945
352885;202210;444;1086;343;909;49;150;210;521;259;671
352890;202210;873;1911;612;1408;41;120;428;862;469;982
352900;202210;24207;58313;16642;43991;2721;7499;7032;17053;9753;24552
352910;202210;445;1113;245;713;20;59;101;254;121;313
352920;202210;3493;8225;2709;6925;134;427;1981;4759;2115;5186
352930;202210;7401;17998;5685;14692;866;2631;2833;6332;3699;8963
352940;202210;33971;82770;27074;69327;3946;11224;16434;39038;20380;50262
352950;202210;651;1646;409;1197;83;273;114;276;197;549
352960;202210;896;2232;521;1452;64;200;173;361;237;561
352965;202210;316;838;216;647;50;150;62;168;112;318
352970;202210;4850;9234;3994;7975;112;301;3446;6526;3558;6827
352980;202210;1767;4047;1374;3500;323;876;756;1839;1079;2715
352990;202210;5654;13358;4319;11220;722;2076;2398;5892;3120;7968
353000;202210;554;1427;319;919;47;164;117;281;164;445
353010;202210;3224;7460;2261;5726;421;1182;1075;2441;1496;3623
353020;202210;4081;9873;2522;6816;387;1192;992;2390;1379;3582
353030;202210;5967;14148;4132;11049;980;2809;1244;3050;2224;5859
353040;202210;921;1920;679;1560;76;203;455;948;531;1151
353050;202210;6489;16964;4657;13342;779;2493;2425;6462;3204;8955
353060;202210;63613;146596;52771;129864;3129;9620;40634;94663;43763;104283
353070;202210;13889;35697;10355;28371;1668;5146;5094;12349;6762;17495
353080;202210;6357;15656;4461;12089;891;2733;1864;4257;2755;6990
353090;202210;741;2010;600;1745;53;173;377;1041;430;1214
353100;202210;361;885;155;449;34;114;47;98;81;212
353110;202210;10190;23926;8216;21184;1903;4877;4043;10847;5946;15724
353120;202210;608;1441;462;1192;57;195;251;546;308;741
353130;202210;3707;8166;2524;6161;606;1631;1105;2313;1711;3944
353140;202210;3784;8332;2884;6913;273;811;1932;4295;2205;5106
353150;202210;1879;4398;1372;3593;272;791;618;1504;890;2295
353160;202210;769;1867;542;1488;70;223;262;627;332;850
353170;202210;741;1769;580;1538;89;251;317;796;406;1047
353180;202210;11952;27937;9453;23738;2185;6041;4399;10099;6584;16140
353190;202210;4327;10668;3371;8821;392;1168;1988;4712;2380;5880
353200;202210;2137;5415;1358;3907;193;639;518;1291;711;1930
353205;202210;580;1542;479;1327;44;149;270;666;314;815
353210;202210;1188;2359;781;1708;26;70;603;1227;629;1297
353215;202210;492;1203;390;1033;48;154;180;413;228;567
353220;202210;920;2394;628;1804;124;341;185;457;309;798
353230;202210;962;2503;745;2159;187;620;211;540;398;1160
353240;202210;3073;7460;2559;6670;341;1027;1563;3802;1904;4829
353250;202210;1682;3501;1160;2692;157;382;674;1510;831;1892
353260;202210;1437;3166;827;2181;146;424;363;865;509;1289
353270;202210;982;2280;820;2011;85;259;532;1185;617;1444
353280;202210;872;2155;636;1778;134;394;237;633;371;1027
353282;202210;2120;5483;1764;4860;152;492;1109;2837;1261;3329
353284;202210;453;1037;259;680;18;56;113;244;131;300
353286;202210;202;483;124;355;26;77;36;79;62;156
353290;202210;1497;3723;867;2448;161;436;254;657;415;1093
353300;202210;2661;6584;1973;5301;305;929;931;2122;1236;3051
353310;202210;495;1121;372;924;30;101;233;515;263;616
353320;202210;832;2028;684;1801;40;140;435;1042;475;1182
353325;202210;956;2510;685;1956;115;335;303;794;418;1129
353330;202210;793;1847;521;1373;74;217;262;604;336;821
353340;202210;4216;10642;3280;8886;527;1664;1804;4387;2331;6051
353350;202210;5337;12173;3942;9738;942;2453;1233;2689;2175;5142
353360;202210;840;2191;685;1904;76;263;417;1077;493;1340
353370;202210;712;1880;581;1667;45;144;381;1058;426;1202
353380;202210;383;995;310;866;39;142;168;406;207;548
353390;202210;8018;18660;6010;15413;497;1484;3767;8956;4264;10440
353400;202210;681;1678;518;1393;87;267;215;448;302;715
353410;202210;652;1571;482;1259;115;320;241;568;356;888
353420;202210;584;1402;391;1024;65;175;93;194;158;369
353430;202210;2946;7459;2347;6386;437;1250;1125;2850;1562;4100
353440;202210;93735;229494;71224;186284;9284;27603;43717;104584;53001;132187
353450;202210;478;1103;337;877;48;156;170;379;218;535
353460;202210;4125;10331;3072;8420;626;1926;757;1707;1383;3633
353470;202210;11578;27949;8604;22558;1402;4146;4112;9552;5514;13698
353475;202210;2038;4723;1405;3568;141;422;805;1817;946;2239
353480;202210;2024;4751;1662;4205;110;342;1208;2862;1318;3204
353490;202210;1305;3191;958;2569;136;379;463;1127;599;1506
353500;202210;1477;3302;1067;2657;234;635;558;1285;792;1920
353510;202210;1219;3220;890;2506;158;467;334;773;492;1240
353520;202210;1338;3237;865;2394;117;354;384;905;501;1259
353530;202210;3215;7537;2607;6491;295;856;1592;3581;1887;4437
353540;202210;2620;6472;2133;5739;342;1011;1227;3149;1569;4160
353550;202210;7820;17815;6323;15457;929;2437;3884;8844;4813;11281
353560;202210;2866;7082;2239;6161;619;1830;803;1949;1422;3779
353570;202210;778;1952;508;1439;87;277;197;472;284;749
353580;202210;3077;7390;2445;6231;442;1130;1361;3299;1803;4429
353590;202210;921;2152;682;1767;92;236;388;954;480;1190
353600;202210;1901;4552;1418;3710;183;520;739;1844;922;2364
353610;202210;944;2522;711;2063;111;341;335;888;446;1229
353620;202210;3735;8879;2681;7172;565;1587;922;2161;1487;3748
353625;202210;763;1764;446;1199;52;172;241;590;293;762
353630;202210;1925;5231;1629;4656;231;728;913;2386;1144;3114
353640;202210;1722;4094;1331;3440;179;462;843;2058;1022;2520
353650;202210;9151;23089;7120;19475;918;2780;4061;10217;4979;12997
353657;202210;438;1091;331;923;33;107;154;396;187;503
353660;202210;1680;3236;1192;2582;164;385;802;1654;966;2039
353670;202210;5457;13710;4276;11556;764;2388;2126;5112;2890;7500
353680;202210;908;2160;679;1836;97;293;409;1023;506;1316
353690;202210;534;1376;242;719;27;78;65;165;92;243
353700;202210;2676;6301;2191;5545;188;518;1525;3688;1713;4206
353710;202210;6042;13004;3811;9057;545;1312;2099;4317;2644;5629
353715;202210;522;1326;301;863;32;90;130;336;162;426
353720;202210;2508;6043;1937;5152;347;1018;953;2445;1300;3463
353730;202210;6047;14483;4778;12340;587;1819;2953;6955;3540;8774
353740;202210;2613;6351;1892;5102;361;1059;822;1996;1183;3055
353750;202210;1136;3199;847;2664;195;628;231;685;426;1313
353760;202210;18879;37995;14764;32712;2613;6252;8646;18420;11259;24672
353770;202210;774;2062;446;1375;62;227;62;145;124;372
353780;202210;8506;20237;7036;17693;1118;3155;4195;9850;5313;13005
353790;202210;3573;9864;2666;8029;618;2067;643;1581;1261;3648
353800;202210;23299;56185;18884;49345;2735;7394;11189;28051;13924;35445
353810;202210;1449;3556;1019;2704;177;491;444;1108;621;1599
353820;202210;2230;5518;1542;4229;394;1109;424;1017;818;2126
353830;202210;764;1757;575;1473;81;243;306;702;387;945
353850;202210;1994;4955;1541;4161;287;796;692;1735;979;2531
353860;202210;3437;8469;2651;7192;597;1910;1282;2993;1879;4903
353870;202210;36860;89593;26818;70951;3681;10784;13984;33070;17665;43854
353880;202210;3869;9679;3097;8272;220;740;2011;4930;2231;5670
353890;202210;3991;7753;2813;6014;157;446;2018;3836;2175;4282
353900;202210;874;2296;652;1882;86;292;278;703;364;995
353910;202210;3891;9229;3328;8392;237;696;2466;6011;2703;6707
353920;202210;2498;6282;1821;5075;500;1521;451;944;951;2465
353930;202210;6735;16164;4831;12603;880;2538;2190;5010;3070;7548
353940;202210;1602;4289;1158;3422;167;550;478;1235;645;1785
353950;202210;4351;10616;3373;8873;845;2435;1240;2891;2085;5326
353960;202210;945;2305;658;1798;165;425;171;444;336;869
353970;202210;814;1744;632;1481;57;162;469;1035;526;1197
353980;202210;21274;48294;16628;40761;770;2388;12736;29314;13506;31702
353990;202210;1160;2601;802;2010;163;427;415;968;578;1395
354000;202210;3159;7198;1873;4830;387;1056;589;1321;976;2377
354010;202210;412;1004;308;836;54;172;175;443;229;615
354020;202210;4927;11921;3956;10096;729;2076;1991;4492;2720;6568
354025;202210;902;2319;596;1725;83;267;190;485;273;752
354030;202210;629;1328;345;865;62;152;160;375;222;527
354040;202210;979;2079;659;1603;35;109;488;1102;523;1211
354050;202210;1273;3349;899;2713;163;570;385;1076;548;1646
354060;202210;4926;12582;3644;9927;572;1808;1897;4479;2469;6287
354070;202210;5192;12219;3587;9181;574;1667;1747;3861;2321;5528
354075;202210;3574;9081;2901;7947;435;1321;1774;4493;2209;5814
354080;202210;1750;4574;1225;3569;195;597;518;1336;713;1933
354085;202210;515;961;401;821;1;4;301;564;302;568
354090;202210;2171;5484;1859;4857;105;302;1450;3625;1555;3927
354100;202210;29717;73758;21982;60787;4241;12815;10821;27913;15062;40728
354105;202210;1606;3775;1170;3054;162;524;585;1354;747;1878
354110;202210;575;1506;444;1268;85;271;187;493;272;764
354120;202210;1764;4448;1199;3258;233;692;423;954;656;1646
354130;202210;7338;17761;5094;13533;1426;3933;1020;2196;2446;6129
354140;202210;23475;55233;17223;43815;2431;6962;9203;20795;11634;27757
354150;202210;3493;7833;2757;6719;704;1758;921;2197;1625;3955
354160;202210;3442;9048;2767;7821;646;1995;1170;2996;1816;4991
354165;202210;888;2381;697;2016;84;307;420;1083;504;1390
354170;202210;2473;6244;2033;5476;218;685;1124;2697;1342;3382
354180;202210;550;1418;436;1195;39;123;255;638;294;761
354190;202210;1876;4980;1360;3914;99;343;730;1938;829;2281
354200;202210;1152;2597;870;2147;76;224;569;1276;645;1500
354210;202210;1303;3127;1028;2687;76;228;693;1668;769;1896
354220;202210;3889;9491;2921;7726;501;1444;1455;3556;1956;5000
354230;202210;994;2256;815;2039;36;114;614;1464;650;1578
354240;202210;2209;5770;1514;4336;263;816;587;1448;850;2264
354250;202210;776;1807;519;1383;115;303;183;439;298;742
354260;202210;11234;25952;8776;21930;1260;3457;4775;11113;6035;14570
354270;202210;1249;3365;1021;2948;155;489;484;1239;639;1728
354280;202210;1050;2322;875;2056;43;135;665;1418;708;1553
354290;202210;1167;3363;956;2923;146;475;522;1537;668;2012
354300;202210;4325;11498;3630;10246;896;2539;1726;4681;2622;7220
354310;202210;964;2543;820;2297;154;482;452;1162;606;1644
354320;202210;1188;2681;792;2052;110;314;395;872;505;1186
354323;202210;570;1274;363;909;39;105;186;402;225;507
354325;202210;1696;4810;1059;3285;204;643;188;523;392;1166
354330;202210;12547;28986;9037;22292;981;2807;5716;12826;6697;15633
354340;202210;48214;112031;35568;90929;4597;13190;21347;51218;25944;64408
354350;202210;1460;3332;1164;2863;142;453;750;1617;892;2070
354360;202210;781;1767;487;1313;113;324;155;361;268;685
354370;202210;1236;3191;1011;2836;157;467;603;1610;760;2077
354380;202210;761;1925;580;1652;82;305;212;479;294;784
354390;202210;19095;42728;13325;32911;2000;5462;7258;16282;9258;21744
354400;202210;2063;6001;1609;5011;279;940;590;1725;869;2665
354410;202210;8822;20590;6951;17289;1025;2892;4037;9154;5062;12046
354420;202210;1812;4359;1301;3436;163;497;724;1700;887;2197
354425;202210;3571;7970;2624;6393;515;1306;1350;3111;1865;4417
354430;202210;2068;4882;1639;4229;126;372;1084;2613;1210;2985
354440;202210;734;1761;479;1271;53;158;252;587;305;745
354450;202210;589;1490;323;966;50;161;110;263;160;424
354460;202210;994;2393;677;1839;149;450;246;614;395;1064
354470;202210;513;1257;352;963;24;88;147;328;171;416
354480;202210;1658;3515;1106;2634;85;242;720;1571;805;1813
354490;202210;996;2698;734;2146;147;436;336;890;483;1326
354500;202210;2806;7142;2247;6243;623;1844;759;1940;1382;3784
354510;202210;943;2406;746;2050;64;210;452;1100;516;1310
354515;202210;527;1404;363;1074;61;189;125;341;186;530
354520;202210;9910;24770;7289;19458;926;2919;4223;10145;5149;13064
354530;202210;6411;16016;5094;13605;1340;3553;1855;4741;3195;8294
354540;202210;1610;3917;1192;3199;211;609;526;1300;737;1909
354550;202210;702;1803;563;1557;77;248;296;734;373;982
354560;202210;2681;6039;1473;3840;156;422;874;2065;1030;2487
354570;202210;1290;3130;571;1606;124;350;85;230;209;580
354580;202210;10771;27105;7487;20891;1099;3444;4011;10336;5110;13780
354600;202210;2575;6249;2001;5220;301;801;1180;2904;1481;3705
354610;202210;554;1392;311;903;31;99;147;398;178;497
354620;202210;602;1550;375;1126;39;135;175;454;214;589
354625;202210;369;955;223;669;30;104;65;160;95;264
354630;202210;2987;7789;2478;6853;706;1997;706;1780;1412;3777
354640;202210;4824;12254;3759;10237;452;1485;1996;4814;2448;6299
354650;202210;1063;2590;852;2241;161;401;456;1154;617;1555
354660;202210;4359;9658;2535;6748;303;952;1136;2694;1439;3646
354670;202210;1388;3589;978;2766;200;626;336;821;536;1447
354680;202210;7433;17277;5858;14796;967;2667;3459;8379;4426;11046
354690;202210;659;1861;474;1461;79;247;196;553;275;800
354700;202210;1088;2685;772;2081;86;268;439;1057;525;1325
354710;202210;568;1423;387;1073;43;120;180;434;223;554
354720;202210;376;848;188;501;61;156;54;143;115;299
354730;202210;14007;36769;11073;31292;1476;4657;6691;17700;8167;22357
354740;202210;391;1016;171;506;32;103;28;62;60;165
354750;202210;2953;7175;2036;5414;318;944;901;2070;1219;3014
354760;202210;2762;6793;2019;5485;420;1243;730;1730;1150;2973
354765;202210;431;1090;194;569;20;74;70;160;90;234
354770;202210;3112;7163;2295;5721;447;1187;1049;2394;1496;3581
354780;202210;79834;179602;62577;147541;4380;12550;45009;97282;49389;109832
354790;202210;1163;2986;905;2575;71;230;584;1588;655;1818
354800;202210;3403;8131;2567;6780;554;1566;1114;2641;1668;4207
354805;202210;1765;3799;1304;3141;109;285;881;1918;990;2203
354810;202210;724;2005;441;1420;73;270;129;357;202;627
354820;202210;1178;3130;846;2523;165;552;306;738;471;1290
354830;202210;664;1499;380;990;78;216;140;317;218;533
354840;202210;1060;2593;638;1706;55;162;356;848;411;1010
354850;202210;28000;65067;20560;52580;1876;5785;13897;32721;15773;38506
354860;202210;2078;5300;1358;3906;218;668;512;1310;730;1978
354870;202210;83251;192017;65595;160822;5120;14781;45324;102528;50444;117309
354880;202210;7610;17824;4174;10757;500;1485;1920;3903;2420;5388
354890;202210;22845;52322;18163;44377;2351;6629;10610;24208;12961;30837
354900;202210;468;1127;309;846;70;217;113;246;183;463
354910;202210;7362;18303;4684;13495;1039;3185;1293;3259;2332;6444
354920;202210;599;1522;303;927;41;132;74;176;115;308
354925;202210;349;941;198;616;19;55;50;136;69;191
354930;202210;441;1027;299;771;40;104;152;350;192;454
354940;202210;3144;8573;2397;7018;710;2231;843;2116;1553;4347
354950;202210;1956;4467;1611;4025;105;357;1175;2732;1280;3089
354960;202210;1049;2587;742;2088;89;301;331;823;420;1124
354970;202210;5454;13786;4350;11990;355;1225;3024;7851;3379;9076
354980;202210;44574;99014;31705;77469;3154;9354;20892;46573;24046;55927
354990;202210;99071;224702;73329;179866;4801;14663;51343;115318;56144;129981
354995;202210;4200;8014;3305;6899;141;369;2724;5436;2865;5805
355000;202210;1957;4458;1494;3779;225;681;800;1799;1025;2480
355010;202210;5104;12824;3420;9346;1132;3010;770;2016;1902;5026
355020;202210;4304;11259;3270;9515;721;2311;1385;3651;2106;5962
355030;202210;1730516;3973506;1301746;3184533;172555;471227;741016;1649827;913571;2121054
355040;202210;4400;9581;3487;8392;302;791;2653;6223;2955;7014
355050;202210;1378;2920;1015;2416;238;577;445;979;683;1556
355060;202210;8293;20508;6267;16914;988;3059;3463;8449;4451;11508
355070;202210;13375;30864;11165;27433;1215;3535;7520;17100;8735;20635
355080;202210;1189;3193;755;2408;169;580;134;356;303;936
355090;202210;1692;4233;1364;3686;241;715;727;1787;968;2502
355100;202210;34854;81045;28705;72036;3268;9230;20057;47876;23325;57106
355110;202210;1200;3059;865;2560;189;601;80;211;269;812
355120;202210;912;2204;642;1805;79;250;324;846;403;1096
355130;202210;1035;2131;596;1361;24;68;434;888;458;956
355140;202210;2838;5319;2421;4751;82;209;2151;4076;2233;4285
355150;202210;6051;14335;4928;12470;537;1493;3253;7788;3790;9281
355160;202210;2904;7337;2081;5939;469;1459;597;1520;1066;2979
355170;202210;15155;34996;12072;30008;1958;5400;6931;16186;8889;21586
355180;202210;3534;8296;2636;6938;496;1533;1336;3142;1832;4675
355190;202210;2342;5779;1855;5005;688;1907;601;1735;1289;3642
355200;202210;1088;3038;922;2772;256;859;328;930;584;1789
355210;202210;3943;9827;2999;7897;633;1741;1322;3251;1955;4992
355220;202210;66766;159455;54520;136995;7524;21524;31815;72335;39339;93859
355230;202210;1516;3656;824;2275;150;437;303;697;453;1134
355240;202210;30946;76718;22414;60598;2340;7149;13725;34386;16065;41535
355250;202210;50932;123795;39312;102265;8152;22793;19561;46797;27713;69590
355255;202210;770;1828;405;1169;50;135;125;343;175;478
355260;202210;1973;4229;1456;3447;113;348;1032;2233;1145;2581
355270;202210;1450;3922;1145;3333;258;784;507;1350;765;2134
355280;202210;41358;96041;30749;77281;3657;10200;17993;41722;21650;51922
355290;202210;1177;2887;920;2475;168;450;460;1162;628;1612
355300;202210;1727;4603;1428;4060;239;731;646;1628;885;2359
355310;202210;1137;2886;843;2373;113;354;479;1283;592;1637
355320;202210;685;1703;506;1369;109;345;207;453;316;798
355330;202210;3765;8757;2959;7404;126;419;2274;5323;2400;5742
355340;202210;5118;10743;3936;9233;732;1750;1981;4750;2713;6500
355350;202210;1766;4540;1344;3750;251;800;603;1506;854;2306
355360;202210;1612;3705;1265;3180;142;382;758;1732;900;2114
355365;202210;448;1060;247;724;45;129;73;191;118;320
355370;202210;7041;16476;5523;14120;1208;2752;2588;6883;3796;9635
355380;202210;3698;9053;2869;7610;566;1641;1112;2508;1678;4149
355385;202210;1760;4173;1447;3720;106;333;952;2205;1058;2538
355390;202210;995;2581;719;2017;108;335;349;857;457;1192
355395;202210;2253;5990;1630;4752;267;872;698;1767;965;2639
355400;202210;11836;31218;9578;26963;2034;6503;4129;10267;6163;16770
355410;202210;30905;78698;20787;58544;4033;12539;7752;20083;11785;32622
355420;202210;760;2257;629;2012;133;489;210;610;343;1099
355430;202210;4672;10934;3626;9143;629;1710;1853;4467;2482;6177
355440;202210;913;2299;589;1666;96;268;130;303;226;571
355450;202210;4473;10738;3105;8177;446;1323;1535;3519;1981;4842
355460;202210;605;1407;404;1068;41;121;182;444;223;565
355465;202210;555;1323;444;1148;65;166;280;708;345;874
355470;202210;1460;3486;858;2316;220;664;302;713;522;1377
355475;202210;417;893;340;794;13;32;255;566;268;598
355480;202210;5327;13565;4256;11890;581;1872;2701;7224;3282;9096
355490;202210;1107;2819;638;1880;62;204;301;800;363;1004
355495;202210;1143;2866;848;2366;117;409;389;919;506;1328
355500;202210;8785;20807;5838;15363;798;2419;2720;6213;3518;8632
355510;202210;1654;3836;1133;2988;206;556;478;1122;684;1678
355520;202210;389;892;195;553;40;122;49;125;89;247
355530;202210;371;805;162;415;8;30;93;207;101;237
355535;202210;669;1707;536;1490;101;324;279;674;380;998
355540;202210;16588;36513;13941;32900;1460;3867;10146;22869;11606;26736
355550;202210;781;2143;658;1918;76;264;374;967;450;1231
355560;202210;1360;3364;779;2238;167;532;32;99;199;631
355570;202210;350;878;195;550;48;144;50;129;98;273
355580;202210;1469;3368;874;2327;160;481;255;603;415;1084
355590;202210;200;497;148;412;15;43;79;209;94;252
355600;202210;1762;4167;1126;3030;174;514;330;833;504;1347
355610;202210;2451;5641;1672;4313;238;667;936;2161;1174;2828
355620;202210;6347;15730;4876;12977;524;1709;2886;6875;3410;8584
355630;202210;3232;7929;2356;6326;268;797;1410;3424;1678;4221
355635;202210;1214;3273;875;2598;132;412;325;872;457;1284
355640;202210;4345;11140;2904;8335;692;1966;594;1680;1286;3646
355645;202210;4775;12469;3476;10154;497;1612;1920;5297;2417;6909
355650;202210;9581;23458;7723;20195;1563;4315;3856;9221;5419;13536
355660;202210;1696;4181;1130;3193;207;542;280;728;487;1270
355670;202210;5353;13231;3849;10105;495;1584;1993;4433;2488;6017
355680;202210;3402;8865;1723;5142;469;1498;133;364;602;1862
355690;202210;899;2485;610;1945;180;598;13;25;193;623
355695;202210;315;818;186;548;17;57;37;77;54;134
355700;202210;10254;26366;8673;23158;1069;3257;5384;13348;6453;16605
355710;202210;12615;27915;8766;21006;1169;3348;4784;9790;5953;13138
355715;202210;558;1458;309;900;80;227;57;161;137;388
355720;202210;1844;4663;1453;4008;228;703;801;2000;1029;2703
355730;202210;1299;3243;1041;2799;108;344;603;1479;711;1823
410010;202210;1500;3939;1133;3186;252;749;259;665;511;1414
410020;202210;1340;3573;986;2838;288;806;265;694;553;1500
410030;202210;2076;5073;1719;4520;242;648;896;2345;1138;2993
410040;202210;17939;45511;13305;37095;2827;8412;4464;11273;7291;19685
410045;202210;907;2344;659;1837;129;399;214;506;343;905
410050;202210;2664;6428;1873;5078;288;883;715;1750;1003;2633
410060;202210;2494;6561;2002;5667;496;1512;580;1497;1076;3009
410070;202210;2389;5669;1742;4536;331;969;686;1555;1017;2524
410080;202210;1625;4106;1159;3305;261;768;251;644;512;1412
410090;202210;1383;3064;1123;2697;137;288;561;1463;698;1751
410100;202210;2519;6716;1732;4980;320;995;171;442;491;1437
410105;202210;636;1489;399;1050;27;82;213;496;240;578
410110;202210;3988;9179;2854;7238;355;1031;1516;3434;1871;4465
410115;202210;670;1651;481;1321;63;198;191;450;254;648
410120;202210;3909;9284;3436;8594;567;1360;2203;5424;2770;6784
410130;202210;1605;3896;1407;3554;212;567;828;2011;1040;2578
410140;202210;21293;48882;14265;36669;2672;7501;4653;10608;7325;18109
410150;202210;19886;45076;10863;28028;1843;5188;3508;7662;5351;12850
410160;202210;3585;9445;2909;8271;624;2003;1091;2863;1715;4866
410165;202210;741;1895;580;1563;78;241;298;739;376;980
410170;202210;3518;8607;2172;5832;408;1186;320;718;728;1904
410180;202210;21007;54179;16372;45167;2658;8137;8203;20115;10861;28252
410185;202210;533;1452;403;1140;76;230;141;333;217;563
410190;202210;2666;6340;1903;4987;389;1029;503;1140;892;2169
410200;202210;6982;15027;3893;9887;768;2097;730;1624;1498;3721
410210;202210;3766;9022;2373;6582;383;1186;801;1865;1184;3051
410220;202210;650;1598;439;1212;88;262;147;352;235;614
410230;202210;2355;5876;1795;4791;268;809;773;1748;1041;2557
410240;202210;6128;15313;4236;11785;849;2720;700;1644;1549;4364
410250;202210;2771;6368;2033;5197;209;589;966;2329;1175;2918
410260;202210;2412;5490;1534;3909;283;713;770;1804;1053;2517
410270;202210;592;1476;427;1182;55;182;179;417;234;599
410275;202210;722;1881;494;1397;75;247;212;518;287;765
410280;202210;2840;7042;1950;5393;249;789;879;2134;1128;2923
410290;202210;3963;10299;2757;7899;844;2316;745;2109;1589;4425
410300;202210;839;1955;662;1688;64;197;351;783;415;980
410302;202210;398;951;239;670;25;82;108;281;133;363
410304;202210;1791;3888;1559;3493;156;375;1157;2467;1313;2842
410305;202210;2062;4588;1445;3696;137;385;953;2313;1090;2698
410310;202210;3686;8746;3051;7663;233;799;2084;4806;2317;5605
410315;202210;897;1911;559;1390;168;418;170;413;338;831
410320;202210;1150;3068;748;2265;96;311;119;314;215;625
410322;202210;783;2014;407;1176;57;167;149;361;206;528
410330;202210;1779;4111;1236;3129;202;519;426;969;628;1488
410335;202210;1009;2521;756;2068;131;388;290;706;421;1094
410337;202210;955;2268;659;1707;93;253;236;518;329;771
410340;202210;559;1485;376;1053;28;101;169;374;197;475
410345;202210;3236;7996;1972;5390;439;1219;730;1764;1169;2983
410347;202210;919;2236;681;1831;82;225;206;529;288;754
410350;202210;1983;4556;1440;3702;148;454;822;1861;970;2315
410360;202210;4723;11376;3525;9311;618;1715;1241;3109;1859;4824
410370;202210;17156;43431;11297;30267;1323;4042;4891;10887;6214;14929
410380;202210;2122;4872;1504;3827;226;648;579;1282;805;1930
410390;202210;3493;7836;2344;5970;489;1504;955;2035;1444;3539
410395;202210;1081;2870;843;2416;174;494;313;916;487;1410
410400;202210;9575;22187;7316;18171;879;2447;4500;10152;5379;12599
410405;202210;1071;2347;752;1875;112;313;376;832;488;1145
410410;202210;1939;4524;1733;4206;130;375;1217;2882;1347;3257
410420;202210;14923;37084;11324;30304;1861;5405;5158;12254;7019;17659
410425;202210;4480;11410;3087;8631;540;1612;1179;2903;1719;4515
410430;202210;16198;38066;11522;29838;1789;5148;4663;10741;6452;15889
410440;202210;2902;7607;2500;6887;392;1201;1389;3606;1781;4807
410442;202210;2993;8213;2381;6952;664;2022;631;1721;1295;3743
410445;202210;2707;7194;1864;5575;414;1355;258;824;672;2179
410450;202210;1829;4268;1355;3546;235;644;472;1124;707;1768
410460;202210;2926;6758;2117;5373;305;884;1048;2338;1353;3222
410465;202210;3603;9574;2745;7998;541;1598;936;2356;1477;3954
410470;202210;2883;7354;2038;5896;620;2023;196;552;816;2575
410480;202210;48828;111421;28116;76068;4150;12683;8366;18767;12516;31450
410490;202210;14392;36575;10508;28908;1754;5235;4788;11703;6542;16938
410500;202210;2180;5319;1423;3930;284;805;299;666;583;1471
410510;202210;2175;5101;1520;3986;347;876;457;1190;804;2066
410520;202210;3627;10373;3171;9524;1006;3200;1160;3435;2166;6635
410530;202210;1858;4371;891;2423;117;357;248;535;365;892
410540;202210;3400;8554;2360;6541;381;1222;1046;2584;1427;3806
410550;202210;9347;23583;6416;17577;1062;3247;1971;4438;3033;7685
410560;202210;1880;4588;1372;3606;304;889;397;838;701;1727
410570;202210;3247;8053;2305;6455;793;2557;231;595;1024;3152
410580;202210;35171;83711;26614;68650;3912;11366;14074;33042;17986;44408
410590;202210;2078;5397;1441;3962;200;588;465;1031;665;1619
410600;202210;2201;5350;1719;4463;355;924;630;1559;985;2483
410610;202210;837;2002;623;1626;56;167;315;722;371;889
410620;202210;3408;8601;2436;6572;610;1767;665;1578;1275;3345
410630;202210;3085;7460;2046;5474;394;1235;503;1004;897;2239
410640;202210;6133;13562;4227;10315;942;2529;680;1638;1622;4167
410645;202210;1651;3824;1378;3493;141;400;1060;2624;1201;3024
410650;202210;3004;7624;2071;5762;386;1177;865;2116;1251;3293
410655;202210;1023;2354;702;1811;76;234;300;662;376;896
410657;202210;723;1866;453;1303;69;214;182;425;251;639
410660;202210;4507;10516;2755;7000;426;1155;1013;2217;1439;3372
410670;202210;1206;2888;733;1987;125;351;266;612;391;963
410680;202210;2866;8052;1893;5713;441;1361;328;957;769;2318
410685;202210;628;1524;454;1219;100;295;188;465;288;760
410690;202210;174351;398095;122136;305141;18660;53136;54920;118656;73580;171792
410700;202210;2950;7040;2404;6206;546;1457;945;2254;1491;3711
410710;202210;1080;2584;691;1865;165;476;278;657;443;1133
410712;202210;817;2092;678;1842;101;289;373;970;474;1259
410715;202210;1044;2803;652;1959;74;251;273;746;347;997
410720;202210;4579;10611;3760;9274;544;1653;1397;3148;1941;4801
410725;202210;1420;3271;870;2300;202;590;193;408;395;998
410730;202210;981;2374;684;1839;98;306;154;408;252;714
410740;202210;1009;2670;762;2221;61;222;392;1107;453;1329
410750;202210;2364;5357;1855;4472;299;771;919;2042;1218;2813
410752;202210;466;1074;249;673;58;140;94;240;152;380
410753;202210;406;1102;285;850;39;137;90;237;129;374
410754;202210;1344;3167;1117;2843;77;194;806;2078;883;2272
410755;202210;680;1644;493;1315;63;173;229;534;292;707
410760;202210;4370;10752;3101;8507;721;2364;842;2096;1563;4460
410765;202210;21657;54626;17162;46392;3471;10388;5739;13073;9210;23461
410770;202210;1218;2767;839;2146;83;185;427;1087;510;1272
410773;202210;1599;3802;1362;3415;174;489;876;2056;1050;2545
410775;202210;1993;4197;1741;3848;43;112;1344;2808;1387;2920
410780;202210;751;1763;501;1309;92;258;159;367;251;625
410785;202210;953;2173;694;1770;93;280;306;736;399;1016
410790;202210;1261;3413;1028;2984;223;698;154;352;377;1050
410800;202210;4172;8366;3337;7217;64;188;2331;4732;2395;4920
410810;202210;541;1355;400;1090;42;155;208;479;250;634
410820;202210;1208;3194;673;1874;144;430;143;300;287;730
410830;202210;54545;120101;39218;95163;6360;17774;19155;41752;25515;59526
410832;202210;1320;3256;1075;2840;98;320;669;1584;767;1904
410840;202210;10993;26006;6523;17674;1334;4097;1937;4165;3271;8262
410845;202210;1457;3177;1151;2740;151;416;683;1488;834;1904
410850;202210;2579;6712;2234;6127;409;1279;1080;2717;1489;3996
410855;202210;851;2012;536;1411;63;188;272;613;335;801
410860;202210;5897;12903;4683;10964;229;720;3294;7046;3523;7766
410865;202210;1734;4582;1468;4103;190;576;794;2298;984;2874
410870;202210;1417;3553;1119;3044;142;427;629;1620;771;2047
410880;202210;5717;14296;3919;11102;699;2037;731;2036;1430;4073
410890;202210;1374;3469;1093;2963;211;578;485;1207;696;1785
410895;202210;1208;3529;988;3055;307;1053;263;703;570;1756
410900;202210;1006;2542;675;1957;98;306;159;336;257;642
410910;202210;525;1139;324;776;16;42;188;395;204;437
410920;202210;1090;2406;811;1986;109;306;445;1008;554;1314
410930;202210;2098;5064;1442;3957;367;1137;254;596;621;1733
410940;202210;30314;75894;22322;61939;4235;13136;8996;22722;13231;35858
410950;202210;2416;6200;2148;5779;166;444;1656;4383;1822;4827
410960;202210;10521;23572;7409;18661;1932;5660;3036;6893;4968;12553
410965;202210;1364;3293;862;2379;108;346;401;1003;509;1349
410970;202210;5072;12841;3579;9978;907;2984;639;1344;1546;4328
410975;202210;1771;3936;1302;3202;184;512;585;1322;769;1834
410980;202210;9057;21069;5947;15684;637;1879;2911;6802;3548;8681
410990;202210;1809;3972;1254;3147;214;601;598;1423;812;2024
411000;202210;811;2094;555;1630;102;335;179;447;281;782
411005;202210;566;1315;353;905;41;112;144;306;185;418
411007;202210;3074;7615;2243;6155;461;1410;827;2061;1288;3471
411010;202210;5476;14847;4196;12343;1202;3625;681;1726;1883;5351
411020;202210;2839;7370;2325;6521;594;1748;734;1957;1328;3705
411030;202210;848;2019;570;1474;80;227;231;497;311;724
411040;202210;1217;2921;645;1729;116;313;177;387;293;700
411050;202210;2393;6982;1879;5912;407;1417;350;895;757;2312
411060;202210;2690;6714;1727;4780;351;1007;495;1178;846;2185
411065;202210;463;1114;286;767;28;87;118;277;146;364
411070;202210;9411;21781;7461;18683;965;2779;4142;9568;5107;12347
411080;202210;2407;5896;1928;5076;470;1414;573;1342;1043;2756
411090;202210;939;2413;586;1722;83;263;139;350;222;613
411095;202210;2970;6705;1719;4534;240;668;308;665;548;1333
411100;202210;1472;3580;987;2707;117;399;363;905;480;1304
411110;202210;763;1929;353;1052;38;99;28;56;66;155
411120;202210;1940;4705;1595;4164;280;910;755;1710;1035;2620
411125;202210;6560;17509;5755;16099;1478;4268;2335;6578;3813;10846
411130;202210;891;2211;620;1696;174;456;169;476;343;932
411140;202210;2609;7501;2113;6468;519;1666;621;1901;1140;3567
411150;202210;4885;11647;3192;8360;676;1919;333;666;1009;2585
411155;202210;1313;3023;888;2273;116;351;457;967;573;1318
411160;202210;467;991;302;731;33;96;89;209;122;305
411170;202210;975;2600;735;2112;162;522;319;839;481;1361
411180;202210;7172;17107;5721;14578;776;2273;3081;6978;3857;9251
411190;202210;2496;6040;1905;5034;253;753;886;2028;1139;2781
411200;202210;6107;15153;4611;12527;970;3080;1549;3434;2519;6514
411210;202210;4280;9041;3036;7038;414;1099;1433;3030;1847;4129
411220;202210;1169;2752;797;2089;162;443;263;614;425;1057
411230;202210;1028;2582;760;2085;171;499;243;605;414;1104
411240;202210;1888;4233;1311;3282;230;622;514;1180;744;1802
411250;202210;2746;6772;1975;5413;417;1259;585;1438;1002;2697
411260;202210;373;915;251;676;37;128;100;224;137;352
411270;202210;2419;6033;1767;4782;280;814;837;2006;1117;2820
411275;202210;1978;4067;1412;3205;132;387;895;1805;1027;2192
411280;202210;1777;4441;1284;3530;300;884;386;925;686;1809
411290;202210;1014;2445;657;1760;67;220;357;881;424;1101
411295;202210;1514;3614;1098;2869;169;467;499;1171;668;1638
411300;202210;1196;2860;758;2034;87;268;293;623;380;891
411310;202210;1139;2356;884;2028;140;358;476;997;616;1355
411320;202210;7056;16445;5314;13488;761;2173;2652;5810;3413;7983
411325;202210;1712;4442;1389;3850;276;784;655;1855;931;2639
411330;202210;3899;9799;2854;7961;671;2084;861;2224;1532;4308
411340;202210;985;2554;587;1703;84;253;180;444;264;697
411342;202210;1263;2910;685;1780;124;361;257;547;381;908
411345;202210;1466;3409;1055;2710;74;227;690;1696;764;1923
411350;202210;3556;8965;2330;6575;596;1783;392;959;988;2742
411360;202210;954;2063;714;1695;73;225;402;810;475;1035
411370;202210;71888;167835;52883;136392;4140;12814;31704;74209;35844;87023
411373;202210;1732;4034;1359;3486;160;431;659;1688;819;2119
411375;202210;1332;3162;917;2398;112;315;371;877;483;1192
411380;202210;1398;3018;943;2196;41;108;640;1354;681;1462
411390;202210;1877;4712;1456;3845;223;672;631;1365;854;2037
411400;202210;2857;6477;2155;5274;219;617;1216;2741;1435;3358
411410;202210;3491;9215;2584;7351;591;1843;668;1639;1259;3482
411420;202210;5066;11825;2705;7469;367;1131;529;1041;896;2172
411430;202210;4865;11789;3679;9679;708;2069;1315;2940;2023;5009
411435;202210;530;1356;302;901;49;159;77;194;126;353
411440;202210;3137;8027;2437;6742;503;1506;721;1761;1224;3267
411450;202210;3129;7611;2356;6359;334;894;1313;3507;1647;4401
411460;202210;5428;13339;3439;9607;528;1693;851;1896;1379;3589
411470;202210;1068;2456;815;2036;109;344;435;937;544;1281
411480;202210;6579;16186;4782;12955;914;2910;1530;3503;2444;6413
411490;202210;2051;4810;1549;4044;208;610;675;1567;883;2177
411500;202210;1655;4147;1148;3106;194;566;253;530;447;1096
411510;202210;2800;6370;2199;5445;344;1002;672;1607;1016;2609
411520;202210;43214;100524;26285;68106;3131;9642;11725;25992;14856;35634
411530;202210;1120;2713;620;1766;97;318;128;326;225;644
411535;202210;612;1687;415;1255;51;168;127;336;178;504
411540;202210;3191;7270;2256;5638;135;342;1361;3254;1496;3596
411545;202210;1072;2896;895;2576;69;222;586;1649;655;1871
411550;202210;834;1947;634;1594;89;238;215;457;304;695
411560;202210;2322;6118;1260;3827;197;634;101;217;298;851
411570;202210;9249;20125;6472;15996;1509;4024;2080;4683;3589;8707
411573;202210;938;2367;752;2046;131;420;382;923;513;1343
411575;202210;2439;6075;1787;4847;334;959;578;1409;912;2368
411580;202210;5491;12645;3305;8994;489;1498;585;1230;1074;2728
411585;202210;713;2016;354;1123;61;191;64;183;125;374
411590;202210;554;1393;412;1119;42;140;224;539;266;679
411600;202210;413;964;263;716;39;106;113;268;152;374
411605;202210;1903;4135;1230;3121;157;461;598;1514;755;1975
411610;202210;3525;7215;2566;5607;63;205;1938;3842;2001;4047
411620;202210;3640;8646;3032;7741;525;1401;1494;3742;2019;5143
411630;202210;1029;2460;669;1836;103;355;272;617;375;972
411640;202210;558;1390;381;1020;52;146;141;309;193;455
411650;202210;233;637;146;446;28;91;36;94;64;185
411660;202210;1056;2497;737;1904;96;258;312;703;408;961
411670;202210;1848;4087;1227;2987;114;298;717;1578;831;1876
411680;202210;1714;4306;1263;3436;247;734;456;1137;703;1871
411690;202210;4811;11403;3532;9208;761;1978;1096;2865;1857;4843
411695;202210;756;2115;514;1517;44;140;228;615;272;755
411700;202210;1968;4864;1331;3670;322;925;268;668;590;1593
411705;202210;2931;7504;2457;6724;392;1114;1535;4239;1927;5353
411710;202210;2487;5989;1707;4561;362;1005;527;1233;889;2238
411720;202210;1248;2868;874;2214;127;332;315;718;442;1050
411721;202210;1178;2814;873;2266;152;398;278;670;430;1068
411722;202210;1123;2932;654;1875;109;319;232;526;341;845
411725;202210;1522;4075;980;2997;233;776;226;622;459;1398
411727;202210;1716;4478;1125;3263;238;716;141;304;379;1020
411729;202210;702;1699;402;1116;69;227;115;252;184;479
411730;202210;6668;16157;5143;13316;946;2744;2352;5704;3298;8448
411740;202210;582;1453;317;901;77;207;68;150;145;357
411745;202210;929;2497;641;1865;83;268;161;354;244;622
411750;202210;7577;18470;5616;14866;716;2086;2860;7024;3576;9110
411760;202210;9033;21816;6816;18280;2037;5673;1472;4045;3509;9718
411770;202210;3967;10662;2910;8440;634;1971;676;1707;1310;3678
411780;202210;3184;8199;2715;7429;717;2032;970;2736;1687;4768
411790;202210;3777;8493;2333;6005;330;1007;879;1873;1209;2880
411800;202210;1390;3746;992;2798;193;600;241;542;434;1142
411810;202210;1844;4480;1350;3543;219;612;511;1183;730;1795
411820;202210;19753;47852;16609;42672;3760;9887;8627;21345;12387;31232
411830;202210;585;1426;429;1139;104;233;63;161;167;394
411840;202210;15201;37689;10691;28837;1668;4942;3910;9048;5578;13990
411845;202210;756;2030;467;1397;72;243;137;357;209;600
411850;202210;9707;22970;6697;17828;1737;4884;1367;3127;3104;8011
411860;202210;897;2365;665;1904;106;334;146;387;252;721
411870;202210;705;1913;511;1500;133;456;94;214;227;670
411880;202210;2950;6563;2138;5297;288;789;994;2247;1282;3036
411885;202210;1281;3206;897;2487;125;404;242;530;367;934
411890;202210;1779;4470;1283;3616;234;717;149;388;383;1105
411900;202210;1013;2585;628;1789;165;493;93;244;258;737
411910;202210;1305;3620;935;2865;183;665;302;802;485;1467
411915;202210;19421;45117;13507;34602;2000;5693;6009;13587;8009;19280
411920;202210;1421;3758;1157;3281;267;841;441;1110;708;1951
411925;202210;587;1429;394;1078;71;201;186;459;257;660
411930;202210;6154;16888;5188;15192;2496;7673;604;1919;3100;9592
411940;202210;4065;10803;3178;9070;746;2204;1165;2937;1911;5141
411950;202210;19171;47058;15954;41959;1801;5529;10223;25154;12024;30683
411960;202210;7238;17846;5680;14928;1022;3016;2308;5389;3330;8405
411965;202210;595;1539;427;1201;57;175;204;505;261;680
411970;202210;1413;2903;1100;2495;212;407;496;1322;708;1729
411980;202210;1992;4368;1462;3568;283;700;691;1572;974;2272
411990;202210;48984;119347;32993;91260;5814;17805;13866;35111;19680;52916
411995;202210;6006;13527;4622;11424;1242;3437;1443;3291;2685;6728
412000;202210;2349;4959;1686;3858;42;138;1277;2689;1319;2827
412010;202210;729;2046;502;1571;62;215;118;274;180;489
412015;202210;619;1627;494;1393;76;220;255;711;331;931
412020;202210;561;1505;344;1057;56;200;109;299;165;499
412030;202210;748;1953;558;1613;72;225;257;666;329;891
412033;202210;1108;2761;772;2129;81;232;317;750;398;982
412035;202210;833;2147;530;1591;89;277;252;716;341;993
412040;202210;835;2117;512;1470;75;212;116;273;191;485
412050;202210;1733;4103;1203;3181;297;865;253;635;550;1500
412060;202210;8836;23454;7165;20191;1907;6113;2018;5159;3925;11272
412065;202210;762;1937;558;1550;104;312;151;384;255;696
412070;202210;1591;3776;1230;3112;148;429;581;1232;729;1661
412080;202210;3207;7774;2362;6193;309;926;1181;2604;1490;3530
412085;202210;393;912;151;425;11;42;40;79;51;121
412090;202210;7875;18339;5807;14853;1257;3532;2510;6159;3767;9691
412100;202210;2227;5471;1635;4458;499;1490;416;1149;915;2639
412110;202210;1136;2830;702;1965;84;246;224;521;308;767
412120;202210;2787;7161;2149;6049;454;1450;673;1592;1127;3042
412125;202210;882;2318;550;1640;95;284;123;338;218;622
412130;202210;946;2237;620;1635;117;305;145;359;262;664
412135;202210;689;1763;340;997;43;161;134;326;177;487
412140;202210;2364;5405;1674;4230;296;815;456;1086;752;1901
412150;202210;3336;8002;2768;7021;486;1435;1425;3165;1911;4600
412160;202210;1072;3221;561;1846;45;150;43;89;88;239
412170;202210;5593;13795;4670;12348;867;2525;2241;5287;3108;7812
412175;202210;1584;4217;1291;3692;293;858;468;1295;761;2153
412180;202210;2042;5271;1512;4323;206;675;625;1616;831;2291
412190;202210;3903;9270;2804;7330;342;1024;1181;2819;1523;3843
412200;202210;2322;6169;1509;4385;384;1223;305;768;689;1991
412210;202210;782;1778;480;1286;72;215;218;525;290;740
412215;202210;4035;10083;2873;7834;629;1800;1257;3386;1886;5186
412217;202210;1221;2857;1001;2484;19;63;763;1743;782;1806
412220;202210;7213;19502;5758;16819;1347;3943;1673;4753;3020;8696
412230;202210;3315;8955;2561;7569;373;1271;477;1177;850;2448
412240;202210;9579;23552;6300;17356;1127;3362;1995;4708;3122;8070
412250;202210;2337;5709;1679;4492;412;1184;345;780;757;1964
412260;202210;1639;3962;1231;3186;230;616;413;971;643;1587
412265;202210;1237;2951;985;2558;120;349;617;1464;737;1813
412270;202210;1259;3266;838;2397;113;365;346;863;459;1228
412280;202210;503;1285;377;1061;85;241;95;229;180;470
412290;202210;1285;2992;934;2403;165;460;361;860;526;1320
412300;202210;2147;5185;1573;4208;272;766;495;1178;767;1944
412310;202210;794;2196;586;1783;100;364;157;393;257;757
412320;202210;879;2145;555;1505;56;203;180;439;236;642
412330;202210;1913;4721;1260;3539;265;824;378;1005;643;1829
412340;202210;1420;3623;1001;2818;162;512;142;355;304;867
412350;202210;3799;9462;2487;6939;460;1384;665;1574;1125;2958
412360;202210;345;835;261;678;5;18;186;460;191;478
412370;202210;1307;3319;903;2552;195;566;224;598;419;1164
412380;202210;1801;4766;1290;3781;315;993;86;261;401;1254
412382;202210;589;1363;384;1020;42;149;204;436;246;585
412385;202210;2837;6850;2260;5833;627;1591;837;2233;1464;3824
412390;202210;2992;6809;2326;5742;423;1112;772;1814;1195;2926
412395;202210;902;2332;637;1766;87;242;313;803;400;1045
412400;202210;1134;2762;780;2097;137;397;251;578;388;975
412402;202210;2879;6664;1987;5229;422;1101;570;1481;992;2582
412405;202210;3640;9159;2374;6871;667;1920;337;907;1004;2827
412410;202210;7787;19042;5733;15761;1028;3270;1890;4692;2918;7962
412420;202210;631;1493;402;1052;40;120;170;392;210;512
412430;202210;650;1568;355;962;46;119;144;358;190;477
412440;202210;3568;8703;2489;6855;575;1621;768;2005;1343;3626
412450;202210;625;1727;403;1193;58;180;40;73;98;253
412460;202210;1387;3205;1065;2680;192;523;493;1175;685;1698
412470;202210;1908;5481;1562;4738;364;1251;452;1224;816;2475
412480;202210;1598;3747;1086;2777;188;522;434;964;622;1486
412490;202210;1605;3635;1221;2998;86;245;737;1639;823;1884
412500;202210;2468;5768;1820;4629;305;844;619;1359;924;2203
412510;202210;2329;6534;1672;4980;450;1455;321;728;771;2183
412520;202210;1656;3963;1001;2691;210;548;163;382;373;930
412530;202210;807;2051;582;1621;96;281;131;328;227;609
412535;202210;945;2403;547;1591;81;245;59;119;140;364
412540;202210;1287;3160;914;2510;172;599;231;597;403;1196
412545;202210;862;2121;573;1560;102;301;183;465;285;766
412550;202210;45095;111058;33043;88219;4816;14171;15882;37480;20698;51651
412555;202210;350;851;233;603;27;91;80;148;107;239
412560;202210;6412;16755;4797;13326;1135;3474;1197;2909;2332;6383
412570;202210;5464;12737;3298;8802;575;1736;658;1426;1233;3162
412575;202210;1335;3034;1079;2627;205;505;554;1212;759;1717
412580;202210;1906;4484;1358;3526;118;348;776;1820;894;2168
412590;202210;541;1349;289;810;57;180;38;72;95;252
412600;202210;2063;4914;1624;4103;107;352;1053;2392;1160;2744
412610;202210;1003;2521;723;1947;98;279;333;766;431;1045
412620;202210;1517;3655;1164;3110;226;665;486;1180;712;1845
412625;202210;11249;28378;7406;20966;1447;4362;967;2264;2414;6626
412627;202210;1367;3577;951;2782;228;751;210;553;438;1304
412630;202210;3331;9232;2314;7080;398;1333;565;1493;963;2826
412635;202210;538;1353;332;944;46;146;106;237;152;383
412640;202210;1186;3002;676;1936;104;294;133;307;237;601
412650;202210;2006;5180;1577;4315;259;805;626;1492;885;2297
412660;202210;3390;8008;2405;6193;285;817;934;2089;1219;2906
412665;202210;496;1176;380;982;70;199;157;376;227;575
412667;202210;2000;5043;1443;3955;217;660;622;1616;839;2276
412670;202210;1127;2420;760;1846;145;398;306;609;451;1007
412680;202210;2497;6274;1692;4817;192;634;529;1231;721;1865
412690;202210;1383;3352;966;2568;187;546;345;793;532;1339
412700;202210;2272;5511;1874;4893;340;962;929;2277;1269;3239
412710;202210;6843;18550;5063;14929;896;2897;1424;3463;2320;6360
412720;202210;1525;4090;1224;3483;190;598;387;848;577;1446
412730;202210;3273;7921;2395;6292;405;1215;1011;2320;1416;3535
412740;202210;2425;6347;1646;4865;319;1058;276;748;595;1806
412750;202210;4768;11747;3842;10320;459;1371;2241;5619;2700;6990
412760;202210;3767;9260;3127;8201;590;1805;1745;4212;2335;6017
412770;202210;14371;35650;8029;23392;1079;3355;1906;4490;2985;7845
412780;202210;1519;3680;1105;2964;261;782;384;912;645;1694
412785;202210;2661;5764;1857;4480;264;651;1176;2719;1440;3370
412788;202210;1669;4393;1343;3829;349;1011;517;1385;866;2396
412790;202210;1649;4090;1035;2936;167;538;396;920;563;1458
412795;202210;1460;3540;825;2320;139;424;183;447;322;871
412796;202210;2662;7133;2234;6397;511;1586;722;1867;1233;3453
412800;202210;5031;11009;3634;8582;379;1113;2025;4084;2404;5197
412810;202210;15692;37700;10551;27777;1214;3728;4644;10555;5858;14283
412820;202210;7658;19721;5445;15417;1323;3976;1559;4184;2882;8160
412830;202210;403;1081;299;873;36;103;82;214;118;317
412840;202210;2318;5122;1645;3896;132;387;1023;2120;1155;2507
412850;202210;3302;8057;2465;6695;285;912;1261;3086;1546;3998
412853;202210;1964;4482;1642;3940;200;579;971;1988;1171;2567
412855;202210;1623;3952;861;2382;116;354;192;408;308;762
412860;202210;885;2126;574;1612;101;323;225;535;326;858
412862;202210;780;1869;522;1443;100;262;205;534;305;796
412863;202210;1524;4156;1339;3814;288;923;660;1678;948;2601
412865;202210;816;2089;587;1631;149;426;155;399;304;825
412870;202210;1165;2785;828;2255;239;730;235;603;474;1333
412880;202210;1108;2821;802;2257;163;503;289;711;452;1214
420005;202210;524;1444;303;915;30;88;149;438;179;526
420010;202210;3868;8825;2588;6677;165;485;1924;4891;2089;5376
420020;202210;585;1711;398;1253;74;270;144;355;218;625
420030;202210;141;477;101;373;28;113;24;87;52;200
420040;202210;698;2007;420;1388;87;331;34;92;121;423
420050;202210;897;2012;618;1500;118;333;351;739;469;1072
420055;202210;198;570;112;358;21;79;40;112;61;191
420060;202210;188;522;135;400;23;61;55;159;78;220
420070;202210;1059;2877;823;2411;167;540;426;1163;593;1703
420075;202210;98;254;52;158;7;26;19;40;26;66
420080;202210;506;1383;354;1005;70;217;116;281;186;498
420090;202210;529;1558;342;1130;70;260;85;226;155;486
420100;202210;1801;4065;1471;3552;104;262;1090;2602;1194;2864
420110;202210;341;1003;291;896;47;160;154;455;201;615
420120;202210;744;1920;514;1439;75;240;253;629;328;869
420125;202210;448;1289;316;998;67;215;101;294;168;509
420127;202210;385;995;171;512;31;114;72;191;103;305
420130;202210;5602;14574;4286;12302;826;2687;1813;4497;2639;7184
420140;202210;5496;13815;4229;11655;1171;3560;1111;2774;2282;6334
420150;202210;819;1977;605;1641;51;156;357;929;408;1085
420160;202210;257;617;110;320;20;73;34;83;54;156
420165;202210;207;593;129;411;26;90;40;105;66;195
420170;202210;375;1061;291;862;53;171;125;308;178;479
420180;202210;190;589;109;394;19;86;27;84;46;170
420190;202210;255;721;150;459;28;85;51;137;79;222
420195;202210;2333;5693;1809;4852;455;1394;791;1889;1246;3283
420200;202210;9078;20439;6035;14972;807;2346;3038;6274;3845;8620
420205;202210;2621;6542;1791;4878;267;813;942;2398;1209;3211
420207;202210;2673;6460;1754;4772;312;958;750;1810;1062;2768
420208;202210;416;1136;245;781;79;266;55;135;134;401
420209;202210;207;623;129;405;15;56;64;175;79;231
420210;202210;5150;12454;3731;10026;579;1769;1968;4885;2547;6654
420213;202210;981;2720;800;2355;163;526;319;882;482;1408
420215;202210;285;804;196;603;48;158;57;174;105;332
420220;202210;414;1192;282;913;47;183;111;304;158;487
420230;202210;7289;18109;5735;15318;716;2172;3311;8104;4027;10276
420240;202210;19024;50495;12451;35446;1533;5104;5921;14181;7454;19285
420243;202210;565;1348;470;1182;78;219;315;758;393;977
420245;202210;2433;5759;1865;4805;168;508;1164;2778;1332;3286
420250;202210;716;1653;634;1533;46;147;494;1114;540;1261
420253;202210;582;1341;420;1112;34;93;257;662;291;755
420257;202210;200;494;138;386;23;70;69;195;92;265
420260;202210;1524;3527;1166;3052;91;294;878;2219;969;2513
420270;202210;705;1742;361;957;42;130;161;370;203;500
420280;202210;1817;4917;1470;4216;203;697;709;1844;912;2541
420285;202210;185;507;114;333;20;81;34;62;54;143
420287;202210;563;1217;398;991;76;199;175;416;251;615
420290;202210;6860;18217;5424;15193;746;2449;3192;8095;3938;10544
420300;202210;9457;25183;5548;16268;1060;3418;1775;4454;2835;7872
420310;202210;1116;2376;623;1540;58;165;340;745;398;910
420315;202210;1080;2796;714;2086;94;302;371;1006;465;1308
420320;202210;7750;19539;5869;16539;1675;5089;1870;4876;3545;9965
420325;202210;408;1089;284;843;41;141;112;282;153;423
420330;202210;1270;3554;792;2487;148;522;251;675;399;1197
420340;202210;1463;3571;1127;2983;255;719;437;1024;692;1743
420350;202210;1672;3750;1276;3089;146;395;856;1987;1002;2382
420360;202210;3620;9445;1985;5998;372;1208;185;502;557;1710
420370;202210;1678;4075;1354;3524;119;395;924;2221;1043;2616
420380;202210;5596;13795;3882;10700;733;2276;1729;4306;2462;6582
420390;202210;1329;3204;950;2467;180;533;343;614;523;1147
420395;202210;1532;4074;1082;3211;158;516;209;457;367;973
420400;202210;1385;3527;976;2748;123;398;527;1370;650;1768
420410;202210;710;1751;535;1403;67;188;318;815;385;1003
420415;202210;419;1136;308;886;58;192;137;376;195;568
420417;202210;765;2157;595;1790;132;384;282;881;414;1265
420419;202210;188;627;133;473;51;196;12;50;63;246
420420;202210;17471;43408;12330;33833;3134;9704;4301;10429;7435;20133
420425;202210;776;2048;534;1532;51;179;283;748;334;927
420430;202210;4084;10385;2589;7214;430;1379;1106;2648;1536;4027
420435;202210;371;937;224;666;41;133;108;304;149;437
420440;202210;1033;2530;698;1839;215;520;250;637;465;1157
420445;202210;286;656;180;466;26;75;62;122;88;197
420450;202210;1040;2894;765;2289;142;515;300;752;442;1267
420455;202210;2595;5793;1928;4799;462;1156;804;1994;1266;3150
420460;202210;12045;30014;9334;25129;1261;3936;5255;13012;6516;16948
420470;202210;752;1903;415;1161;69;220;116;256;185;476
420475;202210;83;212;36;108;4;16;11;25;15;41
420480;202210;6997;16384;4593;12314;801;2280;2022;5165;2823;7445
420490;202210;458;1207;319;906;48;160;150;386;198;546
420500;202210;1663;4277;1112;3301;194;675;510;1376;704;2051
420510;202210;189;505;111;342;20;73;31;74;51;147
420515;202210;143;393;101;303;13;49;36;87;49;136
420517;202210;879;2195;725;1910;83;233;421;1095;504;1328
420519;202210;381;925;264;730;34;101;127;341;161;442
420520;202210;346;915;195;629;28;95;8;12;36;107
420530;202210;966;2769;665;2093;122;439;224;579;346;1018
420535;202210;256;710;105;331;12;42;32;80;44;122
420540;202210;50931;116450;35674;91106;4793;14225;15354;33417;20147;47642
420543;202210;285;795;221;646;30;106;96;243;126;349
420545;202210;1788;5175;1354;4204;282;930;505;1408;787;2338
420550;202210;5094;12420;3409;9520;558;1705;1474;3889;2032;5594
420555;202210;420;1132;285;856;36;133;152;415;188;548
420560;202210;505;1136;358;928;52;128;209;537;261;665
420570;202210;3691;8891;2791;7275;451;1353;1502;3588;1953;4941
420580;202210;2150;5652;1503;4539;347;1147;457;1239;804;2386
420590;202210;3689;9532;2346;6662;383;1262;700;1557;1083;2819
420600;202210;1506;3885;1220;3362;107;404;789;2003;896;2407
420610;202210;671;1762;455;1337;101;295;216;614;317;909
420620;202210;1025;2471;707;1927;137;411;285;739;422;1150
420630;202210;1268;3646;923;2828;155;523;440;1254;595;1777
420640;202210;589;1573;311;997;88;285;34;99;122;384
420650;202210;4625;11462;3116;8408;457;1426;1406;3096;1863;4522
420660;202210;527;1286;334;879;64;183;72;154;136;337
420665;202210;877;2156;595;1673;102;321;272;657;374;978
420670;202210;1494;4071;901;2770;107;364;199;473;306;837
420675;202210;253;624;163;467;13;51;100;261;113;312
420680;202210;347;745;196;536;27;100;110;265;137;365
420690;202210;1139;3105;751;2201;110;355;261;629;371;984
420700;202210;3795;9408;2973;7974;249;768;2009;5112;2258;5880
420710;202210;1347;3617;1099;3101;134;472;641;1564;775;2036
420720;202210;1625;4149;1230;3443;194;603;732;1890;926;2493
420730;202210;4466;10936;3451;9260;587;1776;1819;4457;2406;6233
420740;202210;562;1583;324;1069;81;286;43;117;124;403
420750;202210;2639;7317;1754;5319;289;1074;660;1736;949;2810
420757;202210;127;321;62;196;8;29;30;94;38;123
420760;202210;472;1303;254;743;38;117;85;211;123;328
420765;202210;663;1817;350;1050;56;196;189;534;245;730
420768;202210;1663;4245;1438;3878;163;436;1046;2780;1209;3216
420770;202210;423;1123;186;643;19;78;38;112;57;190
420775;202210;356;943;212;652;39;136;80;210;119;346
420780;202210;1184;3196;711;2116;129;374;128;354;257;728
420785;202210;273;668;200;528;18;58;92;182;110;240
420790;202210;1400;3735;1069;3058;196;678;611;1557;807;2235
420800;202210;915;2080;570;1448;133;355;300;708;433;1063
420810;202210;1829;5120;1518;4519;358;1273;736;1861;1094;3134
420820;202210;17186;41323;12752;34209;1886;5589;6620;16429;8506;22018
420830;202210;6189;15209;4659;12533;802;2440;2097;5195;2899;7635
420840;202210;682;2044;359;1242;76;279;36;110;112;389
420845;202210;3623;8826;2508;6891;491;1606;1113;2787;1604;4393
420850;202210;1399;4099;941;2991;175;605;275;751;450;1356
420860;202210;473;1218;284;865;72;229;81;211;153;440
420870;202210;1028;2735;697;2062;146;465;246;664;392;1129
420880;202210;1445;4067;1147;3481;231;779;486;1338;717;2117
420890;202210;9795;25439;6204;18034;910;2933;2181;5439;3091;8372
420895;202210;221;607;142;414;21;67;69;182;90;249
420900;202210;1967;4670;1226;3375;161;570;567;1288;728;1858
420910;202210;43564;109657;29529;83439;4427;14381;13285;32357;17712;46738
420915;202210;568;1923;450;1626;75;310;236;843;311;1153
420917;202210;596;1441;286;710;46;91;157;388;203;479
420920;202210;109;274;46;136;4;12;11;27;15;39
420930;202210;22395;53417;16661;43522;2369;7098;9154;21667;11523;28765
420940;202210;4222;9888;2737;7393;573;1768;766;1600;1339;3368
420945;202210;230;668;136;404;24;81;57;143;81;224
420950;202210;486;1300;316;925;52;179;95;231;147;410
420960;202210;1343;3163;980;2582;156;479;454;1045;610;1524
420970;202210;2881;7299;1997;5699;419;1245;650;1844;1069;3089
420980;202210;314;1028;261;905;89;323;65;223;154;546
420985;202210;450;1177;263;814;49;167;71;188;120;355
420990;202210;443;1272;273;876;46;153;59;162;105;315
421000;202210;682;1966;479;1534;105;354;102;261;207;615
421003;202210;540;1287;189;527;13;32;17;36;30;68
421005;202210;125;358;87;274;17;52;34;109;51;161
421010;202210;4509;11414;3285;9158;575;1877;1217;2754;1792;4631
421020;202210;478;1418;383;1234;60;233;197;579;257;812
421030;202210;1277;3366;972;2750;212;671;388;993;600;1664
421040;202210;824;1891;501;1381;54;161;307;802;361;963
421050;202210;1442;3677;967;2649;151;465;382;866;533;1331
421055;202210;192;498;113;326;17;54;56;142;73;196
421060;202210;915;2442;658;1892;116;394;306;749;422;1143
421070;202210;810;2254;510;1525;80;274;234;597;314;871
421080;202210;643;1785;509;1517;83;298;227;620;310;918
421085;202210;416;1149;183;602;23;73;33;90;56;163
421090;202210;349;879;200;537;20;74;78;165;98;239
421100;202210;1069;2249;500;1325;80;227;147;321;227;548
421105;202210;1963;4961;1416;3941;240;720;648;1669;888;2389
421110;202210;1609;3788;1338;3399;120;374;879;2173;999;2547
421120;202210;1338;3829;935;2949;134;460;297;792;431;1252
421125;202210;449;1092;321;823;89;250;132;309;221;559
421130;202210;7318;19562;6058;17068;1114;3502;3246;8463;4360;11965
421140;202210;431;1102;290;821;61;179;110;275;171;454
421145;202210;506;1316;342;984;93;300;101;240;194;540
421150;202210;901;2397;611;1792;115;385;260;646;375;1031
421160;202210;771;2000;599;1657;83;284;377;950;460;1234
421165;202210;279;787;174;521;29;91;56;132;85;223
421170;202210;1464;3632;1252;3299;117;317;920;2397;1037;2714
421175;202210;1258;3123;768;2265;138;473;339;923;477;1396
421180;202210;494;1209;281;788;36;120;142;330;178;450
421185;202210;399;974;284;753;38;117;147;349;185;466
421187;202210;319;952;194;636;38;116;72;230;110;346
421189;202210;500;1350;377;1106;58;201;161;416;219;617
421190;202210;16976;42902;12514;34496;2107;6628;5791;14091;7898;20719
421200;202210;949;2446;741;2057;92;314;419;1081;511;1395
421205;202210;275;701;208;579;43;125;88;235;131;360
421210;202210;1368;3293;776;2270;170;485;255;707;425;1192
421220;202210;1777;4879;1406;4120;384;1204;488;1278;872;2482
421223;202210;479;1179;331;925;63;191;189;500;252;691
421225;202210;1256;3322;1090;3061;126;430;730;1981;856;2411
421227;202210;856;2281;562;1660;116;360;234;682;350;1042
421230;202210;749;1891;509;1448;103;324;183;492;286;816
421240;202210;325;921;149;500;25;111;29;66;54;177
421250;202210;3086;7427;2303;6162;384;1023;1331;3387;1715;4410
421260;202210;299;915;79;248;17;54;9;23;26;77
421265;202210;1111;2476;965;2292;78;177;807;1898;885;2075
421270;202210;458;1207;238;749;54;183;90;262;144;445
421280;202210;3050;7601;2318;6358;368;1156;1208;3066;1576;4222
421290;202210;1367;3578;654;1871;108;325;146;361;254;686
421300;202210;386;999;187;589;31;107;37;108;68;215
421310;202210;269;741;186;569;56;180;76;216;132;396
421315;202210;379;957;243;674;47;128;83;213;130;341
421320;202210;754;2278;417;1335;40;126;62;104;102;230
421330;202210;748;2097;503;1545;107;341;143;400;250;741
421335;202210;468;1334;384;1186;62;214;186;540;248;754
421340;202210;1770;4665;1238;3700;200;669;537;1486;737;2155
421350;202210;2090;4989;1409;3860;261;767;536;1407;797;2174
421360;202210;2701;6801;1655;4734;421;1409;565;1233;986;2642
421370;202210;935;2819;603;1956;111;399;200;530;311;929
421380;202210;1066;2530;933;2334;88;270;643;1519;731;1789
421390;202210;187;498;77;262;20;71;21;61;41;132
421400;202210;780;2002;523;1506;89;299;245;608;334;907
421410;202210;233;647;121;425;32;93;33;147;65;240
421415;202210;247;649;177;475;26;79;70;157;96;236
421420;202210;750;1968;542;1514;59;187;288;740;347;927
421430;202210;109;334;70;232;9;27;12;30;21;57
421440;202210;813;2091;503;1494;94;267;210;603;304;870
421450;202210;563;1586;349;1107;49;161;42;128;91;289
421460;202210;427;1282;239;853;14;48;19;50;33;98
421470;202210;422;1124;291;871;41;131;103;307;144;438
421480;202210;3814;9697;2663;7373;366;1213;1196;2950;1562;4163
421490;202210;141;444;86;300;12;52;19;56;31;108
421500;202210;2873;7783;2019;6020;432;1504;622;1488;1054;2992
421505;202210;393;983;325;879;29;100;206;535;235;635
421507;202210;527;1363;317;911;57;177;140;354;197;531
421510;202210;508;1331;342;966;47;165;163;365;210;530
421520;202210;561;1443;337;914;49;125;130;300;179;425
421530;202210;406;1169;235;783;33;149;48;109;81;258
421535;202210;539;1331;337;915;47;140;187;467;234;607
421540;202210;419;942;240;662;28;88;89;222;117;310
421545;202210;802;2253;614;1910;125;448;294;830;419;1278
421550;202210;2814;7077;2153;5898;355;1059;1168;3019;1523;4078
421555;202210;249;682;72;226;10;33;16;28;26;61
421560;202210;117;370;69;236;12;46;22;59;34;105
421565;202210;1198;2936;867;2404;205;622;353;882;558;1504
421567;202210;624;1817;462;1388;133;437;129;375;262;812
421568;202210;380;1066;215;659;38;134;75;203;113;337
421569;202210;193;527;89;257;11;43;50;127;61;170
421570;202210;1861;4854;1357;3841;246;786;577;1391;823;2177
421575;202210;394;1083;282;786;34;118;152;374;186;492
421580;202210;5858;14997;3853;10868;536;1762;1643;3889;2179;5651
421590;202210;225;605;171;490;37;119;74;192;111;311
421600;202210;725;1822;486;1320;84;260;182;411;266;671
421605;202210;842;2128;617;1763;111;309;260;747;371;1056
421610;202210;1231;3110;850;2397;169;535;310;798;479;1333
421620;202210;4932;12268;3406;9563;664;2121;1435;3576;2099;5697
421625;202210;167;464;87;266;14;41;22;53;36;94
421630;202210;3518;8785;2329;6534;399;1272;848;2028;1247;3300
421635;202210;520;1338;352;1002;30;117;204;489;234;606
421640;202210;840;2103;599;1732;133;398;290;787;423;1185
421650;202210;3218;8201;2234;6424;479;1612;793;1964;1272;3576
421660;202210;14992;38832;11068;31220;1561;5100;5606;14057;7167;19157
421670;202210;1104;2918;772;2107;145;460;356;841;501;1301
421680;202210;2199;4342;1847;3814;90;277;1561;2992;1651;3269
421690;202210;1846;5032;1278;3850;254;838;371;1015;625;1853
421700;202210;738;2077;492;1508;95;324;144;364;239;688
421710;202210;261;785;143;451;19;63;62;174;81;237
421715;202210;193;479;142;359;22;71;90;202;112;273
421720;202210;2595;6751;1558;4540;337;1087;482;1184;819;2271
421725;202210;346;821;190;533;29;91;84;195;113;286
421730;202210;643;1798;414;1171;66;192;208;526;274;718
421740;202210;1025;2725;697;2053;119;384;274;678;393;1062
421750;202210;1152;2665;621;1709;132;390;222;558;354;948
421755;202210;213;578;118;350;21;73;45;109;66;182
421760;202210;1309;3250;863;2443;163;531;331;800;494;1331
421770;202210;3089;7667;2216;6168;426;1213;884;2352;1310;3565
421775;202210;255;656;152;441;18;56;54;122;72;178
421780;202210;1146;3054;763;2258;138;449;343;904;481;1353
421790;202210;1096;2838;603;1866;121;386;195;539;316;925
421795;202210;235;652;168;502;27;82;53;142;80;224
421800;202210;4098;10344;3092;8505;480;1466;1646;4183;2126;5649
421810;202210;713;1833;490;1430;59;178;249;708;308;886
421820;202210;1374;3805;911;2715;175;613;317;780;492;1393
421825;202210;1967;4498;1661;4038;119;318;1239;2936;1358;3254
421830;202210;2366;6499;1764;5263;380;1236;428;1165;808;2401
421835;202210;310;716;216;559;33;93;123;310;156;403
421840;202210;388;1172;308;986;59;216;93;270;152;486
421850;202210;475;1329;270;910;47;164;58;147;105;311
421860;202210;338;895;193;600;27;98;66;162;93;260
421870;202210;6284;14825;4804;12083;513;1604;2959;6551;3472;8155
421875;202210;373;1066;155;477;24;77;35;89;59;166
421880;202210;806;2201;535;1608;111;317;141;408;252;725
421885;202210;323;849;203;578;29;81;95;244;124;325
421890;202210;1205;3183;924;2642;134;482;568;1482;702;1964
421895;202210;523;1260;451;1148;57;130;288;762;345;892
421900;202210;1328;3356;972;2583;115;372;481;1061;596;1433
421910;202210;404;1198;225;754;32;137;47;116;79;253
421915;202210;483;1316;292;869;66;208;63;151;129;359
421917;202210;750;1652;431;1212;112;340;107;301;219;641
421920;202210;494;1427;345;1112;113;381;106;332;219;713
421930;202210;3903;9395;2257;6318;436;1333;809;1945;1245;3278
421935;202210;515;1438;421;1247;97;277;246;720;343;997
421940;202210;441;1229;206;613;35;113;62;153;97;266
421950;202210;3916;9556;2320;6510;454;1408;683;1586;1137;2994
421960;202210;188;447;103;293;11;34;39;89;50;123
421970;202210;2450;6010;1572;4228;288;901;704;1639;992;2540
421985;202210;397;1063;273;809;34;107;134;367;168;474
422000;202210;2485;5823;2016;5117;160;506;1417;3467;1577;3973
430003;202210;717;1801;500;1425;83;258;255;707;338;965
430005;202210;394;955;287;776;18;58;190;469;208;527
430010;202210;2266;4847;1672;3950;336;760;886;2108;1222;2868
430020;202210;679;1484;497;1222;62;182;307;693;369;875
430030;202210;1287;2797;743;1816;117;314;403;875;520;1189
430040;202210;12095;26731;7776;19635;2015;5400;2143;4946;4158;10346
430045;202210;676;1500;493;1193;25;77;376;871;401;948
430047;202210;289;618;112;289;21;56;36;84;57;140
430050;202210;995;2341;603;1601;110;305;278;689;388;994
430055;202210;326;753;158;415;16;52;82;181;98;233
430057;202210;108;237;48;131;13;37;13;34;26;71
430060;202210;25096;60720;20053;52972;3294;9492;11058;27884;14352;37376
430063;202210;894;2308;743;2025;141;391;427;1145;568;1536
430064;202210;1409;3482;1023;2777;174;502;554;1441;728;1943
430066;202210;131;284;100;233;8;23;80;176;88;199
430070;202210;775;1946;171;521;32;103;25;60;57;163
430080;202210;1130;2677;659;1738;94;304;355;802;449;1106
430085;202210;1126;2242;686;1574;103;259;332;728;435;987
430087;202210;1096;2480;904;2229;83;250;613;1451;696;1701
430090;202210;546;1361;212;667;38;130;47;124;85;254
430100;202210;1257;2858;733;1894;123;344;266;584;389;928
430105;202210;1729;4102;1208;3230;185;574;604;1508;789;2082
430107;202210;197;540;98;283;14;37;30;74;44;111
430110;202210;2680;6187;2013;5177;330;911;959;2365;1289;3276
430120;202210;1553;4086;1071;2959;179;486;489;1261;668;1747
430130;202210;4314;9017;3201;7507;1109;2578;667;1859;1776;4437
430140;202210;1258;3040;894;2396;140;403;450;1145;590;1548
430150;202210;669;1656;375;1072;80;249;108;273;188;522
430155;202210;283;679;128;373;20;63;24;49;44;112
430160;202210;26966;55334;21771;48300;1759;4590;15444;32396;17203;36986
430163;202210;4271;8636;3062;6907;74;248;2490;5345;2564;5593
430165;202210;389;951;142;426;13;38;26;62;39;100
430170;202210;1128;2792;392;1238;83;314;72;157;155;471
430175;202210;1019;2382;871;2108;159;385;495;1156;654;1541
430180;202210;819;1926;600;1537;121;306;268;672;389;978
430185;202210;758;1859;376;1049;99;292;79;185;178;477
430187;202210;1013;1967;750;1658;84;171;520;1131;604;1302
430190;202210;1778;4125;1393;3540;247;648;683;1625;930;2273
430192;202210;137;356;59;165;12;32;19;44;31;76
430195;202210;507;1407;81;258;9;29;16;39;25;68
430200;202210;1386;3638;1083;3098;309;914;277;841;586;1755
430205;202210;631;1281;585;1196;8;25;547;1090;555;1115
430210;202210;8215;20204;5164;13802;753;2207;1516;3095;2269;5302
430215;202210;405;941;249;641;35;101;110;265;145;366
430220;202210;694;1665;234;703;28;96;74;177;102;273
430222;202210;282;727;192;556;30;93;69;182;99;275
430223;202210;317;767;239;637;24;69;142;362;166;431
430225;202210;30;64;24;55;2;3;15;32;17;35
430230;202210;2480;6002;2080;5441;114;349;1669;4283;1783;4632
430235;202210;518;1338;328;952;50;155;93;213;143;368
430237;202210;632;1332;474;1088;23;66;375;826;398;892
430240;202210;1629;3628;905;2359;122;371;428;966;550;1337
430245;202210;915;2225;731;1898;128;319;436;1160;564;1479
430250;202210;1243;2801;899;2253;312;833;215;472;527;1305
430258;202210;156;389;118;316;12;34;58;151;70;185
430260;202210;854;2018;586;1540;63;190;339;859;402;1049
430265;202210;275;758;187;596;25;92;72;229;97;321
430270;202210;4126;8555;3352;7430;351;959;2495;5159;2846;6118
430280;202210;6225;13239;4503;10454;739;1786;2332;5082;3071;6868
430290;202210;2688;5555;2191;4964;163;416;1694;3695;1857;4111
430300;202210;12914;28999;9920;24151;1266;3513;5986;13549;7252;17062
430310;202210;16471;37926;11976;29975;1463;4066;6860;15802;8323;19868
430320;202210;1154;2730;660;1786;64;169;369;967;433;1136
430330;202210;783;1814;457;1181;80;209;164;378;244;587
430340;202210;754;1637;516;1268;68;170;335;785;403;955
430350;202210;10553;23640;8165;19732;1007;2634;5039;11472;6046;14106
430355;202210;401;1057;159;496;32;99;17;42;49;141
430360;202210;1042;2367;642;1680;150;440;195;438;345;878
430367;202210;423;871;264;618;38;120;158;318;196;438
430370;202210;574;1496;235;688;45;132;60;134;105;266
430380;202210;765;1807;387;1135;77;238;93;237;170;475
430390;202210;4222;9696;2767;7142;591;1661;372;704;963;2365
430400;202210;1288;2506;944;2042;163;386;478;955;641;1341
430410;202210;655;1433;474;1156;43;119;344;803;387;922
430420;202210;3723;8555;2901;6973;378;1093;1846;3955;2224;5048
430430;202210;624;1503;276;804;49;157;52;134;101;291
430435;202210;2146;4884;1591;3956;268;713;787;1880;1055;2593
430440;202210;5267;12823;4246;11188;485;1408;2690;6855;3175;8263
430450;202210;9312;20084;7626;17355;1254;3275;4351;9117;5605;12392
430460;202210;47929;109672;35452;89584;4744;13280;20102;47705;24846;60985
430461;202210;252;642;96;275;20;68;39;91;59;159
430462;202210;372;911;194;559;37;108;53;129;90;237
430463;202210;8705;20997;6469;17021;1272;3736;2981;7305;4253;11041
430465;202210;690;1576;462;1161;71;203;272;647;343;850
430466;202210;5873;13337;4753;11682;796;2124;2736;6202;3532;8326
430467;202210;624;1411;458;1156;46;136;281;650;327;786
430468;202210;1737;3866;1424;3434;105;334;1097;2523;1202;2857
430469;202210;706;1914;124;385;10;34;34;66;44;100
430470;202210;7028;16849;4716;12870;1234;3839;1280;3036;2514;6875
430471;202210;885;2162;751;1936;109;333;492;1169;601;1502
430480;202210;726;1923;460;1354;68;217;146;337;214;554
430485;202210;201;495;96;257;23;50;23;60;46;110
430490;202210;508;1215;293;794;37;108;142;318;179;426
430495;202210;463;1207;314;928;46;145;154;426;200;571
430500;202210;1185;2858;835;2298;270;825;236;568;506;1393
430510;202210;34260;83189;24868;65819;4236;12550;11464;27071;15700;39621
430511;202210;400;1067;151;467;22;60;19;42;41;102
430512;202210;1248;2566;992;2196;218;514;424;914;642;1428
430513;202210;940;2122;475;1191;60;182;275;599;335;781
430515;202210;458;1176;328;922;38;119;160;419;198;538
430517;202210;1655;4230;1266;3425;205;548;728;1927;933;2475
430520;202210;1593;3807;880;2330;146;406;241;566;387;972
430530;202210;1121;2662;471;1343;76;224;132;343;208;567
430535;202210;4380;10376;3161;8284;448;1218;1655;4075;2103;5293
430537;202210;636;1429;569;1302;53;104;445;996;498;1100
430540;202210;715;1652;437;1198;62;177;253;663;315;840
430543;202210;1279;2179;793;1613;179;337;237;541;416;878
430544;202210;829;2213;548;1612;137;436;189;533;326;969
430545;202210;3115;7207;2362;6123;386;1004;1341;3414;1727;4418
430550;202210;436;1138;323;912;86;238;94;245;180;483
430558;202210;182;399;76;193;3;7;39;93;42;100
430560;202210;347;778;180;514;28;87;62;150;90;237
430570;202210;1017;2320;719;1819;139;449;350;717;489;1166
430580;202210;966;2269;702;1874;168;447;269;768;437;1215
430583;202210;209;510;48;136;3;10;13;26;16;36
430585;202210;247;572;129;342;25;78;46;98;71;176
430587;202210;238;609;176;508;20;63;78;220;98;283
430590;202210;1624;3647;1272;3097;139;370;868;2043;1007;2413
430593;202210;34;94;26;67;6;19;13;28;19;47
430595;202210;496;1225;132;399;19;54;32;71;51;125
430597;202210;533;1272;269;748;22;57;79;165;101;222
430600;202210;2285;5689;1003;2783;157;446;242;588;399;1034
430605;202210;1604;3830;1165;3081;175;491;533;1346;708;1837
430607;202210;814;1727;543;1263;31;84;363;784;394;868
430610;202210;7572;16319;5412;13137;1348;3842;1980;4175;3328;8017
430613;202210;305;679;88;240;8;23;27;57;35;80
430620;202210;931;2091;705;1701;130;375;374;760;504;1135
430630;202210;506;1325;156;451;30;86;45;108;75;194
430632;202210;506;1277;217;607;38;102;81;212;119;314
430635;202210;703;1454;517;1139;47;97;378;824;425;921
430637;202210;585;1328;445;1114;43;125;292;684;335;809
430640;202210;1338;3433;905;2572;131;387;351;878;482;1265
430642;202210;420;1124;262;748;40;135;105;268;145;403
430645;202210;195;444;99;247;12;31;33;59;45;90
430650;202210;2246;5515;1661;4592;518;1342;622;1922;1140;3264
430655;202210;367;852;221;568;27;86;123;264;150;350
430660;202210;6346;14682;4877;12375;805;2254;2603;6237;3408;8491
430670;202210;716;1630;524;1306;90;221;239;570;329;791
430673;202210;608;1318;282;746;58;149;105;255;163;404
430675;202210;284;803;71;235;10;32;12;39;22;71
430676;202210;7090;16037;5678;13878;903;2281;3427;8065;4330;10346
430680;202210;1424;3423;927;2482;292;817;307;645;599;1462
430690;202210;3872;9137;3097;7812;931;2425;1241;3029;2172;5454
430692;202210;241;688;193;608;11;38;152;486;163;524
430693;202210;1117;2779;678;1935;147;459;190;495;337;954
430695;202210;465;1057;280;694;52;133;127;285;179;418
430697;202210;583;1343;456;1168;68;182;284;724;352;906
430700;202210;9789;22423;6323;16294;1300;3695;1716;3753;3016;7448
430705;202210;432;959;215;576;25;72;91;216;116;288
430710;202210;2311;4169;1570;3211;89;239;1217;2328;1306;2567
430720;202210;953;2189;501;1390;59;180;273;693;332;873
430730;202210;1134;2899;772;2195;112;315;329;886;441;1201
430740;202210;809;2059;419;1241;82;275;124;328;206;603
430745;202210;567;1252;402;951;49;163;239;452;288;615
430750;202210;1991;4547;1284;3306;338;898;498;1181;836;2079
430755;202210;545;1275;390;977;33;102;233;514;266;616
430760;202210;2965;6728;2311;5749;469;1260;1116;2575;1585;3835
430770;202210;9069;20505;7256;17810;789;2224;4836;11303;5625;13527
430780;202210;2526;5869;1684;4482;284;814;846;2133;1130;2947
430781;202210;729;1727;476;1187;164;435;169;343;333;778
430783;202210;420;919;274;697;51;149;143;349;194;498
430786;202210;39;115;25;86;5;15;4;9;9;24
430790;202210;5899;13401;4359;10823;417;1264;2742;6214;3159;7478
430800;202210;1041;2076;792;1748;51;127;599;1254;650;1381
430805;202210;479;1079;332;796;12;43;259;576;271;619
430807;202210;710;1633;432;1117;61;182;192;410;253;592
430810;202210;911;2073;449;1200;66;207;187;420;253;627
430820;202210;1545;4059;924;2759;146;446;295;772;441;1218
430825;202210;298;695;117;289;17;41;43;96;60;137
430830;202210;2393;5516;1983;4790;126;334;1506;3448;1632;3782
430840;202210;1347;2936;951;2322;122;296;614;1454;736;1750
430843;202210;202;477;94;254;10;24;33;79;43;103
430845;202210;643;1347;435;1003;48;129;283;577;331;706
430850;202210;2864;7058;1992;5476;555;1611;555;1483;1110;3094
430860;202210;1299;3027;658;1805;104;356;291;660;395;1016
430865;202210;683;1629;423;1159;100;310;121;249;221;559
430870;202210;627;1617;270;830;55;173;56;146;111;319
430880;202210;1809;3757;1287;2941;150;405;857;1822;1007;2227
430885;202210;202;514;123;357;12;32;82;235;94;267
430890;202210;1309;3070;847;2298;150;488;115;262;265;750
430900;202210;3925;7526;2775;5958;134;401;2064;4070;2198;4471
430905;202210;1132;2666;770;2005;139;388;309;723;448;1111
430910;202210;2667;6760;2017;5452;305;967;972;2246;1277;3213
430912;202210;603;1603;395;1168;54;143;233;699;287;842
430915;202210;636;1706;413;1233;116;371;110;323;226;694
430920;202210;32766;75286;26258;64841;3000;8401;17250;40416;20250;48817
430925;202210;101;216;50;131;4;13;24;62;28;75
430930;202210;14725;31266;10805;25508;1308;3382;6627;14699;7935;18081
430940;202210;1470;3533;986;2621;231;638;378;886;609;1524
430950;202210;1077;2123;719;1557;52;153;529;1037;581;1190
430955;202210;484;1208;135;373;22;59;37;87;59;146
430957;202210;226;653;199;591;40;114;116;345;156;459
430960;202210;1670;3787;972;2563;224;630;349;824;573;1454
430965;202210;1847;3964;1481;3427;67;157;1153;2660;1220;2817
430970;202210;443;1021;251;671;38;115;125;307;163;422
430975;202210;605;1600;461;1291;75;239;188;470;263;709
430980;202210;515;1124;293;753;40;111;147;330;187;441
430990;202210;754;1916;517;1429;70;218;257;671;327;889
430995;202210;674;1545;484;1246;73;194;274;659;347;853
431000;202210;1626;3707;695;1953;126;358;64;150;190;508
431010;202210;3182;7783;2280;6246;415;1289;825;1899;1240;3188
431020;202210;10406;21567;6179;14984;983;2837;2921;5992;3904;8829
431030;202210;388;1013;190;604;42;150;30;92;72;242
431033;202210;5056;11099;3443;8558;757;1895;1300;3110;2057;5005
431036;202210;354;760;79;226;3;6;28;65;31;71
431040;202210;1067;2470;693;1860;75;255;390;940;465;1195
431041;202210;510;1110;353;860;67;166;165;355;232;521
431043;202210;487;1171;295;800;29;111;174;406;203;517
431046;202210;119;301;47;139;6;19;8;18;14;37
431050;202210;1559;3449;1124;2775;193;471;623;1519;816;1990
431053;202210;831;2010;449;1284;84;251;152;341;236;592
431055;202210;713;1594;555;1345;54;134;387;938;441;1072
431057;202210;247;688;149;462;31;106;56;156;87;262
431060;202210;6907;15775;4774;12335;1111;3133;1796;4209;2907;7342
431065;202210;529;1224;373;971;56;156;196;486;252;642
431070;202210;497;1267;297;848;65;204;80;215;145;419
431075;202210;312;795;176;499;35;122;75;175;110;297
431080;202210;725;1903;508;1456;77;232;170;422;247;654
431085;202210;949;2308;529;1391;57;165;252;634;309;799
431087;202210;502;1270;400;1071;55;152;240;616;295;768
431090;202210;479;1079;184;541;31;91;42;120;73;211
431100;202210;5167;10048;3736;8247;358;879;2548;5306;2906;6185
431110;202210;1780;3781;1251;2874;177;468;658;1335;835;1803
431112;202210;788;1867;656;1640;78;229;446;1050;524;1279
431113;202210;605;1437;482;1212;110;290;273;637;383;927
431115;202210;1215;3094;944;2610;104;370;645;1657;749;2027
431120;202210;3295;7758;2242;5809;507;1469;858;1968;1365;3437
431123;202210;424;1035;283;759;47;128;146;376;193;504
431125;202210;1419;3365;1024;2652;295;764;508;1317;803;2081
431127;202210;237;623;71;215;7;27;11;26;18;53
431130;202210;4015;9140;3117;7777;487;1328;1651;3917;2138;5245
431140;202210;7126;16183;4411;11213;538;1531;2023;4308;2561;5839
431142;202210;770;1702;578;1406;93;248;376;888;469;1136
431150;202210;1221;2993;888;2414;135;402;465;1186;600;1588
431160;202210;808;2016;532;1460;128;375;168;420;296;795
431162;202210;643;1518;440;1159;40;135;260;616;300;751
431164;202210;202;460;55;164;6;16;12;29;18;45
431170;202210;546;1376;401;1088;116;305;97;244;213;549
431171;202210;1074;2126;900;1916;180;356;625;1327;805;1683
431173;202210;549;1328;391;1101;117;389;124;296;241;685
431175;202210;1554;3418;956;2396;144;353;420;992;564;1345
431177;202210;1129;2668;851;2237;162;453;471;1193;633;1646
431179;202210;379;824;125;357;24;71;40;109;64;180
431180;202210;2793;6796;1728;4725;380;1064;405;933;785;1997
431190;202210;693;1684;294;836;32;97;68;148;100;245
431198;202210;489;1313;398;1142;90;271;170;488;260;759
431200;202210;386;945;116;312;23;58;16;41;39;99
431205;202210;275;688;152;431;47;129;44;118;91;247
431210;202210;780;1685;617;1440;134;313;297;719;431;1032
431213;202210;330;813;247;658;22;61;126;310;148;371
431215;202210;712;1646;367;1023;38;118;189;483;227;601
431217;202210;205;499;141;373;29;90;59;135;88;225
431220;202210;705;1642;446;1169;86;229;227;538;313;767
431225;202210;1881;3934;1455;3288;139;338;1018;2234;1157;2572
431230;202210;865;2222;651;1747;131;406;321;730;452;1136
431235;202210;198;542;27;92;0;0;6;20;6;20
431237;202210;434;1243;330;1024;49;173;165;486;214;659
431238;202210;44;136;37;122;9;33;16;43;25;76
431240;202210;6395;14238;5168;12327;538;1573;3402;7487;3940;9060
431242;202210;366;829;300;702;37;100;198;439;235;539
431244;202210;461;1072;241;615;30;90;105;229;135;319
431245;202210;1564;3439;1032;2533;90;230;546;1236;636;1466
431247;202210;331;753;213;532;30;93;108;223;138;316
431250;202210;2280;5120;1749;4411;402;977;887;2317;1289;3294
431260;202210;366;945;221;651;25;93;87;229;112;322
431261;202210;329;910;267;803;26;101;153;414;179;515
431262;202210;319;877;166;533;29;104;82;256;111;360
431265;202210;1843;4195;738;2024;121;376;218;489;339;865
431267;202210;292;702;194;508;22;67;124;299;146;366
431270;202210;3406;7061;1836;4464;423;1124;630;1427;1053;2551
431275;202210;179;453;119;317;21;66;63;142;84;208
431280;202210;310;839;141;449;28;86;26;70;54;156
431290;202210;429;1233;277;867;53;182;54;151;107;333
431295;202210;87;210;34;93;8;26;11;23;19;49
431300;202210;345;885;91;269;10;38;32;76;42;114
431301;202210;304;824;85;261;14;46;10;22;24;68
431303;202210;777;1833;465;1226;33;102;207;455;240;557
431306;202210;2710;6145;1686;4413;217;627;733;1669;950;2296
431308;202210;45;126;37;105;13;36;15;44;28;80
431310;202210;638;1555;439;1149;68;172;218;524;286;696
431320;202210;827;2159;499;1481;80;257;167;428;247;685
431330;202210;2227;4988;1239;3255;161;480;610;1401;771;1881
431333;202210;247;631;136;389;21;63;43;110;64;173
431335;202210;39;109;22;74;7;26;1;4;8;30
431337;202210;4765;10085;3986;8953;232;746;3244;6844;3476;7590
431339;202210;530;1267;375;999;95;243;148;400;243;643
431340;202210;22957;52588;16468;41848;2288;6584;8802;20480;11090;27064
431342;202210;481;1048;358;853;49;119;240;561;289;680
431344;202210;414;1010;226;641;36;99;123;332;159;431
431346;202210;245;593;86;268;15;47;17;40;32;87
431349;202210;1144;2438;763;1714;114;287;461;953;575;1240
431350;202210;5907;13513;4609;11486;583;1634;2837;6585;3420;8219
431360;202210;676;1529;342;904;90;265;107;244;197;509
431365;202210;2863;5721;2265;4933;104;281;1880;3929;1984;4210
431370;202210;6091;13241;4534;10858;867;2274;2464;5612;3331;7886
431380;202210;1099;2716;878;2362;184;525;486;1285;670;1810
431390;202210;3251;7531;2101;5564;215;692;1160;2649;1375;3341
431395;202210;2112;4365;1628;3665;159;387;1147;2455;1306;2842
431400;202210;367;982;206;616;40;120;42;100;82;220
431402;202210;1092;2225;810;1812;96;232;550;1165;646;1397
431403;202210;230;628;175;521;43;151;70;180;113;331
431405;202210;6819;16373;5324;13897;872;2637;2676;6311;3548;8948
431406;202210;685;1729;447;1228;121;303;149;446;270;749
431407;202210;624;1572;423;1160;68;176;217;573;285;749
431410;202210;23164;52653;16579;41811;2163;6371;9876;22534;12039;28905
431413;202210;290;792;68;218;8;22;20;54;28;76
431415;202210;877;2039;580;1532;113;340;248;565;361;905
431417;202210;648;1344;419;983;66;183;228;504;294;687
431420;202210;2057;4184;1562;3531;113;306;1064;2254;1177;2560
431430;202210;675;1621;347;984;51;155;119;299;170;454
431440;202210;44933;94069;33986;78003;5278;13800;18564;37934;23842;51734
431442;202210;184;501;87;278;13;37;10;33;23;70
431445;202210;414;1142;126;408;10;36;22;54;32;90
431446;202210;337;907;262;760;28;89;145;405;173;494
431447;202210;905;2208;507;1424;86;240;159;446;245;686
431449;202210;957;2225;641;1647;99;268;326;756;425;1024
431450;202210;3070;5439;2416;4555;176;287;1917;3492;2093;3779
431454;202210;52;168;43;146;10;37;23;71;33;108
431455;202210;655;1474;337;852;31;72;177;404;208;476
431460;202210;3735;8038;2452;5875;508;1282;987;2222;1495;3504
431470;202210;1663;4208;1204;3305;237;701;459;1172;696;1873
431475;202210;297;787;58;194;3;12;7;13;10;25
431477;202210;546;1301;304;825;73;175;108;274;181;449
431478;202210;249;664;55;171;9;26;6;12;15;38
431480;202210;4118;9760;3232;8361;782;2059;1370;3479;2152;5538
431490;202210;156570;330950;122418;279870;7010;20132;93478;200684;100488;220816
431500;202210;574;1364;433;1116;63;168;227;553;290;721
431505;202210;301;674;205;530;21;56;143;365;164;421
431507;202210;363;839;141;405;41;126;23;52;64;178
431510;202210;2063;4899;1401;3637;432;1112;386;1012;818;2124
431513;202210;261;554;139;351;35;110;44;75;79;185
431514;202210;146;343;119;300;4;13;81;184;85;197
431515;202210;659;1438;493;1153;114;284;266;584;380;868
431517;202210;77;217;61;185;8;30;28;80;36;110
431520;202210;441;1047;187;525;27;95;84;185;111;280
431530;202210;6308;13125;3883;9479;812;2079;1673;3834;2485;5913
431531;202210;259;595;152;399;29;75;55;135;84;210
431532;202210;720;1521;415;993;71;180;200;459;271;639
431535;202210;337;842;154;446;29;84;33;86;62;170
431540;202210;2122;5955;1934;5704;89;279;1496;4457;1585;4736
431545;202210;402;964;89;228;12;26;35;84;47;110
431550;202210;2599;6106;1831;4710;258;753;1002;2380;1260;3133
431555;202210;831;1748;497;1186;42;114;295;692;337;806
431560;202210;31262;70249;21604;55325;4143;10350;8795;22622;12938;32972
431570;202210;6764;13196;5834;11915;283;777;4908;9417;5191;10194
431575;202210;462;1019;393;908;77;156;236;521;313;677
431580;202210;770;1881;514;1391;62;204;291;711;353;915
431590;202210;886;2261;629;1730;142;404;243;611;385;1015
431595;202210;437;1099;276;779;56;163;100;257;156;420
431600;202210;2164;4892;1543;3927;277;787;698;1620;975;2407
431610;202210;1743;3918;1144;2882;180;461;481;1282;661;1743
431620;202210;560;1334;302;785;64;187;150;318;214;505
431630;202210;1548;3628;726;2004;158;494;238;570;396;1064
431640;202210;8479;17446;7144;15726;800;1985;4918;10382;5718;12367
431642;202210;781;1664;478;1139;98;215;217;484;315;699
431643;202210;424;995;203;551;22;56;75;182;97;238
431645;202210;2950;5229;2349;4481;43;112;2074;3822;2117;3934
431647;202210;362;831;122;336;15;43;32;74;47;117
431650;202210;172;457;125;376;19;66;53;129;72;195
431660;202210;1082;2685;518;1536;88;307;130;335;218;642
431670;202210;1452;3290;877;2266;142;384;416;958;558;1342
431673;202210;259;672;104;339;11;35;32;95;43;130
431675;202210;429;1070;117;384;17;56;21;52;38;108
431680;202210;11790;26514;8921;21530;1728;4702;4567;9949;6295;14651
431690;202210;32179;72481;23398;57498;3400;9724;13275;30041;16675;39765
431695;202210;268;613;159;413;26;102;90;192;116;294
431697;202210;555;1203;428;1015;80;183;240;563;320;746
431700;202210;1792;3994;1410;3356;228;483;757;1824;985;2307
431710;202210;18207;37734;13456;31267;1634;4238;8602;19015;10236;23253
431720;202210;8409;18981;5146;13260;1248;3408;1242;2677;2490;6085
431725;202210;43;105;32;87;9;31;16;37;25;68
431730;202210;5545;11984;3732;9277;679;1866;1878;4313;2557;6179
431740;202210;6388;14291;4316;10949;1014;2883;1323;2933;2337;5816
431750;202210;10216;24110;7460;19716;1781;4967;2694;6823;4475;11790
431755;202210;369;970;92;297;7;29;25;67;32;96
431760;202210;6441;13659;4486;10574;484;1354;2756;5936;3240;7290
431770;202210;2501;5184;1906;4391;313;670;1237;2861;1550;3531
431775;202210;247;603;133;379;31;100;31;69;62;169
431780;202210;2582;5819;1698;4274;288;763;625;1499;913;2262
431790;202210;905;2252;612;1680;126;357;266;688;392;1045
431795;202210;316;754;147;415;23;67;45;116;68;183
431800;202210;10238;22663;6596;17050;1818;5539;843;1850;2661;7389
431805;202210;323;810;72;255;2;3;3;6;5;9
431810;202210;3949;8347;2535;5904;367;950;1441;3046;1808;3996
431820;202210;2644;6399;2023;5445;484;1481;911;2290;1395;3771
431830;202210;10703;22212;7775;18244;2308;6170;1322;3120;3630;9290
431840;202210;3461;7820;2796;6820;403;1085;1742;4127;2145;5212
431842;202210;574;1385;203;597;36;119;57;152;93;271
431843;202210;367;945;251;696;56;172;111;279;167;451
431844;202210;212;570;77;248;15;48;18;56;33;104
431845;202210;586;1404;387;1017;35;99;242;608;277;707
431846;202210;367;805;320;739;16;38;282;644;298;682
431848;202210;188;470;102;287;11;36;32;73;43;109
431849;202210;417;998;78;221;11;32;13;28;24;60
431850;202210;5245;12907;4021;10661;967;2761;1322;3253;2289;6014
431860;202210;790;1740;454;1122;58;166;285;662;343;828
431861;202210;125;329;79;230;17;56;26;63;43;119
431862;202210;587;1713;482;1527;91;342;232;675;323;1017
431870;202210;28650;65103;23090;56750;2194;6280;15350;35435;17544;41715
431880;202210;4895;11466;3601;9283;440;1329;2001;4777;2441;6106
431890;202210;6069;13954;3907;9984;1102;2906;1039;2557;2141;5463
431900;202210;1274;2997;830;2223;135;402;402;956;537;1358
431910;202210;906;2038;362;938;58;158;118;234;176;392
431912;202210;671;1516;545;1313;73;181;371;868;444;1049
431915;202210;1403;2925;1121;2505;69;177;887;1900;956;2077
431920;202210;1585;3128;1309;2787;33;77;1162;2426;1195;2503
431930;202210;881;2094;602;1609;206;541;198;537;404;1078
431935;202210;101;248;72;198;12;37;16;36;28;73
431936;202210;367;937;209;568;43;121;110;286;153;407
431937;202210;188;471;126;355;29;74;43;115;72;189
431940;202210;3637;7858;2361;5662;168;468;1520;3380;1688;3848
431950;202210;2693;6255;2112;5346;523;1364;906;2206;1429;3570
431960;202210;3701;8312;2807;6792;805;2045;770;1757;1575;3802
431970;202210;498;1210;230;623;50;152;64;147;114;299
431971;202210;98;244;50;147;11;35;12;31;23;66
431973;202210;693;1929;466;1472;41;153;334;1037;375;1190
431975;202210;129;259;39;100;9;26;8;13;17;39
431980;202210;1482;3207;1173;2749;126;389;796;1667;922;2056
431990;202210;8224;17841;5733;14389;417;1281;3690;8814;4107;10095
432000;202210;18661;39581;14171;32884;1758;4687;9271;19966;11029;24653
432010;202210;3331;7236;2254;5554;520;1299;768;1739;1288;3038
432020;202210;1921;4802;1207;3342;366;1050;265;697;631;1747
432023;202210;632;1405;308;801;41;109;137;300;178;409
432026;202210;1243;3051;955;2505;274;727;346;946;620;1673
432030;202210;521;1158;299;775;23;61;178;423;201;484
432032;202210;398;966;260;688;25;75;139;326;164;401
432035;202210;851;2188;711;1944;179;464;343;968;522;1432
432040;202210;1305;2952;535;1510;55;177;238;581;293;758
432045;202210;209;544;128;379;20;66;55;152;75;218
432050;202210;676;1543;492;1232;64;196;255;609;319;805
432055;202210;856;1998;577;1497;183;453;153;409;336;862
432057;202210;175;438;146;372;7;17;101;232;108;249
432060;202210;506;1183;149;452;16;55;42;120;58;175
432065;202210;267;673;202;543;48;138;94;235;142;373
432067;202210;996;2478;832;2132;90;248;571;1413;661;1661
432070;202210;1993;4623;1448;3670;213;612;753;1709;966;2321
432080;202210;6172;13033;4598;10703;732;2070;2336;4898;3068;6968
432085;202210;477;1188;367;1020;73;227;186;479;259;706
432090;202210;3309;7737;1987;5268;469;1132;794;1992;1263;3124
432100;202210;1115;2657;555;1618;103;317;105;233;208;550
432110;202210;2702;6327;1973;5100;456;1291;528;1136;984;2427
432120;202210;4463;10976;3600;9562;580;1765;1883;4583;2463;6348
432130;202210;3407;7613;2819;6785;495;1201;1520;3640;2015;4841
432132;202210;306;772;167;478;25;80;83;203;108;283
432135;202210;1224;2582;842;1958;89;207;553;1295;642;1502
432140;202210;2345;5823;1861;4940;225;674;1239;3132;1464;3806
432143;202210;1851;4488;1399;3780;110;342;877;2287;987;2629
432145;202210;2112;5281;1391;3852;216;654;461;1031;677;1685
432146;202210;155;405;122;364;42;140;35;95;77;235
432147;202210;659;1715;350;1041;123;377;58;174;181;551
432149;202210;585;1331;274;720;32;80;118;281;150;361
432150;202210;4980;11273;3782;9359;710;2043;1942;4251;2652;6294
432160;202210;7934;18147;6036;15312;1489;4015;2356;5767;3845;9782
432162;202210;233;513;39;119;5;18;10;17;15;35
432163;202210;188;448;37;101;2;6;7;9;9;15
432166;202210;778;1994;632;1721;116;365;244;570;360;935
432170;202210;1863;4711;1284;3674;226;708;526;1335;752;2043
432180;202210;3579;7933;1956;5037;295;868;880;1934;1175;2802
432183;202210;465;1235;349;987;71;245;160;407;231;652
432185;202210;1042;2475;633;1708;125;370;285;696;410;1066
432190;202210;2664;5867;1931;4757;177;532;1292;2906;1469;3438
432195;202210;1190;2875;737;2029;138;387;261;696;399;1083
432200;202210;4582;10139;3507;8542;247;681;2547;5934;2794;6615
432210;202210;514;1199;354;918;49;142;199;454;248;596
432215;202210;787;1952;679;1783;83;195;406;1057;489;1252
432218;202210;268;622;117;311;15;47;40;77;55;124
432220;202210;4429;9554;3195;7582;548;1348;1780;3991;2328;5339
432225;202210;184;455;123;340;18;49;55;154;73;203
432230;202210;917;2086;445;1202;58;189;186;423;244;612
432232;202210;596;1396;376;1026;69;202;173;422;242;624
432234;202210;345;824;176;490;36;86;46;111;82;197
432235;202210;61;152;33;81;6;19;16;30;22;49
432237;202210;360;858;310;777;7;16;264;643;271;659
432240;202210;21318;46103;15861;38996;1456;3530;10954;26522;12410;30052
432250;202210;8176;20405;6155;16534;1128;3335;3234;8110;4362;11445
432252;202210;557;1246;360;879;48;129;189;418;237;547
432253;202210;1112;2948;772;2138;217;646;197;469;414;1115
432254;202210;738;1670;222;632;30;90;36;72;66;162
432255;202210;127;310;76;205;10;29;41;98;51;127
432260;202210;6936;16031;5259;13023;1060;2891;2561;5694;3621;8585
432270;202210;2735;6604;2192;5656;645;1730;756;1877;1401;3607
432280;202210;1547;3708;829;2346;131;424;280;638;411;1062
432285;202210;157;461;36;101;4;10;9;25;13;35
432290;202210;425;1057;271;735;60;184;91;197;151;381
432300;202210;37852;84570;29353;71583;2607;7759;20406;46502;23013;54261
432310;202210;1264;2741;973;2259;114;242;747;1737;861;1979
432320;202210;237;531;109;301;14;40;39;87;53;127
432330;202210;232;511;74;232;13;42;15;47;28;89
432335;202210;189;544;70;248;9;28;9;26;18;54
432340;202210;395;972;176;551;33;106;56;168;89;274
432345;202210;1015;1894;868;1721;15;38;765;1471;780;1509
432350;202210;391;913;196;551;39;128;59;130;98;258
432360;202210;251;725;51;167;5;14;16;45;21;59
432370;202210;418;922;249;639;29;85;137;326;166;411
432375;202210;626;1442;432;1073;125;323;143;355;268;678
432377;202210;180;535;43;151;3;10;10;25;13;35
432380;202210;2405;6174;1702;4909;277;878;878;2419;1155;3297
500020;202210;4075;9238;2921;7475;259;820;1999;4889;2258;5709
500025;202210;1373;3219;877;2316;106;287;488;1226;594;1513
500060;202210;10106;25803;7162;19894;909;2756;4140;11236;5049;13992
500070;202210;6165;14147;4428;11317;803;2241;2158;5339;2961;7580
500080;202210;1894;4346;1165;3047;196;584;453;1021;649;1605
500085;202210;2476;5781;1728;4475;440;1236;660;1550;1100;2786
500090;202210;2490;6069;1692;4753;278;844;510;1522;788;2366
500100;202210;4653;10961;3494;9131;578;1668;1426;3419;2004;5087
500110;202210;12854;28961;8912;22939;1703;4703;4322;10873;6025;15576
500124;202210;2726;6962;2196;6146;336;922;1348;3809;1684;4731
500150;202210;1896;3937;1329;3181;228;630;726;1572;954;2202
500190;202210;6157;14860;4048;10959;850;2409;1425;3491;2275;5900
500200;202210;3331;7113;2242;5366;192;483;1422;3208;1614;3691
500210;202210;6287;13318;4512;11044;1188;3020;2287;5416;3475;8436
500215;202210;1735;4399;1285;3616;138;417;730;2006;868;2423
500220;202210;4046;9997;2973;8221;458;1322;1555;4009;2013;5331
500230;202210;2570;5526;1977;4717;270;703;1267;2883;1537;3586
500240;202210;5100;13771;3702;10964;545;1714;1576;4659;2121;6373
500260;202210;3973;7945;2567;6048;268;713;1565;3446;1833;4159
500270;202210;183180;403062;119277;300721;16352;46991;56006;125937;72358;172928
500280;202210;1689;3932;1113;3060;174;473;612;1686;786;2159
500290;202210;4515;10346;2791;7456;430;1330;1059;2499;1489;3829
500295;202210;4964;11194;3282;8356;574;1692;1413;3086;1987;4778
500310;202210;1262;2366;834;1839;116;203;480;1057;596;1260
500315;202210;5950;12843;4920;11468;308;800;4070;9222;4378;10022
500320;202210;25271;61691;17600;49325;4302;12072;7038;20513;11340;32585
500325;202210;7329;15034;5195;12177;624;1602;3231;7225;3855;8827
500330;202210;8446;17846;5626;13806;528;1360;3221;7826;3749;9186
500345;202210;2674;6180;1810;4789;305;863;676;1676;981;2539
500348;202210;2913;6793;2215;5652;186;539;1514;3760;1700;4299
500350;202210;1453;3767;838;2492;93;296;304;818;397;1114
500370;202210;33983;82520;24819;67749;3229;10080;12628;32878;15857;42958
500375;202210;3167;7769;2011;5494;268;803;789;1869;1057;2672
500380;202210;4357;10181;3051;8047;863;2302;529;1418;1392;3720
500390;202210;785;1563;492;1209;74;202;289;707;363;909
500400;202210;1949;4709;1292;3457;212;650;494;1158;706;1808
500410;202210;2942;6456;2058;5198;239;579;1119;2945;1358;3524
500430;202210;3428;7904;2342;6294;375;1016;942;2732;1317;3748
500440;202210;1981;4473;1096;2955;183;507;420;1140;603;1647
500450;202210;2360;5523;1469;4032;291;811;370;961;661;1772
500460;202210;4669;11457;2850;8017;512;1594;695;1777;1207;3371
500470;202210;3380;8557;2223;6252;524;1625;655;1523;1179;3148
500480;202210;2382;6914;1949;6229;205;692;1378;4445;1583;5137
500490;202210;1408;3116;844;2238;164;502;221;577;385;1079
500500;202210;4963;12279;3296;9710;1005;3340;374;1152;1379;4492
500510;202210;873;2063;580;1534;38;125;387;931;425;1056
500515;202210;1992;4812;1520;4093;211;615;827;2166;1038;2781
500520;202210;4223;11081;3224;9411;710;2023;1588;4782;2298;6805
500525;202210;1199;3218;947;2836;135;426;566;1652;701;2078
500540;202210;6410;15785;3912;11383;1093;3550;642;1558;1735;5108
500560;202210;6890;16601;5546;14924;240;730;4589;12357;4829;13087
500568;202210;5715;11672;3566;8474;709;1772;1543;3284;2252;5056
500570;202210;10684;23099;7389;17818;967;2747;4158;9015;5125;11762
500580;202210;3847;9250;2778;7420;683;1892;1204;3143;1887;5035
500600;202210;4553;10695;3316;8728;759;2111;1008;2557;1767;4668
500620;202210;9998;24309;6946;18685;1032;2999;3520;8763;4552;11762
500625;202210;660;1666;447;1257;76;241;189;479;265;720
500627;202210;947;2410;585;1773;95;303;175;489;270;792
500630;202210;9454;19973;5616;13934;1175;3154;1816;4157;2991;7311
500635;202210;3228;9727;2393;8553;270;861;1610;6262;1880;7123
500640;202210;2189;4407;1464;3464;67;176;1014;2276;1081;2452
500660;202210;25302;58158;17539;47161;5238;14563;5987;16085;11225;30648
500690;202210;3363;7889;2317;6252;727;2155;858;2173;1585;4328
500710;202210;4001;9845;2881;7915;692;2091;887;2306;1579;4397
500720;202210;6203;15016;4141;11569;834;2528;1378;3621;2212;6149
500730;202210;1290;2975;715;1961;142;382;219;588;361;970
500740;202210;5706;12789;3658;9664;757;2076;1508;3827;2265;5903
500750;202210;1391;3229;983;2566;135;402;449;1030;584;1432
500755;202210;1388;3378;875;2432;152;470;265;633;417;1103
500769;202210;6368;14829;3586;9792;899;2513;500;1193;1399;3706
500770;202210;1736;4378;1198;3492;224;687;416;1139;640;1826
500780;202210;1552;3628;999;2671;175;530;262;571;437;1101
500790;202210;9019;22607;6494;18143;1291;3933;2416;6560;3707;10493
500793;202210;2576;6073;1843;4834;359;1009;758;1808;1117;2817
500795;202210;3677;7780;2952;6841;190;398;2409;5644;2599;6042
500797;202210;976;2318;651;1733;199;578;195;478;394;1056
500800;202210;4290;9215;2677;6809;716;2041;614;1569;1330;3610
500830;202210;24683;57234;16861;43450;3621;9926;6344;15130;9965;25056
500840;202210;1763;4013;1103;2778;125;333;545;1240;670;1573
510010;202210;2203;4489;1567;3685;196;453;1053;2456;1249;2909
510020;202210;5031;12042;2753;7689;469;1372;795;1959;1264;3331
510025;202210;9099;20544;5952;15663;667;1909;3321;8208;3988;10117
510030;202210;3824;7847;2528;5905;254;635;1315;2966;1569;3601
510035;202210;1360;3423;871;2631;242;739;308;1014;550;1753
510040;202210;2964;6114;2240;5220;265;549;1423;3426;1688;3975
510050;202210;2800;5286;1961;4234;208;554;1418;2905;1626;3459
510060;202210;1851;4406;1260;3356;293;829;287;609;580;1438
510080;202210;1898;4574;1260;3544;220;686;536;1391;756;2077
510100;202210;849;1803;618;1463;71;200;387;838;458;1038
510120;202210;334;564;196;406;10;19;156;309;166;328
510125;202210;2540;6060;1937;5117;242;779;969;2297;1211;3076
510130;202210;2020;4654;1425;3738;293;845;701;1723;994;2568
510140;202210;3736;9205;2573;7700;965;3123;811;2497;1776;5620
510160;202210;2409;5023;1883;4362;44;122;1701;3902;1745;4024
510170;202210;6182;14751;4705;12435;896;2601;2257;5688;3153;8289
510180;202210;18547;38116;12626;29950;2011;5207;6468;15380;8479;20587
510185;202210;2138;5252;1398;4175;534;1658;355;1272;889;2930
510190;202210;2934;7624;1825;5794;459;1578;365;1189;824;2767
510250;202210;21650;49749;16112;41608;2351;6693;9275;23625;11626;30318
510260;202210;2204;8887;1840;8270;273;1179;1099;5604;1372;6783
510263;202210;4615;12104;3056;9057;550;1813;745;1891;1295;3704
510267;202210;6904;18761;4062;12441;722;2340;787;2021;1509;4361
510268;202210;1621;3965;1130;3144;313;928;278;613;591;1541
510269;202210;1223;3099;791;2325;145;477;330;899;475;1376
510270;202210;3662;9764;2561;7869;390;1331;1084;3234;1474;4565
510279;202210;2199;5420;1278;3748;182;586;389;1005;571;1591
510285;202210;1280;3174;831;2386;212;677;263;665;475;1342
510300;202210;5014;11161;3811;9613;276;731;2826;7122;3102;7853
510305;202210;1790;4610;1177;3497;246;742;362;1085;608;1827
510310;202210;1267;2959;902;2393;226;578;337;922;563;1500
510320;202210;4962;11263;3413;8788;763;2187;1092;2455;1855;4642
510325;202210;5379;14801;3658;11441;852;2818;862;2644;1714;5462
510330;202210;3201;8715;2126;6902;501;1730;812;2758;1313;4488
510335;202210;5981;15886;4524;13551;792;2578;2357;6957;3149;9535
510336;202210;618;1616;447;1358;66;186;244;801;310;987
510337;202210;1819;4889;1184;3774;431;1483;302;915;733;2398
510340;202210;120870;253950;83636;201917;16840;46537;36881;80857;53721;127394
510343;202210;1519;3405;1017;2601;136;398;564;1339;700;1737
510345;202210;1605;4006;1213;3296;223;641;632;1546;855;2187
510350;202210;3898;9198;2601;7137;776;2196;651;1726;1427;3922
510360;202210;2434;4501;1466;3389;60;114;1074;2586;1134;2700
510370;202210;2162;5681;1646;4872;255;766;1001;3004;1256;3770
510380;202210;668;1528;389;1062;51;168;163;420;214;588
510385;202210;1499;4653;1117;3971;101;431;764;2785;865;3216
510390;202210;1746;3905;1210;3290;280;788;673;1826;953;2614
510395;202210;852;1739;576;1352;33;73;418;989;451;1062
510410;202210;6352;15682;4714;12989;712;2027;2938;8074;3650;10101
510420;202210;3198;5873;2237;4631;77;176;1763;3562;1840;3738
510450;202210;644;1466;380;1019;85;221;125;309;210;530
510452;202210;1102;2892;806;2336;117;359;441;1253;558;1612
510454;202210;1417;3464;999;2765;155;400;585;1742;740;2142
510455;202210;1123;2822;732;2094;146;462;286;740;432;1202
510460;202210;2402;5681;1708;4631;615;1940;543;1075;1158;3015
510480;202210;5982;13637;3941;9948;699;1965;1759;3973;2458;5938
510490;202210;2138;4895;1612;4235;260;691;1019;2698;1279;3389
510500;202210;1809;4182;1098;3074;268;802;282;751;550;1553
510510;202210;4852;12542;3412;10172;1001;3261;1031;3010;2032;6271
510515;202210;6570;15824;4514;12289;881;2645;1689;4096;2570;6741
510517;202210;1900;4575;1313;3722;496;1536;328;806;824;2342
510520;202210;2787;5428;1525;3794;154;408;676;1738;830;2146
510523;202210;1441;3189;1018;2555;131;353;638;1533;769;1886
510525;202210;10006;25754;7338;20666;1255;3839;3150;8169;4405;12008
510530;202210;657;1587;490;1357;45;139;328;902;373;1041
510550;202210;3168;8402;2400;7138;473;1519;1250;3609;1723;5128
510558;202210;2750;6986;2017;5864;258;698;1041;3232;1299;3930
510560;202210;2238;5978;1416;4386;347;1122;287;923;634;2045
510562;202210;7294;16151;5404;13050;832;2100;2849;6551;3681;8651
510590;202210;3937;8901;2880;7577;277;764;2052;5397;2329;6161
510600;202210;1459;2903;1048;2337;118;307;666;1362;784;1669
510610;202210;3380;7453;2341;6076;325;994;1405;3470;1730;4464
510615;202210;3512;8123;2449;6492;360;1000;1453;3815;1813;4815
510617;202210;1293;3542;1034;3165;124;415;739;2327;863;2742
510618;202210;1556;3776;1104;3086;206;675;574;1508;780;2183
510619;202210;901;2190;507;1460;103;312;104;229;207;541
510620;202210;1609;3483;806;2199;305;933;69;138;374;1071
510621;202210;1899;4780;1127;3357;263;826;302;783;565;1609
510622;202210;6717;17405;4276;12427;1300;4074;614;1524;1914;5598
510623;202210;3420;7853;2450;6374;516;1467;962;2416;1478;3883
510624;202210;1974;4939;1049;3236;118;412;215;586;333;998
510625;202210;4322;9821;2655;6958;520;1475;920;2335;1440;3810
510626;202210;1697;4006;1129;3123;270;839;296;800;566;1639
510627;202210;764;1855;425;1221;107;322;114;343;221;665
510628;202210;1826;3804;1171;2986;368;1062;447;1031;815;2093
510629;202210;2102;5463;1385;4149;301;990;371;1064;672;2054
510630;202210;4132;10662;2606;7946;588;1884;649;2091;1237;3975
510631;202210;715;1539;540;1291;20;37;425;1027;445;1064
510637;202210;4419;9678;3117;7863;753;2134;1147;2758;1900;4892
510642;202210;7229;18289;5601;15944;945;3087;3358;9260;4303;12347
510645;202210;1234;2280;745;1666;166;369;348;780;514;1149
510650;202210;8966;19981;7115;17973;917;1514;5169;14354;6086;15868
510665;202210;2077;4282;1307;3110;287;616;524;1355;811;1971
510670;202210;513;1052;306;775;34;83;160;402;194;485
510675;202210;8030;20666;5418;15852;1334;4367;1044;2699;2378;7066
510677;202210;2759;6624;1967;5467;358;1098;1098;2982;1456;4080
510680;202210;853;2054;489;1417;94;305;134;323;228;628
510682;202210;2112;5568;1567;4700;515;1726;531;1491;1046;3217
510685;202210;649;1698;470;1364;50;140;275;806;325;946
510700;202210;5249;11494;3645;9284;354;1047;2523;6220;2877;7267
510704;202210;13788;30720;9311;23416;2228;5985;2849;6419;5077;12404
510706;202210;2950;8034;2022;6484;376;1239;831;2868;1207;4107
510710;202210;3642;8416;2272;5926;576;1477;634;1535;1210;3012
510715;202210;784;1535;521;1197;54;147;316;683;370;830
510718;202210;2755;6028;1676;4578;357;982;765;2335;1122;3317
510719;202210;579;1164;338;820;37;109;173;363;210;472
510720;202210;1112;2387;735;1860;176;493;302;689;478;1182
510724;202210;1072;2849;714;2158;98;337;332;921;430;1258
510726;202210;1098;1984;640;1439;72;167;350;766;422;933
510729;202210;706;1575;324;875;45;138;93;253;138;391
510730;202210;3629;8214;2492;6504;361;1095;1351;3234;1712;4329
510735;202210;1536;3927;1249;3539;103;263;1011;2901;1114;3164
510740;202210;1202;2711;822;2063;84;259;519;1170;603;1429
510757;202210;633;1919;501;1703;145;563;206;643;351;1206
510760;202210;55535;115266;34609;84612;6792;18902;13512;29205;20304;48107
510770;202210;5121;10442;3614;8560;271;570;2513;6147;2784;6717
510774;202210;492;1195;341;963;68;187;183;540;251;727
510775;202210;814;1959;500;1454;113;351;145;384;258;735
510776;202210;855;2053;583;1535;104;307;278;712;382;1019
510777;202210;1823;4520;1314;3874;239;848;792;2199;1031;3047
510779;202210;965;2443;708;2015;82;210;443;1327;525;1537
510780;202210;5217;11969;3810;9963;739;1835;1939;5434;2678;7269
510785;202210;2531;6227;1460;4304;339;1055;401;1179;740;2234
510787;202210;4120;10874;2766;8249;1029;3189;268;729;1297;3918
510788;202210;657;1447;437;1127;68;162;197;574;265;736
510790;202210;23825;58495;14968;42934;3263;10230;1632;4081;4895;14311
510792;202210;12759;33446;8152;24646;1927;6335;1708;4457;3635;10792
510794;202210;1569;4061;1124;3350;347;1180;225;545;572;1725
510795;202210;12889;30780;9114;24370;2022;6077;3156;7551;5178;13628
510800;202210;1801;4587;1230;3641;357;1164;166;367;523;1531
510805;202210;1843;4793;1181;3577;242;798;475;1307;717;2105
510810;202210;830;1591;540;1218;165;327;262;630;427;957
510820;202210;950;1743;550;1255;29;70;367;806;396;876
510830;202210;1090;2387;823;2050;79;191;571;1457;650;1648
510835;202210;751;1620;485;1253;56;171;303;738;359;909
510840;202210;76809;149624;55645;124105;8893;19345;33581;75454;42474;94799
510850;202210;2182;5259;1413;4070;507;1658;84;122;591;1780
510860;202210;3180;7845;2081;6131;706;2275;406;1194;1112;3469
510880;202210;891;2384;638;1933;165;491;165;503;330;994
510885;202210;737;1735;479;1336;88;235;121;320;209;555
510890;202210;1002;2623;716;2105;222;710;209;576;431;1286
510895;202210;1819;4268;1248;3325;174;558;669;1562;843;2120
520005;202210;4436;10606;3557;9467;1056;2448;1473;4687;2529;7135
520010;202210;3514;8646;2619;6996;547;1625;1061;2429;1608;4054
520013;202210;4304;10110;2793;7412;712;1882;805;2261;1517;4143
520015;202210;626;1466;453;1209;107;284;162;467;269;751
520017;202210;1473;3451;1016;2733;185;558;443;1071;628;1629
520020;202210;673;1232;523;1059;50;103;402;795;452;898
520025;202210;47739;117136;40764;107359;5807;16010;26356;68338;32163;84348
520030;202210;8600;18319;7161;16421;547;1258;5494;12376;6041;13634
520050;202210;486;1112;278;728;55;134;123;316;178;450
520055;202210;2086;4880;1281;3268;199;503;578;1375;777;1878
520060;202210;2296;5507;1545;4224;297;923;395;1049;692;1972
520080;202210;2295;5377;1764;4675;345;861;869;2417;1214;3278
520082;202210;1001;2381;699;1873;118;334;303;853;421;1187
520085;202210;1249;2887;996;2531;240;615;469;1168;709;1783
520090;202210;1103;1985;806;1667;88;121;641;1377;729;1498
520110;202210;53630;132498;36632;104048;9921;30345;3374;8464;13295;38809
520120;202210;303;668;160;416;20;63;68;158;88;221
520130;202210;4751;10574;3649;8885;729;1858;1536;3573;2265;5431
520140;202210;61252;151121;42593;119719;14142;42260;5832;16433;19974;58693
520145;202210;721;1537;453;1152;97;255;166;374;263;629
520150;202210;842;1890;627;1608;74;189;354;868;428;1057
520160;202210;1063;2404;719;1800;127;300;296;745;423;1045
520170;202210;5700;11145;3791;8885;362;882;2661;6116;3023;6998
520180;202210;3346;7841;2697;6920;350;1050;1749;4296;2099;5346
520215;202210;2179;4849;1594;4011;218;605;930;2239;1148;2844
520235;202210;923;1867;613;1447;97;250;353;807;450;1057
520250;202210;2017;4759;1476;3929;584;1640;267;837;851;2477
520260;202210;918;2043;559;1467;111;301;205;522;316;823
520280;202210;1038;2168;807;1830;158;360;424;950;582;1310
520310;202210;1247;2522;816;1888;189;510;367;822;556;1332
520320;202210;2411;5771;1850;4927;239;606;1006;2740;1245;3346
520330;202210;6099;14468;4673;12118;687;2126;2680;6402;3367;8528
520340;202210;2767;5700;1617;4066;162;369;841;2209;1003;2578
520350;202210;3740;8533;2642;6870;846;2270;850;2210;1696;4480
520355;202210;2333;5921;1675;4701;484;1460;284;687;768;2147
520357;202210;1060;2291;770;1883;32;83;622;1494;654;1577
520360;202210;969;2258;752;1918;132;375;350;813;482;1188
520380;202210;1699;4010;1018;2795;165;494;342;814;507;1308
520390;202210;1437;3137;911;2429;236;697;210;583;446;1280
520393;202210;815;1781;556;1384;79;209;244;554;323;763
520396;202210;1087;2484;908;2212;59;144;651;1522;710;1666
520400;202210;1944;4271;1507;3702;96;264;1116;2721;1212;2985
520410;202210;2727;5552;1864;4319;272;730;1052;2246;1324;2976
520420;202210;463;968;361;815;22;59;272;588;294;647
520425;202210;1843;4285;1039;2771;289;845;213;469;502;1314
520430;202210;2993;6507;1807;4612;418;1117;323;752;741;1869
520440;202210;3612;8304;2058;5542;439;1312;463;1147;902;2459
520450;202210;17380;38988;11960;30577;3201;8465;3390;8586;6591;17051
520455;202210;976;2367;683;1923;198;572;202;575;400;1147
520460;202210;1294;2827;1000;2443;198;417;623;1615;821;2032
520465;202210;1103;2429;903;2164;59;182;700;1636;759;1818
520470;202210;2814;6368;2152;5529;596;1584;957;2543;1553;4127
520480;202210;1159;2925;850;2398;189;553;352;939;541;1492
520485;202210;1804;5036;1407;4411;264;863;630;1914;894;2777
520490;202210;5314;12706;4094;10831;639;1887;2475;6283;3114;8170
520495;202210;2028;3888;1534;3234;112;237;1140;2389;1252;2626
520500;202210;2126;4785;1581;3872;193;569;918;2048;1111;2617
520505;202210;1184;2233;926;1925;87;160;708;1449;795;1609
520510;202210;11931;27019;8935;22573;1524;4494;4409;10228;5933;14722
520520;202210;1420;3332;1094;2851;270;765;459;1159;729;1924
520530;202210;3044;7528;2217;6084;405;1088;1086;3141;1491;4229
520540;202210;3746;9163;2483;6768;451;1309;768;1846;1219;3155
520545;202210;1724;3892;1343;3316;315;766;656;1604;971;2370
520547;202210;1612;3859;1237;3225;261;686;628;1615;889;2301
520549;202210;20332;47722;16926;42915;2058;5849;11476;27839;13534;33688
520551;202210;6189;14349;5187;12930;467;1431;3860;9142;4327;10573
520552;202210;1161;2751;900;2371;179;466;463;1275;642;1741
520570;202210;649;1381;416;1023;75;151;178;443;253;594
520580;202210;2659;5498;2005;4736;356;810;1157;2766;1513;3576
520590;202210;1675;3862;1141;3000;285;761;403;1020;688;1781
520620;202210;11772;27803;9464;24522;1795;5033;5091;12755;6886;17788
520630;202210;1084;2507;755;1977;98;264;341;842;439;1106
520640;202210;2982;6709;2207;5387;532;1276;720;1846;1252;3122
520650;202210;1296;2599;932;2104;189;385;492;1162;681;1547
520660;202210;641;1526;360;1027;69;219;105;289;174;508
520670;202210;1188;2836;975;2514;110;262;646;1651;756;1913
520680;202210;1009;2210;809;1928;124;258;499;1199;623;1457
520690;202210;402;941;270;729;84;216;75;198;159;414
520710;202210;545;1221;371;932;19;55;255;599;274;654
520725;202210;1723;3839;1150;2895;186;525;581;1406;767;1931
520735;202210;1113;2444;741;1857;214;487;247;627;461;1114
520740;202210;3087;6477;2263;5404;478;1119;1084;2607;1562;3726
520750;202210;901;1901;638;1524;93;227;355;806;448;1033
520753;202210;1606;3880;1203;3179;219;661;571;1376;790;2037
520760;202210;1781;3439;1496;3106;33;68;1374;2854;1407;2922
520780;202210;1825;4103;1319;3360;176;445;682;1681;858;2126
520790;202210;3922;8719;2688;6762;433;991;1405;3723;1838;4714
520800;202210;22589;52362;17776;45407;2944;7613;10360;26566;13304;34179
520810;202210;1497;2961;1111;2521;260;570;566;1415;826;1985
520815;202210;704;2031;510;1616;101;334;154;471;255;805
520830;202210;2181;4354;1570;3625;102;239;1204;2731;1306;2970
520840;202210;3547;8666;2825;7690;798;2392;1022;2784;1820;5176
520850;202210;1092;2203;835;1853;165;422;442;937;607;1359
520860;202210;11275;27500;8339;22567;1962;5502;3229;8422;5191;13924
520870;202210;183395;392790;132537;316925;24807;62665;61788;138338;86595;201003
520880;202210;11678;30519;9317;26313;1954;5672;3924;10685;5878;16357
520890;202210;5926;12251;4176;9633;637;1727;2283;4884;2920;6611
520910;202210;5915;13763;3842;10303;772;2231;1069;2559;1841;4790
520915;202210;982;2396;645;1733;127;388;258;630;385;1018
520920;202210;5668;11527;4112;9640;795;1711;2214;5395;3009;7106
520929;202210;785;1759;597;1483;103;207;268;708;371;915
520940;202210;1178;2892;918;2507;73;236;696;1847;769;2083
520945;202210;573;1205;413;988;31;80;259;596;290;676
520960;202210;1383;2902;1058;2447;371;812;373;953;744;1765
520970;202210;4282;10257;3213;8571;1118;2991;633;1839;1751;4830
520980;202210;951;2032;694;1703;107;280;337;776;444;1056
520990;202210;3836;8518;3130;7650;498;1096;2133;5340;2631;6436
520993;202210;1492;3437;984;2538;165;457;435;1077;600;1534
520995;202210;3138;7239;2317;6009;510;1287;710;1927;1220;3214
521000;202210;11781;28276;7834;21130;1253;3544;2552;6312;3805;9856
521010;202210;4857;11417;3555;9204;521;1498;1908;4638;2429;6136
521015;202210;950;2183;662;1678;48;133;427;1016;475;1149
521020;202210;5181;12006;3137;8299;713;2008;779;1952;1492;3960
521030;202210;959;1652;748;1368;24;54;654;1153;678;1207
521040;202210;10384;23845;7622;19601;1861;4798;2554;6888;4415;11686
521056;202210;1251;3052;872;2404;257;684;203;600;460;1284
521060;202210;1239;3038;860;2329;174;520;308;796;482;1316
521080;202210;1292;2626;690;1718;118;305;300;698;418;1003
521090;202210;3841;9729;2566;7184;612;1859;292;757;904;2616
521100;202210;2408;4948;1807;4149;239;578;1152;2638;1391;3216
521120;202210;6144;13614;4612;11656;900;1989;1778;5281;2678;7270
521130;202210;1201;2648;573;1519;58;152;299;798;357;950
521140;202210;1949;4521;1416;3595;197;501;781;1865;978;2366
521150;202210;16864;35257;11054;26940;2639;7088;4620;10757;7259;17845
521160;202210;1001;1913;633;1356;72;135;404;834;476;969
521170;202210;1332;2871;958;2308;146;381;454;1011;600;1392
521180;202210;10607;25473;8226;21533;1577;4467;3869;9768;5446;14235
521190;202210;14290;33296;9098;24897;2174;6423;2698;6949;4872;13372
521200;202210;865;1974;581;1512;72;203;283;692;355;895
521205;202210;750;1643;573;1370;26;65;457;1052;483;1117
521210;202210;962;2427;562;1581;109;331;148;318;257;649
521220;202210;4759;10391;3184;7982;805;2217;1193;2777;1998;4994
521225;202210;530;1014;396;866;36;77;308;674;344;751
521230;202210;1759;4056;1464;3670;601;1564;482;1203;1083;2767
521250;202210;46697;106487;37966;94551;8861;23674;20668;49363;29529;73037
521260;202210;647;1376;485;1138;70;191;286;619;356;810
521270;202210;2624;5560;2203;5044;234;458;1582;3713;1816;4171
521280;202210;2261;5597;1699;4696;345;1018;737;2007;1082;3025
521290;202210;692;1453;475;1175;50;131;294;690;344;821
521295;202210;1476;2996;1134;2568;154;309;750;1701;904;2010
521300;202210;2223;5091;1695;4329;336;822;906;2360;1242;3182
521305;202210;804;1749;543;1382;55;160;333;814;388;974
521308;202210;5962;14449;4146;11207;375;1104;2597;6659;2972;7763
521310;202210;13207;30698;9045;23484;1709;4855;3860;9239;5569;14094
521340;202210;489;1027;325;802;28;69;186;436;214;505
521350;202210;2353;5599;1782;4733;133;400;1285;3292;1418;3692
521370;202210;1524;3715;967;2789;301;952;167;498;468;1450
521375;202210;1850;4474;1238;3424;253;703;315;942;568;1645
521377;202210;1678;3325;1220;2760;137;259;898;2153;1035;2412
521380;202210;7723;19275;4941;14241;767;2331;997;2967;1764;5298
521385;202210;851;1880;634;1590;94;213;342;907;436;1120
521390;202210;830;1984;553;1531;133;412;85;235;218;647
521400;202210;3559;7771;2829;6837;272;693;1975;4671;2247;5364
521405;202210;1672;4121;1115;3078;127;356;602;1581;729;1937
521410;202210;1130;2514;889;2157;220;479;461;1169;681;1648
521440;202210;1801;4051;1387;3460;441;1034;577;1514;1018;2548
521450;202210;5094;13871;3764;11311;990;3041;852;2615;1842;5656
521460;202210;7555;17889;5414;14131;1415;3878;1887;4710;3302;8588
521470;202210;981;2299;674;1741;105;252;315;756;420;1008
521480;202210;619;1321;417;991;66;165;210;431;276;596
521483;202210;2872;6483;2051;5267;503;1268;817;2136;1320;3404
521486;202210;2172;4844;1657;4099;164;296;1068;2661;1232;2957
521487;202210;561;1215;406;1010;69;171;257;634;326;805
521490;202210;1048;2541;767;2086;31;111;558;1423;589;1534
521500;202210;2541;6079;1926;5214;189;703;1172;2935;1361;3638
521520;202210;1009;2135;792;1841;142;277;434;1062;576;1339
521523;202210;17988;48314;14758;43253;4405;13429;5246;14951;9651;28380
521525;202210;1321;2911;1004;2463;90;276;671;1554;761;1830
521530;202210;2754;6756;1709;4690;335;938;464;1166;799;2104
521540;202210;979;2348;705;1906;153;474;298;754;451;1228
521550;202210;1999;4770;1105;3038;201;596;267;742;468;1338
521560;202210;6926;16172;5066;13667;1402;3784;2118;5969;3520;9753
521565;202210;820;1903;568;1487;103;269;255;663;358;932
521570;202210;4808;12088;3301;9329;653;2042;351;996;1004;3038
521580;202210;644;1410;420;1050;73;185;174;395;247;580
521590;202210;1044;2119;749;1704;98;238;453;970;551;1208
521600;202210;550;1345;341;954;63;183;170;434;233;617
521630;202210;2097;4247;1303;3131;396;980;354;787;750;1767
521640;202210;2391;5297;1512;3976;326;953;480;1174;806;2127
521645;202210;640;1554;376;1060;162;445;25;52;187;497
521680;202210;1737;4364;1330;3715;349;1008;494;1354;843;2362
521690;202210;656;1518;542;1366;87;236;312;761;399;997
521710;202210;4288;9732;2801;7250;496;1440;796;1737;1292;3177
521720;202210;3038;6305;1967;4729;244;643;1147;2685;1391;3328
521730;202210;4960;12496;3705;10416;982;3161;907;2116;1889;5277
521740;202210;5626;13205;4384;11398;1362;3814;1349;3190;2711;7004
521760;202210;23135;53674;18820;47610;3718;10568;10580;25408;14298;35976
521770;202210;4046;8882;2631;6684;580;1534;634;1559;1214;3093
521800;202210;8701;20900;6197;16834;1820;5013;1873;5569;3693;10582
521805;202210;1356;2586;900;2018;193;399;459;1102;652;1501
521810;202210;889;1913;639;1570;123;301;349;880;472;1181
521830;202210;7312;17904;5901;15741;457;1443;4261;10947;4718;12390
521839;202210;1116;2362;845;1941;75;206;604;1280;679;1486
521850;202210;8741;18839;5405;13778;1638;4102;693;1702;2331;5804
521860;202210;2012;5118;1356;3892;243;770;418;1071;661;1841
521870;202210;840;2181;599;1721;128;400;193;462;321;862
521878;202210;1017;2443;654;1763;56;168;339;831;395;999
521880;202210;28467;64788;20410;52424;4328;11869;9048;21917;13376;33786
521890;202210;4157;9817;2848;7603;740;2002;794;1948;1534;3950
521900;202210;1657;3678;862;2323;206;462;21;56;227;518
521910;202210;1736;3534;1220;2895;270;640;544;1266;814;1906
521920;202210;681;1641;527;1395;64;210;318;779;382;989
521925;202210;947;2297;694;1905;144;436;281;726;425;1162
521930;202210;6699;15150;4480;11823;1280;2817;1755;5135;3035;7952
521935;202210;1234;2800;856;2168;73;203;512;1215;585;1418
521940;202210;1618;3283;1058;2505;181;483;559;1249;740;1732
521945;202210;803;1882;565;1471;81;210;312;802;393;1012
521950;202210;903;1999;623;1564;103;266;291;719;394;985
521960;202210;825;2007;562;1522;55;186;331;812;386;998
521970;202210;3462;7238;2615;6201;238;486;1949;4765;2187;5251
521971;202210;924;2109;640;1672;163;415;174;434;337;849
521973;202210;1921;4595;1486;3925;148;361;1007;2643;1155;3004
521975;202210;17009;39906;13807;35367;2401;6677;8113;20085;10514;26762
521980;202210;2836;6069;2135;5154;144;355;1626;3901;1770;4256
521990;202210;1745;3914;1472;3518;267;716;900;2102;1167;2818
522000;202210;3326;8002;2582;7048;611;1721;1276;3663;1887;5384
522005;202210;467;1004;302;758;54;144;110;275;164;419
522010;202210;5669;13037;4016;10340;865;2373;1514;3651;2379;6024
522015;202210;1316;3143;967;2604;261;724;406;1067;667;1791
522020;202210;6717;14670;4507;11329;900;2330;1999;5029;2899;7359
522026;202210;930;2270;580;1665;91;314;173;405;264;719
522028;202210;621;1422;434;1105;78;242;215;475;293;717
522040;202210;4651;9198;3273;7364;319;804;2261;4784;2580;5588
522045;202210;25247;63425;18869;52819;4107;12230;5167;13687;9274;25917
522050;202210;1463;3475;1031;2733;191;567;455;1058;646;1625
522060;202210;3671;9011;2656;7405;461;1231;1262;3582;1723;4813
522068;202210;2290;4971;1838;4439;113;233;1499;3644;1612;3877
522070;202210;1030;1988;844;1723;22;40;745;1486;767;1526
522100;202210;1030;2427;693;1852;101;272;334;850;435;1122
522108;202210;1354;2816;1050;2397;65;147;803;1780;868;1927
522119;202210;2377;5078;1890;4473;378;749;1059;2631;1437;3380
522130;202210;647;1450;489;1239;44;91;371;962;415;1053
522140;202210;29959;71195;21022;55573;4539;12788;6750;16335;11289;29123
522145;202210;964;2140;680;1730;137;391;367;898;504;1289
522150;202210;1329;2959;862;2227;208;558;227;559;435;1117
522155;202210;1253;3003;971;2577;144;343;579;1547;723;1890
522157;202210;881;1774;715;1574;37;78;559;1225;596;1303
522160;202210;7570;17987;4818;13215;1278;3768;530;1540;1808;5308
522170;202210;3315;7887;2554;6763;323;849;1589;4206;1912;5055
522180;202210;902;1958;580;1389;105;257;173;430;278;687
522185;202210;29902;67499;22039;57050;8680;24401;4399;12029;13079;36430
522190;202210;983;2071;666;1589;150;355;277;611;427;966
522200;202210;2469;6276;1821;5141;486;1367;582;1629;1068;2996
522205;202210;1990;4541;1440;3728;426;1143;462;1163;888;2306
522220;202210;1439;3191;1053;2670;130;305;639;1680;769;1985
522230;202210;1646;3675;1286;3149;200;545;780;1859;980;2404
530010;202210;295178;712946;248345;643466;33559;94895;154435;382888;187994;477783
110001;202209;4750;12441;3178;9543;737;2455;1124;3278;1861;5733
110002;202209;16793;40365;12206;32845;3147;9079;3528;9316;6675;18395
110003;202209;879;2434;637;1955;154;496;176;477;330;973
110004;202209;16430;39173;11323;30514;2439;6875;4075;10527;6514;17402
110005;202209;3026;7426;2141;6011;461;1303;674;1993;1135;3296
110006;202209;1762;4734;1078;3329;205;691;232;641;437;1332
110007;202209;1505;3684;979;2801;284;812;269;891;553;1703
110008;202209;4209;9952;3133;8463;603;1371;1778;5410;2381;6781
110009;202209;5393;14028;3470;10585;764;2560;1320;3840;2084;6400
110010;202209;9823;27466;7498;23360;1658;4724;3665;12844;5323;17568
110011;202209;9018;22267;6166;17280;1773;5191;1345;3654;3118;8845
110012;202209;20364;47854;13310;36200;3411;9411;2800;7335;6211;16746
110013;202209;7045;18694;4905;14618;1845;5829;823;2478;2668;8307
110014;202209;4625;11278;3149;8557;465;1406;1613;4188;2078;5594
110015;202209;7200;17175;4638;12543;945;2862;1500;3479;2445;6341
110018;202209;5159;12270;3260;9061;684;2024;841;2176;1525;4200
110020;202209;106999;228900;81269;194632;17583;42266;41096;100376;58679;142642
110025;202209;6135;13886;4197;10647;640;1787;2234;5413;2874;7200
110026;202209;670;1697;478;1383;119;368;150;448;269;816
110028;202209;8824;21087;5548;15422;1355;4198;698;1894;2053;6092
110029;202209;1832;4290;1120;3088;207;572;456;1256;663;1828
110030;202209;16310;36144;10224;27105;2819;8129;1473;4134;4292;12263
110032;202209;4358;11286;2623;7784;806;2367;503;1585;1309;3952
110033;202209;5310;14825;3990;12399;1303;4161;1230;4103;2533;8264
110034;202209;3744;8380;2536;6717;916;2677;641;1887;1557;4564
110037;202209;1893;5285;1333;4228;347;1127;469;1496;816;2623
110040;202209;3517;9136;2564;7454;632;2016;784;2158;1416;4174
110045;202209;5685;15280;4104;12479;1110;3593;1438;4404;2548;7997
110050;202209;2055;5255;1363;4039;430;1443;200;497;630;1940
110060;202209;1100;3065;726;2211;170;546;191;569;361;1115
110070;202209;1848;5345;1312;4179;358;1249;336;947;694;2196
110080;202209;7800;17342;5863;14885;1216;3115;3015;7986;4231;11101
110090;202209;683;1793;469;1398;122;407;125;351;247;758
110092;202209;1577;4247;1105;3384;229;712;550;1728;779;2440
110094;202209;3397;9339;2535;7724;1012;3269;345;1103;1357;4372
110100;202209;2105;5655;1651;4841;573;1740;556;1666;1129;3406
110110;202209;2143;5413;1526;4436;464;1438;330;1029;794;2467
110120;202209;1546;4091;1103;3236;274;843;328;944;602;1787
110130;202209;3267;7653;1972;5347;359;961;246;628;605;1589
110140;202209;2871;7579;2101;6117;397;1277;977;2697;1374;3974
110143;202209;1699;4291;1217;3433;342;1055;383;1031;725;2086
110145;202209;1152;2805;693;1962;162;450;281;817;443;1267
110146;202209;627;1546;422;1199;113;301;157;499;270;800
110147;202209;938;2249;620;1664;88;272;314;735;402;1007
110148;202209;1148;2966;588;1766;152;494;66;158;218;652
110149;202209;4083;9889;2784;7876;958;2788;683;2073;1641;4861
110150;202209;3035;7319;1970;5674;635;2007;394;1231;1029;3238
110155;202209;1002;2721;702;2020;146;484;284;725;430;1209
110160;202209;1733;4837;1256;3845;417;1305;263;821;680;2126
110170;202209;2492;5957;1610;4368;230;709;937;2353;1167;3062
110175;202209;2521;6612;1710;4930;312;959;739;2032;1051;2991
110180;202209;1656;4152;1163;3218;154;458;613;1641;767;2099
120001;202209;4191;10734;3388;9551;456;1512;2275;6264;2731;7776
120005;202209;2325;8002;2108;7677;222;826;1618;6026;1840;6852
120010;202209;7200;17678;6202;16275;493;1234;4870;12877;5363;14111
120013;202209;2960;8554;2547;8012;726;2201;1191;4197;1917;6398
120017;202209;3588;8971;3062;8236;434;1116;2012;5727;2446;6843
120020;202209;18071;59250;16606;56641;1088;4274;13310;45248;14398;49522
120025;202209;4552;10395;3727;9450;508;1265;2532;6736;3040;8001
120030;202209;7471;27005;6893;26031;440;2069;5274;20279;5714;22348
120032;202209;2054;8193;1941;7981;95;594;1657;6671;1752;7265
120033;202209;5168;16042;4830;15459;104;540;4283;13479;4387;14019
120034;202209;3451;10496;2983;9757;131;626;2527;8078;2658;8704
120035;202209;5060;15738;4707;15148;277;1030;4027;12847;4304;13877
120038;202209;3634;9785;3122;9018;423;1294;2047;5942;2470;7236
120039;202209;2383;9171;2213;8848;127;684;1802;7139;1929;7823
120040;202209;71885;178038;62156;163820;7819;21846;41660;108515;49479;130361
120042;202209;4216;12948;3894;12405;247;834;3222;10219;3469;11053
120043;202209;1739;6353;1518;6036;54;354;1302;5070;1356;5424
120045;202209;7236;16652;6107;15324;480;1265;4830;12147;5310;13412
120050;202209;11908;35974;10954;34643;509;1926;9290;29358;9799;31284
120060;202209;11737;39705;10736;38265;489;2328;9282;32857;9771;35185
120070;202209;4117;11464;3544;10693;540;1486;2296;7390;2836;8876
120080;202209;6524;15543;5859;14623;726;1701;4423;11209;5149;12910
130002;202209;4041;13190;3590;12586;421;1068;2900;10776;3321;11844
130006;202209;3052;9773;2531;8955;609;1905;1333;5402;1942;7307
130008;202209;3203;9856;2767;9243;164;561;2229;7659;2393;8220
130010;202209;5025;12461;4296;11624;160;383;3836;10454;3996;10837
130014;202209;4569;11729;3477;10093;616;1818;2045;6174;2661;7992
130020;202209;3301;11823;2905;11246;134;737;2396;9199;2530;9936
130030;202209;18525;39670;17295;38293;194;529;16489;36216;16683;36745
130040;202209;4861;13143;4016;12061;534;1479;2937;9170;3471;10649
130050;202209;8686;28749;7312;26964;349;1239;6389;24039;6738;25278
130060;202209;8561;31452;7276;29788;418;2287;6014;24360;6432;26647
130063;202209;7554;22631;6668;21632;199;854;6063;19628;6262;20482
130068;202209;4608;13421;3876;12451;231;901;3103;9928;3334;10829
130070;202209;9043;23030;7423;21260;599;1405;5881;17478;6480;18883
130080;202209;9142;27845;7920;26478;423;1241;6874;23511;7297;24752
130083;202209;3300;9779;2895;9272;300;901;2246;7487;2546;8388
130090;202209;4795;11897;4269;11291;69;165;3831;10364;3900;10529
130100;202209;8927;25126;7492;23617;161;381;6931;22239;7092;22620
130110;202209;10508;25933;8586;23567;1571;3843;5464;16455;7035;20298
130115;202209;6087;17204;5247;16235;153;467;4620;14435;4773;14902
130120;202209;18467;54044;16396;51385;1361;4594;13579;42563;14940;47157
130130;202209;7206;18984;5604;16977;612;1705;4048;13034;4660;14739
130140;202209;8440;26519;7390;25337;330;1413;6359;21882;6689;23295
130150;202209;4672;14347;4398;14042;75;390;4084;13003;4159;13393
130160;202209;7784;20751;6729;19474;359;890;5917;17385;6276;18275
130165;202209;3923;13193;3695;12936;165;599;3289;11639;3454;12238
130170;202209;15857;38168;13051;35052;465;1523;11566;30965;12031;32488
130180;202209;5137;14956;4897;14695;38;212;4734;14157;4772;14369
130185;202209;24037;51696;19827;47190;1518;2014;16943;42418;18461;44432
130190;202209;23465;68779;19058;62551;1606;5279;14613;48660;16219;53939
130195;202209;2931;9636;2458;9054;113;453;2069;7724;2182;8177
130200;202209;3571;8435;2948;7649;173;569;2462;6271;2635;6840
130210;202209;1747;5956;1567;5733;125;589;1264;4570;1389;5159
130220;202209;3036;8598;2496;7954;70;244;2245;7284;2315;7528
130230;202209;5935;21201;5178;20190;197;1058;4583;17874;4780;18932
130240;202209;17460;39720;14634;36209;161;759;13717;33412;13878;34171
130250;202209;31242;84023;26721;78827;1602;4108;22029;67157;23631;71265
130255;202209;5996;16463;5126;14987;238;681;4241;12360;4479;13041
130260;202209;397868;919868;335216;837255;69016;176075;206496;514775;275512;690850
130270;202209;11510;36232;9508;33245;1729;5548;6046;22327;7775;27875
130280;202209;4351;14938;3963;14498;141;557;3653;13452;3794;14009
130290;202209;19684;49617;17627;47146;716;1987;16019;42852;16735;44839
130300;202209;5937;17406;5281;16533;168;729;4554;14178;4722;14907
130310;202209;9960;24134;8826;22784;454;1205;7710;19919;8164;21124
130320;202209;4140;12478;3456;11555;441;1382;2485;8634;2926;10016
130330;202209;5555;15646;4495;14397;219;785;3785;12375;4004;13160
130340;202209;29821;78223;25713;73658;1339;3593;21969;64537;23308;68130
130350;202209;4509;15039;4019;14406;141;731;3516;12540;3657;13271
130353;202209;9718;23364;7907;21091;1190;2936;5450;15167;6640;18103
130356;202209;6645;18621;5621;17100;1024;3004;3438;10966;4462;13970
130360;202209;3575;10697;2895;9867;77;336;2595;8843;2672;9179
130370;202209;5982;23790;5023;22394;642;3452;3254;14626;3896;18078
130380;202209;8903;35748;8311;34857;688;3382;6697;28068;7385;31450
130390;202209;8248;29011;7199;27471;417;1951;6284;23896;6701;25847
130395;202209;2993;8498;2496;7722;189;655;2011;6110;2200;6765
130400;202209;3375;9306;2853;8610;103;300;2532;7710;2635;8010
130406;202209;13368;42514;11301;39998;1914;6254;7834;29157;9748;35411
130410;202209;5314;16525;4576;15393;1214;4188;2462;8625;3676;12813
130420;202209;17629;54036;14809;50498;1558;5584;11015;38234;12573;43818
130423;202209;5115;14770;4442;13977;217;839;3905;12220;4122;13059
130426;202209;3750;11981;3388;11578;54;184;3013;10825;3067;11009
130430;202209;5731;13172;4913;12140;191;472;4385;10745;4576;11217
130440;202209;6933;17153;5945;15986;124;407;5578;14977;5702;15384
140002;202209;2962;7868;2558;7390;161;431;2112;6261;2273;6692
140005;202209;3906;10238;3394;9640;626;1640;2371;7072;2997;8712
140010;202209;61267;157136;49149;139579;11660;34859;21340;61902;33000;96761
140015;202209;5649;13172;4742;12178;331;722;4063;10776;4394;11498
140017;202209;7137;16202;6308;15183;389;864;5336;13024;5725;13888
140020;202209;6784;16943;5840;15785;380;1127;4721;12762;5101;13889
140023;202209;3326;8618;2667;7724;365;1058;1926;5698;2291;6756
140028;202209;2446;5773;2057;5292;133;356;1609;4158;1742;4514
140030;202209;7661;15985;6936;15163;316;462;6305;14090;6621;14552
140040;202209;3401;11981;3129;11627;101;521;2890;10680;2991;11201
140045;202209;3915;12867;3359;12116;803;2291;1924;7941;2727;10232
140047;202209;7315;19136;6106;17389;729;2143;4324;12525;5053;14668
140050;202209;2007;5294;1705;4870;283;713;1161;3456;1444;4169
140060;202209;2613;5666;2323;5281;226;443;1925;4451;2151;4894
140070;202209;2398;11380;2319;11244;143;934;2001;9545;2144;10479
150010;202209;60765;129249;54755;121680;1536;2907;49042;108381;50578;111288
150013;202209;2618;5587;2205;5139;119;227;1891;4490;2010;4717
150020;202209;18134;46752;16638;44754;1720;3594;13348;37338;15068;40932
150030;202209;10767;35232;9686;33975;596;1885;8231;30014;8827;31899
150034;202209;5333;11477;4343;10278;237;549;3693;8815;3930;9364
150040;202209;19253;45226;16850;42579;1203;1553;14775;39409;15978;40962
150050;202209;9405;26243;8585;25191;223;667;7874;23314;8097;23981
150060;202209;28071;68954;22677;61094;3023;8291;15007;40892;18030;49183
150070;202209;10770;29949;9626;28627;195;759;9001;26650;9196;27409
150080;202209;110317;235057;91020;209613;24648;56838;29637;79235;54285;136073
150085;202209;11426;26256;10371;25030;125;346;9812;23697;9937;24043
150090;202209;14532;39014;13544;37406;539;1585;11962;32603;12501;34188
150095;202209;8847;19188;7811;17964;810;1024;6520;15783;7330;16807
150100;202209;3413;10883;2999;10216;245;756;2375;8301;2620;9057
150110;202209;5240;19033;4838;18581;161;652;4461;17402;4622;18054
150120;202209;9524;26346;8827;25511;359;694;7872;23259;8231;23953
150125;202209;1053;2446;762;2036;100;297;486;1265;586;1562
150130;202209;28904;73700;24744;67546;4716;11266;15196;44446;19912;55712
150140;202209;352025;699951;300292;633768;32272;65994;209436;436237;241708;502231
150145;202209;4967;14384;4080;13015;1383;4245;1591;5902;2974;10147
150150;202209;21779;48158;18627;44261;1404;3106;14497;34529;15901;37635
150157;202209;4366;10807;3452;9594;435;1192;2273;6535;2708;7727
150160;202209;4971;10563;4629;10111;406;937;3769;8014;4175;8951
150170;202209;33797;87823;30021;81853;5053;11963;19561;56741;24614;68704
150172;202209;6835;15558;5563;13853;316;766;4392;10957;4708;11723
150175;202209;2132;5681;1773;5089;192;669;1263;3493;1455;4162
150178;202209;14988;32119;11336;27949;990;1411;9063;24062;10053;25473
150180;202209;33597;88253;30509;84825;2488;4434;25095;74895;27583;79329
150190;202209;9095;22934;8411;22122;142;512;7847;20471;7989;20983
150195;202209;6282;17400;5824;16759;194;680;5285;15088;5479;15768
150200;202209;6997;18091;6308;17307;38;144;5894;16167;5932;16311
150210;202209;37833;102453;35584;99734;1290;3491;31679;89825;32969;93316
150215;202209;11942;31069;10266;28455;1760;4948;6164;17171;7924;22119
150220;202209;16379;39747;14316;36981;816;2109;11046;28230;11862;30339
150230;202209;16622;40360;14747;37877;1406;2972;10810;28708;12216;31680
150240;202209;42928;105692;35964;94438;7531;20304;17153;43327;24684;63631
150250;202209;4954;16973;4626;16614;448;1655;3933;14310;4381;15965
150260;202209;3473;9400;3062;8802;92;318;2660;7565;2752;7883
150270;202209;10735;28028;7545;22394;2098;6474;2111;6464;4209;12938
150275;202209;8878;23434;8107;22406;209;756;7200;19546;7409;20302
150276;202209;2756;6796;2380;6336;295;674;1674;4867;1969;5541
150277;202209;6710;14649;5350;13112;636;1623;3907;9764;4543;11387
150280;202209;8589;29191;8255;28686;494;1532;7091;25240;7585;26772
150285;202209;4100;12392;3530;11480;235;727;2753;9024;2988;9751
150290;202209;13429;31543;12153;30190;518;758;10995;28022;11513;28780
150293;202209;11938;26013;9351;22715;1029;2491;6485;15808;7514;18299
150295;202209;8818;21621;6251;18057;2019;5809;2163;7185;4182;12994
150300;202209;3656;8086;3343;7713;32;94;3153;7229;3185;7323
150304;202209;5266;13813;4379;12481;621;1572;3038;9012;3659;10584
150307;202209;6888;19685;6205;18588;305;881;4967;14932;5272;15813
150309;202209;7843;20268;6351;17874;816;2225;4072;11697;4888;13922
150310;202209;8650;30597;8127;29958;234;1098;7241;27007;7475;28105
150320;202209;11136;26824;10081;25342;736;1773;7740;19399;8476;21172
150330;202209;17431;48202;16046;46301;1989;4551;11509;35725;13498;40276
150340;202209;2902;7806;2537;7296;301;827;1877;5435;2178;6262
150345;202209;11029;26524;9786;24920;346;988;8695;21945;9041;22933
150350;202209;11685;25048;10580;23648;671;1194;9126;20495;9797;21689
150360;202209;29984;74264;23988;66840;2474;4753;17994;52959;20468;57712
150370;202209;13905;36212;11370;32863;1392;3382;8246;25398;9638;28780
150375;202209;4551;16853;4100;16236;233;918;3595;14397;3828;15315
150380;202209;12918;29035;10473;25874;218;661;9159;22376;9377;23037
150390;202209;8434;31392;7465;29863;1322;4496;4987;21256;6309;25752
150400;202209;8001;25022;7585;24353;117;459;6467;21351;6584;21810
150405;202209;10649;25052;9171;23311;655;1166;7362;19342;8017;20508
150410;202209;2333;6400;1976;5841;202;522;1389;4169;1591;4691
150420;202209;54540;133959;42709;117084;9952;28137;19839;57066;29791;85203
150430;202209;9765;25317;8861;24203;646;1320;7463;20827;8109;22147
150440;202209;7446;19091;6719;18148;587;1412;5364;14683;5951;16095
150442;202209;37342;75967;31539;69118;2078;4535;25035;53871;27113;58406
150445;202209;9299;22378;8287;20963;143;429;7584;18994;7727;19423
150450;202209;7120;23232;6619;22586;338;1613;5955;19917;6293;21530
150460;202209;10211;29003;9265;27844;413;1052;7885;24506;8298;25558
150470;202209;25195;60053;22525;56916;334;1166;21088;52762;21422;53928
150475;202209;6555;18060;5559;16523;867;2234;3739;11704;4606;13938
150480;202209;16986;46280;15242;43832;2951;6948;10176;31794;13127;38742
150490;202209;9801;30815;8832;29507;616;1749;7246;24922;7862;26671
150495;202209;6782;18860;6385;18351;179;684;5820;16591;5999;17275
150497;202209;3193;9224;2523;8053;506;1643;1379;4640;1885;6283
150500;202209;3817;8941;3352;8274;221;545;2674;6469;2895;7014
150503;202209;6508;15649;4679;13343;1487;3832;1875;5991;3362;9823
150506;202209;15815;39395;13501;36309;2329;5631;9053;26068;11382;31699
150510;202209;14265;39531;12403;36487;1082;2988;9608;28500;10690;31488
150520;202209;9738;30717;9308;30199;163;927;8744;28134;8907;29061
150530;202209;14388;44577;12447;41845;1061;2971;9712;33709;10773;36680
150540;202209;6370;14617;5498;13345;268;599;4682;11272;4950;11871
150543;202209;8863;22211;7343;20318;612;1722;5636;15994;6248;17716
150548;202209;12524;34304;11117;32348;462;1315;9728;28457;10190;29772
150549;202209;2343;6015;1965;5485;73;229;1609;4479;1682;4708
150550;202209;24787;66380;20155;58949;5100;15099;8238;25205;13338;40304
150553;202209;45583;115129;34968;97265;8572;24345;15365;42979;23937;67324
150555;202209;2428;5849;1887;5036;174;391;1242;3468;1416;3859
150560;202209;2301;5932;2048;5493;240;624;1359;3648;1599;4272
150563;202209;3194;8597;2581;7527;508;1549;1417;4101;1925;5650
150565;202209;5280;15426;4658;14471;126;460;3785;11863;3911;12323
150570;202209;9109;22487;8343;21480;307;903;7438;18960;7745;19863
150580;202209;13484;46242;11553;44121;1335;3978;9143;37144;10478;41122
150590;202209;9736;29600;8319;27923;178;868;7640;25577;7818;26445
150600;202209;12449;33781;11507;32635;317;922;10516;29996;10833;30918
150610;202209;3797;8916;3378;8285;127;395;2930;7012;3057;7407
150611;202209;3888;9517;3377;8819;85;290;2991;7673;3076;7963
150613;202209;17492;44152;13330;37402;2481;7398;6905;18829;9386;26227
150616;202209;4515;11574;3247;9391;643;1987;1513;4241;2156;6228
150618;202209;8439;21993;6847;19573;928;2765;4221;12227;5149;14992
150619;202209;8069;20514;6604;18512;632;1467;5019;14505;5651;15972
150620;202209;8619;25436;7481;23538;1218;3434;4498;14979;5716;18413
150630;202209;8210;18315;7492;17467;185;440;6788;15641;6973;16081
150635;202209;6486;15728;5428;14051;653;1538;3637;9492;4290;11030
150640;202209;2500;6846;2272;6554;42;114;2070;6018;2112;6132
150650;202209;14626;35603;12674;32675;3287;8058;5972;16441;9259;24499
150655;202209;6678;16951;6015;16005;111;396;5400;14167;5511;14563
150658;202209;5333;14286;3912;11909;924;2938;1775;5564;2699;8502
150660;202209;6797;17478;5938;16254;1054;2758;3621;9980;4675;12738
150670;202209;12002;23570;9567;20787;763;1514;7756;17208;8519;18722
150680;202209;92513;234865;73455;206349;15942;42243;38083;114868;54025;157111
150690;202209;3217;7084;2772;6576;125;225;2421;5826;2546;6051
150700;202209;8173;20821;7273;19700;825;1674;5515;15707;6340;17381
150710;202209;4555;13313;4079;12593;397;1189;2999;9447;3396;10636
150715;202209;6579;15878;5410;14221;298;743;4486;11772;4784;12515
150720;202209;10111;25840;9313;24766;378;1138;8198;21601;8576;22739
150730;202209;15858;42936;13461;39476;1725;5182;9606;28790;11331;33972
150740;202209;4773;11970;4133;11010;418;858;3051;8425;3469;9283
150745;202209;6724;16746;5476;15006;704;1990;3925;10968;4629;12958
150746;202209;2121;5438;1875;5083;61;183;1592;4243;1653;4426
150747;202209;6067;16068;5370;15069;403;998;4225;12009;4628;13007
150750;202209;4452;12294;3626;11086;400;1234;2528;8082;2928;9316
150760;202209;13919;36599;12518;34692;2035;5015;8456;24526;10491;29541
150770;202209;8462;25375;7755;24585;238;536;7090;23121;7328;23657
150775;202209;1424;3377;1114;2984;142;415;779;2074;921;2489
150780;202209;5834;15618;5186;14863;312;812;4572;13398;4884;14210
150790;202209;7359;17798;6169;16507;531;1080;4138;13162;4669;14242
150795;202209;19276;50710;16614;46894;3054;8462;10436;30317;13490;38779
150796;202209;4973;10170;4271;9376;176;332;3760;8261;3936;8593
150797;202209;5430;14129;4610;12979;426;1096;3701;10508;4127;11604
150800;202209;16768;46398;14998;44120;2207;6007;10539;32152;12746;38159
150803;202209;10242;24632;9427;23544;283;814;8507;20968;8790;21782
150805;202209;4326;11881;3663;10981;323;889;2789;8577;3112;9466
150808;202209;7896;21237;5793;17778;2028;6779;984;3328;3012;10107
150810;202209;25363;58503;19147;51073;4206;10727;9880;29416;14086;40143
150812;202209;7782;18121;6886;16790;418;1288;5541;12886;5959;14174
150815;202209;11549;30697;9652;28455;1223;3558;7433;22351;8656;25909
150820;202209;18270;37714;16030;35063;2019;3045;12090;28560;14109;31605
150830;202209;15486;45504;14370;44153;688;1764;12669;39944;13357;41708
150835;202209;4099;10879;3558;10086;389;1125;2596;7347;2985;8472
150840;202209;10063;25306;8149;22369;1139;3516;5001;13231;6140;16747
160005;202209;1663;3656;1467;3432;80;203;1255;2919;1335;3122
160010;202209;2622;6534;2422;6321;22;100;2336;6041;2358;6141
160015;202209;4679;9959;4233;9447;75;197;4018;8903;4093;9100
160020;202209;3019;7837;2618;7325;299;705;1964;5778;2263;6483
160021;202209;1504;4979;1336;4776;63;266;1002;3715;1065;3981
160023;202209;1658;5062;1473;4757;257;770;926;3140;1183;3910
160025;202209;2362;6072;2200;5894;42;84;2109;5672;2151;5756
160027;202209;13778;28745;12498;27192;736;1634;10849;23432;11585;25066
160030;202209;102331;248293;85170;226394;16032;39761;50532;142681;66564;182442
160040;202209;7297;21042;6421;19866;420;1171;5533;17379;5953;18550
160050;202209;7006;17587;5786;16038;2080;4795;2724;9125;4804;13920
160053;202209;5127;13456;4535;12654;264;648;3774;10835;4038;11483
160055;202209;1922;3677;1854;3604;29;83;1786;3430;1815;3513
160060;202209;36574;78881;30841;72424;2661;5144;24706;60009;27367;65153
160070;202209;3602;11385;3141;10695;343;979;2335;8477;2678;9456
160080;202209;4005;10622;3501;10068;54;163;3245;9448;3299;9611
170025;202209;778;1918;488;1388;91;257;163;456;254;713
170030;202209;1348;3776;987;3110;195;605;394;1280;589;1885
170035;202209;1735;4144;1265;3404;105;308;771;1971;876;2279
170040;202209;2223;5503;1737;4837;197;564;1042;2995;1239;3559
170070;202209;2279;4853;1617;4024;88;225;981;2487;1069;2712
170100;202209;2889;7327;2354;6464;313;814;1508;4191;1821;5005
170105;202209;776;2081;515;1569;126;372;158;444;284;816
170110;202209;1192;3195;913;2734;65;257;573;1624;638;1881
170130;202209;1672;4294;1263;3621;130;442;776;2149;906;2591
170190;202209;1879;4405;1449;3748;199;634;871;2114;1070;2748
170200;202209;2413;5318;1576;3988;273;722;650;1575;923;2297
170210;202209;32518;81541;24504;68656;6958;20959;4823;13815;11781;34774
170215;202209;1524;3748;1206;3315;54;197;940;2536;994;2733
170220;202209;6818;19464;5569;17299;1987;6156;1622;5779;3609;11935
170230;202209;1448;3898;1083;3238;295;875;302;917;597;1792
170240;202209;3405;8051;2741;7041;165;516;2065;5137;2230;5653
170255;202209;4459;11916;3252;9875;594;1873;1543;4716;2137;6589
170270;202209;1005;2320;681;1831;76;203;382;991;458;1194
170290;202209;3685;9234;3166;8554;276;547;2427;6828;2703;7375
170300;202209;2606;5937;2116;5226;167;395;1587;3830;1754;4225
170305;202209;792;1996;644;1741;77;204;358;974;435;1178
170307;202209;1254;3572;1029;3168;120;425;648;1911;768;2336
170310;202209;1869;4289;1335;3483;168;472;702;1808;870;2280
170320;202209;1218;3030;924;2557;110;341;559;1537;669;1878
170330;202209;1116;3105;1012;2953;30;132;874;2486;904;2618
170360;202209;684;1638;496;1352;23;86;338;846;361;932
170370;202209;1534;3603;1093;2908;192;519;534;1334;726;1853
170380;202209;2141;5614;1611;4799;128;415;960;2930;1088;3345
170382;202209;615;1642;498;1455;19;74;366;1024;385;1098
170384;202209;1976;6144;1626;5519;326;1082;871;2947;1197;4029
170386;202209;1098;2843;662;2011;73;261;245;674;318;935
170388;202209;857;2104;611;1696;87;255;317;827;404;1082
170389;202209;1027;2946;814;2576;86;305;511;1635;597;1940
170390;202209;2154;4306;1624;3687;37;96;1402;3196;1439;3292
170410;202209;731;1714;537;1399;27;93;374;905;401;998
170460;202209;468;1202;375;1056;51;153;240;679;291;832
170510;202209;1068;2743;754;2215;33;135;493;1334;526;1469
170550;202209;7991;19496;6011;16463;1613;4866;1923;5057;3536;9923
170555;202209;1614;3928;1280;3430;140;314;635;1781;775;2095
170560;202209;1167;2999;887;2609;102;294;536;1636;638;1930
170600;202209;1612;3965;1252;3439;234;599;689;1957;923;2556
170610;202209;1943;4527;1443;3797;113;363;956;2403;1069;2766
170625;202209;509;1233;333;917;39;91;138;348;177;439
170650;202209;1744;4355;1416;3858;136;442;954;2485;1090;2927
170700;202209;4181;11266;3164;9354;637;1940;1398;3973;2035;5913
170710;202209;1908;4268;1447;3608;177;458;970;2376;1147;2834
170720;202209;2124;4796;1616;4018;160;479;1104;2631;1264;3110
170730;202209;1275;3093;961;2628;112;262;582;1630;694;1892
170740;202209;2375;7069;2015;6431;152;573;1505;4679;1657;5252
170755;202209;1007;2490;714;2017;122;370;336;890;458;1260
170765;202209;1341;3166;942;2550;165;437;483;1296;648;1733
170770;202209;2156;5570;1731;4932;169;501;1224;3433;1393;3934
170820;202209;4571;12057;3521;10304;667;1978;1810;5293;2477;7271
170825;202209;1221;2532;996;2246;93;200;766;1708;859;1908
170830;202209;1584;3807;1189;3174;298;913;558;1334;856;2247
170900;202209;3329;9297;2842;8612;274;765;2247;6945;2521;7710
170930;202209;4662;11707;3513;9627;810;2343;1128;2919;1938;5262
170950;202209;13539;35274;9545;28292;2805;8939;1315;4030;4120;12969
170980;202209;596;1404;427;1132;46;141;239;599;285;740
171050;202209;1935;5535;1670;5095;104;341;1311;4012;1415;4353
171070;202209;1576;4030;1340;3693;279;669;682;2183;961;2852
171090;202209;1179;2858;926;2497;146;420;483;1290;629;1710
171110;202209;663;1680;447;1286;72;216;207;543;279;759
171150;202209;1171;2707;722;1970;59;183;444;1173;503;1356
171180;202209;875;2249;564;1665;93;256;237;704;330;960
171190;202209;2322;6687;1949;6043;297;956;1190;3701;1487;4657
171195;202209;980;2784;767;2393;104;424;479;1375;583;1799
171200;202209;718;1886;524;1557;134;454;169;450;303;904
171215;202209;449;1102;347;940;37;108;199;514;236;622
171240;202209;885;2627;682;2274;20;123;471;1502;491;1625
171245;202209;895;2363;685;1956;49;171;419;1103;468;1274
171250;202209;1129;2889;795;2340;139;447;360;1036;499;1483
171270;202209;554;1805;430;1534;78;317;207;732;285;1049
171280;202209;1036;2790;829;2450;64;197;544;1621;608;1818
171320;202209;4563;11901;3530;10140;707;2018;1430;4167;2137;6185
171330;202209;3322;8447;2548;7128;625;1814;1156;3188;1781;5002
171360;202209;1768;4488;1335;3881;137;372;854;2666;991;3038
171370;202209;852;1966;645;1675;70;187;411;1040;481;1227
171380;202209;1725;4411;1416;3991;161;397;999;2986;1160;3383
171395;202209;1173;2841;795;2206;81;265;511;1362;592;1627
171420;202209;2324;5932;1757;4922;314;937;912;2464;1226;3401
171430;202209;1291;3410;1064;3006;72;229;715;1903;787;2132
171488;202209;2942;7468;2278;6406;407;1138;1191;3322;1598;4460
171500;202209;1044;2470;734;1960;81;245;456;1166;537;1411
171510;202209;972;2777;824;2517;78;267;555;1669;633;1936
171515;202209;574;1322;406;1059;29;99;268;633;297;732
171525;202209;836;2066;629;1729;66;202;404;1040;470;1242
171550;202209;380;1009;292;886;41;157;158;436;199;593
171570;202209;1264;3374;1050;3008;155;457;617;1780;772;2237
171575;202209;1968;4866;1282;3702;137;390;644;1818;781;2208
171610;202209;7006;18390;5155;15286;1236;4019;1198;3778;2434;7797
171620;202209;3443;7995;2924;7286;174;470;2427;6026;2601;6496
171630;202209;1277;3049;974;2632;139;390;635;1721;774;2111
171650;202209;2634;6889;2026;5911;504;1611;619;1819;1123;3430
171660;202209;2693;6290;1886;5012;181;494;1216;3177;1397;3671
171665;202209;1442;3778;1141;3300;244;737;518;1500;762;2237
171670;202209;2190;5438;1622;4501;236;706;744;1997;980;2703
171700;202209;1338;3436;973;2784;115;349;578;1607;693;1956
171720;202209;900;2134;691;1821;60;169;500;1293;560;1462
171750;202209;1616;4459;1135;3579;264;823;287;1080;551;1903
171780;202209;1527;3486;1085;2823;94;280;736;1850;830;2130
171790;202209;1613;4835;1281;4170;191;626;651;2084;842;2710
171800;202209;837;2079;637;1790;63;194;362;973;425;1167
171820;202209;13887;36172;10234;30156;2427;7624;2778;8512;5205;16136
171830;202209;1803;5191;1531;4741;277;828;825;2696;1102;3524
171840;202209;839;2046;621;1708;23;77;378;985;401;1062
171845;202209;783;1737;591;1461;49;161;416;962;465;1123
171850;202209;1127;3186;947;2826;44;187;731;2099;775;2286
171855;202209;1194;3348;998;3001;93;280;606;1764;699;2044
171865;202209;584;1537;491;1400;56;177;303;818;359;995
171870;202209;933;2376;652;1892;104;314;326;928;430;1242
171875;202209;1682;4114;1378;3665;44;183;1091;2788;1135;2971
171880;202209;1661;4052;1439;3762;38;132;1168;3013;1206;3145
171884;202209;1282;3111;977;2616;236;579;457;1264;693;1843
171886;202209;1749;4437;1271;3743;327;1061;329;1028;656;2089
171888;202209;680;1848;471;1454;34;130;276;807;310;937
171889;202209;497;1395;331;1061;73;258;116;341;189;599
171890;202209;1397;3767;1040;3185;138;443;654;1965;792;2408
171900;202209;659;2045;506;1745;78;229;234;817;312;1046
172000;202209;666;1832;516;1562;112;328;195;589;307;917
172010;202209;1440;4044;1211;3685;115;325;756;2312;871;2637
172015;202209;426;1350;324;1154;56;182;142;509;198;691
172020;202209;3378;8459;2934;7910;211;601;2174;5981;2385;6582
172025;202209;830;2090;598;1733;45;142;422;1208;467;1350
172030;202209;1432;3911;1171;3490;91;303;857;2516;948;2819
172049;202209;1438;3337;945;2636;133;362;491;1414;624;1776
172065;202209;1698;3936;1342;3478;144;283;970;2767;1114;3050
172080;202209;2795;7427;2237;6474;128;419;1495;4231;1623;4650
172085;202209;517;1328;325;927;58;173;122;313;180;486
172090;202209;4819;10567;3778;9218;144;379;3061;7341;3205;7720
172093;202209;510;1457;366;1202;26;109;208;648;234;757
172097;202209;810;1960;542;1515;82;238;211;559;293;797
172100;202209;59481;136988;44095;113735;8106;22952;18825;47256;26931;70208
172110;202209;1932;6219;1649;5804;106;448;1289;4550;1395;4998
172120;202209;5890;15800;4619;13809;489;1600;2791;8234;3280;9834
172125;202209;477;1198;364;1022;31;105;209;537;240;642
172130;202209;687;1619;515;1336;23;88;345;813;368;901
172208;202209;3057;6709;2398;5864;212;460;1749;4289;1961;4749
172210;202209;3107;7022;2396;6157;252;631;1569;4167;1821;4798
210005;202209;22512;59244;16932;50419;4307;13417;7242;21951;11549;35368
210010;202209;2471;6332;2261;6091;47;226;2064;5463;2111;5689
210015;202209;3620;10029;3093;9327;156;478;2553;7732;2709;8210
210020;202209;9007;18420;7737;16946;217;414;7061;15511;7278;15925
210030;202209;5163;15885;4677;15141;479;1561;3689;12091;4168;13652
210040;202209;2531;4921;2225;4558;56;151;1997;3995;2053;4146
210043;202209;6786;17689;5674;16192;367;1105;4510;12908;4877;14013
210047;202209;7894;21598;6226;19433;157;693;5386;16748;5543;17441
210050;202209;2826;7979;2257;7001;159;673;1707;5083;1866;5756
210055;202209;2401;6434;2132;6070;54;178;1879;5371;1933;5549
210060;202209;8561;28712;7550;26932;735;2746;5279;19256;6014;22002
210070;202209;7850;19258;7238;18482;78;223;6798;17284;6876;17507
210080;202209;5049;14504;4740;14159;47;243;4413;13136;4460;13379
210083;202209;7058;16628;5955;15430;108;325;5621;14533;5729;14858
210087;202209;3155;8282;2659;7625;158;504;2117;6033;2275;6537
210090;202209;10579;29654;9748;28307;497;1267;8357;24310;8854;25577
210095;202209;7336;22279;6632;21360;484;1508;5305;17748;5789;19256
210100;202209;7383;21051;6363;19292;784;2360;4294;13138;5078;15498
210110;202209;3397;9253;3100;8886;57;270;2793;7924;2850;8194
210120;202209;33143;72818;28265;66760;1679;3228;22453;53561;24132;56789
210125;202209;5115;12561;4432;11788;736;1479;3165;9032;3901;10511
210130;202209;4856;11347;3931;10208;95;221;3458;8967;3553;9188
210135;202209;2037;4647;1691;4162;45;119;1485;3612;1530;3731
210140;202209;24293;58355;18962;51513;2829;7556;11959;32883;14788;40439
210150;202209;5438;11636;4781;10759;106;305;4202;9246;4308;9551
210160;202209;24666;56768;21181;52457;1780;3874;16469;41559;18249;45433
210170;202209;19721;51156;18134;49113;1370;3026;15011;41710;16381;44736
210173;202209;2611;9097;2443;8828;97;507;2144;7653;2241;8160
210177;202209;3707;9507;3173;8824;436;1076;2353;6787;2789;7863
210180;202209;1732;4038;1506;3764;36;90;1353;3383;1389;3473
210190;202209;6469;14900;5348;13379;93;289;4671;11487;4764;11776
210193;202209;1569;3990;1346;3648;50;138;1046;2818;1096;2956
210197;202209;2284;6557;2059;6251;144;399;1673;5193;1817;5592
210200;202209;9127;26057;8021;24405;497;1657;6361;19306;6858;20963
210203;202209;8351;22092;6993;20325;521;1502;5551;16490;6072;17992
210207;202209;4415;9841;3588;8894;145;311;3002;7495;3147;7806
210210;202209;8587;25091;7709;23883;147;762;6617;20290;6764;21052
210215;202209;2774;8000;2394;7455;136;622;1940;5921;2076;6543
210220;202209;7847;22649;7382;21991;138;859;6695;19411;6833;20270
210230;202209;6562;16984;5943;16060;155;433;5400;14556;5555;14989
210232;202209;13565;37759;11096;34115;1614;4891;7323;23513;8937;28404
210235;202209;3987;10851;3459;10096;167;577;2898;8419;3065;8996
210237;202209;4790;10539;4103;9765;24;137;3920;9203;3944;9340
210240;202209;2893;8158;2607;7714;76;270;2158;6285;2234;6555
210250;202209;6860;17828;6185;16980;129;445;5597;15339;5726;15784
210255;202209;3035;8447;2593;7694;286;921;1682;4843;1968;5764
210260;202209;5997;16618;5155;15380;393;1244;4129;12296;4522;13540
210270;202209;5709;13945;5040;13115;78;367;4582;11754;4660;12121
210275;202209;3913;9035;3319;8318;181;400;2708;6841;2889;7241
210280;202209;7031;16878;5771;15066;176;723;4729;11874;4905;12597
210290;202209;9677;21404;8684;20217;125;332;8197;18989;8322;19321
210300;202209;37513;95604;30316;85388;5513;14724;16085;49768;21598;64492
210310;202209;3505;8036;3031;7389;48;134;2771;6710;2819;6844
210312;202209;3265;7085;2899;6690;18;81;2728;6188;2746;6269
210315;202209;4135;9154;3669;8630;128;285;3368;7959;3496;8244
210317;202209;5068;14145;4596;13586;99;452;4204;12320;4303;12772
210320;202209;29611;66009;27535;63443;257;1198;25887;58571;26144;59769
210325;202209;4071;10531;3390;9629;392;1125;2555;7336;2947;8461
210330;202209;30209;73481;24273;66265;3955;8809;15784;47586;19739;56395
210340;202209;14116;32176;12652;30359;641;1335;10554;25824;11195;27159
210350;202209;10961;27194;9632;25569;121;419;8773;23123;8894;23542
210355;202209;4457;13826;3905;12960;114;512;3301;10929;3415;11441
210360;202209;14323;41684;12880;39421;508;2253;9775;28855;10283;31108
210370;202209;14090;26744;10661;23138;393;571;9737;21566;10130;22137
210375;202209;3823;9666;2806;8159;913;2835;765;2368;1678;5203
210380;202209;6394;14767;5499;13696;263;697;4724;11678;4987;12375
210390;202209;3606;9652;3350;9262;71;326;3057;8303;3128;8629
210400;202209;5373;13969;4730;13220;254;487;4166;11987;4420;12474
210405;202209;8535;20231;6912;18066;1220;2782;4106;11468;5326;14250
210407;202209;2354;6881;1956;6194;118;393;1507;4777;1625;5170
210408;202209;3114;10267;2871;9941;191;774;2290;7964;2481;8738
210409;202209;4378;13502;3928;12883;219;777;3185;10683;3404;11460
210410;202209;4164;11071;3503;9945;91;378;2896;8010;2987;8388
210420;202209;4309;12622;3803;11735;219;632;3128;9704;3347;10336
210430;202209;2505;6855;2166;6389;177;479;1737;5227;1914;5706
210440;202209;4968;12208;4299;11385;208;409;3800;10182;4008;10591
210450;202209;2625;7037;2252;6498;224;544;1698;5061;1922;5605
210455;202209;5610;13060;4331;11456;1019;2797;2184;5802;3203;8599
210460;202209;4111;10961;3429;10053;114;398;2902;8441;3016;8839
210462;202209;1896;5261;1582;4785;64;183;1245;3790;1309;3973
210465;202209;3059;7966;2639;7391;125;488;2198;5995;2323;6483
210467;202209;7201;19335;6209;18056;459;1206;5025;14954;5484;16160
210470;202209;2133;5481;1579;4701;147;422;1146;3453;1293;3875
210480;202209;19520;52634;16121;48511;1951;4186;11528;38147;13479;42333
210490;202209;3854;8918;3071;7880;80;212;2607;6640;2687;6852
210500;202209;7156;24608;6581;23679;356;1607;5535;19726;5891;21333
210510;202209;7524;20595;6653;19664;198;524;6053;18144;6251;18668
210515;202209;4320;11542;3664;10763;187;591;3071;9144;3258;9735
210520;202209;2941;7892;2621;7466;128;423;2192;6159;2320;6582
210530;202209;63558;145946;49430;125767;9369;25211;19733;54712;29102;79923
210535;202209;4237;11858;3841;11294;135;479;3368;9879;3503;10358
210540;202209;17343;45799;14444;41646;1868;4831;9821;29841;11689;34672
210542;202209;7493;16286;5809;14383;513;1156;4582;11545;5095;12701
210545;202209;2499;7102;2291;6766;46;184;1988;5785;2034;5969
210547;202209;4211;13707;3697;12806;212;768;2900;10231;3112;10999
210550;202209;6689;18943;5109;16416;577;1991;3245;10676;3822;12667
210560;202209;4225;11935;3712;11121;99;374;3182;9385;3281;9759
210565;202209;1706;4704;1409;4288;93;362;1070;3278;1163;3640
210570;202209;12528;31427;11057;29615;273;784;9874;26539;10147;27323
210580;202209;3389;8107;2669;7222;204;476;1923;5485;2127;5961
210590;202209;4739;13026;4049;12165;82;416;3597;10751;3679;11167
210592;202209;3184;8076;2940;7705;28;134;2599;6659;2627;6793
210594;202209;2803;7209;2182;6263;184;492;1550;4623;1734;5115
210596;202209;3303;10133;2928;9486;346;1115;2145;7156;2491;8271
210598;202209;2301;5705;2054;5377;92;262;1789;4665;1881;4927
210600;202209;3357;8607;2706;7684;300;792;1789;5087;2089;5879
210610;202209;3507;8235;2993;7621;59;239;2626;6578;2685;6817
210620;202209;3453;7653;2814;6861;168;313;2362;5758;2530;6071
210630;202209;3595;10548;3179;9851;162;613;2555;7826;2717;8439
210632;202209;7034;16146;6284;15170;197;705;5604;13172;5801;13877
210635;202209;1882;6219;1760;6000;179;570;1340;4694;1519;5264
210637;202209;2996;8732;2512;8054;154;560;1930;6262;2084;6822
210640;202209;5555;16842;5151;16377;62;315;4792;15195;4854;15510
210650;202209;7936;20716;7077;19620;101;356;6340;17508;6441;17864
210660;202209;9280;24565;8283;22983;187;826;7210;19418;7397;20244
210663;202209;3544;8126;3140;7642;309;489;2344;6223;2653;6712
210667;202209;2236;6554;1986;6180;47;164;1710;5436;1757;5600
210670;202209;6193;16533;5574;15605;121;484;5004;13810;5125;14294
210675;202209;6330;14451;5412;13338;568;1171;4262;10814;4830;11985
210680;202209;5583;11659;4721;10664;111;185;4392;9939;4503;10124
210690;202209;10308;24227;8686;22424;264;828;7879;20115;8143;20943
210700;202209;3191;8011;2532;7070;172;435;1935;5474;2107;5909
210710;202209;6027;16143;5289;15182;103;444;4762;13528;4865;13972
210720;202209;3509;10109;3052;9551;90;412;2696;8370;2786;8782
210725;202209;1513;4448;1293;4110;53;182;924;3036;977;3218
210730;202209;1662;3445;1400;3097;69;130;1206;2676;1275;2806
210735;202209;5284;13722;4461;12689;276;666;3673;10837;3949;11503
210740;202209;5987;13984;5072;12939;121;265;4321;10968;4442;11233
210745;202209;4870;12141;4410;11575;61;209;3983;10375;4044;10584
210750;202209;28697;69364;24836;64473;3369;7673;16605;45273;19974;52946
210760;202209;6999;15364;5872;14170;134;241;5494;13417;5628;13658
210770;202209;7184;16197;6141;15015;57;236;5742;13874;5799;14110
210780;202209;8479;24115;7285;22184;495;1519;5703;17364;6198;18883
210790;202209;5144;14103;4536;13301;276;720;3765;11314;4041;12034
210800;202209;5624;13616;4805;12516;75;294;4347;11110;4422;11404
210805;202209;4680;15081;4307;14535;197;718;3680;12487;3877;13205
210810;202209;5612;14819;5062;14125;432;1037;4089;11771;4521;12808
210820;202209;8226;21611;6845;19450;968;2561;4132;12169;5100;14730
210825;202209;9278;22749;8397;21629;268;758;7587;19419;7855;20177
210830;202209;10019;23909;9074;22766;732;1326;7528;19620;8260;20946
210840;202209;5083;9555;4656;9042;33;124;4387;8295;4420;8419
210845;202209;7118;17373;6247;16408;47;148;5976;15729;6023;15877
210850;202209;7876;21484;6563;19565;494;1376;5162;15610;5656;16986
210860;202209;24463;55043;20221;49984;997;2169;16722;42466;17719;44635
210870;202209;8692;19507;6907;17509;141;371;6219;15685;6360;16056
210880;202209;4778;13007;4260;12345;223;697;3379;9704;3602;10401
210890;202209;5676;12709;5191;12157;243;609;4587;10588;4830;11197
210900;202209;5532;14807;4299;12646;1562;4649;875;2940;2437;7589
210905;202209;2575;5586;2188;5106;47;78;2045;4795;2092;4873
210910;202209;8421;23986;6940;21618;857;2610;4557;14308;5414;16918
210920;202209;3577;10354;3125;9755;68;323;2829;8719;2897;9042
210923;202209;2234;5115;1940;4688;87;219;1596;3764;1683;3983
210927;202209;5310;16143;4579;15241;603;1929;3127;10880;3730;12809
210930;202209;3379;8901;2978;8191;91;362;2574;6818;2665;7180
210940;202209;4230;11162;3827;10668;345;1504;3157;8110;3502;9614
210945;202209;9044;21508;8044;20358;494;980;6643;17394;7137;18374
210950;202209;6245;15579;4832;13622;588;1293;3306;10003;3894;11296
210955;202209;1743;4935;1457;4476;292;857;846;2683;1138;3540
210960;202209;10560;28802;9042;26507;2684;7702;4071;12959;6755;20661
210970;202209;1931;4627;1590;4073;88;267;1331;3267;1419;3534
210975;202209;2021;5592;1816;5284;178;520;1350;3927;1528;4447
210980;202209;12240;24253;10853;22809;137;256;10287;21608;10424;21864
210990;202209;20264;50610;15739;44887;1560;3772;11204;33429;12764;37201
211000;202209;16977;43703;13980;40000;2277;5653;9541;29063;11818;34716
211003;202209;7298;17747;6132;16380;119;449;5460;14605;5579;15054
211010;202209;7956;23195;7176;22228;84;385;6567;20427;6651;20812
211020;202209;10046;25057;8769;23645;219;706;7706;21149;7925;21855
211023;202209;2389;6941;2193;6690;125;380;1815;5524;1940;5904
211027;202209;4428;10897;4204;10566;113;363;3890;9614;4003;9977
211030;202209;4454;11230;3937;10584;382;947;2913;8015;3295;8962
211040;202209;5106;16626;4671;15890;119;617;4163;14044;4282;14661
211050;202209;10798;24472;9679;23075;130;406;8865;20979;8995;21385
211060;202209;8670;22052;7866;20999;171;627;7053;18574;7224;19201
211065;202209;2876;6607;2403;6011;113;236;2083;5282;2196;5518
211070;202209;9645;26363;8173;24230;332;1077;6939;20501;7271;21578
211080;202209;1536;3750;1206;3255;31;168;937;2344;968;2512
211085;202209;2497;6281;2061;5725;196;382;1606;4730;1802;5112
211090;202209;3543;8963;3180;8548;28;128;2949;7870;2977;7998
211100;202209;8164;17853;7580;17175;34;111;7194;16249;7228;16360
211102;202209;3898;11108;3524;10570;323;981;2807;8455;3130;9436
211105;202209;2656;7636;2223;6889;119;378;1704;5187;1823;5565
211107;202209;5436;15666;4584;14416;181;608;3661;11991;3842;12599
211110;202209;7396;17418;5875;15221;254;749;4785;12070;5039;12819
211120;202209;55878;124603;45671;112688;7613;17030;29161;75221;36774;92251
211125;202209;2210;6139;1857;5605;42;194;1581;4726;1623;4920
211130;202209;219662;479613;188788;439910;26636;54898;119495;289754;146131;344652
211140;202209;5429;14813;4679;13843;182;563;3948;11759;4130;12322
211150;202209;11064;26551;9248;24296;459;1010;7603;20380;8062;21390
211153;202209;3395;8344;2362;7056;408;1097;1463;4634;1871;5731
211157;202209;1433;4019;1209;3602;85;255;866;2566;951;2821
211160;202209;6008;13582;4870;12025;129;468;4016;9407;4145;9875
211163;202209;1703;5057;1525;4806;56;201;1323;4190;1379;4391
211167;202209;1954;5141;1806;4937;25;100;1682;4567;1707;4667
211170;202209;8140;16752;7513;16027;51;136;7176;15147;7227;15283
211172;202209;2939;7505;2463;6785;92;315;1995;5271;2087;5586
211174;202209;3324;8446;3005;8089;32;165;2847;7583;2879;7748
211176;202209;4858;12640;3781;11077;321;1001;2928;8537;3249;9538
211178;202209;6094;11865;5264;10983;25;105;5103;10543;5128;10648
211180;202209;4799;14227;4381;13640;171;702;3664;11263;3835;11965
211190;202209;3812;9436;3219;8590;31;166;2941;7727;2972;7893
211195;202209;1855;4324;1613;3972;59;150;1422;3474;1481;3624
211200;202209;2452;6622;1918;5785;188;591;1348;4021;1536;4612
211210;202209;7041;19766;6294;18741;461;1424;5096;15190;5557;16614
211220;202209;49069;107636;40781;97620;3847;8580;30719;74008;34566;82588
211223;202209;6132;14950;4984;13428;635;1711;3257;8830;3892;10541
211227;202209;1950;5648;1671;5254;68;266;1366;4309;1434;4575
211230;202209;9921;24427;8487;22408;331;711;7267;19319;7598;20030
211240;202209;9630;25939;9020;25163;195;734;8381;23130;8576;23864
211245;202209;8992;22218;7886;21051;150;336;7489;20062;7639;20398
211250;202209;17626;45939;15933;43441;1304;3581;12588;34160;13892;37741
211260;202209;9302;26702;8046;25213;189;777;7214;22723;7403;23500
211270;202209;11655;33312;9922;31076;400;1578;8114;25558;8514;27136
211280;202209;17882;38646;16041;36388;472;1020;14606;33061;15078;34081
211285;202209;2351;6586;2090;6248;157;517;1603;4802;1760;5319
211290;202209;8132;22378;7248;21182;296;954;5998;17443;6294;18397
211300;202209;8333;22629;7217;20797;467;1432;5529;15670;5996;17102
211400;202209;13788;34402;11230;30918;1448;3804;7485;21537;8933;25341
220005;202209;2280;5172;2053;4861;38;100;1747;4008;1785;4108
220010;202209;1675;4390;1348;3838;39;131;1055;2961;1094;3092
220020;202209;5114;11294;4434;10401;154;417;3864;8849;4018;9266
220025;202209;2729;5363;2338;4801;81;132;1941;3856;2022;3988
220027;202209;1606;3512;1379;3207;30;97;1207;2735;1237;2832
220030;202209;4430;9470;4110;9064;101;268;3651;7876;3752;8144
220040;202209;9158;25118;7922;22853;1490;3964;4520;13512;6010;17476
220045;202209;1844;4784;1532;4301;24;128;1323;3593;1347;3721
220050;202209;6275;13774;5441;12745;66;230;5098;11744;5164;11974
220060;202209;3420;5779;2958;5250;29;49;2835;4992;2864;5041
220070;202209;2789;6474;2315;5798;69;145;1949;4813;2018;4958
220080;202209;849;2223;734;2063;14;58;631;1741;645;1799
220090;202209;1997;4373;1611;3810;71;100;1321;3163;1392;3263
220095;202209;1164;2076;1107;2016;23;41;1031;1861;1054;1902
220100;202209;1668;4014;1322;3490;30;118;1082;2722;1112;2840
220105;202209;2394;6563;2063;6007;140;446;1545;4452;1685;4898
220110;202209;4167;9965;3618;9084;42;169;3234;7986;3276;8155
220115;202209;3315;8389;3037;8040;150;418;2643;6932;2793;7350
220117;202209;1624;3500;1274;3026;13;48;1070;2456;1083;2504
220120;202209;19827;38783;18337;36930;72;276;17542;34755;17614;35031
220130;202209;1326;3153;1099;2848;24;106;986;2479;1010;2585
220140;202209;2742;4971;2340;4515;80;154;2103;4072;2183;4226
220150;202209;7578;19470;6846;18264;149;552;5818;15119;5967;15671
220155;202209;1371;3598;1091;3103;23;82;785;2149;808;2231
220157;202209;1288;2726;1081;2428;27;62;877;1927;904;1989
220160;202209;3303;8160;2813;7309;55;191;2299;5772;2354;5963
220170;202209;1808;4404;1516;3983;26;102;1323;3419;1349;3521
220173;202209;2449;6236;1946;5368;51;192;1538;4122;1589;4314
220177;202209;2737;6050;2601;5904;6;19;2566;5805;2572;5824
220180;202209;1404;2867;1153;2474;6;31;967;1922;973;1953
220190;202209;9690;19654;8278;17855;597;1111;6460;14218;7057;15329
220191;202209;1911;5074;1732;4786;120;372;1272;3406;1392;3778
220192;202209;2380;5684;1718;4553;40;136;1408;3633;1448;3769
220194;202209;2146;5253;1878;4841;54;193;1574;3880;1628;4073
220196;202209;2516;5736;2285;5407;20;90;2001;4620;2021;4710
220198;202209;1556;3544;1319;3256;12;25;1214;3008;1226;3033
220200;202209;5860;15573;5098;14556;126;425;4313;12267;4439;12692
220202;202209;2524;6237;2126;5605;33;128;1835;4733;1868;4861
220205;202209;3115;7507;2768;6912;85;234;2355;5744;2440;5978
220207;202209;893;2412;749;2172;78;201;476;1427;554;1628
220208;202209;2077;5762;1677;5032;273;851;894;2658;1167;3509
220209;202209;1797;4757;1515;4262;27;96;1245;3455;1272;3551
220210;202209;2278;4603;1996;4195;18;56;1774;3596;1792;3652
220211;202209;2034;4187;1863;3968;21;70;1655;3456;1676;3526
220213;202209;2097;4980;1769;4436;33;116;1438;3424;1471;3540
220217;202209;2834;6785;2625;6545;162;226;2318;6010;2480;6236
220220;202209;15615;31868;13456;28831;510;1139;11201;23446;11711;24585
220225;202209;1164;2671;942;2393;2;12;885;2226;887;2238
220230;202209;6847;15119;5899;13834;159;312;5211;12206;5370;12518
220240;202209;3703;9452;3054;8370;97;382;2506;6666;2603;7048
220245;202209;2383;4298;1847;3674;10;37;1715;3352;1725;3389
220250;202209;3580;8691;3136;8145;25;98;2931;7544;2956;7642
220253;202209;1905;4668;1603;4205;35;118;1376;3523;1411;3641
220255;202209;2312;4821;1951;4322;43;153;1692;3588;1735;3741
220260;202209;5936;14842;5164;13526;279;688;4136;10793;4415;11481
220265;202209;1771;4686;1618;4486;89;315;1357;3658;1446;3973
220270;202209;7031;20619;6560;19779;178;892;5554;16076;5732;16968
220271;202209;1753;3987;1527;3679;44;117;1314;3140;1358;3257
220272;202209;2010;5286;1740;4796;51;181;1325;3480;1376;3661
220273;202209;1486;3828;1234;3384;60;201;945;2538;1005;2739
220275;202209;3091;5860;2504;5087;46;70;2300;4613;2346;4683
220277;202209;2809;5879;2365;5267;108;196;1964;4308;2072;4504
220280;202209;2313;4272;1949;3825;27;49;1770;3397;1797;3446
220285;202209;1945;3952;1684;3643;11;47;1606;3418;1617;3465
220290;202209;8200;20272;6523;17990;537;1327;4626;13242;5163;14569
220300;202209;2301;5985;1792;5332;34;172;1475;4322;1509;4494
220310;202209;3789;8893;2985;7962;48;176;2604;6880;2652;7056
220320;202209;3568;9273;2747;7852;76;341;2168;5950;2244;6291
220323;202209;1946;4993;1484;4261;46;181;1224;3387;1270;3568
220325;202209;1396;3878;1164;3484;32;140;936;2739;968;2879
220327;202209;1935;4746;1687;4354;63;213;1413;3523;1476;3736
220330;202209;6220;12206;5359;11207;44;148;4979;10205;5023;10353
220335;202209;2200;5468;1995;5192;124;206;1690;4488;1814;4694
220340;202209;2100;5212;1578;4349;77;247;1009;2666;1086;2913
220342;202209;1416;3655;1262;3437;88;189;975;2698;1063;2887
220345;202209;3634;7334;2761;6154;22;74;2468;5386;2490;5460
220350;202209;3876;9037;3099;7900;221;510;2180;5527;2401;6037
220360;202209;1534;3506;1184;2956;19;59;968;2339;987;2398
220370;202209;10451;26358;9413;24774;379;1026;7952;20704;8331;21730
220375;202209;1996;4774;1765;4496;11;15;1701;4348;1712;4363
220380;202209;1861;3762;1495;3259;22;45;1318;2839;1340;2884
220385;202209;1102;2229;900;1891;7;13;807;1656;814;1669
220390;202209;14346;31424;11439;27282;1923;4632;6166;14599;8089;19231
220400;202209;1770;3811;1341;3156;19;64;1046;2318;1065;2382
220410;202209;1386;3441;1119;2999;28;99;926;2417;954;2516
220415;202209;996;2337;798;2008;24;50;630;1550;654;1600
220420;202209;2189;5759;1741;4897;77;264;1275;3489;1352;3753
220430;202209;3415;7359;3044;6873;51;133;2766;6118;2817;6251
220435;202209;2418;5182;2099;4705;29;90;1818;3927;1847;4017
220440;202209;3770;8715;3201;7905;52;245;2889;6797;2941;7042
220450;202209;3235;7222;2691;6552;47;163;2403;5750;2450;5913
220455;202209;1611;4093;1530;3994;10;52;1415;3669;1425;3721
220460;202209;1378;2757;1272;2612;29;63;1137;2255;1166;2318
220465;202209;2806;7724;2470;7216;169;490;1933;5672;2102;6162
220470;202209;4522;10868;3989;10027;188;408;3112;7708;3300;8116
220480;202209;3108;7426;2468;6446;217;430;1676;4380;1893;4810
220490;202209;2856;6442;2429;5916;27;125;2135;5074;2162;5199
220500;202209;3871;8395;3235;7440;127;237;2528;5679;2655;5916
220510;202209;3183;7652;2554;6597;107;254;2036;5279;2143;5533
220515;202209;2104;4365;1929;4122;76;99;1647;3508;1723;3607
220520;202209;6072;13804;5447;12933;136;281;4607;10974;4743;11255
220525;202209;1657;3588;1387;3266;10;32;1280;3004;1290;3036
220527;202209;1924;4135;1610;3686;51;112;1433;3284;1484;3396
220530;202209;1950;3996;1638;3601;167;358;1260;2854;1427;3212
220535;202209;1024;2439;948;2326;31;107;780;1830;811;1937
220540;202209;3777;10724;3460;10118;221;620;2803;8170;3024;8790
220545;202209;1737;4583;1573;4330;78;301;1326;3555;1404;3856
220550;202209;10250;29127;8999;26845;502;1681;6719;19525;7221;21206
220551;202209;1712;4122;1480;3737;24;84;1259;3093;1283;3177
220552;202209;1902;5028;1530;4390;22;111;1236;3404;1258;3515
220553;202209;2488;4903;2091;4393;27;52;1898;3935;1925;3987
220554;202209;1149;2554;885;2158;87;164;626;1508;713;1672
220555;202209;4501;8260;3991;7660;32;91;3613;6839;3645;6930
220556;202209;1520;3872;1303;3488;42;178;972;2434;1014;2612
220557;202209;1958;5427;1607;4698;105;382;1148;3210;1253;3592
220558;202209;1708;3952;1360;3473;24;92;1165;2875;1189;2967
220559;202209;2191;4713;1854;4199;55;95;1540;3463;1595;3558
220560;202209;2277;4304;1904;3857;20;40;1783;3570;1803;3610
220570;202209;9574;24555;8591;23148;651;1584;6770;18231;7421;19815
220580;202209;7981;19360;7197;18189;110;312;6439;16171;6549;16483
220585;202209;2411;6801;1987;6037;64;166;1610;4892;1674;5058
220590;202209;1803;4047;1494;3617;107;222;1168;2810;1275;3032
220595;202209;3265;7702;2936;7274;91;282;2527;6132;2618;6414
220600;202209;2185;3715;1917;3412;18;33;1806;3175;1824;3208
220605;202209;1722;4660;1475;4233;22;116;1184;3267;1206;3383
220610;202209;3345;8250;3111;7919;18;95;2942;7406;2960;7501
220620;202209;10204;25533;9301;24336;136;656;8555;21950;8691;22606
220630;202209;411;1115;317;949;28;88;196;554;224;642
220635;202209;2091;5603;1845;5121;66;227;1487;3998;1553;4225
220640;202209;2767;6973;2335;6353;93;310;1880;5057;1973;5367
220650;202209;2883;6426;2472;5827;99;203;2025;4752;2124;4955
220660;202209;2986;8512;2492;7700;76;351;2045;6150;2121;6501
220665;202209;1531;4007;1304;3649;34;154;1114;3011;1148;3165
220667;202209;1910;5091;1723;4779;88;287;1396;3805;1484;4092
220669;202209;1924;5074;1823;4931;40;171;1631;4292;1671;4463
220670;202209;2730;5938;2183;5184;30;88;1931;4512;1961;4600
220672;202209;4030;8825;3323;7980;101;342;2950;6895;3051;7237
220675;202209;1517;3756;1346;3462;81;227;1012;2551;1093;2778
220680;202209;3636;7838;3470;7632;243;330;3040;6915;3283;7245
220690;202209;1849;4393;1589;3999;106;296;1205;2962;1311;3258
220695;202209;1090;2734;986;2556;22;61;833;2123;855;2184
220700;202209;14493;28510;11906;25178;461;1044;9772;19943;10233;20987
220710;202209;1036;2527;753;2049;22;78;581;1516;603;1594
220720;202209;2698;5402;2422;5054;26;80;2178;4433;2204;4513
220730;202209;1612;3874;1378;3516;15;65;1202;2971;1217;3036
220735;202209;1222;2449;938;2028;39;76;739;1553;778;1629
220740;202209;1617;3742;1290;3308;57;146;1063;2743;1120;2889
220750;202209;5183;10789;4579;9989;251;402;4058;8915;4309;9317
220755;202209;1765;3626;1475;3217;30;71;1243;2645;1273;2716
220760;202209;4204;8913;3691;8254;43;141;3496;7738;3539;7879
220770;202209;31842;81694;27360;74481;6999;20116;12174;32867;19173;52983
220775;202209;1617;3358;1444;3147;6;26;1408;3035;1414;3061
220777;202209;1823;4237;1419;3630;56;106;999;2667;1055;2773
220779;202209;1422;3446;1214;3121;37;113;1016;2560;1053;2673
220780;202209;6913;15087;6203;14094;361;852;4908;11043;5269;11895
220785;202209;1711;3366;1501;3105;21;49;1411;2890;1432;2939
220790;202209;12356;30449;11038;28633;237;898;9518;24246;9755;25144
220793;202209;1173;2600;946;2230;14;33;809;1875;823;1908
220795;202209;1648;3776;1436;3475;28;88;1274;3053;1302;3141
220800;202209;25522;48137;22012;43659;1021;1894;18004;34800;19025;36694
220810;202209;3634;8945;3059;8005;80;184;2461;6527;2541;6711
220820;202209;7071;14839;6232;13670;267;466;5265;11454;5532;11920
220830;202209;8913;20350;7879;18899;412;992;6416;15065;6828;16057
220840;202209;15383;40104;13011;35776;1989;5260;7981;21561;9970;26821
220850;202209;3551;9826;3146;9319;58;269;2820;8336;2878;8605
220855;202209;990;1940;861;1780;13;50;793;1605;806;1655
220860;202209;1401;2813;1196;2534;23;68;1111;2307;1134;2375
220865;202209;2647;6639;2017;5552;47;197;1532;4040;1579;4237
220870;202209;3925;8780;3271;7953;35;153;3011;7204;3046;7357
220880;202209;7837;14294;6799;13052;151;314;6260;11905;6411;12219
220885;202209;1783;4386;1488;3949;86;266;1197;3112;1283;3378
220887;202209;1886;3551;1585;3160;45;65;1456;2894;1501;2959
220890;202209;1668;4465;1429;4125;56;195;1164;3343;1220;3538
220900;202209;2592;5156;2184;4622;26;53;1970;4084;1996;4137
220910;202209;2068;4587;1763;4140;322;508;1226;3108;1548;3616
220915;202209;1075;2680;838;2263;8;31;629;1589;637;1620
220920;202209;1829;4809;1577;4484;98;290;1309;3735;1407;4025
220930;202209;2363;5030;1999;4551;21;57;1803;4157;1824;4214
220935;202209;1230;3273;962;2713;19;84;651;1708;670;1792
220937;202209;1709;4072;1435;3635;37;120;1147;2830;1184;2950
220940;202209;2223;4781;1820;4133;39;116;1552;3369;1591;3485
220945;202209;579;1765;458;1547;23;120;312;1017;335;1137
220950;202209;1593;3406;1067;2608;15;45;862;2002;877;2047
220955;202209;1934;4276;1594;3726;19;41;1393;3204;1412;3245
220960;202209;865;2090;629;1698;34;107;397;993;431;1100
220965;202209;2157;4993;1872;4593;24;110;1647;3914;1671;4024
220970;202209;2571;5027;1918;4112;9;32;1702;3527;1711;3559
220975;202209;893;2067;766;1909;11;51;690;1659;701;1710
220980;202209;1442;3462;1284;3254;31;100;1107;2743;1138;2843
220985;202209;1721;3676;1488;3325;97;172;1153;2548;1250;2720
220987;202209;1767;4569;1557;4225;53;181;1289;3446;1342;3627
220990;202209;1924;4847;1674;4469;26;101;1410;3706;1436;3807
220995;202209;1625;3734;1335;3254;13;42;1136;2713;1149;2755
220997;202209;2849;7471;2580;7033;50;193;2297;6100;2347;6293
221000;202209;5598;13128;4887;12144;158;502;4175;10198;4333;10700
221005;202209;1929;4256;1755;3977;24;97;1517;3273;1541;3370
221010;202209;1536;2935;1215;2545;37;53;1075;2225;1112;2278
221020;202209;1752;4920;1572;4623;26;98;1226;3574;1252;3672
221030;202209;2004;4146;1704;3780;22;57;1516;3381;1538;3438
221035;202209;1876;4151;1595;3769;37;56;1404;3342;1441;3398
221037;202209;826;1991;693;1768;13;45;524;1246;537;1291
221038;202209;603;1542;469;1320;25;81;334;908;359;989
221039;202209;982;2452;805;2167;30;115;652;1700;682;1815
221040;202209;5163;13361;4426;12155;220;606;3566;9743;3786;10349
221050;202209;5516;10897;4952;10200;84;207;4528;9231;4612;9438
221060;202209;11446;27442;9423;24212;491;1099;7542;19205;8033;20304
221062;202209;1556;3954;1337;3629;81;205;1105;2956;1186;3161
221063;202209;1417;3323;1228;3061;63;179;1004;2434;1067;2613
221065;202209;3470;7359;3025;6643;14;48;2745;5906;2759;5954
221070;202209;3903;10906;3130;9352;442;1285;1894;5744;2336;7029
221080;202209;4277;9300;3495;8151;49;180;2968;6639;3017;6819
221090;202209;1642;3687;1352;3255;14;42;1180;2773;1194;2815
221093;202209;1994;4473;1807;4169;179;348;1313;2969;1492;3317
221095;202209;1059;2467;874;2204;32;95;707;1762;739;1857
221097;202209;980;2273;735;1863;16;48;573;1366;589;1414
221100;202209;165830;377943;140728;338750;9639;26725;103700;236558;113339;263283
221110;202209;12993;32077;11840;30637;352;881;10426;26883;10778;27764
221120;202209;5702;14761;5050;13810;173;534;4359;11846;4532;12380
221130;202209;7019;15304;5515;12693;820;1773;3575;7878;4395;9651
221135;202209;2395;4951;2081;4553;83;156;1788;3977;1871;4133
221140;202209;1865;3486;1558;3116;50;86;1386;2744;1436;2830
221150;202209;1321;2965;999;2440;24;108;794;1810;818;1918
221160;202209;870;1957;768;1828;43;56;596;1434;639;1490
221170;202209;1201;2940;1109;2784;7;22;1007;2474;1014;2496
230010;202209;3556;8503;2906;7423;42;142;2399;5921;2441;6063
230015;202209;4232;11245;3664;10132;218;650;2644;7167;2862;7817
230020;202209;18248;46471;16905;44464;837;2072;14271;37689;15108;39761
230030;202209;15168;33898;12697;30646;464;1061;10583;25621;11047;26682
230040;202209;5157;11842;4270;10478;48;197;3695;8846;3743;9043
230050;202209;3037;8713;2321;7127;286;961;1174;3266;1460;4227
230060;202209;2879;6938;2252;5898;40;151;1819;4622;1859;4773
230070;202209;5215;11776;4172;9988;590;1230;2642;6436;3232;7666
230075;202209;11673;31448;10573;29635;539;1801;8646;23649;9185;25450
230080;202209;3697;6829;2845;5787;11;25;2657;5359;2668;5384
230090;202209;5484;11606;4585;10241;155;338;3846;8334;4001;8672
230100;202209;26144;56618;22771;52296;1996;4617;16254;36888;18250;41505
230110;202209;15877;42928;13287;38090;2005;5958;7393;20588;9398;26546
230120;202209;9756;22718;8393;20637;629;1585;6159;14962;6788;16547
230125;202209;3639;8616;2997;7607;77;265;2449;5959;2526;6224
230130;202209;6694;18346;5424;15732;360;1025;3771;10751;4131;11776
230140;202209;4210;11105;3503;9755;108;431;2766;7362;2874;7793
230150;202209;1893;5047;1552;4361;185;499;948;2646;1133;3145
230160;202209;8730;17878;7564;16222;236;466;6509;13655;6745;14121
230170;202209;7351;19198;5939;16437;430;1159;4158;11253;4588;12412
230180;202209;1903;4739;1587;4171;13;55;1298;3269;1311;3324
230185;202209;5515;13316;4602;11885;457;1124;3241;8482;3698;9606
230190;202209;17165;46583;14110;40996;1734;5154;8158;23127;9892;28281
230195;202209;6770;17377;6046;16202;349;946;4649;12366;4998;13312
230200;202209;5633;14444;4629;12648;279;795;3441;9139;3720;9934
230205;202209;5178;12834;4523;11927;304;752;3559;9253;3863;10005
230210;202209;13126;26683;11162;24138;502;1040;9017;19007;9519;20047
230220;202209;18449;39868;16172;36736;938;2106;13266;29586;14204;31692
230230;202209;8398;21620;7525;20000;415;1131;5895;15316;6310;16447
230240;202209;16503;37443;14008;33454;836;1703;10953;25961;11789;27664
230250;202209;10713;26835;9877;25613;444;1214;7586;18999;8030;20213
230260;202209;18169;46340;15580;42056;2269;5866;9387;25172;11656;31038
230270;202209;8768;21213;6711;17595;921;2207;3818;10418;4739;12625
230280;202209;24410;56017;20130;49177;426;1686;16609;38245;17035;39931
230290;202209;6296;14522;5293;12764;209;487;4276;9987;4485;10474
230300;202209;5965;13715;5318;12836;70;207;4690;11305;4760;11512
230310;202209;5495;14231;4599;12651;171;589;3339;8855;3510;9444
230320;202209;9043;23712;7478;21014;254;1003;5844;15886;6098;16889
230330;202209;5682;13884;4425;11583;139;450;3354;8457;3493;8907
230340;202209;4558;12776;3902;11497;241;783;2798;7972;3039;8755
230350;202209;22815;53521;19943;49519;941;2849;14831;35685;15772;38534
230360;202209;3620;8415;2833;7102;154;377;2076;5163;2230;5540
230365;202209;3710;7865;3063;6949;85;252;2671;5933;2756;6185
230370;202209;89819;198951;78541;183708;4641;12864;61810;137835;66451;150699
230380;202209;7415;18458;5838;15618;144;534;4459;11373;4603;11907
230390;202209;4040;10389;3452;9484;80;327;2762;7353;2842;7680
230393;202209;4029;10238;3209;8662;83;411;2572;6559;2655;6970
230395;202209;6684;16694;5685;15040;542;1422;3802;9885;4344;11307
230400;202209;6591;16020;5762;14749;75;364;4685;11405;4760;11769
230410;202209;15213;41882;12483;37104;921;2900;8648;25545;9569;28445
230420;202209;35537;87061;29129;76649;2889;7989;18317;46211;21206;54200
230423;202209;5376;14543;4693;13292;313;974;3390;9334;3703;10308
230425;202209;7239;19400;6620;18257;694;1817;4672;12801;5366;14618
230426;202209;3189;7540;2308;5930;46;173;1779;4371;1825;4544
230427;202209;2098;5436;1470;4186;149;452;818;2129;967;2581
230428;202209;11650;28742;9942;26307;1447;3805;5872;15106;7319;18911
230430;202209;5736;14835;4501;12703;159;538;3433;9423;3592;9961
230435;202209;7662;17318;6225;14969;878;2034;3685;8745;4563;10779
230440;202209;571672;1206050;487087;1090008;31736;79469;363944;779296;395680;858765
230445;202209;4851;12173;3906;10571;247;666;2645;6878;2892;7544
230450;202209;4460;11115;3878;10281;191;683;2983;7509;3174;8192
230460;202209;2628;6255;2255;5671;67;236;1903;4660;1970;4896
230465;202209;5023;12327;4208;10846;138;433;3285;8090;3423;8523
230470;202209;13265;38910;11872;36422;755;2798;8761;25998;9516;28796
230480;202209;1788;4467;1493;3964;58;247;1174;2900;1232;3147
230490;202209;3281;8138;2717;7088;208;651;1840;4431;2048;5082
230495;202209;7153;17891;6254;16397;746;2043;3998;10133;4744;12176
230500;202209;10682;31395;9381;29109;336;1218;7542;23344;7878;24562
230510;202209;2071;5125;1622;4260;167;435;996;2518;1163;2953
230520;202209;5587;13685;4793;12365;380;931;3496;8827;3876;9758
230523;202209;19221;51769;15131;43655;3412;9554;4300;12737;7712;22291
230526;202209;4652;11308;3904;10125;332;675;2743;7357;3075;8032
230530;202209;6372;18394;5298;16410;994;3157;3097;9552;4091;12709
230533;202209;5774;11345;4561;9576;66;184;3930;7879;3996;8063
230535;202209;5873;15355;4923;13800;346;1085;3294;9111;3640;10196
230540;202209;17780;45195;15091;41170;303;1095;12474;33485;12777;34580
230550;202209;27332;62563;22397;54739;1895;4683;15523;36638;17418;41321
230560;202209;9064;19631;7224;16882;197;416;6130;14287;6327;14703
230565;202209;3670;9055;3041;7948;95;310;2427;6130;2522;6440
230570;202209;3942;9180;3317;8321;68;216;2763;6791;2831;7007
230580;202209;14595;31827;12551;28986;547;1124;10514;24069;11061;25193
230590;202209;11318;28363;9384;25083;683;1774;6890;18080;7573;19854
230600;202209;4471;10056;3499;8466;143;337;2447;5885;2590;6222
230610;202209;7917;19293;6948;17717;478;1202;5470;13840;5948;15042
230620;202209;2448;5987;1898;4973;100;316;1263;3078;1363;3394
230625;202209;11621;28163;9931;25359;1981;5331;4764;11563;6745;16894
230630;202209;13914;34765;12178;31703;1331;3207;8154;21192;9485;24399
230640;202209;31742;87724;28565;82633;1358;4757;22903;64743;24261;69500
230650;202209;6215;14955;5226;13350;140;542;4352;10667;4492;11209
230655;202209;11550;33181;10839;32045;819;2236;8732;26111;9551;28347
230660;202209;7016;18824;5625;16435;173;770;4527;12889;4700;13659
230670;202209;7017;15188;5058;12191;149;411;4055;9411;4204;9822
230680;202209;3251;7921;2690;7002;178;363;1871;4867;2049;5230
230690;202209;8191;22050;6885;19595;496;1534;4371;12283;4867;13817
230700;202209;12789;27912;10214;23454;444;1059;7930;17529;8374;18588
230710;202209;7851;22709;6851;20699;649;1964;4647;13816;5296;15780
230720;202209;2265;6048;1866;5341;134;366;1275;3554;1409;3920
230725;202209;5544;14408;4964;13440;366;1152;3414;8827;3780;9979
230730;202209;70763;170050;55492;148512;12206;32665;21608;60126;33814;92791
230740;202209;7034;18019;5888;16211;183;541;4667;12755;4850;13296
230750;202209;9711;23651;7949;20824;142;506;6437;16279;6579;16785
230760;202209;13606;32164;11705;29370;471;1496;9000;21660;9471;23156
230763;202209;5677;13885;4646;12177;96;397;3715;9323;3811;9720
230765;202209;51929;125252;43564;112476;4630;12856;27452;67532;32082;80388
230770;202209;35193;70710;30049;64310;2003;4426;23415;48522;25418;52948
230780;202209;7753;24046;6926;22183;916;2817;4200;13530;5116;16347
230790;202209;3724;9232;3318;8619;140;457;2606;6435;2746;6892
230800;202209;10379;28789;9005;26179;1162;3456;5342;14912;6504;18368
230810;202209;12443;34638;11003;32324;509;1675;8539;24528;9048;26203
230820;202209;4080;12064;3355;10564;316;1178;2100;6272;2416;7450
230830;202209;9182;21942;7751;19665;283;699;6294;15543;6577;16242
230835;202209;4885;10517;3780;8859;125;288;3092;7052;3217;7340
230837;202209;4278;10362;3826;9644;80;307;3304;7995;3384;8302
230840;202209;11257;29768;9647;27076;781;2180;7101;19752;7882;21932
230850;202209;12218;30094;10327;26752;563;1421;7739;19769;8302;21190
230860;202209;7671;14776;6440;13089;194;315;5750;11508;5944;11823
230870;202209;21546;43700;18514;38982;847;1631;15154;31169;16001;32800
230880;202209;2354;6475;2141;6132;68;297;1682;4630;1750;4927
230890;202209;5259;15070;4721;14121;234;817;3532;10291;3766;11108
230900;202209;3837;9740;3225;8586;127;450;2388;6035;2515;6485
230910;202209;4039;9113;3167;7845;58;237;2650;6422;2708;6659
230920;202209;5481;13905;4410;12162;113;423;3418;9072;3531;9495
230930;202209;8064;20522;6587;17975;317;941;4615;12263;4932;13204
230940;202209;9850;21821;8547;19928;178;415;7368;16941;7546;17356
230945;202209;7730;19719;6559;17612;319;978;4830;12454;5149;13432
230950;202209;7368;16401;6483;15224;119;299;5586;13020;5705;13319
230960;202209;15388;40417;13216;36480;2060;5837;6866;18263;8926;24100
230970;202209;18676;43812;15827;39579;1509;3946;10670;25748;12179;29694
230980;202209;3937;8866;3400;8001;317;724;2470;5732;2787;6456
230990;202209;1970;5011;1621;4353;70;260;1177;2976;1247;3236
231000;202209;3164;7507;2481;6233;79;234;1893;4499;1972;4733
231010;202209;4572;8951;3583;7401;26;105;3246;6464;3272;6569
231020;202209;10388;27230;9203;25114;1368;3417;5757;15974;7125;19391
231025;202209;9720;22676;8567;20941;589;1354;6701;16167;7290;17521
231030;202209;8490;23231;6474;19199;853;2475;3775;11059;4628;13534
231040;202209;3723;8832;3179;7915;87;247;2670;6388;2757;6635
231050;202209;14358;32095;11711;27706;499;1316;9315;21157;9814;22473
231060;202209;3348;8431;2965;7846;94;300;2361;6297;2455;6597
231070;202209;9526;24778;8189;22470;715;2003;5623;15114;6338;17117
231080;202209;4551;11670;3755;10361;214;670;2683;7301;2897;7971
231085;202209;8787;18602;7051;16543;212;522;5698;13073;5910;13595
231090;202209;5096;12222;3723;9661;124;468;2655;6477;2779;6945
231095;202209;2567;7133;2036;6030;197;567;1338;3927;1535;4494
231100;202209;3555;9319;2898;8156;139;458;2178;5946;2317;6404
231110;202209;4274;11455;3926;10828;348;1085;2766;7296;3114;8381
231120;202209;2840;7255;2374;6492;108;311;1772;4741;1880;5052
231123;202209;2268;5375;1755;4481;106;252;1260;3160;1366;3412
231126;202209;6481;16101;5236;13839;293;741;3887;10082;4180;10823
231130;202209;29516;61241;24762;55397;1300;3569;19535;41542;20835;45111
231135;202209;4897;12508;4034;10908;161;465;2915;7714;3076;8179
231140;202209;20185;50464;16315;44237;742;2597;12112;31449;12854;34046
231150;202209;6990;17380;4976;13534;822;2234;1853;5015;2675;7249
231160;202209;8352;21487;7409;19809;766;1951;4862;12898;5628;14849
231170;202209;5514;14167;4547;12424;282;834;3277;8517;3559;9351
231180;202209;17777;44990;14423;38516;2292;6152;7526;19471;9818;25623
231190;202209;4793;12037;3730;10164;87;332;2909;7651;2996;7983
231195;202209;5887;16088;4817;14058;302;983;3481;10021;3783;11004
231200;202209;10025;25110;8683;22642;146;669;7393;18295;7539;18964
231210;202209;5712;14890;4795;13370;144;570;3839;10312;3983;10882
231220;202209;15903;34792;12553;29035;640;1355;9453;20950;10093;22305
231230;202209;11363;32685;9962;30167;708;2309;7484;22314;8192;24623
231240;202209;14124;37602;12357;34464;1697;4581;7694;21236;9391;25817
231250;202209;2443;5500;1607;3830;78;181;1090;2434;1168;2615
231260;202209;3892;9451;3297;8536;310;717;2307;6009;2617;6726
231270;202209;7673;17592;6220;15273;149;562;4852;11292;5001;11854
231280;202209;2060;5789;1790;5317;169;485;1221;3621;1390;4106
231290;202209;43186;117640;36160;104881;4860;14183;19264;53793;24124;67976
231300;202209;4915;12220;3837;10179;148;484;2704;6830;2852;7314
231310;202209;9671;21168;7674;17778;589;1498;5584;12292;6173;13790
231320;202209;8290;21273;6347;17827;153;458;4952;13751;5105;14209
231325;202209;2888;6751;2265;5762;158;297;1640;4153;1798;4450
231330;202209;12664;32640;10511;28694;1377;3588;6723;18325;8100;21913
231335;202209;6556;15701;5448;14001;153;471;4647;11790;4800;12261
231340;202209;21959;60161;19626;56332;1451;4168;14841;42729;16292;46897
231350;202209;18929;46006;17159;43536;276;894;15447;38671;15723;39565
231355;202209;5213;13697;4605;12623;216;658;3659;9797;3875;10455
231360;202209;9282;25194;7980;23065;383;1203;6304;17933;6687;19136
231370;202209;2418;6131;1923;5258;44;143;1480;3967;1524;4110
231375;202209;4760;13386;4237;12527;119;437;3499;10244;3618;10681
231380;202209;7124;16637;6281;15533;191;441;5234;12921;5425;13362
231390;202209;3944;10490;3505;9780;113;458;2647;7089;2760;7547
231395;202209;5086;13089;4244;11764;285;789;2988;8078;3273;8867
231400;202209;11749;29726;9812;26305;297;1217;7685;19703;7982;20920
231410;202209;18902;48738;17102;46027;990;2408;13924;37523;14914;39931
240010;202209;3007;7182;2349;6058;355;907;1207;2997;1562;3904
240020;202209;16771;39797;13946;35067;824;2458;9861;23605;10685;26063
240030;202209;4616;8559;4169;7939;94;264;3790;6932;3884;7196
240040;202209;916;2444;759;2160;20;78;512;1379;532;1457
240050;202209;4006;9719;3136;8180;67;185;2407;6100;2474;6285
240060;202209;1727;4080;1363;3441;47;126;1071;2644;1118;2770
240070;202209;3136;7737;2765;6981;213;588;2007;4786;2220;5374
240080;202209;3435;8433;2700;7193;123;357;1928;5004;2051;5361
240090;202209;2719;5828;2227;5056;32;73;1915;4247;1947;4320
240100;202209;13215;27825;10610;23568;213;654;8713;18248;8926;18902
240110;202209;5629;14254;4690;12571;166;594;3590;9181;3756;9775
240120;202209;3970;10245;3310;9370;244;843;2398;6596;2642;7439
240130;202209;4731;8320;3872;7228;32;76;3531;6472;3563;6548
240140;202209;2090;5824;1761;5238;207;690;1109;3182;1316;3872
240145;202209;7996;20545;6438;17942;710;2040;4134;11314;4844;13354
240150;202209;1230;2985;1031;2621;47;152;812;1974;859;2126
240160;202209;1714;4567;1399;3999;41;173;1032;2840;1073;3013
240165;202209;1146;2786;946;2433;29;95;788;1958;817;2053
240170;202209;3360;7845;2821;6952;306;751;1854;4498;2160;5249
240180;202209;3585;9687;2867;8249;613;1710;1322;3925;1935;5635
240185;202209;1578;4348;1416;4072;50;193;1124;3107;1174;3300
240190;202209;1320;3268;1111;2950;27;100;928;2424;955;2524
240200;202209;15354;33234;12411;28541;1467;3416;7650;16792;9117;20208
240210;202209;4140;8563;3421;7439;35;147;3001;6217;3036;6364
240220;202209;8576;23654;7614;22165;476;1655;5866;16799;6342;18454
240230;202209;6984;15847;5493;13489;296;607;4065;10096;4361;10703
240240;202209;2062;5560;1401;4121;181;570;495;1243;676;1813
240250;202209;3755;8395;3241;7656;56;208;2774;6309;2830;6517
240260;202209;19221;49150;16676;45056;4793;12535;7141;21325;11934;33860
240270;202209;2910;7521;2397;6715;114;341;1697;4837;1811;5178
240280;202209;1914;4511;1585;3987;69;168;1240;3071;1309;3239
240290;202209;1343;3550;1078;3021;30;130;743;1888;773;2018
240300;202209;2628;6207;1902;4962;100;257;1194;3023;1294;3280
240310;202209;9954;24394;7855;20778;1039;2768;4081;10521;5120;13289
240320;202209;2250;5689;1556;4338;99;303;1069;2830;1168;3133
240325;202209;42228;99086;34626;86885;4202;11784;20782;48987;24984;60771
240330;202209;2128;5263;1644;4404;69;228;1152;2897;1221;3125
240340;202209;2496;4874;2021;4190;59;147;1698;3346;1757;3493
240350;202209;3026;6216;2696;5834;72;138;2448;5286;2520;5424
240360;202209;14325;34142;12783;31838;1991;4601;8183;20520;10174;25121
240370;202209;2628;5663;2029;4611;91;251;1537;3260;1628;3511
240375;202209;1092;2472;895;2157;38;125;698;1581;736;1706
240380;202209;2699;6865;2080;5618;210;528;1198;3161;1408;3689
240390;202209;1166;2601;798;1943;27;58;530;1194;557;1252
240400;202209;1717;3850;1288;3150;39;141;932;2120;971;2261
240410;202209;692;1908;554;1641;54;199;328;908;382;1107
240420;202209;6033;17891;5384;16633;485;1825;3704;10910;4189;12735
240430;202209;4215;9579;3522;8453;113;354;2760;6285;2873;6639
240440;202209;3324;6687;2842;6015;293;534;2148;4527;2441;5061
240450;202209;5209;12945;4065;10904;339;1085;2528;6227;2867;7312
240460;202209;4074;9517;3641;8846;308;662;2928;7168;3236;7830
240470;202209;4003;11280;3049;9365;648;1806;1414;4592;2062;6398
240480;202209;672;1676;412;1125;29;75;203;518;232;593
240485;202209;2500;6452;1996;5579;152;457;1315;3666;1467;4123
240490;202209;1938;4311;1482;3543;88;174;1083;2526;1171;2700
240500;202209;2497;6109;2147;5525;109;289;1745;4416;1854;4705
240510;202209;1920;4752;1640;4335;70;217;1309;3351;1379;3568
240520;202209;1913;3890;1460;3293;101;213;1154;2591;1255;2804
240530;202209;2835;6711;2498;6175;133;270;2066;5033;2199;5303
240540;202209;2724;6023;2432;5587;49;125;2174;4948;2223;5073
240550;202209;1038;2264;922;2075;14;49;826;1799;840;1848
240560;202209;4652;9626;4010;8800;176;318;3341;7290;3517;7608
240570;202209;3195;7934;2147;5741;305;828;798;1935;1103;2763
240580;202209;10285;26131;9076;24078;520;1468;7408;19363;7928;20831
240590;202209;1059;2122;903;1893;21;34;741;1497;762;1531
240600;202209;2079;5093;1502;3995;57;160;1056;2649;1113;2809
240610;202209;5467;12571;4658;11206;219;560;3496;8076;3715;8636
240615;202209;1501;3453;1201;2964;106;276;874;2058;980;2334
240620;202209;2290;5536;1962;5001;72;228;1630;4035;1702;4263
240630;202209;2552;6041;2292;5634;262;438;1665;4245;1927;4683
240640;202209;1089;2597;854;2205;34;100;653;1629;687;1729
240650;202209;4738;12576;3965;11072;306;826;2744;7613;3050;8439
240660;202209;4915;8974;4488;8416;52;122;4248;7848;4300;7970
240670;202209;2992;7403;2368;6199;186;531;1587;3966;1773;4497
240680;202209;1908;4437;1516;3790;46;148;1204;2869;1250;3017
240690;202209;1392;2981;1088;2480;24;86;914;1959;938;2045
240700;202209;2733;7443;2181;6452;105;335;1619;4727;1724;5062
240710;202209;22947;49029;19630;43984;1663;3836;14686;31638;16349;35474
240720;202209;6094;13929;5151;12603;594;1469;3413;8245;4007;9714
240725;202209;1281;3360;968;2797;46;127;621;1728;667;1855
240730;202209;2688;6715;2104;5655;64;213;1620;4210;1684;4423
240740;202209;2212;5543;1762;4667;71;230;1258;3127;1329;3357
240750;202209;2648;7785;2217;6895;283;970;1302;3957;1585;4927
240760;202209;2032;4141;1474;3331;116;165;1098;2575;1214;2740
240770;202209;3867;9435;3261;8609;141;487;2696;6940;2837;7427
240780;202209;6233;15151;5213;13496;721;1833;3383;8641;4104;10474
240790;202209;1045;2626;852;2298;23;103;635;1617;658;1720
240800;202209;68498;140964;55155;121866;5103;11953;36597;75757;41700;87710
240810;202209;122731;274275;106416;249318;9527;23302;76815;173821;86342;197123
240820;202209;7274;19338;6372;17750;837;2356;4026;11221;4863;13577
240830;202209;10101;26099;8754;24134;332;1151;7072;19141;7404;20292
240840;202209;1276;2917;1014;2509;47;101;717;1722;764;1823
240850;202209;1638;4132;1122;3073;91;248;647;1674;738;1922
240860;202209;1701;3849;1282;3146;36;131;1043;2441;1079;2572
240870;202209;1231;2871;931;2377;155;378;476;1244;631;1622
240880;202209;1472;4345;1282;3981;117;450;918;2776;1035;3226
240890;202209;6258;14224;4937;11974;460;1281;3242;7133;3702;8414
240895;202209;3472;9417;3126;8867;417;1110;2223;6440;2640;7550
240910;202209;4110;10027;3394;8793;55;189;2773;6952;2828;7141
240920;202209;1236;2761;997;2419;113;192;613;1537;726;1729
240930;202209;4326;8836;3512;7835;256;383;2345;5731;2601;6114
240933;202209;1877;4285;1563;3838;35;138;1332;3153;1367;3291
240940;202209;8571;17924;6838;15204;617;1385;4673;9830;5290;11215
240950;202209;1305;3504;1112;3136;38;157;888;2378;926;2535
240960;202209;828;2154;739;1973;17;62;590;1504;607;1566
240970;202209;2341;5034;1903;4353;71;212;1601;3521;1672;3733
240980;202209;4672;10886;4194;10127;71;300;3701;8591;3772;8891
240990;202209;3446;8045;3038;7350;225;679;2278;5144;2503;5823
241000;202209;1193;2679;920;2203;16;50;739;1675;755;1725
241010;202209;3677;9772;3333;9106;144;502;2688;7062;2832;7564
241020;202209;2485;6006;1887;4873;100;310;1362;3304;1462;3614
241025;202209;1907;5094;1525;4435;48;183;1100;3099;1148;3282
241030;202209;2855;8233;2288;7082;280;798;1449;4485;1729;5283
241040;202209;2494;7096;2124;6484;90;396;1628;4887;1718;5283
241050;202209;1681;4227;1343;3629;40;133;1001;2617;1041;2750
241060;202209;952;2361;812;2082;44;102;568;1388;612;1490
241070;202209;825;1995;686;1777;15;39;535;1325;550;1364
241080;202209;1342;3448;1035;2832;34;114;741;1940;775;2054
241090;202209;2417;6218;1924;5399;85;321;1437;3871;1522;4192
241100;202209;1374;3496;1035;2829;55;129;691;1840;746;1969
241105;202209;1236;3290;997;2854;186;552;460;1283;646;1835
241110;202209;1077;2801;802;2242;47;128;514;1371;561;1499
241120;202209;8684;22649;7316;20378;774;2196;4742;13183;5516;15379
241140;202209;3887;9501;2961;7709;121;366;2183;5483;2304;5849
241142;202209;894;2224;677;1836;59;150;404;1028;463;1178
241150;202209;6918;16169;6046;14856;246;591;4747;11470;4993;12061
241160;202209;1361;3485;1048;2914;171;517;572;1475;743;1992
241170;202209;1555;3643;1311;3223;31;103;1087;2560;1118;2663
241180;202209;1210;2805;891;2245;88;225;508;1217;596;1442
241190;202209;1393;3221;1149;2779;18;65;863;1976;881;2041
241200;202209;29787;64678;26309;59388;2847;6774;18228;39084;21075;45858
241210;202209;1871;4351;1374;3468;103;288;867;2099;970;2387
241220;202209;11784;29675;10365;27401;2264;5964;5180;13843;7444;19807
241230;202209;3440;8167;2963;7469;99;259;2459;6108;2558;6367
241240;202209;1407;3703;843;2512;98;307;281;779;379;1086
241250;202209;7225;17436;5827;15026;150;647;4589;11137;4739;11784
241255;202209;3194;8401;2734;7553;159;511;2024;5373;2183;5884
241260;202209;5885;13700;4704;11803;177;517;3630;8734;3807;9251
241270;202209;1866;5025;1547;4433;122;381;1088;3038;1210;3419
241280;202209;3039;6127;2642;5451;93;191;2279;4579;2372;4770
241290;202209;3815;8478;2787;6877;94;254;2207;5272;2301;5526
241300;202209;1806;4331;1466;3774;37;130;1032;2519;1069;2649
241310;202209;2771;5744;2394;5224;64;120;2079;4477;2143;4597
241320;202209;1121;3316;948;2996;98;342;582;1779;680;2121
241330;202209;2044;4693;1619;4136;23;73;1436;3620;1459;3693
241335;202209;4393;10774;3825;9796;126;420;3151;7778;3277;8198
241340;202209;2031;4909;1608;4119;198;610;917;2133;1115;2743
241350;202209;2565;6249;2221;5662;107;287;1725;4281;1832;4568
241355;202209;1621;3894;1297;3299;50;102;968;2421;1018;2523
241360;202209;2402;5611;1735;4336;69;193;1286;3050;1355;3243
241370;202209;1592;3881;1214;3159;59;185;893;2142;952;2327
241380;202209;831;1996;650;1694;73;180;374;958;447;1138
241390;202209;3128;8267;2743;7698;156;476;2121;5926;2277;6402
241400;202209;4279;10759;3743;9960;221;698;2894;7507;3115;8205
241410;202209;2888;7813;2331;6715;240;761;1498;4200;1738;4961
241415;202209;2230;5364;1891;4757;47;175;1556;3711;1603;3886
241420;202209;3540;9249;3171;8661;527;1525;1987;5393;2514;6918
241430;202209;828;1897;529;1345;17;49;358;845;375;894
241440;202209;9964;26590;8913;24853;310;993;7279;19887;7589;20880
241445;202209;1637;3367;1422;3087;31;66;1272;2738;1303;2804
241450;202209;3494;7467;2841;6484;227;460;2167;4907;2394;5367
241460;202209;4594;11239;3649;9384;292;787;2482;6087;2774;6874
241470;202209;1672;4021;1329;3518;45;155;1103;2853;1148;3008
241475;202209;1437;3575;1125;3025;24;92;843;2122;867;2214
241480;202209;3640;10158;2978;8811;830;2443;1050;3345;1880;5788
241490;202209;876;1779;628;1419;15;43;510;1110;525;1153
241500;202209;945;2292;848;2180;6;15;782;2010;788;2025
250010;202209;3161;8307;2605;7205;81;250;1964;5258;2045;5508
250020;202209;1900;4518;1416;3650;94;163;1050;2700;1144;2863
250030;202209;8368;20429;7301;18835;881;2307;5092;13031;5973;15338
250040;202209;5553;14233;4845;13030;702;1843;3065;8180;3767;10023
250050;202209;4401;10338;3913;9725;170;448;3259;8164;3429;8612
250053;202209;1515;3821;1369;3605;138;307;955;2526;1093;2833
250057;202209;864;2453;789;2345;7;33;727;2152;734;2185
250060;202209;6958;16030;6132;14907;392;962;4878;11725;5270;12687
250070;202209;4749;11836;3959;10523;46;202;3183;8128;3229;8330
250073;202209;953;2245;751;1920;7;21;609;1519;616;1540
250077;202209;3186;6779;2465;5681;34;107;2100;4660;2134;4767
250080;202209;7022;13854;5844;12443;75;211;5316;11111;5391;11322
250090;202209;4527;8795;3985;8111;59;141;3558;7023;3617;7164
250100;202209;3971;11118;3546;10369;163;569;2771;7844;2934;8413
250110;202209;5955;14683;5399;13921;335;993;4183;10552;4518;11545
250115;202209;897;1901;681;1587;8;31;548;1226;556;1257
250120;202209;2185;5791;1850;5255;28;134;1479;4073;1507;4207
250130;202209;7434;15798;6370;14385;54;233;5685;12438;5739;12671
250135;202209;1657;3801;1442;3443;62;145;1214;2854;1276;2999
250140;202209;2608;6878;2395;6618;150;460;1983;5538;2133;5998
250150;202209;5566;15685;4993;14761;180;669;4024;11583;4204;12252
250153;202209;1657;3948;1349;3493;75;167;1060;2717;1135;2884
250157;202209;2482;5925;2198;5476;47;158;1854;4480;1901;4638
250160;202209;4543;10042;3635;8825;81;203;3127;7504;3208;7707
250170;202209;2226;5195;1988;4858;38;131;1705;4056;1743;4187
250180;202209;28420;57453;24490;52591;1038;2761;20053;41172;21091;43933
250190;202209;5133;11943;4320;10797;389;945;3116;7550;3505;8495
250200;202209;3153;5941;2718;5397;41;93;2459;4719;2500;4812
250205;202209;966;2805;817;2576;20;88;637;1979;657;2067
250210;202209;1695;4663;1502;4355;64;246;1164;3281;1228;3527
250215;202209;1889;4755;1587;4339;100;291;906;2494;1006;2785
250220;202209;782;1971;615;1706;31;111;437;1159;468;1270
250230;202209;1918;3992;1352;3188;21;61;1062;2411;1083;2472
250240;202209;3677;8052;3289;7433;40;161;2955;6467;2995;6628
250250;202209;5786;13721;5104;12792;399;678;3934;10417;4333;11095
250260;202209;1842;4835;1543;4305;58;176;1201;3337;1259;3513
250270;202209;1440;3881;1316;3733;99;288;924;2768;1023;3056
250280;202209;4790;10355;4283;9703;275;475;3362;7739;3637;8214
250290;202209;2113;4590;1754;4080;19;56;1399;3163;1418;3219
250300;202209;7329;15828;6593;14959;214;688;5606;12257;5820;12945
250310;202209;1423;3642;1158;3204;54;134;848;2317;902;2451
250320;202209;16691;31751;14628;29447;178;503;13512;26542;13690;27045
250330;202209;3169;7141;2709;6529;77;247;2365;5487;2442;5734
250340;202209;1482;3136;1281;2870;18;44;1153;2559;1171;2603
250350;202209;4541;11881;3932;10832;329;685;2975;8456;3304;9141
250355;202209;2605;6367;2305;5998;18;78;2133;5521;2151;5599
250360;202209;2157;5071;1921;4759;56;177;1623;3890;1679;4067
250370;202209;18901;39714;16034;35574;244;768;14154;30319;14398;31087
250375;202209;1552;3287;1265;2956;6;14;1178;2772;1184;2786
250380;202209;2145;4572;1974;4369;44;146;1777;3789;1821;3935
250390;202209;2303;5122;1946;4585;148;345;1491;3484;1639;3829
250400;202209;85895;196934;65351;166223;18708;49791;20272;52237;38980;102028
250403;202209;2879;5834;2569;5495;49;255;2243;4460;2292;4715
250407;202209;1809;3661;1282;2919;145;259;805;1982;950;2241
250410;202209;828;1972;707;1775;17;44;589;1416;606;1460
250415;202209;2352;5650;2057;5220;35;132;1803;4470;1838;4602
250420;202209;1621;3558;1468;3351;14;36;1365;3074;1379;3110
250430;202209;9047;18088;7807;16490;352;657;6542;13422;6894;14079
250435;202209;1876;4845;1472;4164;21;98;1126;3051;1147;3149
250440;202209;5204;12819;4495;11906;98;252;3920;10279;4018;10531
250450;202209;2146;5014;1761;4496;105;190;1352;3571;1457;3761
250460;202209;8836;21711;7741;20171;540;1474;6017;15516;6557;16990
250470;202209;2000;4485;1645;3932;68;144;1305;3042;1373;3186
250480;202209;4539;11326;3802;10415;69;173;3266;9002;3335;9175
250485;202209;819;1724;614;1443;66;101;408;943;474;1044
250490;202209;6777;13369;6008;12500;105;325;5443;10990;5548;11315
250500;202209;2370;5948;2086;5473;55;161;1712;4405;1767;4566
250510;202209;6907;14619;5933;13323;215;305;5005;11391;5220;11696
250520;202209;2176;5353;1852;4933;87;267;1446;3750;1533;4017
250523;202209;2740;5747;2397;5300;205;469;1842;3970;2047;4439
250527;202209;2035;4468;1836;4246;17;56;1676;3824;1693;3880
250530;202209;780;1799;665;1634;19;51;548;1298;567;1349
250535;202209;1576;4196;1397;3880;28;123;1120;3009;1148;3132
250540;202209;4080;7483;3457;6804;459;496;2746;5773;3205;6269
250550;202209;893;2661;784;2461;51;165;539;1667;590;1832
250560;202209;2010;5041;1727;4636;46;180;1433;3730;1479;3910
250570;202209;3241;8523;2793;7748;158;471;2110;5788;2268;6259
250580;202209;1222;2914;1076;2721;52;199;896;2173;948;2372
250590;202209;1237;2587;1118;2424;32;80;999;2098;1031;2178
250600;202209;8999;22223;7435;20097;281;832;5784;15373;6065;16205
250610;202209;3384;8728;3006;8175;121;388;2438;6583;2559;6971
250620;202209;1062;2315;904;2064;49;133;705;1545;754;1678
250625;202209;2745;7281;2428;6774;49;221;2089;5670;2138;5891
250630;202209;14673;33201;12354;29504;1172;2952;8683;19878;9855;22830
250640;202209;4481;10309;4008;9694;81;294;3524;8327;3605;8621
250650;202209;1274;2656;1022;2327;15;57;887;1969;902;2026
250660;202209;1841;4123;1445;3555;36;96;1200;2823;1236;2919
250670;202209;2737;7610;2466;7139;49;197;2140;6043;2189;6240
250680;202209;7268;14370;6551;13566;39;166;6151;12410;6190;12576
250690;202209;8595;17018;7219;15359;188;354;6220;13059;6408;13413
250700;202209;5402;13888;4698;12807;705;1912;2997;8107;3702;10019
250710;202209;5135;13498;4456;12549;349;1036;3237;9096;3586;10132
250720;202209;3332;8106;2958;7580;64;256;2630;6612;2694;6868
250730;202209;5390;12192;4745;11348;181;534;4070;9428;4251;9962
250740;202209;2439;5380;2006;4810;131;291;1527;3654;1658;3945
250750;202209;141442;309781;121116;282020;8785;22364;90781;204250;99566;226614
250760;202209;3502;6743;3132;6203;42;146;2871;5496;2913;5642
250770;202209;4798;12998;4281;12311;665;1641;2785;8456;3450;10097
250780;202209;2217;5149;1867;4556;68;186;1520;3591;1588;3777
250790;202209;3076;7998;2675;7419;96;386;2133;5693;2229;6079
250800;202209;2862;6843;2476;6242;115;232;1983;4966;2098;5198
250810;202209;1709;3776;1421;3383;146;223;1076;2706;1222;2929
250820;202209;2434;5745;2230;5511;40;139;2026;4933;2066;5072
250830;202209;7316;19627;6038;17158;227;807;4358;11752;4585;12559
250840;202209;868;2563;752;2351;37;135;555;1739;592;1874
250850;202209;2120;5541;1870;5115;36;145;1551;4129;1587;4274
250855;202209;1341;3255;1184;3028;45;132;982;2446;1027;2578
250860;202209;4109;10724;3407;9610;477;1375;1955;5391;2432;6766
250870;202209;1255;2997;1052;2684;61;145;810;2063;871;2208
250880;202209;1912;4446;1570;3946;124;299;1153;2874;1277;3173
250890;202209;14181;29291;12516;27225;325;1215;10919;22443;11244;23658
250900;202209;3965;8925;3483;8136;71;205;3038;6868;3109;7073
250905;202209;2891;7322;2655;7015;44;166;2402;6306;2446;6472
250910;202209;8963;17327;7679;15915;80;240;6995;14251;7075;14491
250915;202209;2615;5264;1916;4511;29;52;1700;4022;1729;4074
250920;202209;4624;9959;4147;9275;290;548;3427;7570;3717;8118
250930;202209;2812;6738;2504;6353;101;316;2058;5070;2159;5386
250933;202209;1486;3859;1292;3530;53;187;1019;2700;1072;2887
250937;202209;951;2260;797;2028;20;71;659;1654;679;1725
250939;202209;2447;5412;2150;5035;51;127;1803;4116;1854;4243
250940;202209;4653;10961;4053;10170;56;157;3601;8942;3657;9099
250950;202209;1996;4776;1603;4249;40;143;1275;3291;1315;3434
250960;202209;1337;3482;1174;3227;30;139;975;2569;1005;2708
250970;202209;10430;23778;9065;21625;263;660;7510;17407;7773;18067
250980;202209;2848;6702;2566;6315;20;89;2255;5372;2275;5461
250990;202209;2538;6797;2157;6159;108;370;1631;4495;1739;4865
251000;202209;2345;6025;1881;5253;47;171;1523;4196;1570;4367
251010;202209;3006;7419;2660;6906;30;125;2325;5919;2355;6044
251020;202209;1849;4628;1660;4342;30;135;1447;3668;1477;3803
251030;202209;1207;2953;987;2566;67;163;668;1712;735;1875
251040;202209;2179;5419;1850;4889;24;108;1578;4096;1602;4204
251050;202209;1176;3081;976;2698;48;168;694;1813;742;1981
251060;202209;1301;2534;984;2139;37;79;743;1602;780;1681
251065;202209;548;1405;399;1122;10;34;288;762;298;796
251070;202209;890;2013;739;1799;15;45;628;1484;643;1529
251080;202209;25641;55749;21105;49249;3535;8129;12110;28652;15645;36781
251090;202209;3344;8699;2799;7780;69;194;2295;6261;2364;6455
251100;202209;936;2727;803;2463;27;86;602;1747;629;1833
251110;202209;2197;5140;1814;4464;124;264;1346;3255;1470;3519
251120;202209;9298;22196;7832;20426;537;1547;5866;14961;6403;16508
251130;202209;5804;9948;5020;9095;40;112;4718;8386;4758;8498
251140;202209;4775;12414;4208;11619;110;355;3376;9237;3486;9592
251150;202209;3300;8469;3004;8009;67;329;2595;6689;2662;7018
251160;202209;2868;6819;2493;6266;29;147;2251;5493;2280;5640
251170;202209;2193;4827;1935;4506;28;89;1752;3959;1780;4048
251180;202209;3348;7598;2774;6817;271;513;1899;4841;2170;5354
251190;202209;6127;12879;5514;12188;57;268;4978;10564;5035;10832
251200;202209;5387;13456;4724;12616;134;328;4020;10792;4154;11120
251203;202209;1149;3383;1029;3117;52;163;691;2032;743;2195
251207;202209;1315;3230;985;2691;23;101;680;1789;703;1890
251210;202209;9585;21439;7801;19002;597;1153;5544;13961;6141;15114
251220;202209;1553;3247;1168;2748;111;211;861;2077;972;2288
251230;202209;5516;13980;4744;12642;112;384;3811;9760;3923;10144
251240;202209;4365;11253;3664;10073;280;700;2471;6817;2751;7517
251250;202209;14283;32702;12574;29930;719;1844;9789;22379;10508;24223
251260;202209;649;1516;581;1410;14;62;475;1081;489;1143
251270;202209;5361;14196;4770;13390;273;708;3736;10780;4009;11488
251272;202209;1676;3905;1537;3737;50;188;1345;3150;1395;3338
251274;202209;993;2583;786;2221;70;198;491;1356;561;1554
251275;202209;1831;3947;1551;3514;78;183;1261;2748;1339;2931
251276;202209;1593;3920;1364;3609;37;151;1103;2799;1140;2950
251278;202209;775;1826;683;1687;32;104;552;1317;584;1421
251280;202209;3323;6927;3032;6533;46;158;2738;5683;2784;5841
251290;202209;9563;17074;8756;16145;260;522;7842;14096;8102;14618
251300;202209;1022;2686;898;2497;14;55;760;2088;774;2143
251310;202209;3323;8400;2842;7651;53;248;2388;6240;2441;6488
251315;202209;2157;6044;1931;5623;107;301;1502;4340;1609;4641
251320;202209;1969;4679;1488;3859;40;143;1137;2836;1177;2979
251330;202209;2558;5236;2063;4643;28;75;1816;4031;1844;4106
251335;202209;1271;3227;1145;3039;23;102;1033;2673;1056;2775
251340;202209;4610;9590;3682;8398;145;349;2939;6562;3084;6911
251350;202209;1264;3214;1146;3029;37;105;951;2471;988;2576
251360;202209;2195;5364;1730;4698;27;79;1384;3670;1411;3749
251365;202209;932;2204;685;1745;23;53;537;1351;560;1404
251370;202209;31149;73525;26717;67490;3585;8901;17222;43211;20807;52112
251380;202209;1813;3976;1571;3613;43;118;1367;3075;1410;3193
251385;202209;904;2159;696;1802;32;83;480;1198;512;1281
251390;202209;9031;21526;8023;20012;650;1669;5880;14344;6530;16013
251392;202209;1221;2979;1031;2686;40;106;812;2091;852;2197
251394;202209;795;2045;643;1782;60;175;438;1155;498;1330
251396;202209;842;2083;705;1846;28;80;484;1204;512;1284
251398;202209;1196;2852;839;2219;22;77;616;1550;638;1627
251400;202209;1734;3415;1383;2957;30;95;1162;2343;1192;2438
251410;202209;1903;3893;1511;3336;14;54;1299;2724;1313;2778
251420;202209;2456;5572;2016;5071;53;173;1628;3966;1681;4139
251430;202209;1790;4854;1608;4545;49;163;1367;3811;1416;3974
251440;202209;1267;3158;1027;2740;65;147;767;2074;832;2221
251445;202209;2021;4770;1856;4552;27;100;1631;3875;1658;3975
251450;202209;5519;13985;4922;13085;66;265;4274;11142;4340;11407
251455;202209;1027;2783;924;2604;26;100;738;2010;764;2110
251460;202209;1142;2854;920;2494;64;187;692;1851;756;2038
251465;202209;552;1434;467;1281;13;57;357;926;370;983
251470;202209;1373;3521;1013;2812;125;394;539;1348;664;1742
251480;202209;1190;2830;918;2368;19;64;690;1676;709;1740
251490;202209;2395;5548;1949;4945;132;278;1464;3693;1596;3971
251500;202209;2558;5935;2327;5636;59;168;2007;4712;2066;4880
251510;202209;3099;8548;2566;7511;112;393;1788;5002;1900;5395
251520;202209;1207;2874;906;2354;93;186;559;1438;652;1624
251530;202209;18657;38138;15337;34091;158;705;13778;29695;13936;30400
251540;202209;3540;9143;3160;8493;76;291;2616;6800;2692;7091
251550;202209;5158;9948;4215;8817;135;225;3538;7367;3673;7592
251560;202209;648;1835;577;1734;41;158;421;1197;462;1355
251570;202209;1102;2860;907;2474;20;97;713;1868;733;1965
251580;202209;2648;5291;2369;4892;29;107;2075;4052;2104;4159
251590;202209;1968;4171;1673;3819;54;129;1447;3194;1501;3323
251593;202209;1127;3050;1001;2835;91;304;689;1882;780;2186
251597;202209;2689;6213;2423;5867;14;65;2237;5313;2251;5378
251600;202209;7517;18530;6526;17031;262;731;5335;13675;5597;14406
251610;202209;3867;9649;3373;8801;267;683;2485;6355;2752;7038
251615;202209;1655;3485;1319;3000;20;66;1120;2436;1140;2502
251620;202209;24266;47600;19027;41293;213;451;16686;36036;16899;36487
251630;202209;6239;12510;5055;10884;283;607;3981;8196;4264;8803
251640;202209;2589;6287;2301;5867;21;98;2081;5194;2102;5292
251650;202209;5068;11339;4376;10457;152;335;3723;8762;3875;9097
251660;202209;4284;11187;3763;10308;62;269;3172;8425;3234;8694
251670;202209;5613;12456;5006;11662;56;218;4594;10445;4650;10663
251675;202209;1052;2217;953;2095;48;120;824;1777;872;1897
251680;202209;3163;7253;2660;6604;111;199;2182;5461;2293;5660
251690;202209;3793;9686;3214;8714;126;365;2427;6520;2553;6885
251700;202209;2653;6639;2195;6012;39;157;1823;4799;1862;4956
251710;202209;938;2200;675;1705;44;118;416;968;460;1086
251720;202209;1568;4002;1250;3467;21;103;980;2598;1001;2701
251740;202209;786;1964;623;1682;33;103;462;1196;495;1299
260005;202209;37138;70914;31135;63445;1775;3752;25116;49374;26891;53126
260010;202209;12340;29167;10167;25763;626;1737;6450;15775;7076;17512
260020;202209;8465;16746;7003;14757;76;305;6078;12351;6154;12656
260030;202209;9362;19232;7996;17353;90;331;7015;14653;7105;14984
260040;202209;8865;20300;7444;18363;487;1245;5517;13555;6004;14800
260050;202209;17359;37747;14905;35000;213;637;13925;32466;14138;33103
260060;202209;5098;10900;4327;9741;367;650;3252;7521;3619;8171
260070;202209;14283;29242;12407;26671;214;770;10777;22155;10991;22925
260080;202209;8466;16027;7391;14689;138;334;6426;12368;6564;12702
260090;202209;6613;14233;5877;13276;379;786;4737;10667;5116;11453
260100;202209;3819;8553;3259;7772;39;185;2883;6678;2922;6863
260105;202209;5913;14335;5287;13507;100;390;4511;11185;4611;11575
260110;202209;26122;66156;23091;61788;1072;3291;18871;49403;19943;52694
260120;202209;18285;41666;15522;37785;1705;3867;10800;26206;12505;30073
260130;202209;4035;8644;3480;7893;100;234;2837;6195;2937;6429
260140;202209;16471;31398;14345;28912;359;861;12661;24823;13020;25684
260150;202209;4657;8904;4092;8223;117;234;3692;7346;3809;7580
260160;202209;9064;17876;7837;16406;119;262;7264;15124;7383;15386
260170;202209;27087;54603;23340;49709;1138;2495;19252;40053;20390;42548
260180;202209;4228;9855;3583;8955;86;297;3048;7473;3134;7770
260190;202209;25858;42924;22292;38841;169;388;20605;34974;20774;35362
260200;202209;13239;28407;11420;26097;504;988;9926;22669;10430;23657
260210;202209;13343;33860;11182;30468;378;1210;8966;24147;9344;25357
260220;202209;15001;28144;13933;26863;408;651;12452;23720;12860;24371
260230;202209;15693;29953;13762;27548;375;692;11803;23264;12178;23956
260240;202209;3297;8729;2843;7896;71;304;2270;6097;2341;6401
260250;202209;2811;6258;2406;5666;98;245;1955;4464;2053;4709
260260;202209;16771;37483;14923;34896;1086;2341;11462;27071;12548;29412
260270;202209;6146;11478;5481;10728;75;250;4963;9415;5038;9665
260280;202209;15411;39009;13956;36959;352;1391;12343;31734;12695;33125
260290;202209;51329;116321;44226;106529;3898;9761;31936;75070;35834;84831
260300;202209;12707;28054;10955;25604;297;815;9395;21482;9692;22297
260310;202209;7932;15996;7136;15034;419;692;5955;12619;6374;13311
260320;202209;8799;23342;7394;21074;160;593;6131;17264;6291;17857
260330;202209;2873;8039;2455;7194;66;228;1975;5617;2041;5845
260340;202209;2658;6021;2312;5534;24;99;2059;4765;2083;4864
260345;202209;34414;77439;29194;70282;2909;7666;19354;44113;22263;51779
260350;202209;7576;14010;6612;12945;30;103;6163;11810;6193;11913
260360;202209;2899;6801;2531;6144;108;303;1788;4204;1896;4507
260370;202209;6623;16422;5617;14774;163;574;4510;11355;4673;11929
260380;202209;5983;15555;5104;14149;218;597;3941;10808;4159;11405
260390;202209;5445;14921;4378;12853;198;581;2959;8482;3157;9063
260392;202209;4731;11809;4281;11246;58;339;3784;9745;3842;10084
260400;202209;26798;50861;23481;46627;351;1037;20197;37822;20548;38859
260410;202209;96590;209454;77560;183601;13993;34790;38743;91305;52736;126095
260415;202209;5713;12364;4967;11271;37;149;4374;9595;4411;9744
260420;202209;16824;28488;14565;26032;66;216;13947;24538;14013;24754
260430;202209;3168;9131;2658;8139;175;581;1789;5386;1964;5967
260440;202209;5217;10668;4639;9928;36;132;4261;8929;4297;9061
260450;202209;6720;15190;5984;14226;339;649;5029;12075;5368;12724
260460;202209;6659;16793;5696;15210;452;1365;3911;9987;4363;11352
260470;202209;6102;13137;5137;12043;109;252;4583;10948;4692;11200
260480;202209;4622;10703;3892;9705;324;859;2805;6938;3129;7797
260490;202209;6906;13066;6098;11983;27;100;5674;10891;5701;10991
260500;202209;7276;16244;6230;14792;443;994;4496;10645;4939;11639
260510;202209;13461;27020;11493;24356;133;445;10381;21388;10514;21833
260515;202209;5444;12666;4300;10655;115;344;3231;7473;3346;7817
260520;202209;19484;40761;16960;37577;1042;2231;13741;29940;14783;32171
260530;202209;11931;29194;10206;26675;118;552;9074;23135;9192;23687
260540;202209;9546;17148;8536;15933;116;261;7939;14560;8055;14821
260545;202209;128;350;84;258;13;51;29;73;42;124
260550;202209;3743;9154;3007;7959;187;628;2041;5017;2228;5645
260560;202209;6881;15714;5711;14010;129;446;4902;11683;5031;12129
260570;202209;11004;22917;9736;21310;214;604;8688;18510;8902;19114
260580;202209;6246;11790;5673;11060;24;67;5312;10204;5336;10271
260590;202209;9888;17174;8572;15738;95;221;7905;14202;8000;14423
260600;202209;41738;92379;34852;82390;1141;3265;28185;63740;29326;67005
260610;202209;9129;21273;7983;19753;392;1045;6131;14876;6523;15921
260620;202209;25786;52894;22985;49231;1163;3212;18808;38097;19971;41309
260630;202209;2805;6793;2291;6006;61;172;1892;4844;1953;5016
260640;202209;31448;58395;27057;53436;884;1796;23431;45355;24315;47151
260650;202209;7468;17008;5956;15148;481;910;4881;12561;5362;13471
260660;202209;9303;19655;8197;18289;291;788;7368;16105;7659;16893
260670;202209;2731;6325;2223;5527;66;193;1717;4072;1783;4265
260680;202209;37196;78167;31531;70497;2083;4959;23617;50670;25700;55629
260690;202209;4053;9539;3342;8462;88;310;2646;6525;2734;6835
260700;202209;8761;18426;8183;17798;40;180;7972;17238;8012;17418
260710;202209;1613;3797;1352;3415;62;202;1083;2672;1145;2874
260720;202209;35673;72126;30958;66435;1786;4191;25208;52774;26994;56965
260730;202209;9793;24438;8483;22622;184;735;7409;19264;7593;19999
260740;202209;1555;3924;1268;3467;22;83;1025;2792;1047;2875
260750;202209;9541;21042;7514;18606;194;396;6583;16699;6777;17095
260760;202209;7989;15780;6999;14641;115;325;6294;12909;6409;13234
260765;202209;10534;25746;9275;24065;639;1887;6798;17117;7437;19004
260770;202209;4603;10457;3752;9108;97;294;3060;7211;3157;7505
260775;202209;6967;15885;6115;14640;146;506;5027;11372;5173;11878
260780;202209;4573;11776;4050;10948;372;1218;2654;6648;3026;7866
260790;202209;170793;334091;144167;300588;17908;37408;100024;202965;117932;240373
260795;202209;4623;8738;4004;7983;154;326;3478;6821;3632;7147
260800;202209;7814;14109;7082;13146;240;393;6328;11484;6568;11877
260805;202209;4595;10808;3946;9769;161;507;3167;7491;3328;7998
260810;202209;8285;19152;7259;17340;296;776;5873;13405;6169;14181
260820;202209;5720;11194;5052;10449;78;233;4398;8993;4476;9226
260825;202209;3499;9279;3056;8538;110;348;2381;6530;2491;6878
260830;202209;5255;13373;4380;11915;483;1087;2962;8227;3445;9314
260840;202209;5700;11844;5105;11066;263;497;4431;9512;4694;10009
260845;202209;5507;12670;4859;11629;204;591;3864;8835;4068;9426
260850;202209;6034;14424;5045;12672;353;967;3468;8200;3821;9167
260860;202209;4064;10432;3471;9400;133;406;2798;7360;2931;7766
260870;202209;5458;11055;4700;10141;123;264;4174;8947;4297;9211
260875;202209;10329;20495;8550;18038;709;1408;6190;13025;6899;14433
260880;202209;13047;30367;11441;27866;245;779;9875;23368;10120;24147
260890;202209;16360;36224;14113;32995;1013;2441;9850;22583;10863;25024
260900;202209;6805;16929;5642;15310;516;1377;3663;9886;4179;11263
260910;202209;4144;9451;3623;8703;127;328;2904;6838;3031;7166
260915;202209;6989;15190;6297;14367;30;115;5976;13466;6006;13581
260920;202209;4284;8385;3666;7731;101;178;3252;6814;3353;6992
260930;202209;4875;12716;4159;11520;159;591;3306;8793;3465;9384
260940;202209;18960;38797;16524;35501;1156;2587;12831;26700;13987;29287
260950;202209;9239;21097;7469;18293;352;1083;5265;11897;5617;12980
260960;202209;106609;199097;89628;178333;7439;15228;66825;127374;74264;142602
260970;202209;6801;15733;5983;14642;392;726;4534;11264;4926;11990
260980;202209;5694;14078;4949;13156;69;199;4510;11993;4579;12192
260990;202209;20711;51051;17415;46574;753;2328;13866;36219;14619;38547
261000;202209;21139;41816;17838;37737;575;1406;14908;30470;15483;31876
261010;202209;2684;6106;2307;5609;110;277;1958;4721;2068;4998
261020;202209;8255;18570;7215;16905;339;830;5931;13410;6270;14240
261030;202209;4926;12605;4329;11613;119;441;3512;9026;3631;9467
261040;202209;6386;16216;5231;14208;158;571;4142;10792;4300;11363
261050;202209;9577;21519;8657;20217;212;484;7336;16841;7548;17325
261060;202209;18109;39052;15795;36328;373;994;13453;30216;13826;31210
261070;202209;88029;172344;73866;154073;6747;13837;53910;109622;60657;123459
261080;202209;8324;17373;7500;16383;117;228;7028;15269;7145;15497
261090;202209;25385;49762;22623;46237;668;1332;19869;39871;20537;41203
261100;202209;10513;24979;9136;23045;625;1545;6938;17257;7563;18802
261110;202209;90305;219717;76482;195870;9391;25897;48171;118746;57562;144643
261120;202209;4872;9898;4263;9079;113;242;3745;7770;3858;8012
261130;202209;9446;19305;8322;17832;133;325;7424;15563;7557;15888
261140;202209;4878;9448;4330;8743;306;563;3368;6752;3674;7315
261150;202209;7055;14907;6202;13733;251;475;5263;11565;5514;12040
261153;202209;2260;6133;1856;5385;71;230;1307;3737;1378;3967
261160;202209;297760;608095;246344;540518;58266;128009;112992;251300;171258;379309
261170;202209;9435;18201;8257;16679;269;520;7267;14280;7536;14800
261180;202209;11561;25212;10138;23426;490;1058;7903;18044;8393;19102
261190;202209;6359;14707;5714;13735;126;552;4880;11157;5006;11709
261200;202209;4232;8378;3689;7682;119;279;3146;6347;3265;6626
261210;202209;2240;4897;1912;4444;111;198;1586;3664;1697;3862
261220;202209;18189;42840;15518;38484;1445;3755;10808;25549;12253;29304
261230;202209;4622;11780;3827;10751;50;193;3220;9045;3270;9238
261240;202209;7509;14943;6653;13739;250;511;5743;11620;5993;12131
261245;202209;4560;11014;3702;9589;69;307;3056;7527;3125;7834
261247;202209;3673;9684;3030;8567;348;935;1921;5500;2269;6435
261250;202209;35804;66804;31877;62362;3682;7109;24598;48053;28280;55162
261255;202209;4802;12629;3882;10916;160;576;2972;8076;3132;8652
261260;202209;19445;38766;17362;36187;244;931;16266;32922;16510;33853
261270;202209;6472;12140;5734;11275;193;391;5133;9858;5326;10249
261280;202209;3046;7524;2634;6883;98;320;2103;5278;2201;5598
261290;202209;3581;7917;2969;7235;90;281;2454;5982;2544;6263
261300;202209;17002;38247;14622;34601;354;1228;12133;27272;12487;28500
261310;202209;12108;25826;10472;23679;827;1937;7928;17433;8755;19370
261320;202209;7326;18158;6339;16618;76;293;5436;13932;5512;14225
261330;202209;7948;15623;7211;14703;221;495;6400;12797;6621;13292
261340;202209;7145;14611;6403;13713;102;317;5867;12227;5969;12544
261350;202209;9953;26926;8644;24718;235;678;6861;19426;7096;20104
261360;202209;10796;21565;9169;19327;390;830;7511;15309;7901;16139
261370;202209;29270;65447;24778;59604;2145;5254;17643;41553;19788;46807
261380;202209;5280;12950;4513;11709;467;1194;3146;8121;3613;9315
261390;202209;20340;52032;17009;46925;1174;3687;11853;31697;13027;35384
261400;202209;6093;15259;5330;13839;258;827;4205;10341;4463;11168
261410;202209;11815;25686;9782;22713;317;934;8208;18271;8525;19205
261420;202209;9877;24511;8913;23383;595;1923;7034;18013;7629;19936
261430;202209;5310;10879;4617;9882;45;183;4193;8635;4238;8818
261440;202209;1633;4494;1333;3929;52;226;964;2707;1016;2933
261450;202209;18085;41742;15933;38611;616;1491;12834;30829;13450;32320
261460;202209;9308;22128;7978;20131;245;691;6561;16300;6806;16991
261470;202209;4635;10463;3970;9545;47;200;3409;8018;3456;8218
261480;202209;6709;17322;5743;15753;260;911;4584;12106;4844;13017
261485;202209;6529;16085;5703;14879;410;1256;4308;10865;4718;12121
261500;202209;8357;18084;7287;16675;688;1291;5061;12029;5749;13320
261510;202209;2137;5747;1843;5277;73;275;1438;4051;1511;4326
261520;202209;2836;7519;2527;6934;120;351;1886;5047;2006;5398
261530;202209;15207;38041;12465;33463;725;2650;7986;19462;8711;22112
261540;202209;11861;28907;10866;27564;2582;5903;5502;15519;8084;21422
261550;202209;4546;10523;3972;9657;206;578;3035;7044;3241;7622
261560;202209;11735;26238;10370;24334;363;1006;8729;19924;9092;20930
261570;202209;4275;10385;3354;8884;239;694;2324;5938;2563;6632
261580;202209;8352;18999;7284;17586;71;321;6720;15960;6791;16281
261590;202209;3378;7354;2748;6469;74;237;2225;5019;2299;5256
261600;202209;7440;14639;6409;13232;201;445;5407;10714;5608;11159
261610;202209;2639;6917;2109;5953;219;615;1261;3614;1480;4229
261618;202209;3518;6736;3123;6202;81;251;2743;5199;2824;5450
261620;202209;5760;13611;5291;12947;673;1456;3772;9628;4445;11084
261630;202209;7152;18545;6076;16544;471;1429;3959;10197;4430;11626
261640;202209;48129;92448;41247;84296;2160;3538;32945;67899;35105;71437
261650;202209;5464;10951;4657;9986;235;473;3780;8008;4015;8481
270010;202209;5024;15229;4322;14070;159;801;3474;10958;3633;11759
270020;202209;5089;10545;4448;9766;113;441;3951;8226;4064;8667
270030;202209;39131;99416;32837;89650;2436;7066;24552;65803;26988;72869
270040;202209;12430;29404;10582;27212;667;1816;8538;21792;9205;23608
270050;202209;6288;13284;5338;12225;162;380;4863;11084;5025;11464
270060;202209;2662;6197;2261;5718;153;402;1811;4506;1964;4908
270070;202209;6140;14015;5372;12969;90;387;4760;11026;4850;11413
270080;202209;1679;4140;1395;3692;77;205;1072;2770;1149;2975
270090;202209;2104;5666;1907;5315;37;161;1663;4527;1700;4688
270100;202209;8434;16134;7415;14781;179;423;6649;12879;6828;13302
270110;202209;3958;8370;3222;7524;204;356;2571;6245;2775;6601
270120;202209;2931;7431;2557;6934;71;250;2131;5647;2202;5897
270130;202209;5971;13788;5142;12802;153;496;4432;10854;4585;11350
270135;202209;2312;5020;1958;4637;27;124;1810;4223;1837;4347
270140;202209;10517;23489;8408;20634;337;1056;6556;15246;6893;16302
270150;202209;3370;8375;3089;7998;14;68;2951;7586;2965;7654
270160;202209;6261;16055;5375;14977;154;542;4849;13386;5003;13928
270170;202209;3779;10168;3162;9295;202;861;2317;6458;2519;7319
270180;202209;2688;7348;2441;7038;38;212;2177;6132;2215;6344
270190;202209;2895;5857;2650;5577;17;81;2518;5203;2535;5284
270200;202209;3085;8223;2670;7632;330;816;1828;5359;2158;6175
270210;202209;7056;14416;6052;13277;73;249;5648;12171;5721;12420
270220;202209;2036;4531;1659;4007;107;320;1271;2888;1378;3208
270230;202209;11531;28541;9674;25790;884;2505;7137;18662;8021;21167
270235;202209;7001;19697;6104;18300;234;786;5048;14950;5282;15736
270240;202209;14141;33546;11823;30452;970;2622;8984;22880;9954;25502
270250;202209;3846;7885;3450;7353;138;302;3059;6397;3197;6699
270255;202209;5165;13463;4095;11630;145;515;3215;8871;3360;9386
270260;202209;6091;17225;5504;16256;88;449;4791;13873;4879;14322
270270;202209;1202;2853;993;2599;114;280;740;1925;854;2205
270280;202209;4509;9724;3602;8630;280;603;2645;6551;2925;7154
270290;202209;9330;26472;8408;25067;158;746;7512;22093;7670;22839
270300;202209;4836;11487;3759;10308;179;428;3013;8395;3192;8823
270310;202209;8080;20455;6911;18750;163;582;5916;15805;6079;16387
270320;202209;6350;17281;5415;15562;234;836;4098;11225;4332;12061
270330;202209;5081;14135;4470;13249;195;857;3743;10850;3938;11707
270340;202209;1943;4589;1649;4191;85;154;1389;3542;1474;3696
270350;202209;2259;4609;1832;4111;153;296;1353;3098;1506;3394
270360;202209;3787;7501;3432;7106;33;104;3296;6761;3329;6865
270370;202209;1577;4452;1427;4190;32;154;1220;3527;1252;3681
270375;202209;4597;8430;3998;7780;15;46;3872;7475;3887;7521
270380;202209;6683;15863;5684;14661;603;1418;4269;11226;4872;12644
270390;202209;1467;3242;1175;2899;12;62;1009;2458;1021;2520
270400;202209;7767;18115;6501;16282;232;602;5212;12767;5444;13369
270410;202209;5640;14412;4887;13310;135;460;4170;11211;4305;11671
270420;202209;7932;19031;7202;17956;193;730;6422;15502;6615;16232
270430;202209;178897;380842;141506;333914;19464;47714;84295;194892;103759;242606
270440;202209;5465;13413;4765;12533;152;467;4186;10928;4338;11395
270450;202209;10434;22517;9310;21183;504;928;7829;18146;8333;19074
270460;202209;4610;9079;3948;8287;257;396;3481;7409;3738;7805
270470;202209;13850;34126;12048;31643;598;1822;9757;25190;10355;27012
270480;202209;3572;8338;3006;7559;152;464;2497;6095;2649;6559
270490;202209;1064;2677;923;2506;37;124;765;2031;802;2155
270500;202209;5827;15603;5187;14562;243;806;4232;11681;4475;12487
270510;202209;7688;16789;6484;15293;333;956;5231;11802;5564;12758
270520;202209;4785;12097;3809;10588;719;2086;1826;5089;2545;7175
270530;202209;1536;4084;1309;3730;81;218;906;2619;987;2837
270540;202209;2698;6572;2275;6029;70;232;1975;5151;2045;5383
270550;202209;7767;18203;6135;16391;580;1461;4571;12427;5151;13888
270560;202209;3459;8005;2877;7240;160;478;2293;5585;2453;6063
270570;202209;6565;13943;5742;12812;408;1042;4788;10274;5196;11316
270580;202209;2818;6916;2542;6545;115;309;2210;5630;2325;5939
270590;202209;1705;4759;1567;4573;13;69;1488;4321;1501;4390
270600;202209;3273;8941;2967;8486;62;228;2629;7435;2691;7663
270610;202209;4297;10164;3764;9470;99;231;3372;8412;3471;8643
270620;202209;1433;3929;1305;3703;28;108;1128;3108;1156;3216
270630;202209;22376;47394;19460;43493;751;2058;16796;36458;17547;38516
270640;202209;6443;16345;5460;14831;148;560;4618;12261;4766;12821
270642;202209;2959;8529;2605;7989;197;682;1976;5941;2173;6623
270644;202209;4699;10353;3928;9389;231;568;3225;7579;3456;8147
270650;202209;4342;10367;3805;9682;267;820;3155;7860;3422;8680
270660;202209;2334;5282;2006;4850;85;214;1573;3707;1658;3921
270670;202209;22748;44161;19410;40153;621;1338;16923;34076;17544;35414
270680;202209;7815;14387;7103;13609;354;445;6482;12657;6836;13102
270690;202209;12096;26391;10151;23927;277;810;8541;19592;8818;20402
270700;202209;650;1747;566;1616;60;183;394;1089;454;1272
270710;202209;6670;17869;5855;16641;371;1135;4604;12920;4975;14055
270720;202209;4475;11078;3971;10266;88;291;3547;8977;3635;9268
270730;202209;9587;19069;8293;17709;1037;1303;6269;14758;7306;16061
270740;202209;2685;6605;2353;6223;82;252;1972;5145;2054;5397
270750;202209;6685;15554;5879;14547;107;406;5275;12800;5382;13206
270760;202209;3965;9817;3286;8883;58;254;2799;7420;2857;7674
270770;202209;27361;61491;22385;55276;3378;8175;14221;35268;17599;43443
270780;202209;2463;5371;2278;5132;46;157;2101;4635;2147;4792
270790;202209;2045;4840;1735;4433;146;365;1358;3442;1504;3807
270800;202209;14230;32414;12867;30546;566;1394;10919;25633;11485;27027
270810;202209;4004;9883;3176;8645;174;569;2401;6334;2575;6903
270820;202209;1880;5158;1597;4717;57;232;1294;3754;1351;3986
270830;202209;6119;13369;4990;12018;168;525;4158;9762;4326;10287
270840;202209;9693;26345;8427;24454;275;1237;7058;19748;7333;20985
270850;202209;10596;22050;9332;20599;553;1429;8083;17526;8636;18955
270860;202209;17226;34706;13850;30918;593;1439;11512;25128;12105;26567
270870;202209;2680;6945;2178;6120;211;583;1476;4126;1687;4709
270880;202209;9153;25187;8161;23697;202;836;6850;19387;7052;20223
270890;202209;4058;9959;3433;9074;418;1087;2122;5565;2540;6652
270895;202209;4543;10787;4078;10207;109;352;3654;8958;3763;9310
270900;202209;1913;4475;1470;3797;24;76;1212;3043;1236;3119
270910;202209;4894;12687;4237;11731;176;443;3541;9723;3717;10166
270915;202209;11199;28647;9086;25353;770;2581;6343;16886;7113;19467
270920;202209;7207;18059;6344;16869;99;442;5572;14435;5671;14877
270930;202209;21630;44599;17042;39369;1938;3860;12296;29428;14234;33288
270940;202209;7277;17536;6089;16168;190;808;4958;12668;5148;13476
280010;202209;704;1859;546;1536;21;88;394;1010;415;1098
280020;202209;6282;13626;5312;12152;352;845;4134;9107;4486;9952
280030;202209;114676;229351;95502;203426;15181;32781;56879;118184;72060;150965
280040;202209;3689;8609;3212;7941;181;566;2491;5876;2672;6442
280050;202209;4977;12868;4162;11575;869;2425;2135;5872;3004;8297
280060;202209;8601;19134;6971;16761;989;2650;4296;10013;5285;12663
280067;202209;8805;18330;7528;16449;616;1016;5545;12077;6161;13093
280070;202209;2026;5674;1849;5403;123;421;1473;4195;1596;4616
280100;202209;5184;11709;4387;10519;535;1144;2842;7045;3377;8189
280110;202209;1935;4094;1658;3702;23;72;1532;3335;1555;3407
280120;202209;9484;23198;8408;21534;1080;2421;5976;15615;7056;18036
280130;202209;10516;22143;9155;20300;567;1286;7336;16028;7903;17314
280140;202209;7474;14627;6613;13467;645;1075;5042;10493;5687;11568
280150;202209;4781;11015;4142;10118;501;1096;2964;7214;3465;8310
280160;202209;1567;3823;1336;3462;136;387;940;2307;1076;2694
280170;202209;7023;14819;6313;13938;221;522;5427;11725;5648;12247
280190;202209;2006;3326;1820;3093;37;99;1691;2785;1728;2884
280200;202209;1473;3567;1212;3192;76;233;894;2256;970;2489
280210;202209;21543;45907;18764;42101;2070;4567;12810;28007;14880;32574
280220;202209;2065;4757;1765;4374;97;234;1419;3518;1516;3752
280230;202209;4966;11400;4028;10007;276;558;2784;6923;3060;7481
280240;202209;3874;9178;3424;8526;38;192;3003;7233;3041;7425
280250;202209;1179;2359;996;2107;59;137;781;1582;840;1719
280260;202209;2962;5825;2619;5402;38;91;2432;4965;2470;5056
280270;202209;2895;6975;2538;6458;138;406;2164;5370;2302;5776
280280;202209;4611;12373;4067;11588;554;1316;2822;8320;3376;9636
280290;202209;26493;57118;22845;52223;2009;4700;15105;34838;17114;39538
280300;202209;16169;31172;14130;28994;1410;1866;10871;23745;12281;25611
280310;202209;1610;3772;1344;3351;50;136;1045;2521;1095;2657
280320;202209;10959;25500;9492;23361;1030;2533;6772;16128;7802;18661
280330;202209;5464;12293;4536;10989;326;760;3351;7960;3677;8720
280340;202209;6316;11922;5282;10772;196;311;4674;9541;4870;9852
280350;202209;38344;71075;34146;65669;923;2223;29771;54987;30694;57210
280360;202209;6645;16877;5772;15532;645;1912;3691;9704;4336;11616
280370;202209;2835;5890;2285;5006;127;229;1774;3810;1901;4039
280380;202209;1239;2903;1041;2644;88;176;738;1910;826;2086
280390;202209;5036;10002;4269;8869;267;446;3507;7223;3774;7669
280400;202209;4982;10542;4352;9730;442;878;3251;7283;3693;8161
280410;202209;3331;7854;2789;7029;266;717;1851;4405;2117;5122
280420;202209;5280;12063;4772;11439;108;272;4369;10425;4477;10697
280430;202209;2807;5722;2483;5303;58;167;2173;4458;2231;4625
280440;202209;5336;12101;4723;11208;188;523;4045;9289;4233;9812
280445;202209;2657;6337;2382;5896;53;165;1912;4542;1965;4707
280450;202209;11735;26162;10146;24023;2341;5536;5004;12199;7345;17735
280460;202209;8596;17751;7790;16686;409;904;6681;14024;7090;14928
280470;202209;1969;4984;1647;4401;116;329;1206;3111;1322;3440
280480;202209;60434;124983;52594;114414;4993;11467;37702;79183;42695;90650
280490;202209;4173;11087;3486;9911;133;539;2648;7167;2781;7706
280500;202209;1278;2590;1054;2315;25;74;880;1919;905;1993
280510;202209;4283;7372;3790;6752;48;138;3478;5945;3526;6083
280520;202209;2321;4741;2029;4351;186;294;1539;3319;1725;3613
280530;202209;2761;6365;2393;5863;123;295;1895;4588;2018;4883
280540;202209;9977;24294;8971;22891;387;1031;7693;19451;8080;20482
280550;202209;8131;16649;6785;14784;120;441;5825;12105;5945;12546
280560;202209;8976;21289;8392;20459;121;404;7578;18111;7699;18515
280570;202209;8363;17168;6914;15420;312;723;5498;11937;5810;12660
280580;202209;7517;16007;6648;14810;490;962;5350;11769;5840;12731
280590;202209;3287;6992;2775;6390;155;423;2114;4637;2269;5060
280600;202209;5058;10964;4461;10127;165;401;3504;7750;3669;8151
280610;202209;3425;6872;3056;6413;122;294;2648;5360;2770;5654
280620;202209;7506;15338;6435;13991;570;865;4662;10616;5232;11481
280630;202209;4840;11260;4430;10729;298;662;3540;8650;3838;9312
280640;202209;2942;6554;2562;6125;118;236;2249;5414;2367;5650
280650;202209;1426;3414;1182;3059;117;305;833;2072;950;2377
280660;202209;4675;8824;4078;8136;144;241;3608;7126;3752;7367
280670;202209;24578;51099;21220;46801;2725;5761;14504;31883;17229;37644
280680;202209;3516;7430;3028;6742;305;545;2053;4755;2358;5300
280690;202209;1233;2556;1042;2319;55;141;867;1856;922;1997
280700;202209;1418;3009;1209;2716;35;88;998;2179;1033;2267
280710;202209;18477;36344;15717;33226;1224;1796;13188;28454;14412;30250
280720;202209;3148;6275;2592;5631;61;141;2133;4623;2194;4764
280730;202209;1198;2843;1018;2569;85;220;720;1738;805;1958
280740;202209;20867;39583;18094;35709;990;2156;14766;27887;15756;30043
280750;202209;3991;10244;3420;9265;230;650;2452;6516;2682;7166
280760;202209;8840;18958;7570;17245;770;1569;5368;12268;6138;13837
290010;202209;3811;7029;2525;5141;15;48;2202;4267;2217;4315
290020;202209;7621;15300;6976;14525;555;847;5846;12441;6401;13288
290030;202209;5701;11227;4687;10105;316;551;3749;8324;4065;8875
290035;202209;6477;12008;5194;10351;254;439;4128;8153;4382;8592
290040;202209;6923;12022;5981;10921;452;574;4984;9285;5436;9859
290050;202209;2426;7130;2052;6374;143;469;1401;4237;1544;4706
290060;202209;1835;3625;1345;2957;166;385;956;2034;1122;2419
290070;202209;51606;97485;44695;88995;2815;5376;35334;68696;38149;74072
290080;202209;7740;18419;6750;17010;730;1763;4836;12205;5566;13968
290090;202209;2705;4463;1969;3679;17;47;1831;3372;1848;3419
290100;202209;11887;27403;9580;24100;1660;3819;5083;13303;6743;17122
290110;202209;6758;15447;5879;14103;767;1710;3695;8860;4462;10570
290115;202209;4777;12780;4048;11521;331;961;3156;8904;3487;9865
290120;202209;7924;17221;6636;15454;189;566;5675;12853;5864;13419
290130;202209;5470;11681;4252;10084;243;507;3103;7548;3346;8055
290135;202209;5401;11195;4376;9548;173;412;3550;7348;3723;7760
290140;202209;5358;12297;4138;10703;222;521;3381;8837;3603;9358
290150;202209;4037;7545;3538;6975;140;344;3054;5810;3194;6154
290160;202209;4256;8369;3774;7719;196;339;3195;6465;3391;6804
290170;202209;4423;9126;3934;8605;128;264;3560;7781;3688;8045
290180;202209;3671;8694;3077;7777;70;259;2637;6474;2707;6733
290190;202209;6092;13003;5451;12187;129;363;4722;10366;4851;10729
290195;202209;3296;6667;2618;5827;161;301;2149;4823;2310;5124
290200;202209;4869;12279;3823;10519;217;520;2777;7664;2994;8184
290205;202209;4285;9595;3775;8853;167;443;3079;7011;3246;7454
290210;202209;17616;39335;15584;36359;1538;2968;11949;28336;13487;31304
290220;202209;4052;7647;3580;7084;100;225;3151;6077;3251;6302
290225;202209;4015;7018;3124;6106;50;139;2900;5535;2950;5674
290230;202209;3873;7450;3559;7097;168;240;2964;6078;3132;6318
290240;202209;5173;10323;4223;9188;73;235;3765;8004;3838;8239
290250;202209;4803;11987;3913;10713;151;374;3231;8983;3382;9357
290260;202209;6545;14017;5553;12593;274;678;4683;10306;4957;10984
290265;202209;3927;10633;3166;9256;270;828;2112;6062;2382;6890
290270;202209;12740;38953;11634;37084;783;2699;9064;28798;9847;31497
290280;202209;7218;19921;6185;17907;473;1559;4283;12008;4756;13567
290290;202209;11494;30801;9164;26671;929;2915;5953;16977;6882;19892
290300;202209;5012;12167;3638;9675;203;602;2590;6627;2793;7229
290310;202209;2731;4782;2239;4220;24;81;2091;3835;2115;3916
290320;202209;34720;78815;28208;69441;4805;11778;16498;40354;21303;52132
290323;202209;4544;11070;3854;9978;98;278;3043;7807;3141;8085
290327;202209;5040;12810;4254;11380;428;1040;2880;7661;3308;8701
290330;202209;2970;5036;2395;4425;26;42;2223;4105;2249;4147
290340;202209;7715;16087;6036;14117;543;1195;4694;11004;5237;12199
290350;202209;5527;14205;4575;12583;262;789;3310;8945;3572;9734
290360;202209;6661;13879;5839;12809;109;275;5221;11265;5330;11540
290370;202209;5745;12714;4188;10674;170;435;2998;7554;3168;7989
290380;202209;7054;15511;5870;13936;177;316;5012;11981;5189;12297
290390;202209;18471;46443;15234;41310;1458;3996;10605;28468;12063;32464
290395;202209;3502;8767;2767;7551;71;267;2173;5774;2244;6041
290400;202209;4509;11055;3591;9582;174;518;2715;7041;2889;7559
290405;202209;5260;13867;4429;12473;413;1179;2976;8453;3389;9632
290410;202209;6521;15978;4949;13574;177;662;3764;10000;3941;10662
290420;202209;3723;9034;3038;8003;101;266;2392;6254;2493;6520
290430;202209;4397;9526;3669;8483;163;493;2943;6433;3106;6926
290440;202209;3433;7654;2454;6135;167;362;1747;4405;1914;4767
290450;202209;5069;9818;4079;8463;102;250;3597;7165;3699;7415
290460;202209;15031;38941;12476;34302;2541;7136;5262;14283;7803;21419
290470;202209;6072;12087;4629;10190;435;979;3122;6680;3557;7659
290475;202209;7820;19974;6509;17811;91;434;5508;14729;5599;15163
290480;202209;2237;4917;1824;4329;65;220;1404;3115;1469;3335
290485;202209;5544;14167;4825;13150;212;660;3923;10654;4135;11314
290490;202209;11425;22937;10346;21527;390;869;8747;17939;9137;18808
290500;202209;4898;13438;3782;11184;662;2073;1563;4421;2225;6494
290510;202209;4400;9189;3691;8295;95;225;3272;7326;3367;7551
290515;202209;4114;10391;3555;9611;32;99;3236;8803;3268;8902
290520;202209;14513;36756;11231;30613;561;1810;7541;19234;8102;21044
290530;202209;5700;14958;4768;13477;102;409;4044;11258;4146;11667
290540;202209;4580;10401;4137;9915;137;390;3697;8810;3834;9200
290550;202209;5038;11523;4378;10754;38;101;4001;9886;4039;9987
290560;202209;7570;17582;5810;15073;470;1433;3909;9596;4379;11029
290570;202209;63163;137694;56405;129271;3317;8117;46127;103351;49444;111468
290580;202209;10931;25663;9503;23716;940;2016;7014;18010;7954;20026
290590;202209;8029;22779;6680;20450;167;589;5488;16861;5655;17450
290600;202209;22185;56286;19129;51442;1024;2811;15163;40316;16187;43127
290610;202209;2881;8273;2235;7009;104;346;1566;4850;1670;5196
290620;202209;7155;18774;6146;17138;428;1075;4919;13779;5347;14854
290630;202209;12368;24605;10169;21869;798;1631;8020;17235;8818;18866
290640;202209;3289;7319;2529;6259;256;494;1723;4516;1979;5010
290650;202209;20972;41098;19092;39024;1105;2551;16745;33570;17850;36121
290660;202209;4501;10515;3554;9012;165;468;2565;6454;2730;6922
290670;202209;10318;20896;9014;19063;243;642;7901;16316;8144;16958
290680;202209;13240;31828;10906;28491;243;990;9227;23494;9470;24484
290682;202209;6691;13675;5804;12533;519;722;4306;10087;4825;10809
290685;202209;4260;8670;3087;7015;508;1006;1693;4095;2201;5101
290687;202209;9461;20722;7851;18268;1095;2329;4937;11791;6032;14120
290689;202209;3286;8308;2446;6842;283;830;1586;4404;1869;5234
290690;202209;6905;15884;5671;14180;359;917;4215;10327;4574;11244
290700;202209;3829;7783;3422;7291;51;153;3131;6527;3182;6680
290710;202209;11090;25336;9399;23064;245;764;8242;19897;8487;20661
290720;202209;25121;56837;22511;53009;1545;3303;17895;41387;19440;44690
290730;202209;8430;17971;7106;16426;435;816;5252;12426;5687;13242
290740;202209;1289;2963;988;2492;17;35;883;2195;900;2230
290750;202209;16305;33039;14045;29692;373;986;11720;23385;12093;24371
290755;202209;2341;6131;1880;5333;116;312;1293;3668;1409;3980
290760;202209;4326;11547;3540;10159;219;535;2486;7263;2705;7798
290770;202209;3583;8697;3304;8368;93;211;2905;7371;2998;7582
290780;202209;9249;21129;7871;19292;339;673;6083;15080;6422;15753
290790;202209;6123;14604;5250;13368;281;685;4313;11008;4594;11693
290800;202209;8489;15056;6154;12401;395;623;4592;9396;4987;10019
290810;202209;6884;14880;5575;13033;225;504;4329;10141;4554;10645
290820;202209;6450;14565;5645;13420;378;752;4013;9495;4391;10247
290830;202209;5127;11415;4500;10449;101;329;3653;7990;3754;8319
290840;202209;21569;50886;18266;45910;2025;4262;12265;32153;14290;36415
290850;202209;11052;20014;9653;18516;529;778;8117;15535;8646;16313
290860;202209;7630;18456;6627;17305;373;856;5531;14772;5904;15628
290870;202209;5684;14048;4314;11547;353;857;2893;7655;3246;8512
290880;202209;1668;3685;1323;3253;198;435;751;2003;949;2438
290890;202209;11770;20636;10419;19142;485;715;9214;17039;9699;17754
290900;202209;2716;6664;2071;5565;170;441;1274;3366;1444;3807
290910;202209;6134;12881;4686;10754;50;128;4090;9244;4140;9372
290920;202209;6440;13802;5598;12798;185;259;4834;11597;5019;11856
290930;202209;8615;22124;6846;19087;263;919;5205;14044;5468;14963
290940;202209;4058;10532;3346;9468;161;551;2642;7330;2803;7881
290950;202209;1685;3867;1349;3368;117;296;889;2234;1006;2530
290960;202209;7239;15773;6433;14799;302;608;5408;12393;5710;13001
290970;202209;3638;10155;2943;8866;120;403;2265;6750;2385;7153
290980;202209;16800;35280;14561;32018;816;1987;10406;21642;11222;23629
290990;202209;11691;27388;10356;25354;322;1108;8815;20722;9137;21830
291000;202209;3905;8994;2994;7877;149;387;2419;6409;2568;6796
291005;202209;20247;43933;17892;41022;861;2043;15082;33920;15943;35963
291010;202209;3480;9935;2735;8332;145;488;1786;5247;1931;5735
291020;202209;1512;3422;1219;2938;26;79;894;2000;920;2079
291030;202209;3016;6505;2193;5195;186;401;1406;3222;1592;3623
291040;202209;6243;15332;5065;13679;247;742;3936;10637;4183;11379
291050;202209;13632;27035;12069;24975;1412;2770;8853;18093;10265;20863
291060;202209;10521;23335;9256;21721;899;1948;7046;16506;7945;18454
291070;202209;21518;47828;18209;42794;357;1182;15735;35783;16092;36965
291072;202209;34491;74617;26394;62084;3745;9096;15333;34415;19078;43511
291075;202209;6352;14210;5677;13180;106;289;4728;10529;4834;10818
291077;202209;1984;4714;1537;3961;86;154;1083;2786;1169;2940
291080;202209;159666;339151;129450;299074;28039;63626;61309;141144;89348;204770
291085;202209;6464;14963;5210;13035;189;509;4277;10497;4466;11006
291090;202209;2599;4326;1941;3606;59;102;1676;3041;1735;3143
291100;202209;4018;7467;2856;6107;138;265;2242;4759;2380;5024
291110;202209;6936;19125;5804;17248;318;1176;4461;12826;4779;14002
291120;202209;10253;20762;8823;19018;517;1087;6964;14882;7481;15969
291125;202209;2808;4332;2155;3609;91;128;1873;3101;1964;3229
291130;202209;3694;9596;2750;7809;75;313;2136;5804;2211;6117
291140;202209;5716;13746;4132;10977;619;1481;2487;6543;3106;8024
291150;202209;3380;5938;2684;5181;20;35;2546;4871;2566;4906
291160;202209;5984;14940;4926;13421;539;1483;3165;8446;3704;9929
291165;202209;2430;6237;1742;4931;27;121;1228;3333;1255;3454
291170;202209;26448;60311;22085;53286;1594;3901;14645;33732;16239;37633
291180;202209;9642;16810;7610;14225;205;446;6788;12306;6993;12752
291185;202209;4242;9065;3767;8374;222;464;2999;6608;3221;7072
291190;202209;9133;19937;7550;17978;252;634;5975;14383;6227;15017
291200;202209;3206;8103;2352;6526;85;315;1583;4093;1668;4408
291210;202209;9178;16756;6839;14119;385;693;5271;10871;5656;11564
291220;202209;5823;13705;5176;12792;450;1072;3644;8868;4094;9940
291230;202209;5980;10451;4742;9107;69;103;4416;8449;4485;8552
291240;202209;4829;11380;4081;10168;78;232;3510;8580;3588;8812
291250;202209;3770;10299;2892;8728;194;569;1800;5487;1994;6056
291260;202209;1719;3602;1397;3195;37;93;1160;2652;1197;2745
291270;202209;6590;14808;5142;12824;459;1055;3709;9380;4168;10435
291280;202209;3406;7389;2532;6123;146;354;1802;4149;1948;4503
291290;202209;6670;15997;5068;13545;492;1364;3370;8796;3862;10160
291300;202209;4639;11066;3692;9552;172;457;2771;7031;2943;7488
291310;202209;6133;14588;5233;13060;138;413;4496;10996;4634;11409
291320;202209;7902;19016;6149;16082;1285;3172;3220;8670;4505;11842
291330;202209;2206;5105;1812;4453;67;181;1397;3331;1464;3512
291340;202209;5033;11655;4015;10033;231;460;2741;6830;2972;7290
291345;202209;3559;9035;3177;8470;185;511;2573;6844;2758;7355
291350;202209;8712;18146;6841;15873;163;380;5859;13473;6022;13853
291360;202209;52386;101293;42139;89442;4975;10148;28307;60792;33282;70940
291370;202209;9724;23612;8551;21854;560;1655;6561;16075;7121;17730
291380;202209;5555;11124;4976;10369;139;370;4425;8985;4564;9355
291390;202209;16178;30278;12491;26227;586;1122;10607;22024;11193;23146
291400;202209;19754;40889;16664;36468;1567;3234;11818;25891;13385;29125
291410;202209;3489;8362;2719;7082;57;182;2042;5172;2099;5354
291420;202209;2230;4889;1734;4270;24;87;1539;3730;1563;3817
291430;202209;3080;7821;2620;7062;90;325;2083;5396;2173;5721
291440;202209;7767;19685;6644;17947;506;1302;4869;13409;5375;14711
291450;202209;13258;24810;11015;22263;439;558;9699;20008;10138;20566
291460;202209;21244;46878;18606;43129;1318;2994;14150;32019;15468;35013
291465;202209;10593;23342;8383;20823;249;893;7213;17489;7462;18382
291470;202209;24881;45581;21318;41565;1188;2119;17001;32974;18189;35093
291480;202209;58055;112294;44711;94884;4817;10227;27430;56090;32247;66317
291490;202209;8692;17018;7761;15992;228;492;7130;14570;7358;15062
291500;202209;6454;12877;5415;11579;116;303;4980;10585;5096;10888
291510;202209;5646;11320;4302;9623;63;211;3773;8242;3836;8453
291520;202209;5446;11108;4159;9480;311;682;3280;7408;3591;8090
291530;202209;2849;5759;2083;4792;226;500;1424;3310;1650;3810
291535;202209;4424;11100;3720;9897;186;466;2988;7982;3174;8448
291540;202209;2619;5125;1836;4189;64;164;1568;3530;1632;3694
291550;202209;8080;14892;6361;12821;554;960;4636;9263;5190;10223
291560;202209;21468;46754;15948;39630;3115;7317;8166;20938;11281;28255
291570;202209;2887;5736;2221;4979;82;172;1941;4369;2023;4541
291580;202209;7702;17394;6075;15301;301;893;4652;11293;4953;12186
291590;202209;3270;6166;2910;5758;88;214;2638;5103;2726;5317
291600;202209;6738;13807;5198;11566;480;1150;3524;7593;4004;8743
291610;202209;8519;16511;7614;15522;645;907;6092;12984;6737;13891
291620;202209;3605;7196;2742;6258;223;422;2069;4854;2292;5276
291630;202209;4262;7935;3268;6725;506;760;2361;5087;2867;5847
291640;202209;21670;44982;16830;38380;1661;3822;10284;22435;11945;26257
291650;202209;12427;25021;11021;23388;956;1339;8947;19760;9903;21099
291660;202209;2296;5205;1669;4263;126;393;1110;2628;1236;3021
291670;202209;2352;5697;1925;5082;209;486;1304;3541;1513;4027
291680;202209;4892;10676;3964;9402;447;1061;2544;6095;2991;7156
291685;202209;5578;12545;4464;11027;184;385;3488;8586;3672;8971
291690;202209;5477;9814;3915;7738;153;318;3407;6538;3560;6856
291700;202209;11430;27330;10069;25165;332;1057;8634;20898;8966;21955
291710;202209;6573;13382;5039;11333;347;806;3803;8271;4150;9077
291720;202209;5112;14135;4208;12415;876;2643;2186;6416;3062;9059
291730;202209;9549;18137;8259;16507;408;793;7015;13918;7423;14711
291733;202209;3505;7958;2890;7134;113;218;2142;5493;2255;5711
291735;202209;3162;8043;2441;6785;83;196;1738;4831;1821;5027
291740;202209;4569;10965;3207;8474;121;255;2224;5809;2345;6064
291750;202209;26518;54897;22015;48415;3026;5817;14321;31972;17347;37789
291760;202209;13536;34029;10628;29666;3217;10378;2936;7737;6153;18115
291770;202209;9032;21545;7542;19043;369;1185;5816;13870;6185;15055
291780;202209;6177;14436;5536;13587;127;382;4806;11551;4933;11933
291790;202209;3685;8124;3353;7725;371;616;2496;6016;2867;6632
291800;202209;43156;90836;34546;79004;4251;10197;21822;47548;26073;57745
291810;202209;13016;27137;11091;24839;456;875;9303;20955;9759;21830
291820;202209;4682;10890;4063;10097;128;336;3319;8148;3447;8484
291830;202209;5761;11291;4709;9939;312;457;3705;7908;4017;8365
291835;202209;7647;20882;6111;18124;665;2002;4002;11941;4667;13943
291840;202209;59722;144592;52067;133266;5322;14404;37695;94857;43017;109261
291845;202209;4142;7983;3471;7182;253;406;2855;6075;3108;6481
291850;202209;5281;12710;4424;11387;140;345;3766;9672;3906;10017
291855;202209;2903;4712;2350;4109;31;55;2226;3868;2257;3923
291860;202209;2480;6156;1676;4626;44;117;1127;3006;1171;3123
291870;202209;1471;3436;991;2606;41;128;688;1762;729;1890
291875;202209;3387;9446;2889;8444;63;269;2141;5997;2204;6266
291880;202209;6542;16252;5473;14539;328;794;4151;11130;4479;11924
291890;202209;2050;3778;1363;2982;199;438;867;1860;1066;2298
291900;202209;1585;3373;1215;2828;32;87;972;2182;1004;2269
291905;202209;2731;6466;2220;5677;106;331;1708;4170;1814;4501
291910;202209;4416;8357;3812;7656;84;173;3426;6842;3510;7015
291915;202209;8736;22164;7059;19406;273;734;5210;14600;5483;15334
291920;202209;40737;88725;35621;82142;1923;5431;28663;63293;30586;68724
291930;202209;3294;7306;2805;6652;304;660;2037;4901;2341;5561
291940;202209;4467;10330;2992;7955;263;647;1794;4711;2057;5358
291950;202209;10817;30384;9002;27081;494;1528;6048;18055;6542;19583
291955;202209;23114;50049;20755;47097;1297;3168;17230;38580;18527;41748
291960;202209;4616;9263;3898;8354;305;480;3121;6872;3426;7352
291970;202209;6034;12479;5108;11380;175;438;4168;9074;4343;9512
291980;202209;12067;30446;9752;26714;920;2323;6600;18295;7520;20618
291990;202209;2729;6216;2276;5668;27;96;2102;5181;2129;5277
291992;202209;5547;11302;4693;10245;281;582;3833;8197;4114;8779
291995;202209;2754;6235;2273;5519;79;264;1872;4358;1951;4622
292000;202209;3177;6599;2622;5943;76;217;2198;4887;2274;5104
292010;202209;7000;14166;5712;12333;93;353;4920;10229;5013;10582
292020;202209;5686;13948;4792;12497;158;564;3907;9784;4065;10348
292030;202209;2493;6502;2150;5916;142;415;1428;3820;1570;4235
292040;202209;5708;12226;4559;10607;184;431;3762;8646;3946;9077
292045;202209;5629;11073;4476;9450;23;70;4205;8818;4228;8888
292050;202209;7617;19092;6149;16656;280;902;4207;11032;4487;11934
292060;202209;15650;30038;14511;28669;508;886;12974;25202;13482;26088
292070;202209;8144;16679;7159;15536;463;905;6122;13276;6585;14181
292080;202209;4541;8672;3801;7754;39;125;3557;7144;3596;7269
292090;202209;5203;10209;3712;8395;200;506;2948;6606;3148;7112
292100;202209;15668;33346;13405;30545;2088;4611;8171;18953;10259;23564
292105;202209;3973;9237;3438;8516;49;174;2901;7107;2950;7281
292110;202209;8084;16192;5887;13184;707;1703;3925;8472;4632;10175
292120;202209;8530;19317;7004;16847;702;1467;4906;11743;5608;13210
292130;202209;4064;8722;3314;7784;194;496;2499;5770;2693;6266
292140;202209;7035;13601;5978;12146;197;378;5299;10594;5496;10972
292145;202209;3121;7502;2596;6667;135;272;1990;5195;2125;5467
292150;202209;19033;42522;16402;38414;438;1157;14002;31898;14440;33055
292160;202209;3506;7517;2673;6473;36;111;2087;5366;2123;5477
292170;202209;10486;25052;8738;22310;468;1402;6723;16598;7191;18000
292180;202209;3431;8634;2553;7047;212;592;1598;4260;1810;4852
292190;202209;3599;8334;3016;7497;279;728;2109;5228;2388;5956
292200;202209;11255;24942;8504;21131;1671;4222;4229;10696;5900;14918
292205;202209;4593;11208;3955;10270;99;295;3423;8832;3522;9127
292210;202209;8160;15823;6774;14120;74;274;6319;12912;6393;13186
292220;202209;2701;5534;2308;4960;133;260;1779;3696;1912;3956
292225;202209;3781;9801;3284;9084;63;255;2860;7784;2923;8039
292230;202209;10415;22137;9195;20611;259;739;7850;17150;8109;17889
292240;202209;5890;15166;5086;13721;297;785;3687;9872;3984;10657
292250;202209;7363;16478;6549;15341;303;790;5289;12026;5592;12816
292260;202209;3937;9337;3475;8758;65;206;3078;7681;3143;7887
292265;202209;4409;10260;3636;9086;66;271;3101;7494;3167;7765
292270;202209;6045;11057;4934;9757;218;321;4108;8074;4326;8395
292273;202209;3391;6509;2694;5666;152;248;1945;4325;2097;4573
292275;202209;2266;4998;1844;4448;57;163;1520;3604;1577;3767
292280;202209;3308;6720;2642;5953;120;208;2227;5133;2347;5341
292285;202209;3088;6495;2426;5634;104;185;1976;4640;2080;4825
292290;202209;8991;20506;7181;18001;202;527;6031;14917;6233;15444
292300;202209;12620;28332;9955;24780;1337;3296;6285;15830;7622;19126
292303;202209;4011;9157;3475;8356;67;161;3095;7340;3162;7501
292305;202209;2738;6632;2479;6282;57;182;2220;5546;2277;5728
292310;202209;8472;18235;7324;16836;113;384;6477;14515;6590;14899
292320;202209;6796;16721;5389;14320;184;573;4178;10819;4362;11392
292330;202209;3880;6627;3244;5928;187;277;2679;4975;2866;5252
292335;202209;5999;13956;5262;12878;255;561;4389;10812;4644;11373
292340;202209;6323;16352;5110;14093;331;817;3598;9882;3929;10699
292350;202209;3205;7541;2683;6854;141;383;2208;5584;2349;5967
292360;202209;5870;14077;4872;12474;256;694;3600;9018;3856;9712
292370;202209;13278;26640;11428;24245;92;337;10806;22519;10898;22856
292380;202209;8252;20466;7321;18872;450;1207;5717;14425;6167;15632
292390;202209;6093;9635;4704;8074;101;168;4294;7319;4395;7487
292400;202209;27112;68299;23294;62584;2180;5841;16359;43678;18539;49519
292405;202209;5531;11785;4602;10381;139;320;3651;8339;3790;8659
292410;202209;2882;5565;2473;5069;101;177;2174;4466;2275;4643
292420;202209;6083;11846;5494;11058;114;268;5028;9846;5142;10114
292430;202209;5839;15760;4414;13154;338;1071;2966;8668;3304;9739
292440;202209;10930;28862;10012;27558;128;611;9093;24669;9221;25280
292450;202209;4786;12260;3619;10085;95;313;2836;7744;2931;8057
292460;202209;7493;15722;6346;14031;174;455;5489;11739;5663;12194
292465;202209;3121;7061;2619;6429;136;274;1757;4627;1893;4901
292467;202209;2536;6006;2247;5629;327;663;1538;4127;1865;4790
292470;202209;3362;7983;2525;6688;144;339;1791;4768;1935;5107
292480;202209;8249;15470;6829;13789;175;345;6196;12405;6371;12750
292490;202209;3379;6524;2809;5789;89;174;2261;4658;2350;4832
292500;202209;8779;19816;7007;17062;431;942;5118;12200;5549;13142
292510;202209;17091;38845;13439;33332;993;2433;9597;23547;10590;25980
292520;202209;9002;20200;7930;18652;385;1055;6480;14848;6865;15903
292525;202209;8044;15904;6654;14326;119;272;6046;12945;6165;13217
292530;202209;40625;94389;32572;81896;6292;16705;17069;41702;23361;58407
292540;202209;5475;8850;4396;7714;128;200;4036;7080;4164;7280
292550;202209;10056;24106;7815;21416;602;1537;5481;15737;6083;17274
292560;202209;5362;12068;4477;10860;167;503;3461;8076;3628;8579
292570;202209;4508;10336;3756;9071;51;185;3228;7506;3279;7691
292575;202209;8100;21048;7359;20045;836;2159;5398;14955;6234;17114
292580;202209;9808;20278;8146;17943;520;721;6748;14961;7268;15682
292590;202209;8645;20890;7227;18401;321;1020;5934;14617;6255;15637
292593;202209;3438;7744;2724;6562;77;197;2290;5411;2367;5608
292595;202209;6866;15728;5946;14608;301;651;4927;12260;5228;12911
292600;202209;13856;32423;11951;29695;655;1466;9495;23601;10150;25067
292610;202209;5510;12016;4653;10650;161;358;3804;8523;3965;8881
292620;202209;8378;18764;6930;17026;124;305;6372;15667;6496;15972
292630;202209;11287;23702;9107;20367;953;2268;6251;13423;7204;15691
292640;202209;9544;24878;7989;22366;479;1333;5538;15535;6017;16868
292650;202209;4996;11402;4413;10640;60;183;4054;9642;4114;9825
292660;202209;12800;32410;10848;29521;656;1649;8168;22450;8824;24099
292665;202209;2385;6451;2002;5936;100;261;1579;4810;1679;5071
292670;202209;4031;10352;3115;8665;252;795;2007;5365;2259;6160
292680;202209;4693;11094;3716;9454;119;308;2872;7044;2991;7352
292690;202209;2962;7151;2027;5654;217;550;1257;3595;1474;4145
292700;202209;12557;29430;10884;26935;667;1482;8183;20066;8850;21548
292710;202209;3705;8702;3458;8398;76;192;3229;7819;3305;8011
292720;202209;10702;22082;9028;20160;485;905;6944;16012;7429;16917
292730;202209;6565;12691;5953;11824;416;638;4875;9794;5291;10432
292740;202209;465665;958684;412614;886991;44013;97686;296923;618249;340936;715935
292750;202209;8419;18008;7403;16678;294;647;6321;14108;6615;14755
292760;202209;4728;11949;4071;10850;196;580;3142;8195;3338;8775
292770;202209;9223;20115;7638;17992;930;2201;5418;12880;6348;15081
292780;202209;2572;4423;1919;3658;48;113;1640;2948;1688;3061
292790;202209;4627;8699;3504;7492;265;485;2773;6042;3038;6527
292800;202209;14513;31126;12438;28064;887;1750;9733;22046;10620;23796
292805;202209;4546;9286;3624;8145;153;363;3005;6628;3158;6991
292810;202209;16246;31877;13380;27701;555;1376;11230;22033;11785;23409
292820;202209;8114;20993;5918;17308;445;1456;4101;11714;4546;13170
292830;202209;3499;7317;2985;6721;136;278;2462;5636;2598;5914
292840;202209;11921;25080;10209;22842;154;487;9278;20249;9432;20736
292850;202209;3070;7168;2580;6496;238;578;1810;4499;2048;5077
292860;202209;22356;42024;20212;39516;413;982;18083;34387;18496;35369
292870;202209;27209;56735;23587;51798;1569;3332;17254;36525;18823;39857
292880;202209;13358;33563;11207;30234;410;1442;8327;21402;8737;22844
292890;202209;10306;22700;9143;21098;174;562;8132;18271;8306;18833
292895;202209;4211;7518;3265;6167;253;393;2570;4872;2823;5265
292900;202209;3642;7992;3288;7505;52;193;2820;6179;2872;6372
292905;202209;5407;12152;4298;10515;137;387;3397;7992;3534;8379
292910;202209;6500;14730;5729;13731;182;423;4632;10815;4814;11238
292920;202209;11947;28668;11049;27491;290;964;9665;23532;9955;24496
292925;202209;6177;16159;5050;14054;406;976;3523;9796;3929;10772
292930;202209;8038;20906;6942;18995;921;2564;4095;10918;5016;13482
292935;202209;3360;6372;2716;5669;22;61;2497;5188;2519;5249
292937;202209;3340;7672;2850;7060;265;576;2042;5177;2307;5753
292940;202209;3604;8044;2870;6961;486;975;1740;4458;2226;5433
292950;202209;10927;25841;9495;23818;507;1244;7263;17874;7770;19118
292960;202209;6513;13870;5460;12432;214;391;4379;9911;4593;10302
292970;202209;4743;11727;4180;10943;112;321;3466;9139;3578;9460
292975;202209;5232;10241;4651;9590;116;270;4270;8715;4386;8985
292980;202209;4760;9042;3981;7977;66;195;3569;6939;3635;7134
292990;202209;13711;34027;11425;30228;421;1291;9002;22998;9423;24289
293000;202209;3280;7037;2776;6271;156;311;2112;4787;2268;5098
293010;202209;22670;50792;18384;44535;2232;5584;11963;28523;14195;34107
293015;202209;10242;27993;8037;23912;685;2038;5518;16510;6203;18548
293020;202209;12310;29974;11123;28319;149;542;10125;25543;10274;26085
293030;202209;6134;14591;4750;12491;380;707;3127;8646;3507;9353
293040;202209;5217;11907;4247;10583;134;365;3605;8914;3739;9279
293050;202209;30438;61180;26746;55973;1897;3714;20430;41770;22327;45484
293060;202209;4477;10650;3590;9050;234;604;2623;6371;2857;6975
293070;202209;38902;76383;34779;71320;2215;4696;28071;55980;30286;60676
293075;202209;4341;11777;3740;10827;74;370;3214;9222;3288;9592
293076;202209;4130;8959;3723;8494;101;192;3292;7569;3393;7761
293077;202209;7789;18771;6296;16512;892;2151;3663;10238;4555;12389
293080;202209;5444;14375;4569;12877;85;361;3755;10321;3840;10682
293090;202209;3642;9917;2801;8486;205;597;1960;5896;2165;6493
293100;202209;6879;16541;5543;14272;287;649;4281;10981;4568;11630
293105;202209;4470;12926;3774;11556;246;778;2606;7955;2852;8733
293110;202209;3082;6429;2600;5763;113;256;2111;4587;2224;4843
293120;202209;6576;13525;5999;12725;587;794;4749;10559;5336;11353
293130;202209;4286;10499;3684;9729;127;414;3189;8284;3316;8698
293135;202209;38113;82435;28244;69293;5148;13475;11771;28522;16919;41997
293140;202209;3511;5956;3099;5476;85;119;2807;4873;2892;4992
293150;202209;6057;16357;4981;14424;393;1243;3435;9669;3828;10912
293160;202209;5203;10442;4592;9762;575;751;3535;8199;4110;8950
293170;202209;6701;11042;5747;9945;114;254;5112;8617;5226;8871
293180;202209;5424;13435;4480;11799;97;344;3644;9300;3741;9644
293190;202209;20069;41877;17731;38667;124;515;16305;34699;16429;35214
293200;202209;11592;23028;9553;19994;515;853;7865;16410;8380;17263
293210;202209;6370;14504;5363;13066;450;1018;4032;9861;4482;10879
293220;202209;7365;15040;5593;12297;803;1714;3620;7640;4423;9354
293230;202209;5774;11500;4372;9754;333;645;3303;7432;3636;8077
293240;202209;5457;12410;4390;10789;226;383;3241;8347;3467;8730
293245;202209;4866;11428;4396;10769;211;512;3692;8927;3903;9439
293250;202209;6990;15052;5616;13207;365;886;4346;10079;4711;10965
293260;202209;5810;13103;4729;11493;192;361;3427;8373;3619;8734
293270;202209;9382;17540;7499;15548;669;819;5926;13145;6595;13964
293280;202209;5350;12292;4644;11310;301;645;3652;8917;3953;9562
293290;202209;20260;49303;17827;45621;1633;4260;12937;32575;14570;36835
293300;202209;8255;16486;7095;14816;542;1082;5458;11070;6000;12152
293305;202209;5272;10835;4453;9811;46;123;4093;8953;4139;9076
293310;202209;2637;5955;2221;5323;32;120;1839;4267;1871;4387
293315;202209;5670;11047;4720;9733;482;672;3690;7804;4172;8476
293317;202209;3466;7026;3082;6490;318;473;2276;4890;2594;5363
293320;202209;16904;33070;15130;31146;224;550;13938;28201;14162;28751
293325;202209;2239;4883;1766;4290;211;491;1168;2831;1379;3322
293330;202209;93255;215067;77372;189540;9441;25878;47069;107074;56510;132952
293340;202209;2532;6468;2057;5642;152;426;1400;3785;1552;4211
293345;202209;4621;10667;3721;9340;466;862;2432;6713;2898;7575
293350;202209;7085;17900;6034;16588;138;405;5301;14616;5439;15021
293360;202209;19317;40461;16759;37145;545;1172;14604;32568;15149;33740
310010;202209;1164;2448;788;1957;99;272;328;727;427;999
310020;202209;3562;8690;2714;7255;463;1306;1106;2732;1569;4038
310030;202209;2340;6016;1824;5132;250;752;1181;3210;1431;3962
310040;202209;973;2342;757;1981;70;238;435;988;505;1226
310050;202209;1916;4937;1626;4494;136;454;1125;2990;1261;3444
310060;202209;3838;9485;3247;8705;129;409;2500;6780;2629;7189
310070;202209;416;905;312;759;11;34;243;573;254;607
310080;202209;888;2261;654;1850;91;278;331;871;422;1149
310090;202209;6286;13684;5197;12012;203;586;4203;9327;4406;9913
310100;202209;4442;10230;3730;9153;108;375;3172;7498;3280;7873
310110;202209;5717;13704;4464;11629;614;1848;2685;6560;3299;8408
310120;202209;776;1759;507;1360;86;289;250;561;336;850
310130;202209;514;1163;439;1055;23;74;353;800;376;874
310140;202209;389;996;294;863;49;171;158;407;207;578
310150;202209;7550;17161;5753;14120;497;1496;3423;7576;3920;9072
310160;202209;11998;26925;9266;22741;1382;3889;4652;10535;6034;14424
310163;202209;1383;3808;1069;3190;234;781;311;797;545;1578
310170;202209;11772;26188;9573;22918;963;2227;6746;15973;7709;18200
310180;202209;2442;5336;1774;4309;186;523;1159;2660;1345;3183
310190;202209;3219;8565;2609;7537;617;1916;573;1543;1190;3459
310200;202209;2397;6268;1810;5242;331;1115;818;2143;1149;3258
310205;202209;1365;3406;1094;2992;142;412;695;1912;837;2324
310210;202209;2853;7103;2310;6136;127;325;1630;4171;1757;4496
310220;202209;1371;3482;1030;2839;77;235;666;1736;743;1971
310230;202209;2719;6613;2216;5718;244;764;1448;3417;1692;4181
310240;202209;1221;3168;1035;2859;49;168;721;1873;770;2041
310250;202209;1467;3163;1225;2807;34;92;1015;2230;1049;2322
310260;202209;4355;10521;2959;8012;747;2377;1059;2302;1806;4679
310270;202209;3566;7064;2892;6189;91;216;2431;5170;2522;5386
310280;202209;3381;6727;2679;5806;135;369;2038;4115;2173;4484
310285;202209;2187;6230;1800;5546;175;607;1122;3415;1297;4022
310290;202209;1895;4511;1607;4001;175;535;1057;2363;1232;2898
310300;202209;1981;5053;1577;4363;169;587;881;2178;1050;2765
310310;202209;390;854;263;652;43;111;142;333;185;444
310320;202209;579;1367;403;1083;17;65;235;591;252;656
310330;202209;578;1308;340;873;46;129;149;345;195;474
310340;202209;9907;23063;7759;19462;947;2362;4169;10224;5116;12586
310350;202209;16203;36616;11619;29371;1683;4752;6184;14537;7867;19289
310360;202209;704;1430;574;1268;29;73;371;784;400;857
310370;202209;1438;4205;1247;3876;236;813;416;1355;652;2168
310375;202209;1026;2336;714;1883;196;516;240;599;436;1115
310380;202209;445;983;251;684;26;73;135;344;161;417
310390;202209;681;1861;545;1605;94;305;244;647;338;952
310400;202209;14875;33653;11269;28290;782;2409;7654;18028;8436;20437
310410;202209;1234;3375;725;2289;76;266;310;858;386;1124
310420;202209;5985;14402;4473;11772;525;1589;2414;5742;2939;7331
310430;202209;2026;5163;1415;4069;244;727;599;1497;843;2224
310440;202209;765;1851;530;1443;61;191;272;674;333;865
310445;202209;1602;4132;1199;3364;96;246;822;2252;918;2498
310450;202209;5700;12310;4385;10313;241;737;3426;7636;3667;8373
310460;202209;2075;5232;1567;4330;201;617;546;1283;747;1900
310470;202209;4150;8649;3195;7391;440;927;2025;4797;2465;5724
310480;202209;1187;2838;897;2362;112;374;528;1242;640;1616
310490;202209;3572;8783;2849;7603;376;1144;1592;3856;1968;5000
310500;202209;1827;4327;1433;3715;201;568;896;2189;1097;2757
310510;202209;2795;6611;2023;5242;341;962;940;2312;1281;3274
310520;202209;1337;3201;950;2501;140;395;465;1193;605;1588
310530;202209;957;2309;694;1874;110;349;271;598;381;947
310540;202209;3604;9553;2911;8274;512;1586;1359;3540;1871;5126
310550;202209;1530;3420;1098;2717;78;256;704;1563;782;1819
310560;202209;20250;48525;14871;38976;1669;5084;7775;17731;9444;22815
310570;202209;1434;3166;1131;2754;48;160;943;2210;991;2370
310590;202209;5170;12233;4126;10362;251;738;2585;5928;2836;6666
310600;202209;1681;4440;1364;3798;175;535;720;1844;895;2379
310610;202209;579;1508;359;1117;100;335;74;207;174;542
310620;202209;270218;619986;207271;509823;21059;62200;123676;271013;144735;333213
310630;202209;5572;14042;4288;11595;521;1452;2515;6485;3036;7937
310640;202209;1807;4255;1474;3696;124;396;1018;2300;1142;2696
310650;202209;2834;7058;2081;5689;145;476;1302;3347;1447;3823
310660;202209;1753;4020;1437;3594;29;78;1270;3124;1299;3202
310665;202209;1700;3756;1414;3383;29;108;1159;2730;1188;2838
310670;202209;79391;181567;66949;161457;5769;15995;47453;107117;53222;123112
310680;202209;946;1995;781;1764;21;76;656;1410;677;1486
310690;202209;2941;6342;2197;5254;199;491;1482;3307;1681;3798
310700;202209;634;1198;500;1039;9;23;417;831;426;854
310710;202209;7449;19310;5432;16253;1178;4043;978;2591;2156;6634
310720;202209;1368;2834;1082;2468;37;120;822;1790;859;1910
310730;202209;12420;29028;10608;26304;444;1370;8094;19074;8538;20444
310740;202209;8220;20511;6219;16735;753;2433;3091;7324;3844;9757
310750;202209;1604;3455;1231;2933;92;251;763;1646;855;1897
310760;202209;850;1953;613;1591;36;97;411;1024;447;1121
310770;202209;1272;3194;882;2591;127;432;413;1043;540;1475
310780;202209;5096;10632;4152;9357;259;610;3099;6882;3358;7492
310790;202209;2195;6413;1886;5784;422;1486;451;1130;873;2616
310800;202209;2764;7763;2009;6268;470;1658;136;360;606;2018
310810;202209;1756;3792;1457;3334;57;174;1127;2416;1184;2590
310820;202209;1351;3226;837;2388;166;483;229;636;395;1119
310825;202209;3217;8069;2555;7057;56;268;2124;5610;2180;5878
310830;202209;2523;6335;1912;5264;348;1068;925;2297;1273;3365
310840;202209;2655;6680;2001;5583;406;1285;691;1649;1097;2934
310850;202209;1584;3983;1295;3558;39;174;963;2506;1002;2680
310855;202209;3875;9199;3059;7937;203;557;2240;5618;2443;6175
310860;202209;8165;21264;6639;18505;780;1978;4002;11274;4782;13252
310870;202209;1083;2433;855;2117;57;162;623;1481;680;1643
310880;202209;1071;2970;810;2411;92;288;473;1366;565;1654
310890;202209;2649;7117;1745;5328;355;1174;278;710;633;1884
310900;202209;4986;12922;3676;10282;662;2099;1580;3896;2242;5995
310910;202209;2595;5935;1827;4736;270;739;498;1158;768;1897
310920;202209;2273;5327;1722;4531;193;587;1114;2795;1307;3382
310925;202209;1309;2970;1036;2566;51;167;795;1848;846;2015
310930;202209;6585;15551;4647;12550;885;2436;2237;6191;3122;8627
310940;202209;8439;17287;6889;15162;247;681;5555;11725;5802;12406
310945;202209;1609;3750;1254;3177;154;442;757;1772;911;2214
310950;202209;2181;6094;1410;4386;235;842;397;997;632;1839
310960;202209;841;2138;499;1453;78;239;128;344;206;583
310970;202209;1377;3887;969;3047;257;827;183;540;440;1367
310980;202209;395;858;219;563;22;63;114;270;136;333
310990;202209;1794;4302;1459;3754;168;496;900;2112;1068;2608
311000;202209;5097;12666;3847;10672;624;1964;2147;5442;2771;7406
311010;202209;1192;2910;977;2550;220;596;517;1319;737;1915
311020;202209;1390;3277;921;2483;72;225;508;1277;580;1502
311030;202209;2203;5114;1591;4114;365;1092;681;1593;1046;2685
311040;202209;341;985;260;811;69;237;59;164;128;401
311050;202209;3645;8457;2786;7180;409;1215;1440;3434;1849;4649
311060;202209;4206;9841;3141;8001;381;1135;1445;3256;1826;4391
311070;202209;2969;6637;2148;5414;289;913;1138;2566;1427;3479
311080;202209;1374;2795;1095;2385;41;124;863;1755;904;1879
311090;202209;2754;7882;2244;6971;478;1587;730;2196;1208;3783
311100;202209;2887;7616;1861;5636;370;1244;530;1361;900;2605
311110;202209;4517;8939;2440;5898;553;1292;590;1413;1143;2705
311115;202209;1736;3309;1456;2956;39;86;1264;2489;1303;2575
311120;202209;8545;20781;6537;17266;992;2911;2725;6187;3717;9098
311130;202209;2227;5423;1709;4715;148;499;1015;2648;1163;3147
311140;202209;1860;4284;1443;3719;139;409;973;2434;1112;2843
311150;202209;1723;5079;1368;4414;181;664;737;2240;918;2904
311160;202209;4923;12875;3626;10592;634;2135;1557;4150;2191;6285
311170;202209;1091;2602;896;2352;58;176;569;1555;627;1731
311180;202209;1815;3734;1230;2901;181;423;703;1577;884;2000
311190;202209;1016;2698;755;2178;114;362;309;750;423;1112
311200;202209;2660;6595;1983;5339;351;1065;848;1925;1199;2990
311205;202209;1105;2904;899;2536;38;129;598;1573;636;1702
311210;202209;1240;3290;1098;3097;129;325;773;2262;902;2587
311220;202209;1037;2393;900;2157;27;96;698;1528;725;1624
311230;202209;9369;25799;7051;21194;1306;4042;2704;8074;4010;12116
311240;202209;1326;3094;1044;2701;165;499;571;1354;736;1853
311250;202209;1571;4008;1210;3390;227;695;464;1166;691;1861
311260;202209;3180;7280;2088;5462;262;795;1043;2355;1305;3150
311265;202209;1649;3620;1191;2917;44;139;915;2126;959;2265
311270;202209;3602;9625;3102;8851;185;732;2201;5951;2386;6683
311280;202209;1389;3503;811;2393;191;613;188;488;379;1101
311290;202209;2125;5987;1913;5571;112;367;1305;3718;1417;4085
311300;202209;5425;13373;4478;11833;196;649;3646;9375;3842;10024
311310;202209;661;1679;554;1494;41;110;361;927;402;1037
311320;202209;3731;10462;3240;9417;299;1047;1735;4500;2034;5547
311330;202209;7525;16479;5924;14079;551;1427;3345;7849;3896;9276
311340;202209;12958;33063;10276;28479;2241;6642;3409;8808;5650;15450
311350;202209;2797;6312;2026;4980;221;598;1054;2276;1275;2874
311360;202209;1343;3032;957;2504;244;690;405;1056;649;1746
311370;202209;5637;12595;4136;10265;491;1418;2357;5391;2848;6809
311380;202209;469;1353;350;1117;54;182;180;556;234;738
311390;202209;2045;5766;1640;5234;723;2544;391;1079;1114;3623
311400;202209;1928;4846;1384;3844;234;708;437;968;671;1676
311410;202209;2273;6139;1828;5414;263;891;964;2694;1227;3585
311420;202209;1933;5170;1452;4301;298;963;487;1213;785;2176
311430;202209;5450;13275;3661;9898;501;1449;1575;3962;2076;5411
311440;202209;3631;9250;2834;7968;886;2752;617;1587;1503;4339
311450;202209;2782;7585;1788;5518;460;1592;394;955;854;2547
311455;202209;1277;2690;908;2168;102;249;548;1259;650;1508
311460;202209;698;1951;453;1418;85;305;102;248;187;553
311470;202209;592;1696;407;1307;97;349;61;186;158;535
311480;202209;1360;2966;1125;2623;87;203;884;2037;971;2240
311490;202209;319;893;245;749;43;158;108;287;151;445
311500;202209;573;1314;450;1132;40;117;284;672;324;789
311510;202209;4153;9556;2975;7650;323;957;1563;3586;1886;4543
311520;202209;780;1942;676;1753;58;181;430;1086;488;1267
311530;202209;11039;23712;7652;18594;1608;4511;2847;6202;4455;10713
311535;202209;1029;2578;744;2024;121;360;336;853;457;1213
311540;202209;631;1724;549;1582;69;221;392;1103;461;1324
311545;202209;2335;6102;2016;5610;94;300;1572;4311;1666;4611
311547;202209;2117;4187;1860;3835;39;86;1604;3189;1643;3275
311550;202209;3596;8912;2950;7824;425;1278;1361;3241;1786;4519
311560;202209;357;710;218;496;32;81;88;167;120;248
311570;202209;1744;3809;1218;3087;49;136;898;2320;947;2456
311580;202209;2702;4802;1901;3847;172;328;1333;2605;1505;2933
311590;202209;731;1738;610;1569;68;204;400;982;468;1186
311600;202209;1839;4094;1489;3633;180;521;1038;2423;1218;2944
311610;202209;2711;7438;2204;6521;142;492;1444;4081;1586;4573
311615;202209;4291;10085;3465;8783;130;428;2819;6870;2949;7298
311620;202209;681;1698;515;1422;66;200;305;791;371;991
311630;202209;1534;3923;1226;3299;105;298;765;2000;870;2298
311640;202209;919;2244;730;1949;105;309;402;988;507;1297
311650;202209;2247;5086;1808;4433;212;554;1121;2610;1333;3164
311660;202209;3656;9684;2706;7848;413;1357;803;1763;1216;3120
311670;202209;1931;4449;1441;3617;157;453;756;1795;913;2248
311680;202209;2710;6582;2086;5549;166;401;1455;3931;1621;4332
311690;202209;736;1396;539;1153;35;82;385;828;420;910
311700;202209;2428;5339;1863;4533;24;100;1562;3650;1586;3750
311710;202209;1843;4948;1365;4151;343;1139;465;1352;808;2491
311720;202209;504;1393;409;1219;49;164;225;652;274;816
311730;202209;5339;12303;3792;9499;840;2321;1731;3882;2571;6203
311740;202209;1153;2793;943;2496;75;150;734;1988;809;2138
311750;202209;4778;12807;3858;11201;312;1128;2590;6987;2902;8115
311760;202209;848;2172;660;1827;101;354;273;574;374;928
311770;202209;2633;6854;2064;5874;437;1361;826;2120;1263;3481
311780;202209;1752;4565;1301;3758;235;748;486;1229;721;1977
311783;202209;2784;6493;2284;5715;49;199;1888;4497;1937;4696
311787;202209;948;2543;733;2083;119;378;298;700;417;1078
311790;202209;1809;4724;1234;3653;242;836;379;978;621;1814
311800;202209;5935;16394;4683;13783;1014;3067;864;2000;1878;5067
311810;202209;1181;3005;961;2634;57;180;705;1829;762;2009
311820;202209;1135;2425;878;2057;71;184;612;1335;683;1519
311830;202209;10469;27550;7610;21709;2158;6451;1469;3950;3627;10401
311840;202209;4612;10386;3703;9125;278;730;2730;6672;3008;7402
311850;202209;413;973;323;819;12;46;233;550;245;596
311860;202209;88360;199323;70256;169470;7365;20504;45335;101000;52700;121504
311870;202209;2208;5463;1555;4359;261;885;686;1696;947;2581
311880;202209;7534;17671;6269;15922;457;1109;4602;11783;5059;12892
311890;202209;2244;4592;1782;3967;42;155;1441;2993;1483;3148
311900;202209;803;1869;602;1603;103;244;322;884;425;1128
311910;202209;5125;11771;3996;10297;702;1906;2142;5359;2844;7265
311920;202209;2635;5989;2126;5264;108;260;1525;3729;1633;3989
311930;202209;5659;11535;4309;9766;762;2026;2423;4872;3185;6898
311940;202209;18798;45343;13621;35944;1815;5248;6257;15036;8072;20284
311950;202209;2800;6676;2085;5440;181;537;1259;3231;1440;3768
311960;202209;583;1359;455;1163;53;162;224;499;277;661
311970;202209;493;1492;369;1197;76;282;94;248;170;530
311980;202209;539;1348;290;868;31;101;113;306;144;407
311990;202209;619;1396;401;1064;62;210;174;384;236;594
311995;202209;1118;3005;592;1814;38;138;91;178;129;316
312000;202209;960;2042;730;1718;32;85;545;1249;577;1334
312010;202209;1316;3059;1053;2668;61;183;758;1823;819;2006
312015;202209;1539;4008;1353;3713;52;224;1097;2900;1149;3124
312020;202209;2103;5937;1478;4544;269;905;354;926;623;1831
312030;202209;2602;5196;2229;4774;59;165;2042;4302;2101;4467
312040;202209;992;2704;706;2139;110;331;315;895;425;1226
312050;202209;1405;3986;1141;3507;222;853;425;1149;647;2002
312060;202209;1158;2628;737;2050;171;498;303;813;474;1311
312070;202209;1074;2830;752;2167;38;146;473;1249;511;1395
312080;202209;3433;7721;2672;6608;145;412;1840;4177;1985;4589
312083;202209;1304;2738;1018;2324;56;175;824;1776;880;1951
312087;202209;3033;6764;2466;5933;90;223;1998;4759;2088;4982
312090;202209;13766;32436;10896;27953;1154;3559;6592;15546;7746;19105
312100;202209;1975;4936;1533;4208;120;395;959;2427;1079;2822
312110;202209;1164;3362;962;2944;166;616;452;1231;618;1847
312120;202209;1230;3164;853;2498;212;733;282;677;494;1410
312125;202209;2359;5259;2023;4806;97;279;1657;3783;1754;4062
312130;202209;1384;3011;1023;2434;78;236;587;1211;665;1447
312140;202209;875;2372;724;2064;158;486;323;838;481;1324
312150;202209;604;1457;510;1290;34;94;350;815;384;909
312160;202209;11493;27523;8934;23243;935;2885;4874;11488;5809;14373
312170;202209;1042;2449;799;2011;49;147;541;1301;590;1448
312180;202209;1663;4014;1350;3481;151;428;790;1907;941;2335
312190;202209;965;2348;759;1995;64;206;450;1067;514;1273
312200;202209;5679;13835;4441;11899;526;1429;2700;6971;3226;8400
312210;202209;1709;3303;1301;2754;45;124;1072;2176;1117;2300
312220;202209;1982;5447;1691;4935;172;531;1105;3223;1277;3754
312230;202209;22980;53404;16650;42559;3279;9513;5929;12533;9208;22046
312235;202209;2571;5488;2086;4835;142;375;1585;3489;1727;3864
312240;202209;933;2746;717;2309;146;487;219;677;365;1164
312245;202209;3917;7459;3358;6685;34;87;3102;6027;3136;6114
312247;202209;1270;2647;889;2086;113;279;554;1229;667;1508
312250;202209;1076;2683;679;1929;96;295;242;630;338;925
312260;202209;1208;2844;974;2492;56;197;767;1848;823;2045
312270;202209;863;2198;662;1793;31;111;397;955;428;1066
312280;202209;499;1368;399;1192;85;281;139;371;224;652
312290;202209;1113;2938;931;2650;160;513;347;896;507;1409
312300;202209;1306;3631;948;2801;214;708;223;508;437;1216
312310;202209;1182;3219;923;2703;123;440;475;1277;598;1717
312320;202209;2492;5845;1817;4717;391;975;504;1264;895;2239
312330;202209;1082;2822;888;2464;109;340;533;1393;642;1733
312340;202209;291;688;207;559;31;113;117;268;148;381
312350;202209;302;578;216;482;15;38;145;288;160;326
312352;202209;1776;5103;1557;4693;285;912;741;2397;1026;3309
312360;202209;3992;10456;3014;8671;616;1924;1238;3211;1854;5135
312370;202209;2480;5704;2003;4984;220;643;1273;2962;1493;3605
312380;202209;2605;5282;2151;4710;16;43;1874;3970;1890;4013
312385;202209;1509;3701;1173;3128;379;1026;300;841;679;1867
312390;202209;2266;5915;1698;4863;255;814;531;1304;786;2118
312400;202209;3629;9571;3081;8695;964;2917;875;2501;1839;5418
312410;202209;17559;41895;14537;37173;1722;4800;9501;23119;11223;27919
312420;202209;4798;11705;3915;10303;747;2217;1988;4914;2735;7131
312430;202209;10762;23727;8840;20552;270;835;6946;15275;7216;16110
312440;202209;1207;3508;1011;3127;494;1598;192;571;686;2169
312450;202209;1599;4297;1225;3627;313;999;488;1414;801;2413
312460;202209;583;1297;425;1071;26;71;286;700;312;771
312470;202209;544;1280;337;918;50;140;101;233;151;373
312480;202209;1244;2891;905;2396;79;252;510;1250;589;1502
312490;202209;3108;6264;2476;5412;192;459;1602;3306;1794;3765
312500;202209;1272;2745;1072;2481;44;146;841;1882;885;2028
312510;202209;5789;14254;3957;10822;793;2156;1153;2898;1946;5054
312520;202209;434;997;343;859;55;174;220;509;275;683
312530;202209;813;1711;684;1560;33;86;514;1167;547;1253
312540;202209;1842;4636;1258;3539;150;409;705;1890;855;2299
312550;202209;971;2279;718;1822;39;109;464;1066;503;1175
312560;202209;2131;5168;1639;4395;103;318;1169;3074;1272;3392
312570;202209;3161;6748;2372;5766;411;972;1229;3028;1640;4000
312580;202209;753;1902;520;1430;46;155;264;652;310;807
312590;202209;1809;4792;1396;3986;142;481;827;2147;969;2628
312595;202209;2489;6490;2040;5805;287;753;1186;3587;1473;4340
312600;202209;1582;3602;1026;2480;145;436;339;799;484;1235
312610;202209;8489;20270;5799;15426;883;2674;2138;4869;3021;7543
312620;202209;2965;6749;2268;5782;59;241;1866;4680;1925;4921
312630;202209;386;1008;286;830;48;174;130;330;178;504
312640;202209;631;1633;470;1374;58;203;233;615;291;818
312650;202209;2460;5543;1719;4232;53;189;1307;2965;1360;3154
312660;202209;1578;3459;1221;2880;94;231;857;1902;951;2133
312670;202209;7214;15261;6082;13552;134;553;5015;10352;5149;10905
312675;202209;1436;3357;1177;2989;52;158;951;2353;1003;2511
312680;202209;1881;4195;1685;3912;44;167;1516;3400;1560;3567
312690;202209;3507;6736;2650;5675;112;233;2108;4433;2220;4666
312695;202209;1215;2849;1020;2541;38;77;855;2093;893;2170
312700;202209;2422;6075;1761;4913;183;593;982;2563;1165;3156
312705;202209;2004;3778;1765;3457;10;37;1676;3247;1686;3284
312707;202209;1613;4173;1133;3320;50;214;769;2088;819;2302
312710;202209;8823;19174;5732;14485;1440;3604;1818;4708;3258;8312
312720;202209;1301;3127;1010;2676;98;304;680;1683;778;1987
312730;202209;1855;4129;1337;3433;126;339;841;2083;967;2422
312733;202209;1540;3833;1155;3134;49;177;786;1962;835;2139
312735;202209;920;2196;711;1812;54;153;470;1098;524;1251
312737;202209;981;1980;708;1602;66;163;496;1073;562;1236
312738;202209;946;2169;684;1724;62;185;449;1031;511;1216
312740;202209;520;1268;332;958;72;215;88;188;160;403
312750;202209;1737;4551;1263;3691;160;565;608;1611;768;2176
312760;202209;2161;5897;1569;4718;233;732;627;1765;860;2497
312770;202209;54136;122152;35249;90388;5965;17000;14324;33828;20289;50828
312780;202209;3100;7984;2612;7193;307;863;1643;4420;1950;5283
312790;202209;280;636;139;400;5;13;32;55;37;68
312800;202209;6753;16657;5374;14180;565;1825;3232;7809;3797;9634
312810;202209;1932;4867;1274;3779;351;1117;414;1117;765;2234
312820;202209;2062;4996;1658;4316;96;262;1198;3054;1294;3316
312825;202209;1828;3545;1548;3193;38;88;1354;2724;1392;2812
312830;202209;3260;8500;2134;6315;481;1523;669;1766;1150;3289
312840;202209;1737;4148;1350;3518;131;402;744;1789;875;2191
312850;202209;1319;2604;978;2133;21;78;721;1397;742;1475
312860;202209;1263;3047;867;2433;214;641;282;688;496;1329
312870;202209;7082;17921;4548;13162;773;2348;1335;3451;2108;5799
312880;202209;1769;4030;1391;3427;220;481;697;1726;917;2207
312890;202209;2769;6166;2049;5025;129;315;1238;2895;1367;3210
312900;202209;1572;3654;1289;3280;122;367;812;2039;934;2406
312910;202209;1757;3101;1052;2195;153;309;577;1157;730;1466
312920;202209;1107;2793;786;2288;131;450;287;702;418;1152
312930;202209;2879;6403;2118;5292;362;934;1058;2659;1420;3593
312940;202209;1195;2967;950;2623;91;301;534;1367;625;1668
312950;202209;3991;8836;2866;7124;431;1250;1575;3559;2006;4809
312960;202209;2064;4975;1709;4448;104;231;1244;3347;1348;3578
312965;202209;1969;4767;1604;4204;161;398;1048;2753;1209;3151
312970;202209;1862;4768;1505;4225;142;509;915;2366;1057;2875
312980;202209;30897;77897;25011;67524;4559;13112;11683;29360;16242;42472
312990;202209;619;1431;422;1110;71;225;214;498;285;723
313000;202209;556;1464;426;1235;30;126;269;708;299;834
313005;202209;2899;7633;2416;6848;118;360;1772;4844;1890;5204
313010;202209;6910;17030;5572;14893;834;2504;3419;8671;4253;11175
313020;202209;1194;3426;908;2831;155;528;202;541;357;1069
313030;202209;1438;2994;1019;2412;64;189;741;1650;805;1839
313040;202209;1026;2871;852;2543;35;151;548;1543;583;1694
313050;202209;2160;5502;1513;4532;247;849;442;1142;689;1991
313055;202209;2238;5445;1927;4977;556;1585;1066;2604;1622;4189
313060;202209;1251;2842;918;2272;206;605;223;496;429;1101
313065;202209;1989;5072;1749;4683;34;145;1478;3818;1512;3963
313070;202209;1053;2623;819;2235;89;260;427;1089;516;1349
313080;202209;456;1186;336;975;61;211;131;313;192;524
313090;202209;6546;15200;5442;13491;275;775;3918;9423;4193;10198
313100;202209;1579;3763;1252;3297;53;185;922;2322;975;2507
313110;202209;1797;4401;1293;3519;122;394;684;1667;806;2061
313115;202209;3495;8935;2790;7643;289;957;1648;4031;1937;4988
313120;202209;4385;9780;3196;8209;196;517;2208;5651;2404;6168
313130;202209;38950;91794;29656;75531;2925;8580;17648;41366;20573;49946
313140;202209;905;1784;618;1421;38;100;479;1075;517;1175
313150;202209;1642;4354;1191;3551;333;1126;209;514;542;1640
313160;202209;1668;3771;1281;3200;22;75;1005;2388;1027;2463
313170;202209;13693;35846;10286;29518;1685;5298;4081;10375;5766;15673
313180;202209;2980;7074;2246;5618;163;446;1560;3692;1723;4138
313190;202209;5427;14226;4009;11469;709;2210;1605;4089;2314;6299
313200;202209;1375;3230;1163;2866;31;97;964;2284;995;2381
313210;202209;4885;11873;4042;10565;454;1294;2607;6483;3061;7777
313220;202209;2272;5511;1506;4051;192;574;718;1664;910;2238
313230;202209;3361;8283;2722;7474;63;214;2229;6101;2292;6315
313240;202209;13494;30349;9587;24339;965;3058;5604;12849;6569;15907
313250;202209;7381;19908;5668;16340;1033;3121;2650;7145;3683;10266
313260;202209;937;2170;670;1752;76;278;383;848;459;1126
313270;202209;8272;16409;6972;14723;474;967;5718;11986;6192;12953
313280;202209;546;1379;368;1038;47;156;173;451;220;607
313290;202209;1200;3581;928;3080;237;887;322;1005;559;1892
313300;202209;2216;5540;1684;4631;365;1068;588;1445;953;2513
313310;202209;1739;4752;1397;4043;229;771;483;1105;712;1876
313320;202209;2361;5834;1700;4783;352;1068;610;1733;962;2801
313330;202209;4974;11625;3771;9863;264;787;2503;6379;2767;7166
313340;202209;1979;4026;1529;3415;93;255;1147;2428;1240;2683
313350;202209;3543;9047;2405;6627;268;873;1111;2590;1379;3463
313360;202209;2005;4494;1376;3505;220;673;734;1659;954;2332
313370;202209;1919;4835;1494;4038;306;876;601;1445;907;2321
313375;202209;2234;5494;1448;4074;258;844;423;1016;681;1860
313380;202209;8339;19350;6084;15291;894;2634;3141;6811;4035;9445
313390;202209;937;2663;800;2421;52;216;546;1557;598;1773
313400;202209;4461;9859;3435;8384;152;444;2620;6175;2772;6619
313410;202209;1680;3935;1254;3226;358;887;617;1558;975;2445
313420;202209;18737;39705;10621;26594;2531;7014;2515;5641;5046;12655
313430;202209;1457;3375;1224;2961;75;288;920;1997;995;2285
313440;202209;8500;16216;6223;13427;195;508;4947;10281;5142;10789
313450;202209;873;2176;626;1729;104;317;222;503;326;820
313460;202209;2760;7182;2205;6287;395;1247;1048;2879;1443;4126
313470;202209;3348;7667;2685;6714;134;388;2101;5142;2235;5530
313480;202209;1315;3506;826;2476;80;270;342;902;422;1172
313490;202209;3695;8872;2047;5873;372;1183;599;1561;971;2744
313500;202209;664;1598;468;1234;55;139;225;540;280;679
313505;202209;12412;28877;10564;26339;440;1185;8549;20977;8989;22162
313507;202209;1658;3841;1313;3317;47;148;1018;2469;1065;2617
313510;202209;18380;44293;14447;36994;1366;3804;8328;19453;9694;23257
313520;202209;18769;44462;15226;38768;677;2103;11871;28932;12548;31035
313530;202209;691;1935;511;1552;68;248;222;570;290;818
313535;202209;2733;6998;2183;5972;243;623;1329;3571;1572;4194
313540;202209;1014;2696;798;2207;114;357;389;944;503;1301
313545;202209;1329;4000;1117;3605;148;500;568;1776;716;2276
313550;202209;2462;6466;2045;5542;231;662;1364;3604;1595;4266
313560;202209;3635;5929;2758;4904;37;70;2489;4356;2526;4426
313570;202209;1198;3149;965;2745;182;545;463;1223;645;1768
313580;202209;7383;15956;5849;13557;354;1012;4242;9247;4596;10259
313590;202209;1353;3312;1092;2946;220;607;572;1608;792;2215
313600;202209;5389;11540;4590;10373;84;306;4134;9031;4218;9337
313610;202209;1196;2762;979;2395;78;221;647;1460;725;1681
313620;202209;6775;16578;5502;14352;522;1650;3581;8817;4103;10467
313630;202209;10705;24029;7728;19619;760;2297;4790;11518;5550;13815
313640;202209;1575;2998;1070;2357;86;217;779;1674;865;1891
313650;202209;1953;5452;1529;4739;135;450;924;2911;1059;3361
313652;202209;1053;2694;928;2481;62;214;704;1758;766;1972
313655;202209;1417;3106;1112;2729;82;207;830;1997;912;2204
313657;202209;1345;3235;1046;2759;35;136;769;1861;804;1997
313660;202209;1376;3242;1146;2873;67;250;873;2023;940;2273
313665;202209;6809;16126;5434;13747;426;1300;3716;8678;4142;9978
313670;202209;66718;151794;46008;117779;5879;16600;23681;56107;29560;72707
313680;202209;1281;2987;1035;2601;51;127;702;1664;753;1791
313690;202209;1161;3248;846;2627;162;553;233;667;395;1220
313695;202209;2138;5199;1586;4297;113;299;1057;2913;1170;3212
313700;202209;3361;9482;2899;8893;231;739;2315;7129;2546;7868
313710;202209;1734;3635;1246;3006;99;278;833;1953;932;2231
313720;202209;7490;18974;5455;14910;725;2207;2587;6240;3312;8447
313730;202209;1681;3285;1260;2743;86;174;829;1780;915;1954
313740;202209;1947;6579;1631;5818;359;1453;412;1279;771;2732
313750;202209;2764;6486;2225;5622;342;1002;1317;3017;1659;4019
313753;202209;2523;5816;1685;4476;301;899;680;1697;981;2596
313760;202209;7129;18182;5659;15489;847;2621;2865;7061;3712;9682
313770;202209;4788;12406;3802;10877;187;525;2889;8368;3076;8893
313780;202209;4807;11601;3552;9667;483;1287;1209;3296;1692;4583
313790;202209;687;1820;581;1619;68;216;364;950;432;1166
313800;202209;1632;3402;1197;2802;110;301;701;1505;811;1806
313810;202209;2129;4612;1731;4054;63;212;1410;3165;1473;3377
313820;202209;20841;50046;13804;35730;2267;6131;4223;9902;6490;16033
313830;202209;477;1302;351;1040;68;230;146;394;214;624
313835;202209;1139;2863;858;2418;83;286;465;1171;548;1457
313840;202209;9662;23170;7652;20038;1761;4855;2199;5581;3960;10436
313850;202209;1189;2625;945;2289;161;430;504;1110;665;1540
313860;202209;3369;8055;2565;6673;345;989;1312;3074;1657;4063
313862;202209;1419;2937;742;1944;47;134;376;971;423;1105
313865;202209;3140;7315;2593;6474;86;259;2010;4785;2096;5044
313867;202209;1649;4633;1310;3978;259;810;675;2120;934;2930
313868;202209;2008;5475;1619;4771;55;215;1226;3439;1281;3654
313870;202209;1266;3010;851;2274;108;313;381;900;489;1213
313880;202209;2575;6100;1955;5064;229;729;1096;2460;1325;3189
313890;202209;2911;5227;2145;4257;67;149;1682;3219;1749;3368
313900;202209;6259;16239;4417;12602;1087;3330;1336;3252;2423;6582
313910;202209;899;2451;685;2037;134;421;168;486;302;907
313920;202209;3359;9130;2759;7961;473;1427;1443;4118;1916;5545
313925;202209;1996;4538;1557;3792;185;408;979;2330;1164;2738
313930;202209;6039;15076;4839;13083;376;1036;3272;8730;3648;9766
313940;202209;11993;32218;9226;27624;1859;6020;2303;7350;4162;13370
313950;202209;6766;13232;5277;11405;247;605;3930;8278;4177;8883
313960;202209;6969;15456;4701;11747;713;2085;2015;4365;2728;6450
313970;202209;1892;4467;1602;4008;51;142;1104;2606;1155;2748
313980;202209;1721;4161;1214;3402;213;675;551;1428;764;2103
313990;202209;2584;6955;2018;5826;305;1088;1173;2931;1478;4019
314000;202209;12742;29119;10225;24934;699;2082;6721;15833;7420;17915
314010;202209;1634;3569;1283;3090;52;180;974;2227;1026;2407
314015;202209;2756;6831;2193;5875;231;753;1344;3267;1575;4020
314020;202209;602;1515;404;1183;140;495;38;102;178;597
314030;202209;966;2528;738;2099;102;296;329;906;431;1202
314040;202209;751;1912;631;1702;87;282;349;884;436;1166
314050;202209;2372;5659;1766;4596;102;330;1139;2693;1241;3023
314053;202209;2454;6397;1972;5502;293;766;1178;3376;1471;4142
314055;202209;2767;6214;2324;5593;88;233;1898;4567;1986;4800
314060;202209;1540;3722;1148;3101;42;134;820;2154;862;2288
314070;202209;6042;14698;4884;12720;680;1879;2776;6822;3456;8701
314080;202209;2366;5776;1713;4705;146;467;825;2003;971;2470
314085;202209;2847;6880;2274;6051;236;669;1454;3821;1690;4490
314090;202209;6029;14248;5172;13032;449;1138;3420;8793;3869;9931
314100;202209;3558;7992;2728;6844;74;202;2009;5005;2083;5207
314110;202209;5980;15378;4879;13368;543;1662;2705;6718;3248;8380
314120;202209;818;1810;389;1057;75;235;139;331;214;566
314130;202209;811;1958;569;1517;23;87;388;954;411;1041
314140;202209;5577;13681;4428;11650;452;1318;2562;6389;3014;7707
314150;202209;1701;3993;1220;3176;97;281;796;2002;893;2283
314160;202209;2840;6538;2034;5206;209;555;942;2324;1151;2879
314170;202209;1135;2808;898;2357;41;145;628;1494;669;1639
314180;202209;6663;16359;5267;14202;538;1454;2930;7818;3468;9272
314190;202209;746;1701;561;1439;71;228;338;788;409;1016
314200;202209;3516;9009;2900;8010;262;706;1904;5155;2166;5861
314210;202209;2365;5714;1831;4780;297;798;683;1664;980;2462
314220;202209;1988;4964;1587;4344;233;746;759;1874;992;2620
314225;202209;1244;3326;993;2861;110;347;630;1737;740;2084
314230;202209;1052;2503;843;2213;84;244;548;1396;632;1640
314240;202209;1281;3240;1001;2832;218;640;415;1154;633;1794
314250;202209;499;1369;319;972;42;138;131;348;173;486
314260;202209;1336;3163;1058;2793;291;759;434;1088;725;1847
314270;202209;3956;9817;3269;8726;88;284;2514;6532;2602;6816
314280;202209;4272;9271;2970;7392;305;857;1787;4117;2092;4974
314290;202209;5498;12625;4631;11174;242;652;3446;7945;3688;8597
314300;202209;2384;6288;1526;4480;323;1018;492;1253;815;2271
314310;202209;4567;11381;3165;9037;901;2876;450;1099;1351;3975
314315;202209;1178;3300;945;2831;62;227;653;1865;715;2092
314320;202209;3924;9717;2659;7396;419;1375;1119;2765;1538;4140
314330;202209;66053;172506;50772;145847;12000;35244;14235;39916;26235;75160
314340;202209;3132;7353;2093;5550;389;1233;788;1709;1177;2942
314345;202209;1920;4721;1556;4105;117;303;1119;2836;1236;3139
314350;202209;1032;2672;705;2074;132;426;154;319;286;745
314360;202209;632;1724;432;1305;62;196;144;379;206;575
314370;202209;886;2094;715;1837;67;194;485;1177;552;1371
314380;202209;1416;3594;999;2897;218;719;316;853;534;1572
314390;202209;18558;42404;13120;33300;1825;5306;5827;12689;7652;17995
314400;202209;4714;13144;3637;11094;1127;3628;1197;3756;2324;7384
314410;202209;3524;9301;2446;7227;512;1729;562;1551;1074;3280
314420;202209;915;2082;672;1710;26;91;443;1057;469;1148
314430;202209;9612;21016;6918;16806;960;2446;3495;8018;4455;10464
314435;202209;2218;5482;1743;4740;277;780;956;2478;1233;3258
314437;202209;1063;2444;783;2002;69;192;497;1214;566;1406
314440;202209;699;1899;505;1523;135;460;128;309;263;769
314450;202209;1743;4221;1430;3706;188;533;797;1885;985;2418
314460;202209;4062;11258;3085;9323;740;2439;1113;2951;1853;5390
314465;202209;2751;6962;2230;6011;46;182;1747;4471;1793;4653
314467;202209;1159;2721;943;2377;97;275;639;1546;736;1821
314470;202209;2679;7046;2213;6174;373;1128;1068;2774;1441;3902
314480;202209;10095;25740;7706;20948;1115;3383;3540;8478;4655;11861
314490;202209;1266;3017;913;2358;72;209;602;1482;674;1691
314500;202209;2219;4912;1571;4063;401;1036;486;1257;887;2293
314505;202209;2722;5528;2224;4856;147;268;1703;3650;1850;3918
314510;202209;2491;6132;1813;5137;483;1561;696;1821;1179;3382
314520;202209;8398;23253;6677;19947;1425;4554;1664;4462;3089;9016
314530;202209;6591;18007;5860;16735;313;1145;4478;12256;4791;13401
314535;202209;3407;7409;2748;6476;146;392;2205;5097;2351;5489
314537;202209;1444;3667;1094;3107;74;204;748;2055;822;2259
314540;202209;499;1151;362;937;16;47;217;512;233;559
314545;202209;2310;4844;2057;4552;63;165;1730;3863;1793;4028
314550;202209;886;1985;598;1525;43;137;344;768;387;905
314560;202209;5735;15391;4329;12479;556;1945;1981;4865;2537;6810
314570;202209;367;968;264;785;23;77;135;391;158;468
314580;202209;569;1552;452;1322;103;306;161;453;264;759
314585;202209;849;2342;644;1922;56;192;321;883;377;1075
314587;202209;2662;6536;2077;5624;568;1488;1045;2822;1613;4310
314590;202209;5216;12904;4014;10822;471;1461;2061;5057;2532;6518
314600;202209;2210;5727;1437;4310;336;1107;187;484;523;1591
314610;202209;11449;26550;8834;22500;1029;3160;4422;11177;5451;14337
314620;202209;2997;5975;2423;5264;157;274;1929;4257;2086;4531
314625;202209;1899;4357;1613;3967;32;149;1396;3305;1428;3454
314630;202209;6081;13928;4884;12281;185;537;3927;9723;4112;10260
314640;202209;987;1978;772;1654;40;115;582;1145;622;1260
314650;202209;1027;2240;694;1719;61;190;433;952;494;1142
314655;202209;1765;4455;1238;3565;163;455;665;1896;828;2351
314660;202209;413;834;303;659;13;31;229;468;242;499
314670;202209;1938;3965;1350;3165;30;83;963;2149;993;2232
314675;202209;1994;4636;1687;4157;91;235;1322;3178;1413;3413
314690;202209;2420;6145;1848;5282;470;1356;737;2036;1207;3392
314700;202209;13983;35310;9721;27680;1552;4861;4441;11699;5993;16560
314710;202209;10043;26179;7465;20936;1099;3428;3001;7272;4100;10700
314720;202209;2765;7690;1933;5964;367;1232;402;1059;769;2291
314730;202209;2948;7214;2074;5647;373;1129;729;1734;1102;2863
314740;202209;3819;9789;3015;8404;492;1484;1583;4110;2075;5594
314750;202209;355;871;278;720;33;111;166;370;199;481
314760;202209;2174;5994;1403;4299;222;819;421;967;643;1786
314770;202209;1190;3279;695;2121;122;363;186;527;308;890
314780;202209;425;993;298;790;29;98;175;420;204;518
314790;202209;14348;35451;10315;28286;1692;5153;4501;11556;6193;16709
314795;202209;1777;4187;1505;3747;56;188;1188;2805;1244;2993
314800;202209;13866;33343;9342;25312;1569;4650;3392;8007;4961;12657
314810;202209;12575;30386;9534;25381;2365;6680;3683;9114;6048;15794
314820;202209;1531;3399;1200;2910;76;228;780;1782;856;2010
314830;202209;2087;5317;1717;4695;168;461;1054;2724;1222;3185
314840;202209;1058;2920;823;2496;70;273;562;1585;632;1858
314850;202209;3194;5613;2639;4946;30;70;2452;4525;2482;4595
314860;202209;3993;10108;3333;8969;143;520;2474;6364;2617;6884
314870;202209;8367;16601;6461;14318;296;629;4947;11066;5243;11695
314875;202209;2174;5941;1913;5578;207;515;1430;4232;1637;4747
314880;202209;939;2164;722;1829;48;137;456;1103;504;1240
314890;202209;592;1671;436;1333;60;206;206;551;266;757
314900;202209;1050;2383;808;1997;89;260;439;1020;528;1280
314910;202209;2004;5307;1491;4472;266;963;690;1864;956;2827
314915;202209;2499;6658;2029;5853;193;567;1282;3656;1475;4223
314920;202209;685;1557;491;1288;25;73;355;917;380;990
314930;202209;7400;19091;5753;16032;922;2939;2647;6517;3569;9456
314940;202209;496;1073;408;937;25;60;294;640;319;700
314950;202209;786;1807;549;1435;55;194;307;714;362;908
314960;202209;1118;2393;880;2027;67;159;621;1379;688;1538
314970;202209;1307;3616;1010;3038;174;576;444;1206;618;1782
314980;202209;2340;5463;1865;4780;181;529;1297;3227;1478;3756
314990;202209;3208;8684;2326;6771;372;1124;655;1663;1027;2787
314995;202209;1990;5025;1548;4251;56;203;1013;2589;1069;2792
315000;202209;1317;3065;950;2498;89;259;616;1551;705;1810
315010;202209;481;1193;391;1058;36;128;239;601;275;729
315015;202209;2966;7363;2587;6761;241;766;1843;4588;2084;5354
315020;202209;946;2538;674;2003;64;238;335;895;399;1133
315030;202209;786;1884;542;1466;184;475;123;301;307;776
315040;202209;1164;2805;978;2519;162;462;621;1476;783;1938
315050;202209;1381;3292;1025;2756;82;251;538;1377;620;1628
315053;202209;1463;3375;1087;2746;107;302;647;1530;754;1832
315057;202209;2149;5602;1700;4854;142;352;1099;3324;1241;3676
315060;202209;816;2256;593;1810;112;374;161;455;273;829
315070;202209;950;1965;753;1670;82;231;515;998;597;1229
315080;202209;3901;9463;2978;7832;135;420;2179;5409;2314;5829
315090;202209;976;2668;742;2250;100;332;341;945;441;1277
315100;202209;1688;4593;1121;3375;142;504;495;1299;637;1803
315110;202209;2672;5764;1951;4715;165;380;1148;2700;1313;3080
315120;202209;15373;32697;11350;26786;1153;2658;6920;16037;8073;18695
315130;202209;2085;5211;1774;4690;199;601;907;2153;1106;2754
315140;202209;3811;9623;3042;8306;579;1734;1601;4066;2180;5800
315150;202209;5273;12448;3821;10123;591;1795;1819;4596;2410;6391
315160;202209;2333;5189;1628;4100;247;657;896;2159;1143;2816
315170;202209;1658;4963;1166;3787;227;780;344;1059;571;1839
315180;202209;21142;48896;12541;33588;1700;5189;4786;10976;6486;16165
315190;202209;2707;5503;2062;4660;203;445;1537;3478;1740;3923
315200;202209;5503;13827;4152;11626;1136;3504;1471;3663;2607;7167
315210;202209;10612;25575;7533;19543;769;2247;3823;8638;4592;10885
315213;202209;1243;3068;1081;2840;24;95;889;2264;913;2359
315217;202209;3209;8361;2427;7074;100;423;1714;4721;1814;5144
315220;202209;10146;25417;7920;21724;639;1590;4463;12332;5102;13922
315230;202209;3587;7274;2951;6441;188;349;2036;4515;2224;4864
315240;202209;3003;7817;2475;6927;564;1666;1142;3118;1706;4784
315250;202209;17806;44220;13344;36085;2008;6018;6238;15270;8246;21288
315260;202209;1151;2905;676;1961;133;400;91;206;224;606
315270;202209;1140;3008;856;2479;124;423;379;924;503;1347
315280;202209;3720;8768;2471;6596;667;1856;597;1545;1264;3401
315290;202209;1432;3302;907;2492;202;604;362;921;564;1525
315300;202209;798;1810;591;1504;29;84;428;1067;457;1151
315310;202209;1557;3570;1187;2962;80;257;829;1862;909;2119
315320;202209;754;2062;530;1618;74;266;207;584;281;850
315330;202209;878;2621;526;1753;65;244;219;626;284;870
315340;202209;3403;7812;2350;6219;551;1460;929;2396;1480;3856
315350;202209;2221;5119;1864;4590;166;468;1376;3235;1542;3703
315360;202209;2063;5515;1624;4679;214;660;782;2067;996;2727
315370;202209;671;1725;546;1499;83;224;235;601;318;825
315380;202209;297;772;205;582;43;119;27;50;70;169
315390;202209;1495;3872;1217;3392;125;433;713;1763;838;2196
315400;202209;5005;12152;3992;10430;459;1332;2415;5922;2874;7254
315410;202209;2835;5979;2058;4848;370;1022;582;1251;952;2273
315415;202209;1769;4470;1434;3935;381;1240;351;856;732;2096
315420;202209;1796;4683;1278;3753;285;915;356;897;641;1812
315430;202209;4268;9750;2990;7881;488;1445;1477;3708;1965;5153
315440;202209;1234;2911;960;2490;92;275;603;1434;695;1709
315445;202209;2711;5384;2021;4454;107;259;1615;3482;1722;3741
315450;202209;2643;6551;2142;5745;203;570;1436;3690;1639;4260
315460;202209;54987;133976;46491;119637;4604;14345;30728;72686;35332;87031
315470;202209;802;2078;568;1541;50;146;293;718;343;864
315480;202209;1722;4423;1258;3464;186;545;580;1437;766;1982
315490;202209;3424;7951;2395;6325;340;976;975;2350;1315;3326
315500;202209;615;1544;385;1083;28;88;222;551;250;639
315510;202209;1664;3689;1368;3281;11;48;1196;2756;1207;2804
315520;202209;1308;3030;1101;2726;39;114;917;2188;956;2302
315530;202209;922;2091;773;1845;64;200;592;1303;656;1503
315540;202209;1971;4805;1317;3606;125;419;585;1456;710;1875
315550;202209;2149;5470;1482;4252;264;896;484;1355;748;2251
315560;202209;7832;20719;6750;18867;389;1063;4961;13654;5350;14717
315570;202209;2962;6989;2128;5528;284;886;1134;2555;1418;3441
315580;202209;3898;8281;3072;7043;419;1057;1375;2901;1794;3958
315590;202209;1498;2910;1249;2554;43;161;1020;1869;1063;2030
315600;202209;2907;8140;2044;6491;443;1327;890;3024;1333;4351
315610;202209;1157;2693;876;2224;116;388;456;963;572;1351
315620;202209;626;1528;472;1297;42;122;254;690;296;812
315630;202209;1348;3337;1026;2750;146;430;530;1269;676;1699
315640;202209;469;1061;366;933;33;102;238;564;271;666
315645;202209;1162;2829;809;2277;139;414;226;594;365;1008
315650;202209;2114;4385;1710;3833;69;161;1363;2984;1432;3145
315660;202209;2448;5883;1847;4816;188;496;1106;2790;1294;3286
315670;202209;19392;47216;15202;39803;2510;7109;7923;19150;10433;26259
315680;202209;3733;9594;2798;7935;365;1140;1467;3933;1832;5073
315690;202209;4523;10452;2737;7425;544;1423;795;2240;1339;3663
315700;202209;10389;25520;7963;20924;762;2275;4573;10955;5335;13230
315710;202209;2137;4800;1534;3926;68;202;1060;2590;1128;2792
315720;202209;5230;13103;4295;11507;201;790;3085;7742;3286;8532
315725;202209;2733;6315;2152;5438;201;491;1437;3750;1638;4241
315727;202209;722;1692;531;1374;62;195;282;658;344;853
315730;202209;727;2019;613;1798;129;406;233;604;362;1010
315733;202209;1754;4049;1364;3446;203;573;658;1487;861;2060
315737;202209;1387;3475;1017;2778;32;119;724;1864;756;1983
315740;202209;998;2582;811;2214;76;255;539;1353;615;1608
315750;202209;1564;3623;1198;3088;91;241;783;2014;874;2255
315760;202209;1470;2979;1214;2646;28;99;1042;2160;1070;2259
315765;202209;2376;5310;1950;4773;24;88;1758;4273;1782;4361
315770;202209;1470;3772;1183;3375;420;1281;290;801;710;2082
315780;202209;37441;93502;31325;82831;2006;6516;21254;52475;23260;58991
315790;202209;4136;11786;3511;10631;341;1032;2078;6576;2419;7608
315800;202209;1571;4717;1194;3876;158;613;508;1401;666;2014
315810;202209;1638;3572;1370;3155;58;164;1112;2449;1170;2613
315820;202209;3537;7798;2885;6948;265;600;2084;4984;2349;5584
315830;202209;1474;4108;999;3056;107;359;286;710;393;1069
315840;202209;1028;2297;743;1826;40;116;422;929;462;1045
315850;202209;1407;3717;1107;3224;151;480;607;1674;758;2154
315860;202209;662;1690;493;1407;95;294;171;397;266;691
315870;202209;533;1369;423;1196;23;76;302;814;325;890
315880;202209;1350;3088;986;2489;119;368;452;950;571;1318
315890;202209;2149;5508;1756;4976;484;1473;745;2114;1229;3587
315895;202209;7616;19153;5669;15501;616;1942;2832;6974;3448;8916
315900;202209;989;2425;813;2166;114;357;477;1188;591;1545
315910;202209;723;1689;627;1554;53;156;492;1187;545;1343
315920;202209;1664;3965;966;2687;160;564;350;807;510;1371
315930;202209;1364;2786;944;2211;86;219;539;1189;625;1408
315935;202209;1304;3503;1039;3026;207;615;453;1285;660;1900
315940;202209;730;1793;576;1573;86;262;307;773;393;1035
315950;202209;1433;3603;1208;3258;107;333;935;2466;1042;2799
315960;202209;6784;17607;4757;13660;1144;3613;1103;2291;2247;5904
315970;202209;660;1666;531;1492;64;200;362;1022;426;1222
315980;202209;5191;10462;3061;7121;515;1295;1525;3133;2040;4428
315990;202209;4106;9865;3220;8375;373;1030;1777;4352;2150;5382
316000;202209;921;1965;736;1707;58;163;486;1049;544;1212
316010;202209;863;2268;638;1863;73;233;282;681;355;914
316020;202209;1097;2838;877;2434;87;297;552;1416;639;1713
316030;202209;3286;8115;2504;6766;374;1031;1495;4065;1869;5096
316040;202209;3139;8548;2230;6829;400;1405;593;1509;993;2914
316045;202209;2739;5627;2519;5357;164;229;2188;4774;2352;5003
316050;202209;469;1192;364;1018;36;100;222;556;258;656
316060;202209;872;1868;643;1569;31;98;474;1095;505;1193
316070;202209;6951;17371;5651;14990;847;2284;2915;7272;3762;9556
316080;202209;934;2672;739;2280;165;567;194;494;359;1061
316090;202209;590;1467;493;1290;42;141;320;739;362;880
316095;202209;1488;4275;1143;3447;267;873;451;1249;718;2122
316100;202209;2872;7601;2119;6071;325;1079;914;2305;1239;3384
316105;202209;842;2042;667;1762;47;128;438;1172;485;1300
316110;202209;17563;42146;14605;37438;874;2762;10891;26482;11765;29244
316120;202209;1468;3705;948;2630;154;482;355;773;509;1255
316130;202209;1547;3226;1034;2424;79;220;651;1418;730;1638
316140;202209;1277;3214;775;2270;140;423;282;790;422;1213
316150;202209;2632;5453;2097;4684;143;410;1253;2572;1396;2982
316160;202209;1181;2872;937;2454;40;143;685;1725;725;1868
316165;202209;1062;2318;839;2001;80;206;563;1271;643;1477
316170;202209;1638;3409;1281;2909;71;228;961;1987;1032;2215
316180;202209;1882;4913;1331;3889;256;801;370;949;626;1750
316190;202209;3161;8438;1827;5346;230;715;760;1887;990;2602
316200;202209;4405;11156;3507;9672;639;1956;1617;4121;2256;6077
316210;202209;6451;17620;4607;13440;1482;4724;516;1280;1998;6004
316220;202209;834;2354;583;1867;114;381;127;394;241;775
316225;202209;1961;3997;1497;3299;48;184;1192;2373;1240;2557
316230;202209;587;1432;455;1217;99;294;222;566;321;860
316240;202209;6742;17438;5862;15900;451;1301;4313;11389;4764;12690
316245;202209;3817;10648;3441;10058;164;750;2723;7528;2887;8278
316250;202209;13202;29600;9998;24451;1867;4889;4122;9727;5989;14616
316255;202209;3525;9084;3037;8302;148;406;2241;6156;2389;6562
316257;202209;1806;3777;1348;3067;124;267;917;2001;1041;2268
316260;202209;3194;6352;2492;5305;273;538;1587;3334;1860;3872
316265;202209;1314;3264;1033;2793;33;92;754;1957;787;2049
316270;202209;4440;12389;3771;11016;457;1430;2107;5740;2564;7170
316280;202209;3586;8919;3003;7895;371;1058;1744;4378;2115;5436
316290;202209;4761;11746;3694;9794;451;1296;1562;3776;2013;5072
316292;202209;7238;17499;5849;15306;639;1878;3899;9653;4538;11531
316294;202209;1090;3018;836;2595;165;593;258;696;423;1289
316295;202209;4212;10793;3453;9544;259;848;2258;5872;2517;6720
316300;202209;1282;3138;1008;2724;60;172;726;1906;786;2078
316310;202209;940;2376;657;1892;138;458;211;549;349;1007
316320;202209;795;2086;604;1782;114;361;143;363;257;724
316330;202209;1245;2943;957;2468;56;156;726;1826;782;1982
316340;202209;1210;2961;935;2494;76;284;615;1496;691;1780
316350;202209;1656;4039;1405;3629;161;438;985;2442;1146;2880
316360;202209;776;1873;657;1685;65;156;503;1321;568;1477
316370;202209;7046;16431;5457;13807;612;1913;3026;6588;3638;8501
316380;202209;2066;4429;1654;3854;88;191;1220;2782;1308;2973
316390;202209;881;2252;658;1880;256;833;135;320;391;1153
316400;202209;1405;3707;913;2765;106;356;347;906;453;1262
316410;202209;1487;3431;1249;3074;42;138;1055;2491;1097;2629
316420;202209;2313;5675;1957;5169;35;152;1602;4049;1637;4201
316430;202209;1048;2590;725;2040;107;340;296;742;403;1082
316440;202209;1015;2924;818;2577;157;563;236;668;393;1231
316443;202209;679;1753;481;1385;106;352;142;378;248;730
316447;202209;2632;5909;2260;5362;35;97;2011;4661;2046;4758
316450;202209;2506;6727;1884;5515;220;696;1131;3194;1351;3890
316460;202209;1586;3828;1297;3356;123;354;850;2048;973;2402
316470;202209;8786;23062;6624;18881;892;2945;3097;7758;3989;10703
316480;202209;247;597;209;548;35;98;122;298;157;396
316490;202209;396;1039;282;821;53;182;96;232;149;414
316500;202209;1526;4365;1045;3249;198;646;281;764;479;1410
316510;202209;950;2834;769;2483;133;430;381;1217;514;1647
316520;202209;1639;3714;1239;3019;187;524;551;1160;738;1684
316530;202209;1290;3085;962;2524;100;356;509;1167;609;1523
316540;202209;1254;2874;1002;2521;149;433;495;1116;644;1549
316550;202209;1727;4324;1454;3857;48;170;1200;3102;1248;3272
316553;202209;5675;15147;4183;11840;537;1711;1975;4805;2512;6516
316555;202209;3107;8457;2693;7919;78;302;2286;6609;2364;6911
316556;202209;651;1417;487;1140;36;103;299;587;335;690
316557;202209;1443;3975;1240;3662;433;1406;449;1253;882;2659
316560;202209;489;1366;349;1092;53;189;134;379;187;568
316570;202209;1679;4374;1408;3907;344;871;473;1424;817;2295
316580;202209;481;933;333;706;30;67;209;415;239;482
316590;202209;1538;3601;1064;2733;165;386;589;1441;754;1827
316600;202209;1170;3088;1012;2793;140;441;631;1632;771;2073
316610;202209;747;2028;601;1795;61;215;364;1035;425;1250
316620;202209;2676;6103;2338;5607;158;350;1854;4405;2012;4755
316630;202209;1830;5027;1534;4485;408;1147;601;2007;1009;3154
316640;202209;194;494;152;428;30;100;61;142;91;242
316650;202209;1332;3441;1081;3064;73;217;739;2019;812;2236
316660;202209;217;503;104;276;13;39;33;67;46;106
316670;202209;1961;4606;1475;3871;393;1070;485;1157;878;2227
316680;202209;2767;6585;2082;5329;163;471;1443;3560;1606;4031
316690;202209;1624;4341;1198;3561;213;699;326;829;539;1528
316695;202209;1131;3079;915;2698;23;81;611;1738;634;1819
316700;202209;594;1044;511;956;9;21;463;834;472;855
316710;202209;4140;11654;3321;10070;430;1509;1875;5207;2305;6716
316720;202209;25546;64368;19758;53807;2970;8799;9923;24887;12893;33686
316730;202209;636;1392;507;1188;52;134;297;613;349;747
316740;202209;1021;2583;894;2389;123;356;621;1635;744;1991
316750;202209;476;1237;351;1035;62;203;151;397;213;600
316760;202209;4686;13223;3980;11941;1325;4409;1519;4422;2844;8831
316770;202209;1897;3847;1426;3237;43;110;1142;2612;1185;2722
316780;202209;712;1908;581;1679;208;680;134;297;342;977
316790;202209;894;2204;664;1769;94;272;210;528;304;800
316800;202209;7928;20148;6329;17451;784;2358;3300;8644;4084;11002
316805;202209;1407;2583;1149;2292;33;88;991;1919;1024;2007
316810;202209;885;2201;667;1820;86;253;448;1206;534;1459
316820;202209;448;921;274;646;17;60;178;371;195;431
316830;202209;1050;2480;820;2116;90;237;516;1301;606;1538
316840;202209;3570;8048;2891;7002;160;492;2272;5218;2432;5710
316850;202209;2684;6017;2053;4993;181;534;1319;2901;1500;3435
316860;202209;27288;61966;20852;52428;2660;7920;11347;26463;14007;34383
316870;202209;10487;25569;7957;20960;931;2832;4329;10168;5260;13000
316880;202209;1304;3099;1102;2826;118;379;711;1670;829;2049
316890;202209;1377;2971;865;2296;104;337;549;1369;653;1706
316900;202209;3078;7462;2451;6355;410;1145;1116;2577;1526;3722
316905;202209;569;1583;459;1374;192;573;126;402;318;975
316910;202209;1212;2921;841;2306;220;654;230;579;450;1233
316920;202209;2326;4912;1750;4079;193;558;1197;2524;1390;3082
316930;202209;11226;28896;8889;24971;1750;5475;3794;9455;5544;14930
316935;202209;5223;12718;3917;10359;645;1888;1858;4431;2503;6319
316940;202209;7557;20398;5938;17255;910;2906;2720;7139;3630;10045
316950;202209;2387;4888;1856;4187;59;131;1584;3511;1643;3642
316960;202209;6382;12930;4693;10737;382;961;3356;7428;3738;8389
316970;202209;4940;12225;4170;10951;540;1532;2109;5043;2649;6575
316980;202209;990;2568;764;2218;225;738;275;731;500;1469
316990;202209;15686;38522;11880;31323;2709;7600;2828;6470;5537;14070
317000;202209;3089;7826;2699;7311;216;470;2059;5673;2275;6143
317005;202209;3107;7945;2434;6648;348;1044;1335;3442;1683;4486
317010;202209;33610;74540;23418;59241;3750;10372;12201;29539;15951;39911
317020;202209;87049;195667;55533;142224;10288;28735;20850;47748;31138;76483
317030;202209;799;1960;638;1735;16;60;479;1271;495;1331
317040;202209;13824;32619;9581;25574;2269;6536;2926;7865;5195;14401
317043;202209;1084;2165;795;1785;40;101;624;1362;664;1463
317047;202209;1355;2954;947;2319;54;160;681;1583;735;1743
317050;202209;1440;4207;1034;3283;155;568;399;1033;554;1601
317052;202209;3030;7168;2422;6244;193;553;1711;4212;1904;4765
317057;202209;2653;5090;2058;4242;35;105;1667;3202;1702;3307
317060;202209;589;1519;358;1049;45;148;141;358;186;506
317065;202209;1295;3520;1052;3043;77;269;656;1727;733;1996
317070;202209;9351;24677;7314;20869;1122;3640;3304;8561;4426;12201
317075;202209;1297;3004;997;2523;123;326;596;1394;719;1720
317080;202209;7952;17167;6073;14215;1135;2835;3029;6766;4164;9601
317090;202209;5602;14542;4905;13456;285;781;3696;10029;3981;10810
317100;202209;3138;7023;2128;5410;414;1110;946;2239;1360;3349
317103;202209;2955;6347;2528;5753;126;402;2084;4496;2210;4898
317107;202209;1815;4171;1363;3353;50;167;923;1942;973;2109
317110;202209;804;1784;451;1232;72;236;178;457;250;693
317115;202209;1310;3478;1075;3047;159;440;627;1774;786;2214
317120;202209;22836;54434;18903;48260;1201;3868;13043;30859;14244;34727
317130;202209;13735;30068;9557;23316;1308;3495;3849;9104;5157;12599
317140;202209;1129;2480;881;2100;62;149;636;1491;698;1640
317150;202209;1244;2624;971;2273;33;109;830;1860;863;1969
317160;202209;4100;9209;2689;6971;285;668;1354;3729;1639;4397
317170;202209;2432;5577;1880;4615;92;290;1286;2819;1378;3109
317180;202209;2220;6436;1628;5079;326;1072;413;1175;739;2247
317190;202209;1310;3326;977;2774;197;595;444;1167;641;1762
317200;202209;7581;18727;5649;15054;1178;3304;1477;3482;2655;6786
317210;202209;1483;3187;1156;2758;43;148;831;1947;874;2095
317220;202209;381;1008;326;913;57;175;192;498;249;673
320010;202209;5674;15606;4330;12880;605;1970;2302;6556;2907;8526
320013;202209;2522;6341;1794;4990;293;861;839;2354;1132;3215
320016;202209;3419;8181;2627;6960;201;551;1793;4673;1994;5224
320020;202209;5740;13372;4419;11140;643;1888;2315;5499;2958;7387
320030;202209;2090;5431;1370;4001;200;630;594;1593;794;2223
320035;202209;2345;5719;1936;5070;340;1019;1119;2796;1459;3815
320040;202209;5377;13969;4485;12404;615;1816;2499;6524;3114;8340
320050;202209;2285;4721;1980;4284;204;577;1343;2641;1547;3218
320060;202209;17406;44055;13058;35661;2181;6433;6048;15051;8229;21484
320070;202209;2405;5696;1826;4637;211;703;1091;2396;1302;3099
320080;202209;6775;16127;4773;12311;822;2293;2056;4801;2878;7094
320090;202209;10124;25367;6825;18887;1413;4267;2559;6349;3972;10616
320100;202209;4073;9746;3312;8465;442;1230;1980;4849;2422;6079
320110;202209;2841;5924;2084;4793;232;633;1321;2740;1553;3373
320115;202209;2610;7543;2246;6964;711;2276;935;3031;1646;5307
320120;202209;31898;74712;23176;59694;2992;8506;11989;28221;14981;36727
320130;202209;68956;168507;56942;147964;6864;19431;35131;86477;41995;105908
320140;202209;4897;12247;3546;9658;468;1509;1814;4492;2282;6001
320150;202209;17936;43104;12981;34307;3045;9080;2319;4929;5364;14009
320160;202209;7817;19836;5814;16271;736;2296;2939;7812;3675;10108
320170;202209;2199;5787;1556;4560;395;1162;553;1693;948;2855
320180;202209;888;2601;699;2224;230;813;181;520;411;1333
320190;202209;3695;10807;2773;8841;595;2144;606;1688;1201;3832
320200;202209;1590;4076;1080;3158;216;695;306;872;522;1567
320210;202209;5694;13243;4395;11071;669;1841;2452;5728;3121;7569
320220;202209;4341;10185;3313;8534;639;1699;1534;3714;2173;5413
320225;202209;1792;5113;1237;3881;373;1291;283;859;656;2150
320230;202209;6750;16617;5121;13936;1152;3323;1542;4279;2694;7602
320240;202209;21389;50396;16083;42178;3992;11398;5078;12607;9070;24005
320245;202209;3937;10835;2858;8526;808;2575;446;1215;1254;3790
320250;202209;3447;8354;2343;5997;403;1113;1050;2341;1453;3454
320255;202209;2495;6892;2171;6333;409;1261;1321;3849;1730;5110
320260;202209;1740;4595;1118;3309;257;799;296;729;553;1528
320265;202209;2802;8159;2163;6866;861;2968;311;932;1172;3900
320270;202209;2714;7134;2070;5908;523;1691;671;1831;1194;3522
320280;202209;10237;24050;8424;21154;1086;3201;5442;12690;6528;15891
320290;202209;1586;4467;1031;3210;263;904;282;807;545;1711
320300;202209;5348;14428;4295;12442;1123;3599;1514;4161;2637;7760
320305;202209;6464;16598;4902;13731;883;2775;2327;6084;3210;8859
320310;202209;2633;6638;1861;5077;318;958;853;2083;1171;3041
320313;202209;3043;6971;2088;5279;405;1134;757;1603;1162;2737
320316;202209;1901;5013;1468;4296;230;680;801;2336;1031;3016
320320;202209;27073;66586;19684;54249;4554;13189;7143;19214;11697;32403
320330;202209;3521;8712;2749;7410;427;1186;1575;4220;2002;5406
320332;202209;10545;25483;8477;21914;1590;4478;4450;10884;6040;15362
320334;202209;2318;6060;1605;4669;303;1038;416;924;719;1962
320335;202209;2144;5794;1462;4283;285;982;477;1246;762;2228
320340;202209;6849;14626;5761;13101;433;1139;4001;8826;4434;9965
320350;202209;6533;14554;4626;11318;452;1292;2638;5855;3090;7147
320360;202209;1688;4043;1210;3166;138;383;601;1454;739;1837
320370;202209;3420;9440;2647;7850;734;2412;958;2627;1692;5039
320380;202209;3686;8324;3082;7350;258;801;2174;4751;2432;5552
320390;202209;9673;23522;7114;18628;1422;3992;2976;7179;4398;11171
320400;202209;4006;10557;2976;8425;778;2406;1133;2962;1911;5368
320405;202209;6524;15336;4944;12707;692;1867;2736;6667;3428;8534
320410;202209;5858;14136;4438;11903;764;2053;2187;5884;2951;7937
320420;202209;4866;11196;3755;9491;802;2159;1461;3476;2263;5635
320425;202209;2652;5758;2027;4763;160;398;1381;3066;1541;3464
320430;202209;3834;9010;3048;7689;426;1136;1862;4499;2288;5635
320435;202209;2861;8217;2257;6984;652;2190;835;2633;1487;4823
320440;202209;1849;4742;1382;3868;236;724;608;1531;844;2255
320450;202209;2578;6391;2087;5532;314;1045;1190;2792;1504;3837
320455;202209;5275;15105;3615;11371;842;2973;885;2384;1727;5357
320460;202209;2560;7153;1868;5761;516;1767;517;1442;1033;3209
320465;202209;1884;4898;1364;3913;298;922;602;1709;900;2631
320470;202209;4998;12327;3737;9890;711;2139;1378;3168;2089;5307
320480;202209;2884;6417;2345;5535;281;656;1572;3584;1853;4240
320490;202209;31316;72747;23620;59991;4249;10929;10841;27036;15090;37965
320495;202209;1723;4359;1251;3452;279;897;261;566;540;1463
320500;202209;80093;191837;64839;166423;7484;21794;40579;96957;48063;118751
320501;202209;6077;16132;4587;13511;1317;4282;1245;3532;2562;7814
320503;202209;3069;8191;2069;6175;577;1888;551;1496;1128;3384
320506;202209;3323;9244;2488;7489;722;2384;461;1174;1183;3558
320510;202209;14921;35976;12112;31310;1499;4124;7171;17702;8670;21826
320515;202209;2170;5628;1627;4505;458;1383;518;1344;976;2727
320517;202209;2616;7170;2097;6125;598;1887;785;2193;1383;4080
320520;202209;55712;130670;43379;110427;6387;18043;21379;50794;27766;68837
320530;202209;43934;103817;35165;89141;2629;8211;23506;54690;26135;62901
330010;202209;34019;77210;28569;68703;2202;6085;21418;49137;23620;55222
330015;202209;2090;4427;1651;3773;216;615;1071;2234;1287;2849
330020;202209;26045;58648;22005;52954;2237;6069;16265;37859;18502;43928
330022;202209;2466;6160;1906;5255;360;1035;855;2299;1215;3334
330023;202209;8647;18539;6877;15912;947;2416;4480;9845;5427;12261
330025;202209;9621;19957;6539;15068;1136;2843;2855;5969;3991;8812
330030;202209;14385;33328;11316;28554;756;2484;8009;18620;8765;21104
330040;202209;22988;52610;19229;46649;895;2821;14772;33560;15667;36381
330045;202209;138704;268151;119196;244183;5401;12321;102590;204808;107991;217129
330050;202209;4232;9695;3412;8431;526;1579;2089;4573;2615;6152
330060;202209;7519;17234;5849;14444;1074;3067;2515;5587;3589;8654
330070;202209;38617;83530;32524;75197;3855;9654;22209;49976;26064;59630
330080;202209;13646;28724;11622;25971;1341;3149;8063;17726;9404;20875
330090;202209;4388;8225;3233;6693;244;450;2272;4753;2516;5203
330093;202209;3723;7862;2918;6817;137;390;2410;5447;2547;5837
330095;202209;1842;4581;1442;3878;156;465;862;2149;1018;2614
330100;202209;97025;220028;84691;202841;3553;10633;69097;160338;72650;170971
330110;202209;3010;7205;2462;6342;263;805;1657;3961;1920;4766
330115;202209;3613;7836;2623;6320;433;1140;1480;3286;1913;4426
330120;202209;4676;8965;3647;7705;167;444;2946;5894;3113;6338
330130;202209;6514;15609;5387;13964;713;1932;3523;8874;4236;10806
330140;202209;5454;11447;4545;10254;199;627;3784;8123;3983;8750
330150;202209;3296;7662;2649;6654;421;1162;1567;3695;1988;4857
330160;202209;1998;4744;1572;4047;303;867;881;2038;1184;2905
330170;202209;200180;400695;171195;363112;19274;42473;127665;265017;146939;307490
330180;202209;2774;5679;2266;4994;102;302;1815;3792;1917;4094
330185;202209;15811;31977;13552;29046;445;1312;11814;24351;12259;25663
330187;202209;7335;15779;5839;13462;718;1881;3890;8325;4608;10206
330190;202209;61718;122236;53932;111869;2282;5688;45673;91595;47955;97283
330200;202209;24525;53047;20444;47996;2693;6407;14642;34008;17335;40415
330205;202209;2860;6420;2185;5350;146;431;1516;3439;1662;3870
330210;202209;4225;9350;3200;7724;388;1021;1886;4163;2274;5184
330220;202209;18822;41006;14184;33619;2157;5802;7271;15420;9428;21222
330225;202209;5541;12459;4329;10680;292;851;3092;7338;3384;8189
330227;202209;25327;52422;21985;48445;531;1510;19789;42484;20320;43994
330230;202209;2394;5080;1625;4041;142;382;793;1939;935;2321
330240;202209;35375;79411;30208;71780;2388;6582;22844;51863;25232;58445
330245;202209;2139;4894;1342;3527;254;708;601;1412;855;2120
330250;202209;59730;128320;50958;116078;5897;14408;36508;80908;42405;95316
330260;202209;7283;15381;5761;13415;277;797;4660;10441;4937;11238
330270;202209;43188;93313;27833;68482;3590;9852;14134;32101;17724;41953
330280;202209;3658;7945;2910;6779;169;503;2112;4496;2281;4999
330285;202209;39078;78095;32391;68888;1280;3554;27114;54892;28394;58446
330290;202209;6141;12232;5077;10866;287;855;4144;8298;4431;9153
330300;202209;7887;16139;5882;13379;403;1055;4407;9499;4810;10554
330310;202209;3635;7668;2766;6328;147;377;2073;4511;2220;4888
330320;202209;23836;49206;18961;43193;2034;4165;14220;32133;16254;36298
330330;202209;66589;129968;54580;114328;3757;8781;43015;86686;46772;95467
330340;202209;25076;53769;19035;44837;2447;6924;11130;23661;13577;30585
330350;202209;223354;432722;190871;394154;7459;17085;167966;339478;175425;356563
330360;202209;10235;21135;8893;19525;301;688;7821;16883;8122;17571
330370;202209;7316;17869;5889;15569;1013;3012;3204;7935;4217;10947
330380;202209;9238;20642;7485;17709;593;1778;5426;11914;6019;13692
330385;202209;5594;13624;4593;12198;741;2224;2563;6412;3304;8636
330390;202209;45284;102640;35352;86273;3435;10288;23990;53653;27425;63941
330395;202209;4553;9696;3781;8736;142;451;3054;6721;3196;7172
330400;202209;4762;11016;4010;9840;180;612;3130;7119;3310;7731
330410;202209;4471;10033;3367;8256;432;1345;2213;4879;2645;6224
330411;202209;3673;9067;2947;7823;172;581;2076;5136;2248;5717
330412;202209;2237;5414;1842;4793;134;433;1303;3141;1437;3574
330414;202209;33246;73221;27726;65871;1694;4585;21827;50327;23521;54912
330415;202209;6048;14824;4498;12179;424;1274;2669;6860;3093;8134
330420;202209;16820;38085;12647;31487;1271;3736;7703;17503;8974;21239
330430;202209;15105;29225;13036;26568;299;893;11374;22242;11673;23135
330440;202209;3838;8850;2996;7470;306;967;2090;4781;2396;5748
330450;202209;1935;4740;1554;4121;125;381;1012;2498;1137;2879
330452;202209;25657;57465;21142;50906;1845;5350;15567;35461;17412;40811
330455;202209;912310;1836371;759125;1627898;74980;173145;560952;1162483;635932;1335628
330460;202209;1609;3875;1251;3362;210;586;678;1768;888;2354
330470;202209;7718;16674;5738;13783;1263;3355;2415;5448;3678;8803
330475;202209;12763;28531;10429;25562;1316;3750;7110;16712;8426;20462
330480;202209;7483;17338;6358;15733;483;1297;4590;10814;5073;12111
330490;202209;156037;319270;129632;284646;10945;25684;98537;210414;109482;236098
330500;202209;11088;23893;9427;21714;559;1478;7461;16667;8020;18145
330510;202209;62854;135485;49990;118049;4952;12868;36586;83113;41538;95981
330513;202209;1701;3873;1374;3435;194;522;818;2020;1012;2542
330515;202209;3852;8884;3194;7994;360;1085;2094;4918;2454;6003
330520;202209;18737;41946;15900;37821;1326;3747;11577;26115;12903;29862
330530;202209;2169;4784;1576;3916;289;778;758;1830;1047;2608
330540;202209;3993;9395;3099;7929;681;1854;1439;3502;2120;5356
330550;202209;17930;37520;14114;32352;2045;5247;9107;19769;11152;25016
330555;202209;28709;50831;24506;45931;884;1872;21190;39238;22074;41110
330560;202209;5161;11926;4186;10411;552;1462;2787;6601;3339;8063
330570;202209;4062;9329;3568;8638;478;1358;2546;5927;3024;7285
330575;202209;8621;18548;7540;16773;306;875;6387;13437;6693;14312
330580;202209;30095;68202;25157;59901;3646;9117;15309;33902;18955;43019
330590;202209;2099;4701;1761;4279;223;529;1187;2906;1410;3435
330600;202209;17381;39318;14457;34815;824;2491;10556;23825;11380;26316
330610;202209;13383;30237;11100;26770;964;2686;7826;17844;8790;20530
330615;202209;2851;6663;2350;6006;394;901;1545;4064;1939;4965
330620;202209;5685;14143;4603;12386;788;2356;2475;6219;3263;8575
330630;202209;40306;86974;31685;73724;1332;4163;24420;53288;25752;57451
350010;202209;2735;6784;1680;4661;323;966;450;967;773;1933
350020;202209;867;2112;537;1494;73;220;195;476;268;696
350030;202209;4450;11367;3476;9743;682;2166;1805;4662;2487;6828
350040;202209;935;2492;567;1741;81;298;186;440;267;738
350050;202209;1809;4150;1252;3239;203;622;477;968;680;1590
350055;202209;1179;2695;940;2332;138;374;541;1200;679;1574
350060;202209;364;827;201;499;28;82;94;210;122;292
350070;202209;4410;10711;3045;8320;463;1408;1358;3239;1821;4647
350075;202209;822;2162;614;1787;204;596;127;378;331;974
350080;202209;805;1998;546;1522;52;166;276;668;328;834
350090;202209;794;1639;513;1208;69;197;311;653;380;850
350100;202209;3209;7562;2344;6159;130;460;1590;3808;1720;4268
350110;202209;607;1363;461;1120;18;56;327;745;345;801
350115;202209;1465;3994;1200;3472;193;623;617;1616;810;2239
350120;202209;783;1754;463;1214;40;132;259;612;299;744
350130;202209;4184;10141;3327;8620;438;1293;1899;4363;2337;5656
350140;202209;877;2261;629;1807;42;150;369;961;411;1111
350150;202209;569;1621;459;1410;89;306;153;391;242;697
350160;202209;15422;36809;11010;28721;1469;4237;6560;15826;8029;20063
350170;202209;3284;8412;2759;7331;386;1135;1549;3744;1935;4879
350180;202209;1223;2787;745;1952;100;275;389;938;489;1213
350190;202209;4422;11618;3232;8967;432;1469;1763;4122;2195;5591
350200;202209;641;1514;500;1267;31;95;347;800;378;895
350210;202209;8020;17037;5730;13501;448;1318;3976;8634;4424;9952
350220;202209;3809;9754;2754;7742;503;1513;1168;2920;1671;4433
350230;202209;1345;3138;1080;2780;162;479;609;1483;771;1962
350240;202209;745;1984;467;1350;84;244;133;332;217;576
350250;202209;4395;11069;3349;9392;866;2526;1102;2974;1968;5500
350260;202209;1062;2288;678;1655;76;203;411;920;487;1123
350270;202209;5528;13447;4423;11440;561;1644;2639;6255;3200;7899
350275;202209;3481;8418;2893;7566;233;779;2139;5243;2372;6022
350280;202209;23356;50545;15382;37914;2185;5816;7865;17802;10050;23618
350290;202209;4253;10849;3113;8623;492;1544;1496;3705;1988;5249
350300;202209;854;2028;652;1664;78;224;417;971;495;1195
350310;202209;1160;3004;895;2513;111;361;428;1073;539;1434
350315;202209;748;1707;535;1381;28;102;329;731;357;833
350320;202209;20630;49692;15865;41462;2643;7716;7805;18403;10448;26119
350330;202209;17730;40264;13310;32358;1165;3278;8992;20273;10157;23551
350335;202209;438;1164;323;941;36;113;146;405;182;518
350340;202209;1650;3999;1026;2849;147;464;476;1163;623;1627
350350;202209;894;2067;703;1860;109;295;421;1112;530;1407
350360;202209;1408;3765;1129;3221;197;605;521;1402;718;2007
350370;202209;869;1982;629;1545;189;445;229;524;418;969
350380;202209;5990;15453;4357;12079;1011;2925;1543;3947;2554;6872
350390;202209;14018;33648;11072;28864;1406;3953;6720;16305;8126;20258
350395;202209;522;1261;263;772;31;95;94;242;125;337
350400;202209;10554;24577;7540;19611;1914;5313;2338;5775;4252;11088
350410;202209;13594;35201;10252;28996;1910;5929;4454;11514;6364;17443
350420;202209;1385;3308;970;2546;178;473;335;730;513;1203
350430;202209;803;1909;621;1628;83;250;358;838;441;1088
350440;202209;2676;5950;2182;5228;113;341;1562;3474;1675;3815
350450;202209;8728;22309;6894;19197;1348;4240;3300;8330;4648;12570
350460;202209;2644;6393;1675;4580;242;699;787;1917;1029;2616
350470;202209;309;707;246;610;10;28;184;431;194;459
350480;202209;1170;2790;780;2103;174;530;200;469;374;999
350490;202209;2438;5710;1773;4677;300;883;831;1893;1131;2776
350500;202209;767;1918;551;1552;72;217;224;584;296;801
350510;202209;1460;3412;1119;2830;96;280;717;1671;813;1951
350520;202209;2902;8002;2319;6951;330;1118;1110;2984;1440;4102
350530;202209;3795;8978;2905;7330;233;692;1815;4162;2048;4854
350535;202209;1877;4586;1572;4153;231;681;996;2511;1227;3192
350540;202209;2511;5051;1930;4245;191;500;1420;2877;1611;3377
350550;202209;11214;25757;7957;20428;756;2356;4903;11371;5659;13727
350560;202209;5489;13085;4583;11666;238;799;3507;8381;3745;9180
350570;202209;37869;95328;31151;83331;4759;14064;17117;42724;21876;56788
350580;202209;2693;6633;1748;4838;473;1494;544;1154;1017;2648
350590;202209;6132;15434;4603;12208;550;1641;2826;6876;3376;8517
350600;202209;41202;91954;26611;67380;3893;11227;12805;29185;16698;40412
350610;202209;9022;22569;6636;18054;787;2498;3787;9376;4574;11874
350620;202209;490;1199;321;931;34;112;185;494;219;606
350630;202209;2035;4480;1525;3659;94;292;1112;2423;1206;2715
350635;202209;13384;29454;10329;24831;1099;2967;7091;16088;8190;19055
350640;202209;1106;2833;615;1785;103;307;189;456;292;763
350650;202209;10763;27008;7802;21376;1288;3918;3493;8649;4781;12567
350660;202209;6177;14438;4851;12371;535;1376;3106;7665;3641;9041
350670;202209;2251;5613;1733;4770;256;735;947;2552;1203;3287
350680;202209;1370;3431;939;2646;149;437;409;1057;558;1494
350690;202209;1771;4272;1293;3449;220;635;684;1742;904;2377
350700;202209;6155;14273;4764;12174;867;2592;2683;6248;3550;8840
350710;202209;3712;9095;3131;8142;552;1673;1728;4086;2280;5759
350715;202209;905;2426;764;2189;154;530;379;920;533;1450
350720;202209;198;467;145;387;23;73;48;98;71;171
350730;202209;759;2053;575;1684;51;172;325;838;376;1010
350740;202209;2082;5062;1422;3764;222;652;546;1252;768;1904
350745;202209;743;1799;434;1213;38;127;215;545;253;672
350750;202209;13833;33549;11036;28905;1779;5459;5710;13404;7489;18863
350760;202209;21800;48563;16696;40231;2211;6483;10042;21274;12253;27757
350770;202209;1294;2955;826;2182;78;228;500;1226;578;1454
350775;202209;864;1855;582;1438;80;199;318;737;398;936
350780;202209;2930;6613;2171;5582;563;1290;919;2615;1482;3905
350790;202209;2635;6664;1711;4970;364;1076;493;1191;857;2267
350800;202209;4526;11645;3863;10560;274;884;2722;7040;2996;7924
350810;202209;3594;8007;2696;6685;538;1382;1296;3043;1834;4425
350820;202209;1143;2530;704;1756;68;201;407;927;475;1128
350830;202209;1043;2628;605;1719;104;325;209;466;313;791
350840;202209;4416;12058;3424;10254;633;2113;1573;4280;2206;6393
350850;202209;10187;25708;8048;22015;1253;3796;4569;11566;5822;15362
350860;202209;4715;11195;4100;10373;216;670;3123;7697;3339;8367
350870;202209;3392;8514;2481;7085;401;1170;1252;3457;1653;4627
350880;202209;1902;4802;1561;4163;397;1100;605;1437;1002;2537
350890;202209;607;1518;402;1104;57;158;144;343;201;501
350900;202209;11615;28407;8482;22249;1248;3729;4707;10976;5955;14705
350910;202209;1186;2551;997;2280;76;194;784;1743;860;1937
350920;202209;15680;35767;13300;32075;474;1485;10958;25193;11432;26678
350925;202209;5264;12980;3882;10659;661;2021;2033;4997;2694;7018
350930;202209;1798;4453;1241;3399;94;285;703;1849;797;2134
350940;202209;3262;7577;2632;6599;220;659;1894;4398;2114;5057
350945;202209;1135;2889;856;2370;143;397;398;1006;541;1403
350950;202209;119910;283878;93755;236718;11011;30598;59338;140424;70349;171022
350960;202209;8312;20936;6480;17506;932;2799;3559;8947;4491;11746
350970;202209;4735;12229;3517;9994;931;2974;1144;2591;2075;5565
350980;202209;932;2196;777;1934;122;342;471;1075;593;1417
350990;202209;2569;6243;1974;5302;462;1402;830;2048;1292;3450
350995;202209;1067;2995;965;2799;81;295;658;1783;739;2078
351000;202209;3784;9426;2502;6926;558;1628;813;2108;1371;3736
351010;202209;474;1122;295;801;47;154;139;352;186;506
351015;202209;1209;3338;993;2904;188;603;430;1086;618;1689
351020;202209;10505;25910;8007;21610;1508;4388;4147;10326;5655;14714
351030;202209;3842;10254;3087;8794;479;1558;1702;4543;2181;6101
351040;202209;6968;15242;5869;13618;235;679;4884;10832;5119;11511
351050;202209;22020;50252;16881;42601;2686;7346;9460;22605;12146;29951
351060;202209;61367;142914;47480;119906;3989;11558;33173;79497;37162;91055
351070;202209;1838;4246;1076;2990;288;846;215;510;503;1356
351080;202209;3557;7924;2705;6898;307;909;1802;4314;2109;5223
351090;202209;407;1042;309;869;57;170;115;303;172;473
351100;202209;3537;8802;2299;6355;460;1399;822;2104;1282;3503
351110;202209;7227;17750;5219;14174;803;2495;2802;7057;3605;9552
351120;202209;900;2178;621;1688;115;340;218;515;333;855
351130;202209;1345;3499;639;1915;113;380;162;419;275;799
351140;202209;2814;7233;2139;6015;454;1426;959;2372;1413;3798
351150;202209;3745;9689;2670;7547;393;1286;1134;2779;1527;4065
351160;202209;1509;4344;1111;3478;230;780;274;719;504;1499
351170;202209;1900;4665;1635;4190;130;405;1167;2762;1297;3167
351190;202209;1209;3161;833;2411;195;569;264;725;459;1294
351200;202209;1988;4519;1483;3776;129;368;1023;2429;1152;2797
351210;202209;1857;4238;1238;3175;83;282;753;1728;836;2010
351220;202209;4679;11238;4032;10225;399;1001;2818;6901;3217;7902
351230;202209;2750;6564;2144;5555;369;1065;1061;2439;1430;3504
351240;202209;2879;7059;1834;4980;480;1322;503;1207;983;2529
351250;202209;1254;3199;753;2165;89;272;284;767;373;1039
351260;202209;1044;2434;739;1904;156;397;287;678;443;1075
351270;202209;654;1674;453;1277;46;148;222;510;268;658
351280;202209;4841;12031;3714;9992;777;2177;1572;3900;2349;6077
351290;202209;1852;4121;1243;3100;115;325;867;2055;982;2380
351300;202209;26482;65834;19488;53160;3413;10168;9659;24330;13072;34498
351310;202209;4537;10227;3546;8659;152;526;2710;6193;2862;6719
351320;202209;988;2714;694;2146;120;397;195;520;315;917
351330;202209;564;1324;440;1081;19;62;318;695;337;757
351340;202209;9776;22790;8249;20214;1383;3958;5122;11240;6505;15198
351350;202209;15784;36522;13087;32178;864;2523;10126;23585;10990;26108
351360;202209;5020;11851;4113;10542;742;2197;2192;5037;2934;7234
351370;202209;2518;6590;1705;4980;415;1303;457;1110;872;2413
351380;202209;57654;129444;41935;103484;4357;11895;26895;62525;31252;74420
351385;202209;486;1198;213;615;34;100;88;226;122;326
351390;202209;1728;3865;1189;3113;72;224;929;2343;1001;2567
351400;202209;1394;3528;1118;2997;157;409;634;1629;791;2038
351410;202209;3243;8316;2433;6837;408;1238;1096;2862;1504;4100
351420;202209;610;1377;373;978;45;113;236;568;281;681
351430;202209;1251;2975;1027;2621;53;157;801;1958;854;2115
351440;202209;4279;10551;2893;7865;564;1624;875;2008;1439;3632
351450;202209;2108;5230;1483;4141;305;1008;403;856;708;1864
351460;202209;1223;2947;1003;2610;123;351;660;1640;783;1991
351470;202209;1512;3553;1186;3022;75;236;801;1902;876;2138
351480;202209;3046;7964;2432;6993;381;1302;1264;3232;1645;4534
351490;202209;2746;6962;2373;6319;72;285;1931;4922;2003;5207
351492;202209;434;1052;368;924;8;26;287;693;295;719
351495;202209;272;663;219;570;25;56;126;310;151;366
351500;202209;54373;119595;42550;101057;5350;13859;28377;63347;33727;77206
351510;202209;16983;37485;12778;30683;1374;3715;8476;19215;9850;22930
351512;202209;573;1441;407;1093;81;221;133;325;214;546
351515;202209;4074;8887;2613;6478;512;1318;668;1717;1180;3035
351518;202209;2868;6951;1894;5236;292;903;831;1952;1123;2855
351519;202209;741;1955;469;1428;103;339;101;257;204;596
351520;202209;1494;3531;715;2035;77;262;363;913;440;1175
351530;202209;415;1034;256;728;47;128;109;266;156;394
351535;202209;2038;4753;1448;3738;226;621;683;1651;909;2272
351540;202209;3280;7505;2259;5784;226;699;1193;2659;1419;3358
351550;202209;9182;21375;6463;16635;653;1908;3711;8700;4364;10608
351560;202209;619;1676;496;1443;109;349;170;459;279;808
351565;202209;310;813;247;706;43;150;89;205;132;355
351570;202209;27869;67882;21928;56811;1865;5488;14802;36126;16667;41614
351580;202209;266;663;158;469;20;58;72;214;92;272
351590;202209;551;1216;290;762;24;72;162;387;186;459
351600;202209;1627;4115;1247;3391;203;577;613;1503;816;2080
351610;202209;835;1858;529;1333;54;151;289;662;343;813
351620;202209;29470;73307;21950;61049;3193;10387;10808;27219;14001;37606
351630;202209;35896;84818;29247;74190;2502;7511;20952;50014;23454;57525
351640;202209;24818;57475;20044;49563;1220;3742;14914;34584;16134;38326
351650;202209;456;1202;220;661;41;130;55;143;96;273
351660;202209;761;2043;517;1531;92;293;141;348;233;641
351670;202209;7521;18992;5034;13727;1076;2874;2124;5250;3200;8124
351680;202209;502;1307;342;984;72;209;105;251;177;460
351685;202209;553;1448;435;1259;88;260;187;480;275;740
351690;202209;1428;3462;847;2367;91;300;390;982;481;1282
351700;202209;1626;3767;1195;3046;208;604;651;1494;859;2098
351710;202209;951;2283;727;1897;58;175;435;1006;493;1181
351720;202209;1893;4542;1342;3617;243;651;631;1578;874;2229
351730;202209;1256;2929;1036;2591;68;203;668;1513;736;1716
351740;202209;4131;9709;3375;8377;449;1251;1976;4472;2425;5723
351750;202209;2065;5036;1288;3655;180;545;620;1630;800;2175
351760;202209;4067;10375;3114;8590;546;1755;1535;3745;2081;5500
351770;202209;2559;6346;2116;5560;517;1298;1134;2869;1651;4167
351780;202209;1381;3329;817;2283;107;337;352;899;459;1236
351790;202209;1891;4124;1474;3552;233;545;905;2113;1138;2658
351800;202209;572;1252;293;754;39;109;117;251;156;360
351810;202209;1374;3325;1133;2973;228;653;578;1394;806;2047
351820;202209;3708;9300;2768;7545;631;1844;971;2372;1602;4216
351830;202209;6146;14505;4742;12213;397;1222;3180;7576;3577;8798
351840;202209;11384;28724;8891;24355;973;3036;5485;13759;6458;16795
351850;202209;1829;4780;1206;3545;207;689;417;966;624;1655
351860;202209;3315;8805;2567;7493;436;1432;1443;4034;1879;5466
351870;202209;32437;76561;25160;64878;5298;14202;11841;29869;17139;44071
351880;202209;204214;461601;160988;391282;23406;66881;101096;224922;124502;291803
351885;202209;1250;2935;1014;2576;53;189;745;1767;798;1956
351890;202209;1021;2511;662;1920;129;421;161;387;290;808
351900;202209;1517;3760;1161;3235;103;277;751;2040;854;2317
351905;202209;711;1866;533;1520;64;205;255;615;319;820
351907;202209;28040;68091;22184;58053;2285;6843;14681;36021;16966;42864
351910;202209;2033;4831;1476;3749;122;359;896;1996;1018;2355
351920;202209;1062;2634;819;2190;115;341;351;833;466;1174
351925;202209;1215;2971;957;2535;96;315;557;1352;653;1667
351930;202209;4994;11681;4524;10885;436;1229;3623;8379;4059;9608
351940;202209;1350;3264;977;2615;162;480;433;1136;595;1616
351950;202209;2036;4083;1565;3443;75;215;1161;2398;1236;2613
351960;202209;6559;15427;4956;12739;1229;3268;2075;4889;3304;8157
351970;202209;12539;30778;10413;27366;1273;4088;6942;16835;8215;20923
351980;202209;1303;2931;868;2238;116;357;478;1114;594;1471
351990;202209;1745;3859;1288;3208;55;183;701;1540;756;1723
352000;202209;3358;8538;2902;7646;261;824;2024;4929;2285;5753
352010;202209;2917;7088;2373;6247;692;1856;687;1808;1379;3664
352020;202209;2054;4959;1649;4270;243;734;971;2263;1214;2997
352030;202209;7534;17622;6093;15367;704;2127;4055;9560;4759;11687
352040;202209;5345;12663;3877;9981;642;1825;1508;3429;2150;5254
352042;202209;4406;9784;3094;7777;368;1067;1953;4712;2321;5779
352044;202209;2534;6319;1541;4460;249;829;394;911;643;1740
352050;202209;17198;43038;11769;32587;3095;9201;2815;6402;5910;15603
352060;202209;919;2284;697;1899;123;364;321;795;444;1159
352070;202209;1155;2273;775;1765;44;119;471;965;515;1084
352080;202209;554;1362;345;965;46;114;112;284;158;398
352090;202209;1901;5155;1578;4568;181;605;806;2086;987;2691
352100;202209;4640;12055;3637;10163;618;1996;1701;4418;2319;6414
352110;202209;866;2283;645;1863;126;373;262;670;388;1043
352115;202209;660;1684;550;1529;125;400;278;695;403;1095
352120;202209;1056;2751;834;2322;78;226;525;1348;603;1574
352130;202209;2355;6217;1525;4254;216;629;698;1766;914;2395
352140;202209;1544;3919;1119;3059;220;600;463;1244;683;1844
352150;202209;1052;2571;770;2096;89;276;496;1270;585;1546
352160;202209;1166;2675;844;2151;93;267;435;1040;528;1307
352170;202209;3681;9188;2876;7641;412;1273;1531;3671;1943;4944
352180;202209;3269;8300;2525;7005;509;1513;1044;2663;1553;4176
352190;202209;1966;4538;1577;3958;276;727;864;2130;1140;2857
352200;202209;394;1148;288;938;42;142;114;355;156;497
352210;202209;28010;58287;22346;50723;1211;3204;17897;39204;19108;42408
352215;202209;763;1864;587;1561;95;271;316;801;411;1072
352220;202209;33773;74046;25735;60956;3479;9426;15967;34198;19446;43624
352230;202209;19468;50950;15406;43703;3760;11760;6121;15408;9881;27168
352240;202209;13168;31182;10270;26556;1819;5255;5454;12733;7273;17988
352250;202209;29787;77105;24637;68688;2907;8949;16646;44647;19553;53596
352260;202209;6271;14755;4467;11292;626;1846;2635;5873;3261;7719
352265;202209;1046;2782;917;2596;146;448;526;1424;672;1872
352270;202209;2435;6445;1923;5416;364;1145;807;2015;1171;3160
352280;202209;2926;6674;2238;5675;288;820;1292;3013;1580;3833
352290;202209;1838;4800;1472;4095;183;553;785;1944;968;2497
352300;202209;1163;2813;768;2047;77;234;421;1032;498;1266
352310;202209;49646;122981;38279;104533;6315;18204;22173;58780;28488;76984
352320;202209;8701;20128;6856;16926;841;2468;4253;9211;5094;11679
352330;202209;3249;7409;2576;6478;290;930;1716;3947;2006;4877
352340;202209;8919;21977;6831;18232;1080;3209;3649;8796;4729;12005
352350;202209;3007;7584;2412;6374;134;432;1756;4407;1890;4839
352360;202209;1834;4393;1471;3760;112;328;1048;2519;1160;2847
352370;202209;1289;3351;1094;3038;37;118;846;2277;883;2395
352380;202209;1121;2730;842;2264;174;485;322;787;496;1272
352390;202209;18711;43367;13142;33740;2019;5835;7559;17775;9578;23610
352400;202209;4373;11603;3440;9813;857;2655;1278;3263;2135;5918
352410;202209;4557;10576;3585;9008;388;1037;2265;5359;2653;6396
352420;202209;1023;2438;696;1908;145;438;238;582;383;1020
352430;202209;10989;24223;8290;19818;1124;2993;4768;10578;5892;13571
352440;202209;24057;60776;18474;50396;4115;11811;7138;18471;11253;30282
352450;202209;960;2244;537;1508;80;236;217;530;297;766
352460;202209;3679;9252;2639;7461;492;1510;1170;3043;1662;4553
352470;202209;3859;9459;3025;8118;253;809;1984;4897;2237;5706
352480;202209;5307;11827;3616;8962;458;1369;1918;4170;2376;5539
352490;202209;1025;2659;808;2282;163;492;356;942;519;1434
352500;202209;13561;32894;9475;25599;3488;10981;2043;3444;5531;14425
352510;202209;5241;13031;4128;11116;478;1476;2672;6717;3150;8193
352520;202209;3590;8807;2775;7442;438;1352;1593;3809;2031;5161
352530;202209;14508;34576;10303;26991;2016;5957;3905;8488;5921;14445
352540;202209;663;1775;490;1435;74;224;222;583;296;807
352550;202209;1160;2966;792;2316;150;522;306;769;456;1291
352560;202209;795;1962;658;1721;49;170;463;1110;512;1280
352570;202209;2592;6798;1728;5116;399;1353;246;422;645;1775
352580;202209;888;2057;736;1807;116;301;447;1038;563;1339
352585;202209;442;1153;317;931;34;126;170;447;204;573
352590;202209;16348;40711;12043;32891;2272;6983;6564;16374;8836;23357
352600;202209;2487;6076;2025;5284;192;571;1362;3275;1554;3846
352610;202209;3397;8467;2585;7148;417;1374;1288;3250;1705;4624
352620;202209;7385;16715;5692;14356;1288;3352;2762;6765;4050;10117
352630;202209;1033;2377;777;2027;135;390;389;946;524;1336
352640;202209;3950;9338;2904;7486;288;796;1781;4257;2069;5053
352650;202209;701;1859;479;1398;76;229;195;531;271;760
352660;202209;1314;3544;1105;3138;105;375;732;1891;837;2266
352670;202209;13422;32606;9762;25744;1666;4910;4814;11268;6480;16178
352680;202209;3960;10780;2915;8483;542;1861;1421;3422;1963;5283
352690;202209;32715;77243;25970;66402;1139;3681;19270;46669;20409;50350
352700;202209;910;2169;685;1822;117;329;323;814;440;1143
352710;202209;6844;16365;5034;13210;1197;3544;2203;5172;3400;8716
352720;202209;12364;28904;10067;24929;1706;4679;5535;12595;7241;17274
352725;202209;644;1430;372;971;20;58;223;528;243;586
352730;202209;5784;16417;5183;15077;659;2148;2533;6236;3192;8384
352740;202209;2903;6578;2210;5556;246;705;1274;3001;1520;3706
352750;202209;499;1189;331;904;41;125;161;381;202;506
352760;202209;2019;5151;1604;4402;184;508;903;2345;1087;2853
352770;202209;1110;2754;796;2189;112;331;408;1032;520;1363
352780;202209;782;2060;550;1585;122;335;169;469;291;804
352790;202209;500;1221;374;977;47;123;168;385;215;508
352800;202209;1651;4590;1165;3532;264;839;221;502;485;1341
352810;202209;1494;3386;991;2516;158;395;539;1309;697;1704
352820;202209;531;1419;395;1187;87;269;102;268;189;537
352830;202209;677;1632;341;965;26;76;121;285;147;361
352840;202209;4908;12828;4016;11276;943;2894;1819;4839;2762;7733
352850;202209;15826;34734;11749;28414;2279;6175;6126;13296;8405;19471
352860;202209;1398;3601;1047;2981;184;577;414;1076;598;1653
352870;202209;1027;2487;707;1850;72;217;443;1086;515;1303
352880;202209;2026;4621;1435;3587;226;590;596;1343;822;1933
352885;202209;425;1066;329;899;47;148;204;523;251;671
352890;202209;848;1877;600;1394;41;121;416;843;457;964
352900;202209;23663;57430;16325;43533;2691;7483;6976;17120;9667;24603
352910;202209;445;1116;248;718;18;49;105;265;123;314
352920;202209;3426;8105;2657;6838;129;407;1940;4702;2069;5109
352930;202209;7127;17620;5508;14476;877;2702;2726;6226;3603;8928
352940;202209;32790;80555;25981;67286;3812;10920;15601;37575;19413;48495
352950;202209;645;1628;410;1197;83;275;106;256;189;531
352960;202209;899;2246;527;1476;70;218;175;365;245;583
352965;202209;311;823;218;650;49;152;62;165;111;317
352970;202209;4627;9003;3784;7753;123;323;3224;6282;3347;6605
352980;202209;1696;3943;1321;3417;301;825;738;1831;1039;2656
352990;202209;5549;13255;4240;11146;689;2024;2362;5891;3051;7915
353000;202209;556;1426;324;926;46;162;120;284;166;446
353010;202209;3182;7427;2237;5715;414;1182;1057;2430;1471;3612
353020;202209;4054;9845;2509;6815;385;1184;983;2400;1368;3584
353030;202209;5866;13955;4041;10893;982;2818;1198;2990;2180;5808
353040;202209;885;1852;649;1504;79;208;421;883;500;1091
353050;202209;6363;16791;4573;13247;764;2447;2376;6419;3140;8866
353060;202209;61944;144504;51392;128219;3049;9463;39608;93859;42657;103322
353070;202209;13481;34970;10036;27793;1598;4966;4927;12131;6525;17097
353080;202209;6160;15352;4313;11868;857;2673;1812;4201;2669;6874
353090;202209;735;2009;599;1754;47;155;386;1079;433;1234
353100;202209;358;875;157;457;36;116;46;99;82;215
353110;202209;9823;23366;7932;20739;1866;4806;3912;10674;5778;15480
353120;202209;583;1392;448;1163;58;201;243;539;301;740
353130;202209;3607;8001;2452;6048;596;1601;1049;2240;1645;3841
353140;202209;3666;8170;2800;6800;257;768;1905;4314;2162;5082
353150;202209;1844;4355;1352;3573;270;786;615;1510;885;2296
353160;202209;772;1884;547;1514;73;237;265;643;338;880
353170;202209;718;1719;562;1501;91;248;300;770;391;1018
353180;202209;11669;27438;9295;23466;2130;5854;4515;10542;6645;16396
353190;202209;4219;10512;3298;8743;382;1168;1976;4784;2358;5952
353200;202209;2101;5365;1325;3857;191;636;492;1242;683;1878
353205;202209;574;1554;481;1350;44;146;278;712;322;858
353210;202209;1153;2318;762;1694;26;72;585;1218;611;1290
353215;202209;485;1191;387;1033;48;153;174;404;222;557
353220;202209;916;2389;629;1812;125;342;182;457;307;799
353230;202209;943;2481;730;2140;176;599;224;578;400;1177
353240;202209;3003;7371;2509;6605;336;1024;1543;3807;1879;4831
353250;202209;1643;3458;1126;2653;156;382;641;1463;797;1845
353260;202209;1413;3110;818;2153;134;397;372;879;506;1276
353270;202209;937;2208;783;1954;88;268;510;1167;598;1435
353280;202209;851;2126;619;1754;136;405;224;609;360;1014
353282;202209;2110;5495;1757;4879;149;489;1132;2923;1281;3412
353284;202209;455;1046;264;692;24;80;121;270;145;350
353286;202209;204;489;124;358;27;81;35;78;62;159
353290;202209;1653;4134;999;2833;172;466;290;761;462;1227
353300;202209;2616;6518;1931;5230;316;968;905;2080;1221;3048
353310;202209;491;1122;369;924;32;104;234;523;266;627
353320;202209;847;2041;705;1832;35;119;497;1208;532;1327
353325;202209;932;2470;673;1935;112;321;293;780;405;1101
353330;202209;776;1826;516;1367;71;212;272;638;343;850
353340;202209;4102;10432;3191;8727;514;1642;1736;4281;2250;5923
353350;202209;5128;11859;3797;9505;896;2317;1229;2753;2125;5070
353360;202209;828;2186;677;1903;75;262;412;1072;487;1334
353370;202209;713;1887;584;1679;43;136;387;1075;430;1211
353380;202209;373;989;301;864;37;134;163;407;200;541
353390;202209;7841;18337;5898;15195;491;1470;3691;8841;4182;10311
353400;202209;670;1657;515;1390;93;284;214;451;307;735
353410;202209;638;1554;471;1251;106;299;243;599;349;898
353420;202209;573;1388;383;1016;65;175;87;184;152;359
353430;202209;2884;7338;2294;6282;425;1216;1114;2844;1539;4060
353440;202209;90163;223436;68412;181593;9004;26962;41623;101600;50627;128562
353450;202209;472;1111;332;883;43;148;172;389;215;537
353460;202209;4083;10281;3058;8437;624;1923;762;1740;1386;3663
353470;202209;11263;27434;8370;22179;1348;4022;3984;9385;5332;13407
353475;202209;2029;4721;1400;3570;138;418;813;1853;951;2271
353480;202209;1984;4722;1627;4176;95;311;1198;2888;1293;3199
353490;202209;1278;3151;935;2537;133;377;444;1096;577;1473
353500;202209;1412;3191;1036;2600;229;624;550;1281;779;1905
353510;202209;1190;3177;874;2490;175;530;326;778;501;1308
353520;202209;1307;3184;847;2368;99;301;385;935;484;1236
353530;202209;3107;7432;2510;6393;292;859;1508;3487;1800;4346
353540;202209;2534;6351;2050;5625;311;946;1210;3178;1521;4124
353550;202209;7630;17560;6204;15332;877;2342;3883;8972;4760;11314
353560;202209;2786;6937;2172;6040;608;1797;757;1896;1365;3693
353570;202209;785;1961;513;1451;84;268;210;517;294;785
353580;202209;2910;7039;2290;5902;423;1090;1259;3078;1682;4168
353590;202209;901;2114;666;1739;87;232;384;953;471;1185
353600;202209;1893;4542;1439;3750;187;527;757;1891;944;2418
353610;202209;914;2477;680;2014;105;333;322;884;427;1217
353620;202209;3620;8694;2618;7074;555;1576;909;2164;1464;3740
353625;202209;741;1715;441;1181;56;179;240;586;296;765
353630;202209;1897;5196;1613;4671;238;761;891;2345;1129;3106
353640;202209;1680;4006;1300;3383;182;477;823;2043;1005;2520
353650;202209;8990;22801;6973;19237;875;2688;3978;10136;4853;12824
353657;202209;429;1071;326;916;32;105;158;405;190;510
353660;202209;1645;3208;1175;2579;154;373;794;1659;948;2032
353670;202209;5343;13533;4207;11447;766;2411;2100;5093;2866;7504
353680;202209;881;2119;655;1803;88;269;403;1034;491;1303
353690;202209;531;1370;242;721;26;78;64;164;90;242
353700;202209;2600;6207;2126;5461;181;506;1486;3673;1667;4179
353710;202209;6110;13277;3826;9194;530;1314;2088;4330;2618;5644
353715;202209;516;1320;298;863;23;74;134;346;157;420
353720;202209;2469;6010;1908;5135;343;1012;950;2460;1293;3472
353730;202209;5793;14071;4571;11998;534;1714;2869;6870;3403;8584
353740;202209;2484;6093;1792;4914;353;1048;746;1853;1099;2901
353750;202209;1119;3156;843;2656;196;634;247;729;443;1363
353760;202209;18265;37173;14289;32049;2535;6049;8364;18140;10899;24189
353770;202209;764;2028;444;1353;64;226;68;163;132;389
353780;202209;8134;19584;6735;17169;1048;3038;4078;9688;5126;12726
353790;202209;3511;9731;2630;7957;615;2075;638;1580;1253;3655
353800;202209;22765;55329;18378;48545;2652;7189;10847;27642;13499;34831
353810;202209;1390;3452;993;2670;163;468;441;1112;604;1580
353820;202209;2194;5458;1511;4179;370;1071;425;1026;795;2097
353830;202209;759;1752;572;1469;85;253;297;683;382;936
353850;202209;1953;4899;1510;4118;274;769;676;1721;950;2490
353860;202209;3310;8289;2548;7061;584;1895;1229;2948;1813;4843
353870;202209;36015;88042;26181;69790;3510;10380;13795;32914;17305;43294
353880;202209;3788;9598;3034;8214;219;735;1963;4905;2182;5640
353890;202209;3887;7607;2756;5941;166;473;1980;3803;2146;4276
353900;202209;849;2254;638;1862;86;290;270;702;356;992
353910;202209;3740;8995;3191;8170;231;679;2375;5887;2606;6566
353920;202209;2523;6383;1847;5177;507;1558;446;946;953;2504
353930;202209;6479;15720;4664;12341;851;2469;2138;4969;2989;7438
353940;202209;1554;4205;1130;3376;160;521;464;1227;624;1748
353950;202209;4289;10569;3346;8899;823;2391;1312;3149;2135;5540
353960;202209;942;2309;663;1817;168;432;175;454;343;886
353970;202209;790;1719;611;1461;54;161;455;1018;509;1179
353980;202209;20397;47044;15914;39754;770;2400;12077;28423;12847;30823
353990;202209;1095;2494;744;1917;145;396;372;890;517;1286
354000;202209;3131;7156;1865;4819;395;1071;563;1264;958;2335
354010;202209;405;1003;300;831;50;163;173;450;223;613
354020;202209;4736;11628;3821;9900;700;2014;1968;4536;2668;6550
354025;202209;879;2263;588;1701;79;258;189;484;268;742
354030;202209;612;1283;343;854;65;160;150;350;215;510
354040;202209;964;2069;647;1595;34;107;479;1099;513;1206
354050;202209;1246;3309;883;2686;162;576;376;1070;538;1646
354060;202209;4765;12353;3537;9798;565;1806;1789;4313;2354;6119
354070;202209;5055;12041;3491;9055;552;1631;1717;3858;2269;5489
354075;202209;3521;9029;2863;7921;422;1297;1758;4512;2180;5809
354080;202209;1704;4471;1192;3508;201;628;484;1264;685;1892
354085;202209;515;959;400;816;0;0;305;572;305;572
354090;202209;2123;5400;1819;4789;101;288;1424;3593;1525;3881
354100;202209;28299;70554;20772;57976;4021;12176;10190;26675;14211;38851
354105;202209;1615;3833;1182;3099;154;497;610;1424;764;1921
354110;202209;554;1463;425;1226;82;263;177;476;259;739
354120;202209;1688;4296;1179;3237;235;702;411;946;646;1648
354130;202209;7174;17530;4978;13379;1383;3853;941;2058;2324;5911
354140;202209;23371;55100;16988;43540;2432;6989;8869;20275;11301;27264
354150;202209;3406;7682;2672;6571;680;1709;895;2165;1575;3874
354160;202209;3362;8912;2692;7689;623;1939;1122;2912;1745;4851
354165;202209;868;2349;683;1995;87;316;399;1049;486;1365
354170;202209;2401;6135;1976;5386;186;596;1133;2793;1319;3389
354180;202209;530;1385;416;1157;40;126;240;613;280;739
354190;202209;1860;4952;1350;3898;99;345;719;1919;818;2264
354200;202209;1132;2566;863;2137;72;212;567;1282;639;1494
354210;202209;1269;3056;1020;2667;60;198;721;1734;781;1932
354220;202209;3790;9366;2881;7702;485;1407;1479;3672;1964;5079
354230;202209;961;2195;781;1979;33;109;597;1442;630;1551
354240;202209;2138;5618;1459;4232;261;814;532;1330;793;2144
354250;202209;758;1779;506;1363;110;288;177;433;287;721
354260;202209;10947;25542;8587;21665;1211;3396;4784;11232;5995;14628
354270;202209;1233;3348;1008;2934;156;491;473;1227;629;1718
354280;202209;1032;2296;859;2034;46;143;648;1388;694;1531
354290;202209;1145;3351;945;2941;150;499;517;1551;667;2050
354300;202209;4326;11613;3647;10393;874;2499;1740;4776;2614;7275
354310;202209;927;2502;789;2262;159;496;415;1109;574;1605
354320;202209;1157;2629;768;2011;96;289;385;863;481;1152
354323;202209;569;1271;363;908;38;100;187;408;225;508
354325;202209;1686;4784;1076;3337;207;655;196;538;403;1193
354330;202209;12239;28494;8805;21927;945;2745;5592;12675;6537;15420
354340;202209;45295;106255;33067;85835;4146;12132;19994;48796;24140;60928
354350;202209;1433;3360;1149;2912;143;447;721;1641;864;2088
354360;202209;766;1761;483;1317;113;327;157;376;270;703
354370;202209;1205;3163;985;2812;151;451;594;1626;745;2077
354380;202209;761;1934;582;1664;88;326;213;484;301;810
354390;202209;18552;41789;12910;32194;1946;5352;7013;15965;8959;21317
354400;202209;1996;5875;1566;4936;280;942;577;1733;857;2675
354410;202209;8532;20186;6725;16964;996;2842;3905;9001;4901;11843
354420;202209;1807;4343;1304;3436;164;495;727;1703;891;2198
354425;202209;3515;7899;2595;6357;509;1294;1317;3049;1826;4343
354430;202209;1997;4775;1587;4164;113;339;1059;2608;1172;2947
354440;202209;728;1752;477;1269;52;155;258;604;310;759
354450;202209;580;1472;327;977;50;157;107;259;157;416
354460;202209;986;2387;675;1849;146;447;255;636;401;1083
354470;202209;504;1226;346;936;21;76;153;346;174;422
354480;202209;1624;3476;1089;2624;81;238;732;1618;813;1856
354490;202209;993;2705;739;2166;146;433;349;927;495;1360
354500;202209;2713;6995;2174;6136;620;1840;720;1903;1340;3743
354510;202209;933;2406;739;2052;59;196;454;1128;513;1324
354515;202209;515;1387;359;1069;57;182;128;353;185;535
354520;202209;9351;23715;6836;18574;882;2804;3931;9674;4813;12478
354530;202209;6230;15721;4939;13343;1320;3495;1747;4600;3067;8095
354540;202209;1601;3929;1196;3235;219;630;520;1311;739;1941
354550;202209;694;1801;557;1556;77;252;295;743;372;995
354560;202209;2668;6051;1481;3874;155;424;877;2082;1032;2506
354570;202209;1362;3316;590;1647;131;363;85;228;216;591
354580;202209;10483;26545;7267;20481;1063;3350;3858;10075;4921;13425
354600;202209;2539;6183;1979;5180;297;788;1170;2899;1467;3687
354610;202209;551;1387;313;905;32;97;148;404;180;501
354620;202209;591;1527;370;1111;39;143;172;443;211;586
354625;202209;367;950;226;683;32;112;65;159;97;271
354630;202209;2949;7796;2452;6882;714;2062;714;1816;1428;3878
354640;202209;4700;12027;3668;10086;443;1464;1929;4703;2372;6167
354650;202209;1045;2569;844;2240;132;333;484;1239;616;1572
354660;202209;4299;9554;2495;6677;303;950;1112;2664;1415;3614
354670;202209;1341;3501;952;2708;192;603;346;859;538;1462
354680;202209;7138;16824;5598;14406;952;2641;3263;8116;4215;10757
354690;202209;647;1836;467;1448;86;276;185;529;271;805
354700;202209;1075;2671;766;2081;87;270;431;1051;518;1321
354710;202209;572;1433;389;1080;44;125;185;448;229;573
354720;202209;366;830;183;492;64;159;50;138;114;297
354730;202209;13564;35653;10697;30328;1413;4443;6504;17346;7917;21789
354740;202209;382;996;167;498;32;103;25;56;57;159
354750;202209;3204;7810;2191;5911;320;966;941;2183;1261;3149
354760;202209;2715;6740;1987;5456;431;1309;725;1747;1156;3056
354765;202209;426;1088;194;569;21;76;69;158;90;234
354770;202209;3049;7064;2249;5661;466;1212;1001;2342;1467;3554
354780;202209;76356;174497;60010;144138;4268;12340;42772;94548;47040;106888
354790;202209;1169;3041;917;2634;75;245;594;1629;669;1874
354800;202209;3295;7956;2512;6687;543;1534;1110;2675;1653;4209
354805;202209;1718;3693;1267;3052;110;284;868;1911;978;2195
354810;202209;724;2028;448;1452;75;276;133;378;208;654
354820;202209;1154;3089;829;2494;165;562;293;713;458;1275
354830;202209;647;1476;373;987;79;228;142;322;221;550
354840;202209;1046;2539;637;1706;57;168;356;857;413;1025
354850;202209;27057;63645;19819;51471;1803;5646;13296;31879;15099;37525
354860;202209;2039;5231;1331;3856;211;654;504;1297;715;1951
354870;202209;80319;186978;63227;156759;4980;14496;43467;99682;48447;114178
354880;202209;7377;17364;3988;10385;489;1450;1784;3694;2273;5144
354890;202209;21982;50905;17486;43276;2265;6417;10247;23823;12512;30240
354900;202209;478;1154;317;874;65;205;116;257;181;462
354910;202209;7189;17941;4567;13241;1016;3127;1239;3149;2255;6276
354920;202209;595;1518;302;932;44;141;70;170;114;311
354925;202209;344;935;199;622;19;55;50;142;69;197
354930;202209;429;1004;294;762;41;109;147;343;188;452
354940;202209;3054;8399;2331;6893;688;2187;822;2088;1510;4275
354950;202209;1918;4406;1575;3967;99;340;1172;2760;1271;3100
354960;202209;1047;2592;746;2110;92;313;330;826;422;1139
354970;202209;5323;13622;4238;11857;357;1243;2919;7735;3276;8978
354980;202209;43359;97054;30700;75800;3027;9063;20089;45388;23116;54451
354990;202209;96097;219978;71240;176721;4650;14359;49923;113655;54573;128014
354995;202209;4022;7822;3151;6739;133;361;2613;5340;2746;5701
355000;202209;1925;4413;1468;3749;222;678;787;1799;1009;2477
355010;202209;5017;12696;3352;9257;1100;2944;750;2011;1850;4955
355020;202209;4263;11156;3221;9394;699;2250;1379;3659;2078;5909
355030;202209;1695284;3921896;1273531;3144326;168071;462282;721131;1624012;889202;2086294
355040;202209;4129;9127;3256;8003;282;740;2457;5919;2739;6659
355050;202209;1351;2861;996;2372;239;583;447;978;686;1561
355060;202209;8036;19989;6059;16475;932;2916;3358;8277;4290;11193
355070;202209;12900;30087;10755;26773;1150;3412;7220;16657;8370;20069
355080;202209;1161;3135;739;2369;162;563;132;352;294;915
355090;202209;1637;4159;1319;3636;234;711;702;1761;936;2472
355100;202209;32148;76137;26168;67422;3185;9043;17766;43802;20951;52845
355110;202209;1157;2964;841;2498;191;618;90;233;281;851
355120;202209;886;2157;630;1785;75;245;320;838;395;1083
355130;202209;1018;2124;587;1367;22;62;425;889;447;951
355140;202209;2728;5222;2321;4667;88;219;2057;4012;2145;4231
355150;202209;5852;14003;4759;12178;516;1444;3143;7625;3659;9069
355160;202209;2852;7253;2052;5891;460;1444;589;1513;1049;2957
355170;202209;14757;34320;11756;29474;1916;5308;6694;15815;8610;21123
355180;202209;3463;8230;2589;6908;473;1492;1339;3187;1812;4679
355190;202209;2302;5718;1821;4955;659;1843;637;1856;1296;3699
355200;202209;1068;3007;911;2762;251;845;330;947;581;1792
355210;202209;3846;9664;2925;7769;593;1653;1311;3263;1904;4916
355220;202209;64507;155803;52676;134059;7482;21576;30374;70177;37856;91753
355230;202209;1486;3589;818;2262;143;419;298;694;441;1113
355240;202209;30193;75387;21759;59447;2209;6865;13263;33598;15472;40463
355250;202209;49076;120670;37787;99746;7841;22034;18606;45480;26447;67514
355255;202209;764;1845;408;1198;48;130;126;359;174;489
355260;202209;1945;4207;1440;3442;113;360;1012;2211;1125;2571
355270;202209;1411;3863;1115;3293;241;750;496;1347;737;2097
355280;202209;40164;94040;29823;75692;3514;9890;17437;40926;20951;50816
355290;202209;1159;2861;904;2450;171;461;448;1141;619;1602
355300;202209;1690;4538;1396;4008;243;734;636;1641;879;2375
355310;202209;1103;2836;824;2354;110;344;458;1257;568;1601
355320;202209;658;1669;498;1372;108;353;207;458;315;811
355330;202209;3703;8662;2908;7320;122;407;2236;5284;2358;5691
355340;202209;5015;10624;3859;9131;696;1674;2033;4899;2729;6573
355350;202209;1729;4471;1320;3715;244;793;594;1504;838;2297
355360;202209;1559;3622;1223;3116;139;373;739;1716;878;2089
355365;202209;439;1045;238;705;45;130;72;192;117;322
355370;202209;6829;16162;5357;13871;1141;2635;2533;6849;3674;9484
355380;202209;3583;8840;2780;7435;552;1619;1076;2450;1628;4069
355385;202209;1741;4156;1434;3714;107;352;955;2227;1062;2579
355390;202209;986;2575;710;2008;106;330;341;850;447;1180
355395;202209;2238;5962;1619;4734;268;876;691;1755;959;2631
355400;202209;11566;30754;9356;26577;1999;6438;4008;10112;6007;16550
355410;202209;30066;77163;20120;57348;3925;12283;7337;19357;11262;31640
355420;202209;752;2258;621;2013;134;500;206;605;340;1105
355430;202209;4569;10782;3533;9012;618;1687;1780;4363;2398;6050
355440;202209;904;2301;579;1658;95;274;131;321;226;595
355450;202209;4322;10447;2999;7968;431;1282;1480;3439;1911;4721
355460;202209;600;1405;401;1066;41;121;179;442;220;563
355465;202209;556;1338;445;1161;63;164;283;716;346;880
355470;202209;1430;3434;841;2282;218;659;293;700;511;1359
355475;202209;416;890;341;796;13;32;255;567;268;599
355480;202209;5216;13342;4168;11711;551;1784;2665;7203;3216;8987
355490;202209;1093;2801;628;1871;63;211;295;797;358;1008
355495;202209;1102;2806;820;2330;108;390;374;906;482;1296
355500;202209;8599;20506;5689;15128;768;2341;2620;6072;3388;8413
355510;202209;1618;3771;1111;2940;210;563;480;1145;690;1708
355520;202209;407;944;210;604;44;128;57;157;101;285
355530;202209;369;807;157;409;9;31;86;197;95;228
355535;202209;663;1705;530;1487;100;322;267;652;367;974
355540;202209;15788;35258;13235;31786;1361;3703;9681;22223;11042;25926
355550;202209;771;2126;655;1913;72;243;369;968;441;1211
355560;202209;1352;3336;779;2240;166;527;33;101;199;628
355570;202209;342;870;193;550;45;135;48;126;93;261
355580;202209;1443;3290;876;2341;158;471;260;624;418;1095
355590;202209;192;482;143;399;13;37;78;205;91;242
355600;202209;1825;4303;1160;3118;199;582;348;893;547;1475
355610;202209;2382;5502;1617;4204;217;604;906;2127;1123;2731
355620;202209;6194;15446;4744;12731;508;1661;2782;6716;3290;8377
355630;202209;3153;7848;2297;6299;279;840;1357;3404;1636;4244
355635;202209;1183;3202;863;2579;132;415;329;893;461;1308
355640;202209;4204;10878;2830;8191;660;1896;613;1746;1273;3642
355645;202209;4754;12456;3458;10163;482;1588;1916;5318;2398;6906
355650;202209;9183;22688;7393;19532;1512;4215;3653;8828;5165;13043
355660;202209;1699;4190;1158;3252;214;561;306;779;520;1340
355670;202209;5191;12934;3756;9917;488;1565;1972;4407;2460;5972
355680;202209;3393;8855;1731;5152;481;1539;136;378;617;1917
355690;202209;888;2470;605;1941;181;606;11;23;192;629
355695;202209;307;793;178;520;13;43;40;79;53;122
355700;202209;9908;25777;8372;22648;1029;3170;5167;13009;6196;16179
355710;202209;12212;27239;8519;20598;1136;3277;4670;9640;5806;12917
355715;202209;549;1442;300;886;73;211;55;160;128;371
355720;202209;1789;4587;1409;3959;210;661;785;2009;995;2670
355730;202209;1258;3157;1011;2737;108;346;573;1416;681;1762
410010;202209;1456;3844;1105;3136;237;704;255;674;492;1378
410020;202209;1309;3538;973;2847;274;782;259;698;533;1480
410030;202209;2018;4984;1682;4474;237;637;877;2335;1114;2972
410040;202209;17460;44608;12982;36486;2754;8293;4380;11185;7134;19478
410045;202209;897;2322;647;1812;120;375;223;541;343;916
410050;202209;2641;6395;1860;5060;282;861;724;1781;1006;2642
410060;202209;2463;6515;1978;5630;486;1490;574;1512;1060;3002
410070;202209;2358;5634;1725;4532;331;969;664;1517;995;2486
410080;202209;1599;4065;1145;3285;261;775;247;642;508;1417
410090;202209;1368;3042;1116;2689;131;280;573;1489;704;1769
410100;202209;2474;6623;1718;4956;324;1008;173;451;497;1459
410105;202209;630;1482;395;1046;28;84;207;487;235;571
410110;202209;3928;9106;2818;7204;362;1064;1472;3360;1834;4424
410115;202209;665;1634;479;1307;61;191;192;454;253;645
410120;202209;3814;9159;3356;8490;536;1295;2173;5429;2709;6724
410130;202209;1581;3867;1388;3532;213;577;810;1966;1023;2543
410140;202209;20898;48246;14011;36260;2631;7400;4496;10350;7127;17750
410150;202209;19619;44555;10714;27742;1824;5122;3365;7446;5189;12568
410160;202209;3537;9366;2881;8239;625;1997;1066;2847;1691;4844
410165;202209;734;1890;577;1571;75;232;299;753;374;985
410170;202209;3487;8591;2173;5866;426;1258;311;711;737;1969
410180;202209;20427;53167;15937;44431;2557;7897;8003;19885;10560;27782
410185;202209;529;1444;400;1133;75;226;137;323;212;549
410190;202209;2635;6290;1891;4967;396;1060;504;1139;900;2199
410200;202209;6886;14878;3850;9827;763;2090;697;1583;1460;3673
410210;202209;3728;8963;2375;6598;389;1220;802;1881;1191;3101
410220;202209;637;1573;429;1193;80;244;146;354;226;598
410230;202209;2285;5745;1753;4717;257;797;768;1744;1025;2541
410240;202209;6096;15251;4227;11765;855;2738;695;1643;1550;4381
410250;202209;2727;6318;2010;5177;192;555;956;2322;1148;2877
410260;202209;2341;5381;1468;3811;244;634;742;1788;986;2422
410270;202209;581;1463;419;1174;57;188;172;418;229;606
410275;202209;713;1874;492;1405;77;255;208;513;285;768
410280;202209;2816;7017;1932;5385;237;758;872;2134;1109;2892
410290;202209;3911;10259;2725;7888;802;2252;755;2148;1557;4400
410300;202209;829;1941;650;1666;59;190;344;766;403;956
410302;202209;391;934;233;656;24;81;105;273;129;354
410304;202209;1747;3817;1527;3436;148;354;1152;2456;1300;2810
410305;202209;2026;4543;1423;3673;131;362;940;2317;1071;2679
410310;202209;3580;8615;2958;7556;236;808;2002;4713;2238;5521
410315;202209;892;1922;554;1401;175;442;157;393;332;835
410320;202209;1145;3056;757;2284;105;329;126;342;231;671
410322;202209;776;2004;405;1177;60;173;149;372;209;545
410330;202209;1763;4085;1221;3105;195;511;424;975;619;1486
410335;202209;1000;2501;750;2057;129;391;293;711;422;1102
410337;202209;949;2261;656;1710;95;263;234;518;329;781
410340;202209;555;1483;374;1059;31;109;166;373;197;482
410345;202209;3155;7859;1904;5276;422;1214;679;1659;1101;2873
410347;202209;911;2230;678;1832;77;211;205;537;282;748
410350;202209;1942;4476;1411;3635;141;440;800;1827;941;2267
410360;202209;4667;11299;3502;9283;623;1733;1265;3184;1888;4917
410370;202209;16878;42929;11102;29937;1293;3984;4792;10804;6085;14788
410380;202209;2076;4804;1486;3802;230;663;564;1254;794;1917
410390;202209;3443;7774;2317;5940;484;1475;947;2041;1431;3516
410395;202209;1076;2862;840;2409;163;464;318;929;481;1393
410400;202209;9272;21748;7077;17820;874;2439;4259;9806;5133;12245
410405;202209;1057;2325;747;1865;113;322;377;829;490;1151
410410;202209;1866;4394;1676;4111;127;376;1179;2822;1306;3198
410420;202209;14546;36389;11040;29770;1815;5303;5004;11999;6819;17302
410425;202209;4394;11263;3027;8535;536;1613;1158;2889;1694;4502
410430;202209;15929;37697;11348;29615;1775;5154;4521;10521;6296;15675
410440;202209;2843;7544;2447;6834;383;1184;1351;3569;1734;4753
410442;202209;2953;8130;2360;6911;646;1963;656;1811;1302;3774
410445;202209;2676;7157;1862;5604;414;1356;267;865;681;2221
410450;202209;1796;4222;1338;3529;223;618;482;1146;705;1764
410460;202209;2852;6626;2071;5278;292;856;1018;2296;1310;3152
410465;202209;3528;9411;2719;7936;546;1579;952;2465;1498;4044
410470;202209;2833;7261;2007;5842;602;1969;195;569;797;2538
410480;202209;47886;109884;27625;75241;4137;12680;8071;18376;12208;31056
410490;202209;14156;36206;10348;28676;1710;5100;4696;11641;6406;16741
410500;202209;2168;5302;1421;3929;267;784;319;708;586;1492
410510;202209;2141;5058;1494;3949;350;876;448;1195;798;2071
410520;202209;3566;10313;3118;9474;978;3134;1132;3431;2110;6565
410530;202209;1837;4321;876;2401;112;338;240;519;352;857
410540;202209;3349;8475;2322;6480;373;1200;1023;2570;1396;3770
410550;202209;9181;23301;6287;17374;1054;3205;1871;4267;2925;7472
410560;202209;1873;4574;1365;3592;306;880;403;872;709;1752
410570;202209;3233;8082;2311;6514;794;2577;252;676;1046;3253
410580;202209;34119;81972;25919;67515;3816;11207;13677;32471;17493;43678
410590;202209;2037;5325;1419;3935;199;600;457;1012;656;1612
410600;202209;2144;5254;1679;4392;355;933;588;1481;943;2414
410610;202209;827;1998;622;1638;54;161;308;718;362;879
410620;202209;3338;8493;2389;6507;613;1769;613;1499;1226;3268
410630;202209;3050;7370;2031;5425;382;1191;499;993;881;2184
410640;202209;6032;13428;4162;10245;924;2506;674;1646;1598;4152
410645;202209;1566;3727;1308;3413;163;488;966;2443;1129;2931
410650;202209;2967;7592;2057;5780;382;1178;853;2124;1235;3302
410655;202209;1017;2351;704;1824;70;208;311;708;381;916
410657;202209;717;1866;451;1312;72;218;177;427;249;645
410660;202209;4423;10400;2720;6978;420;1145;1004;2224;1424;3369
410670;202209;1185;2856;724;1971;122;340;264;627;386;967
410680;202209;2834;7988;1876;5689;439;1360;327;950;766;2310
410685;202209;616;1503;448;1214;98;289;182;456;280;745
410690;202209;170131;390806;119075;299982;18092;51806;53297;116519;71389;168325
410700;202209;2909;7011;2382;6204;537;1434;955;2330;1492;3764
410710;202209;1072;2573;689;1868;153;446;287;684;440;1130
410712;202209;809;2073;671;1825;100;290;371;963;471;1253
410715;202209;1045;2819;652;1973;73;245;274;754;347;999
410720;202209;4500;10459;3706;9168;544;1653;1383;3141;1927;4794
410725;202209;1396;3230;850;2270;195;568;186;403;381;971
410730;202209;956;2331;677;1830;107;334;144;386;251;720
410740;202209;1004;2661;757;2210;61;221;387;1096;448;1317
410750;202209;2320;5287;1832;4442;305;787;922;2072;1227;2859
410752;202209;461;1066;250;680;54;133;97;246;151;379
410753;202209;397;1083;278;835;42;142;87;230;129;372
410754;202209;1301;3109;1077;2786;74;189;773;2032;847;2221
410755;202209;665;1612;482;1293;69;185;214;508;283;693
410760;202209;4313;10634;3064;8409;718;2332;846;2131;1564;4463
410765;202209;20965;53332;16662;45430;3376;10182;5576;12884;8952;23066
410770;202209;1212;2753;840;2140;87;189;425;1080;512;1269
410773;202209;1595;3818;1363;3442;169;478;893;2116;1062;2594
410775;202209;1959;4163;1709;3816;46;116;1302;2751;1348;2867
410780;202209;744;1759;499;1315;89;253;162;380;251;633
410785;202209;924;2129;671;1732;90;272;288;700;378;972
410790;202209;1241;3374;1021;2965;225;689;155;367;380;1056
410800;202209;4094;8328;3276;7196;69;207;2266;4698;2335;4905
410810;202209;527;1331;385;1062;40;153;195;457;235;610
410820;202209;1196;3162;667;1855;138;411;150;321;288;732
410830;202209;53228;118164;38211;93687;6317;17724;18305;40576;24622;58300
410832;202209;1296;3225;1056;2818;98;316;662;1604;760;1920
410840;202209;10824;25713;6465;17610;1342;4115;1920;4215;3262;8330
410845;202209;1410;3138;1099;2693;159;431;602;1380;761;1811
410850;202209;2530;6673;2195;6095;390;1232;1060;2727;1450;3959
410855;202209;844;1992;531;1396;61;180;268;607;329;787
410860;202209;5705;12639;4517;10747;237;732;3114;6801;3351;7533
410865;202209;1709;4535;1449;4069;168;521;800;2311;968;2832
410870;202209;1415;3560;1127;3065;143;427;642;1660;785;2087
410880;202209;5640;14147;3913;11117;701;2073;736;2050;1437;4123
410890;202209;1337;3408;1061;2909;207;584;463;1166;670;1750
410895;202209;1196;3509;982;3049;302;1041;265;713;567;1754
410900;202209;994;2532;675;1967;99;312;157;336;256;648
410910;202209;525;1145;325;782;15;38;192;409;207;447
410920;202209;1073;2375;801;1966;109;306;437;988;546;1294
410930;202209;2071;5036;1426;3946;366;1146;252;617;618;1763
410940;202209;29684;74762;21870;61125;4096;12760;8764;22534;12860;35294
410950;202209;2379;6157;2119;5754;156;436;1663;4440;1819;4876
410960;202209;10254;23178;7234;18375;1849;5430;2984;6906;4833;12336
410965;202209;1355;3268;871;2398;110;348;429;1075;539;1423
410970;202209;4958;12575;3502;9787;879;2888;606;1307;1485;4195
410975;202209;1760;3931;1309;3244;185;525;605;1381;790;1906
410980;202209;8878;20836;5862;15635;627;1888;2864;6783;3491;8671
410990;202209;1773;3924;1224;3104;208;584;577;1401;785;1985
411000;202209;803;2076;554;1625;103;341;185;470;288;811
411005;202209;558;1300;348;890;41;112;139;301;180;413
411007;202209;3034;7555;2224;6134;451;1383;828;2106;1279;3489
411010;202209;5337;14641;4104;12230;1155;3537;626;1607;1781;5144
411020;202209;2813;7357;2314;6526;595;1753;744;2000;1339;3753
411030;202209;847;2013;575;1480;80;223;240;523;320;746
411040;202209;1200;2907;634;1722;108;306;174;382;282;688
411050;202209;2348;6892;1866;5899;408;1414;350;900;758;2314
411060;202209;2645;6647;1710;4763;358;1026;474;1158;832;2184
411065;202209;460;1110;285;769;27;85;122;296;149;381
411070;202209;9221;21570;7322;18562;891;2599;4100;9686;4991;12285
411080;202209;2376;5869;1909;5066;472;1442;552;1315;1024;2757
411090;202209;936;2418;588;1734;82;261;138;348;220;609
411095;202209;2959;6690;1714;4533;248;696;317;700;565;1396
411100;202209;1454;3554;982;2708;115;390;358;905;473;1295
411110;202209;757;1912;353;1052;39;105;26;53;65;158
411120;202209;1889;4618;1547;4081;284;916;709;1628;993;2544
411125;202209;6468;17367;5694;16010;1395;3973;2424;6942;3819;10915
411130;202209;881;2199;614;1689;168;442;166;475;334;917
411140;202209;2584;7468;2110;6487;520;1675;632;1956;1152;3631
411150;202209;4837;11586;3169;8356;671;1910;339;694;1010;2604
411155;202209;1283;2988;865;2247;121;358;428;931;549;1289
411160;202209;454;974;302;738;30;86;90;216;120;302
411170;202209;953;2561;716;2078;159;515;310;829;469;1344
411180;202209;7076;17067;5679;14650;781;2272;3056;7075;3837;9347
411190;202209;2445;5981;1863;4983;253;758;848;1974;1101;2732
411200;202209;6013;14990;4531;12397;940;3036;1538;3440;2478;6476
411210;202209;4205;8909;2995;6970;416;1107;1416;3016;1832;4123
411220;202209;1141;2721;778;2069;151;414;256;620;407;1034
411230;202209;1015;2562;752;2073;165;480;243;615;408;1095
411240;202209;1868;4201;1301;3273;227;616;516;1191;743;1807
411250;202209;2722;6741;1973;5425;403;1231;602;1494;1005;2725
411260;202209;372;915;252;682;35;122;98;219;133;341
411270;202209;2366;5930;1723;4695;271;792;803;1946;1074;2738
411275;202209;1933;4036;1378;3186;136;403;839;1720;975;2123
411280;202209;1739;4382;1259;3495;319;938;333;809;652;1747
411290;202209;998;2430;645;1752;60;202;351;888;411;1090
411295;202209;1496;3575;1090;2851;159;436;498;1187;657;1623
411300;202209;1185;2849;764;2054;89;274;309;674;398;948
411310;202209;1124;2340;874;2018;129;330;473;1004;602;1334
411320;202209;6874;16221;5165;13324;754;2180;2527;5650;3281;7830
411325;202209;1716;4456;1391;3861;277;786;657;1863;934;2649
411330;202209;3868;9763;2831;7935;653;2053;860;2251;1513;4304
411340;202209;978;2554;586;1711;83;254;176;438;259;692
411342;202209;1263;2917;686;1780;121;352;258;553;379;905
411345;202209;1448;3375;1050;2701;73;219;702;1738;775;1957
411350;202209;3491;8838;2302;6532;601;1794;410;1010;1011;2804
411360;202209;935;2046;706;1702;70;217;401;831;471;1048
411370;202209;70877;166258;52150;135301;4070;12690;31275;73881;35345;86571
411373;202209;1709;3990;1343;3452;154;412;653;1684;807;2096
411375;202209;1327;3146;923;2409;107;297;376;897;483;1194
411380;202209;1379;2993;938;2197;44;111;634;1354;678;1465
411390;202209;1843;4668;1435;3836;221;665;615;1361;836;2026
411400;202209;2804;6424;2115;5241;208;585;1185;2729;1393;3314
411410;202209;3400;8983;2521;7196;566;1751;641;1609;1207;3360
411420;202209;5000;11714;2712;7519;375;1147;531;1055;906;2202
411430;202209;4739;11604;3592;9566;714;2115;1279;2904;1993;5019
411435;202209;526;1345;302;896;52;162;80;202;132;364
411440;202209;3092;7948;2422;6723;498;1498;731;1831;1229;3329
411450;202209;3079;7531;2324;6315;317;852;1304;3515;1621;4367
411460;202209;5340;13182;3400;9543;520;1663;829;1867;1349;3530
411470;202209;1028;2400;777;1979;118;366;387;856;505;1222
411480;202209;6491;16066;4723;12885;873;2796;1583;3709;2456;6505
411490;202209;2021;4757;1527;3996;183;550;673;1566;856;2116
411500;202209;1624;4103;1122;3068;190;565;244;517;434;1082
411510;202209;2769;6351;2189;5457;341;1008;684;1670;1025;2678
411520;202209;42447;99228;26050;67839;3094;9513;11557;25917;14651;35430
411530;202209;1098;2671;606;1740;100;334;128;332;228;666
411535;202209;606;1668;407;1230;54;175;123;327;177;502
411540;202209;3154;7231;2226;5609;127;340;1347;3264;1474;3604
411545;202209;1062;2882;883;2560;68;225;580;1643;648;1868
411550;202209;833;1949;638;1603;91;247;217;464;308;711
411560;202209;2297;6107;1254;3848;193;625;101;223;294;848
411570;202209;9000;19702;6273;15647;1443;3885;1941;4454;3384;8339
411573;202209;928;2345;743;2024;136;440;364;877;500;1317
411575;202209;2423;6077;1784;4868;326;946;583;1435;909;2381
411580;202209;5474;12629;3346;9124;505;1569;618;1334;1123;2903
411585;202209;698;1984;347;1097;66;207;65;181;131;388
411590;202209;538;1362;400;1096;41;137;217;529;258;666
411600;202209;403;939;255;699;38;107;109;261;147;368
411605;202209;1870;4092;1205;3090;156;459;577;1483;733;1942
411610;202209;3449;7151;2500;5555;62;203;1883;3816;1945;4019
411620;202209;3548;8521;2959;7643;508;1368;1479;3748;1987;5116
411630;202209;994;2400;649;1798;105;361;257;593;362;954
411640;202209;555;1391;385;1035;53;149;148;327;201;476
411650;202209;232;637;144;445;30;97;34;89;64;186
411660;202209;1056;2511;743;1934;93;252;307;699;400;951
411670;202209;1818;4047;1206;2960;111;287;708;1573;819;1860
411680;202209;1688;4263;1253;3436;252;756;447;1133;699;1889
411690;202209;4736;11280;3480;9127;730;1925;1092;2876;1822;4801
411695;202209;748;2105;512;1516;44;138;229;625;273;763
411700;202209;1955;4846;1316;3649;320;920;262;672;582;1592
411705;202209;2876;7461;2417;6707;377;1091;1518;4267;1895;5358
411710;202209;2433;5899;1675;4507;354;993;516;1230;870;2223
411720;202209;1234;2830;868;2197;125;323;318;728;443;1051
411721;202209;1164;2780;861;2236;147;395;284;680;431;1075
411722;202209;1106;2922;647;1879;112;340;224;509;336;849
411725;202209;1496;3998;971;2957;233;770;230;629;463;1399
411727;202209;1706;4473;1117;3260;246;741;144;328;390;1069
411729;202209;701;1701;407;1133;64;215;119;263;183;478
411730;202209;6583;16039;5085;13245;920;2678;2371;5802;3291;8480
411740;202209;583;1463;320;911;81;213;65;148;146;361
411745;202209;909;2444;636;1851;88;288;158;344;246;632
411750;202209;7380;18116;5485;14597;688;2013;2816;6950;3504;8963
411760;202209;8844;21474;6731;18126;2027;5674;1494;4183;3521;9857
411770;202209;3881;10465;2856;8309;627;1949;672;1712;1299;3661
411780;202209;3146;8148;2677;7375;715;2047;971;2751;1686;4798
411790;202209;3685;8325;2260;5867;322;986;824;1779;1146;2765
411800;202209;1369;3721;976;2781;193;607;225;516;418;1123
411810;202209;1816;4429;1338;3531;221;617;514;1206;735;1823
411820;202209;18639;45889;15646;40957;3518;9438;8090;20411;11608;29849
411830;202209;580;1411;423;1120;109;245;59;157;168;402
411840;202209;14993;37383;10545;28636;1652;4912;3787;8870;5439;13782
411845;202209;751;2033;463;1401;74;256;132;352;206;608
411850;202209;9510;22596;6578;17601;1704;4742;1335;3157;3039;7899
411860;202209;868;2290;649;1859;101;323;142;378;243;701
411870;202209;695;1896;505;1487;132;450;98;237;230;687
411880;202209;2906;6521;2107;5277;267;749;989;2273;1256;3022
411885;202209;1274;3193;897;2491;129;419;239;525;368;944
411890;202209;1753;4400;1267;3570;230;706;146;379;376;1085
411900;202209;999;2560;621;1784;154;467;108;293;262;760
411910;202209;1278;3567;925;2866;171;629;291;796;462;1425
411915;202209;18894;44241;13167;34070;1940;5597;5861;13449;7801;19046
411920;202209;1408;3733;1152;3274;257;805;448;1145;705;1950
411925;202209;582;1426;396;1083;68;195;186;457;254;652
411930;202209;6096;16791;5147;15148;2439;7514;601;1944;3040;9458
411940;202209;3995;10692;3124;8984;737;2183;1138;2903;1875;5086
411950;202209;18555;46018;15477;41143;1693;5220;9970;24925;11663;30145
411960;202209;7160;17734;5629;14873;1023;3013;2295;5451;3318;8464
411965;202209;580;1514;417;1182;54;167;200;504;254;671
411970;202209;1395;2890;1087;2488;209;405;501;1336;710;1741
411980;202209;1951;4287;1428;3497;284;688;647;1504;931;2192
411990;202209;48128;117965;32368;90303;5705;17603;13482;34579;19187;52182
411995;202209;5784;13104;4470;11114;1195;3307;1403;3272;2598;6579
412000;202209;2297;4904;1646;3824;43;143;1233;2636;1276;2779
412010;202209;726;2048;499;1563;65;228;119;281;184;509
412015;202209;616;1626;492;1397;79;229;256;718;335;947
412020;202209;555;1489;340;1045;55;194;109;302;164;496
412030;202209;725;1913;539;1580;70;227;240;634;310;861
412033;202209;1094;2742;765;2120;80;228;304;722;384;950
412035;202209;824;2136;527;1599;88;275;254;736;342;1011
412040;202209;822;2096;498;1450;73;210;106;258;179;468
412050;202209;1782;4223;1212;3218;300;872;257;655;557;1527
412060;202209;8717;23265;7081;20073;1862;5993;2008;5224;3870;11217
412065;202209;760;1941;562;1566;109;327;153;386;262;713
412070;202209;1556;3722;1204;3069;146;432;552;1189;698;1621
412080;202209;3104;7576;2292;6062;302;913;1107;2462;1409;3375
412085;202209;389;906;149;422;14;47;38;76;52;123
412090;202209;7685;18054;5689;14657;1219;3447;2446;6061;3665;9508
412100;202209;2187;5413;1619;4431;498;1494;413;1141;911;2635
412110;202209;1119;2796;701;1960;82;241;223;522;305;763
412120;202209;2744;7106;2117;6012;452;1450;665;1594;1117;3044
412125;202209;868;2281;542;1618;96;284;119;332;215;616
412130;202209;936;2221;617;1629;116;306;148;369;264;675
412135;202209;681;1754;338;995;42;160;130;318;172;478
412140;202209;2327;5343;1646;4183;286;788;456;1101;742;1889
412150;202209;3296;7928;2736;6963;475;1402;1431;3223;1906;4625
412160;202209;1061;3191;562;1843;50;170;46;99;96;269
412170;202209;5517;13683;4622;12272;851;2489;2218;5277;3069;7766
412175;202209;1562;4174;1281;3685;285;835;474;1318;759;2153
412180;202209;2008;5230;1487;4302;206;682;626;1642;832;2324
412190;202209;3872;9234;2781;7317;336;1022;1161;2826;1497;3848
412200;202209;2285;6103;1496;4376;381;1227;303;772;684;1999
412210;202209;781;1786;482;1297;73;219;213;516;286;735
412215;202209;3966;9960;2828;7759;620;1768;1236;3366;1856;5134
412217;202209;1189;2818;979;2457;21;74;740;1712;761;1786
412220;202209;7102;19255;5679;16644;1326;3893;1734;4924;3060;8817
412230;202209;3248;8827;2529;7514;383;1309;483;1204;866;2513
412240;202209;9404;23190;6182;17091;1093;3251;1933;4621;3026;7872
412250;202209;2311;5648;1667;4466;413;1184;338;770;751;1954
412260;202209;1611;3915;1221;3173;230;620;414;976;644;1596
412265;202209;1207;2914;972;2541;121;354;600;1430;721;1784
412270;202209;1224;3217;808;2346;111;361;334;854;445;1215
412280;202209;492;1258;366;1034;85;244;95;235;180;479
412290;202209;1267;2966;918;2374;165;461;352;846;517;1307
412300;202209;2076;5067;1524;4125;264;759;471;1150;735;1909
412310;202209;796;2202;590;1793;101;367;160;406;261;773
412320;202209;873;2140;554;1514;57;202;177;445;234;647
412330;202209;1867;4626;1258;3533;266;827;390;1058;656;1885
412340;202209;1391;3582;1002;2823;159;506;151;375;310;881
412350;202209;3713;9296;2461;6892;458;1374;654;1564;1112;2938
412360;202209;340;827;258;676;6;24;180;445;186;469
412370;202209;1253;3222;885;2526;190;558;224;608;414;1166
412380;202209;1788;4736;1279;3753;314;997;90;269;404;1266
412382;202209;584;1357;383;1023;44;156;204;437;248;593
412385;202209;2805;6823;2249;5844;626;1602;841;2265;1467;3867
412390;202209;2959;6746;2306;5711;431;1126;757;1796;1188;2922
412395;202209;894;2332;634;1775;88;241;303;792;391;1033
412400;202209;1123;2756;774;2102;141;413;242;567;383;980
412402;202209;2839;6591;1966;5185;430;1126;544;1410;974;2536
412405;202209;3604;9093;2349;6827;673;1936;317;882;990;2818
412410;202209;7612;18694;5618;15522;983;3160;1863;4681;2846;7841
412420;202209;627;1481;399;1047;38;113;176;410;214;523
412430;202209;646;1565;358;973;47;128;147;358;194;486
412440;202209;3515;8618;2459;6799;584;1628;742;1966;1326;3594
412450;202209;614;1713;401;1196;58;181;42;79;100;260
412460;202209;1355;3166;1048;2670;183;507;495;1183;678;1690
412470;202209;1893;5447;1555;4725;370;1265;445;1214;815;2479
412480;202209;1551;3677;1058;2734;176;496;425;949;601;1445
412490;202209;1589;3614;1211;2985;85;240;726;1624;811;1864
412500;202209;2446;5732;1818;4636;302;836;635;1400;937;2236
412510;202209;2295;6494;1656;4985;439;1438;331;763;770;2201
412520;202209;1641;3931;991;2661;207;544;164;387;371;931
412530;202209;799;2034;577;1610;87;246;126;311;213;557
412535;202209;929;2369;604;1736;124;382;86;175;210;557
412540;202209;1274;3124;903;2482;167;577;236;613;403;1190
412545;202209;808;2013;576;1563;104;310;186;468;290;778
412550;202209;44104;109312;32347;87065;4709;13982;15417;36741;20126;50723
412555;202209;337;828;226;598;32;107;73;139;105;246
412560;202209;6288;16535;4753;13281;1104;3388;1221;3023;2325;6411
412570;202209;5381;12636;3263;8786;558;1739;647;1428;1205;3167
412575;202209;1313;2996;1062;2600;196;489;553;1223;749;1712
412580;202209;1857;4433;1338;3518;112;329;775;1854;887;2183
412590;202209;532;1327;285;805;55;177;37;74;92;251
412600;202209;2044;4895;1606;4079;109;359;1028;2344;1137;2703
412610;202209;996;2520;716;1944;96;272;333;782;429;1054
412620;202209;1497;3635;1147;3096;221;641;478;1186;699;1827
412625;202209;10914;27595;7151;20354;1372;4155;841;2020;2213;6175
412627;202209;1332;3515;929;2734;208;680;219;605;427;1285
412630;202209;3292;9142;2283;7017;388;1293;568;1514;956;2807
412635;202209;522;1325;321;916;41;132;114;259;155;391
412640;202209;1183;2997;673;1936;103;289;140;332;243;621
412650;202209;1971;5100;1547;4241;255;796;614;1471;869;2267
412660;202209;3277;7829;2340;6097;279;804;895;2044;1174;2848
412665;202209;478;1136;366;949;61;181;157;371;218;552
412667;202209;1994;5030;1449;3976;216;651;631;1652;847;2303
412670;202209;1096;2382;738;1821;151;398;270;561;421;959
412680;202209;2465;6218;1679;4783;199;662;529;1237;728;1899
412690;202209;1369;3332;953;2549;191;562;334;777;525;1339
412700;202209;2239;5458;1855;4860;324;915;932;2316;1256;3231
412710;202209;6795;18519;5045;14942;902;2930;1420;3516;2322;6446
412720;202209;1494;4037;1202;3446;189;603;376;853;565;1456
412730;202209;3199;7795;2335;6189;403;1195;959;2252;1362;3447
412740;202209;2392;6290;1632;4836;315;1042;274;757;589;1799
412750;202209;4721;11679;3831;10348;444;1345;2273;5741;2717;7086
412760;202209;3664;9105;3049;8102;581;1795;1695;4152;2276;5947
412770;202209;13932;34703;7793;22857;1040;3247;1783;4246;2823;7493
412780;202209;1504;3669;1105;2982;261;778;389;926;650;1704
412785;202209;2626;5729;1839;4471;275;656;1146;2701;1421;3357
412788;202209;1653;4364;1332;3810;348;1004;510;1382;858;2386
412790;202209;1629;4073;1019;2916;164;522;372;871;536;1393
412795;202209;1452;3538;822;2327;138;423;178;445;316;868
412796;202209;2659;7133;2235;6403;511;1587;729;1886;1240;3473
412800;202209;4897;10834;3538;8467;374;1105;1945;3982;2319;5087
412810;202209;15313;37044;10318;27383;1191;3685;4528;10431;5719;14116
412820;202209;7529;19491;5361;15273;1284;3873;1561;4258;2845;8131
412830;202209;402;1087;299;879;36;102;82;219;118;321
412840;202209;2263;5070;1596;3843;135;393;969;2055;1104;2448
412850;202209;3250;7983;2416;6621;278;881;1240;3075;1518;3956
412853;202209;1910;4413;1590;3878;195;567;916;1912;1111;2479
412855;202209;1614;3950;873;2430;121;380;197;422;318;802
412860;202209;886;2130;577;1622;99;318;228;544;327;862
412862;202209;770;1848;518;1439;95;251;204;531;299;782
412863;202209;1501;4115;1328;3796;281;909;650;1665;931;2574
412865;202209;806;2063;572;1603;145;423;153;398;298;821
412870;202209;1147;2740;815;2222;237;727;239;617;476;1344
412880;202209;1081;2768;784;2216;160;485;270;690;430;1175
420005;202209;515;1430;302;922;31;92;150;445;181;537
420010;202209;3812;8747;2554;6640;162;471;1911;4899;2073;5370
420020;202209;564;1656;387;1219;70;261;143;347;213;608
420030;202209;138;466;98;361;27;110;22;80;49;190
420040;202209;683;1974;411;1373;92;358;33;94;125;452
420050;202209;868;1948;599;1460;120;339;331;700;451;1039
420055;202209;193;561;108;352;21;79;40;117;61;196
420060;202209;188;522;135;400;23;61;55;159;78;220
420070;202209;1016;2782;782;2324;170;545;386;1075;556;1620
420075;202209;97;252;56;168;9;30;18;39;27;69
420080;202209;505;1369;358;1010;73;223;127;318;200;541
420090;202209;507;1496;325;1079;65;239;77;204;142;443
420100;202209;1766;4020;1447;3529;99;254;1079;2597;1178;2851
420110;202209;335;991;288;891;48;164;150;447;198;611
420120;202209;727;1885;503;1413;73;234;252;627;325;861
420125;202209;442;1271;310;984;65;220;104;305;169;525
420127;202209;376;971;165;495;30;110;68;180;98;290
420130;202209;5409;14173;4146;12007;790;2579;1752;4442;2542;7021
420140;202209;5312;13374;4073;11262;1137;3441;1072;2719;2209;6160
420150;202209;798;1942;586;1605;52;164;344;908;396;1072
420160;202209;247;600;104;309;19;70;31;77;50;147
420165;202209;198;562;123;388;29;100;38;97;67;197
420170;202209;368;1061;284;858;53;179;117;299;170;478
420180;202209;191;594;113;402;17;79;30;90;47;169
420190;202209;242;693;140;436;28;84;45;124;73;208
420195;202209;2257;5559;1742;4735;412;1314;757;1832;1169;3146
420200;202209;8555;19435;5674;14231;770;2241;2809;5880;3579;8121
420205;202209;2528;6363;1734;4770;258;806;930;2405;1188;3211
420207;202209;2557;6207;1669;4571;288;883;712;1755;1000;2638
420208;202209;412;1132;246;787;77;254;57;143;134;397
420209;202209;202;609;128;399;15;56;65;177;80;233
420210;202209;4961;12089;3606;9778;550;1716;1913;4800;2463;6516
420213;202209;965;2686;791;2337;162;525;314;870;476;1395
420215;202209;276;777;190;584;46;146;54;168;100;314
420220;202209;402;1161;275;893;46;178;107;290;153;468
420230;202209;7040;17642;5535;14941;670;2065;3196;7930;3866;9995
420240;202209;18478;49231;12117;34691;1501;5001;5757;13932;7258;18933
420243;202209;539;1306;448;1148;68;191;302;744;370;935
420245;202209;2286;5462;1750;4555;160;489;1100;2659;1260;3148
420250;202209;672;1588;595;1474;43;140;459;1060;502;1200
420253;202209;575;1328;414;1100;31;86;256;668;287;754
420257;202209;194;483;132;375;22;68;66;190;88;258
420260;202209;1471;3427;1122;2963;87;281;857;2198;944;2479
420270;202209;692;1731;351;960;42;126;149;362;191;488
420280;202209;1756;4779;1433;4127;191;661;688;1794;879;2455
420285;202209;169;454;110;321;21;83;33;58;54;141
420287;202209;554;1203;391;978;73;188;174;421;247;609
420290;202209;6657;17798;5237;14807;709;2348;3085;7914;3794;10262
420300;202209;9188;24583;5429;16011;1028;3340;1747;4406;2775;7746
420310;202209;1090;2326;616;1518;52;155;355;775;407;930
420315;202209;1037;2691;688;2028;89;290;368;1008;457;1298
420320;202209;7477;18934;5640;16009;1619;4952;1814;4763;3433;9715
420325;202209;402;1095;282;860;42;147;111;295;153;442
420330;202209;1204;3363;771;2424;140;492;251;681;391;1173
420340;202209;1395;3463;1095;2933;236;685;424;997;660;1682
420350;202209;1599;3641;1208;2982;140;380;796;1897;936;2277
420360;202209;3574;9356;1971;5970;372;1219;186;515;558;1734
420370;202209;1634;4001;1318;3460;119;399;901;2185;1020;2584
420380;202209;5517;13688;3828;10641;721;2241;1702;4293;2423;6534
420390;202209;1293;3109;929;2407;173;502;341;617;514;1119
420395;202209;1500;4020;1070;3182;162;541;218;471;380;1012
420400;202209;1382;3529;973;2749;122;391;524;1376;646;1767
420410;202209;706;1738;537;1397;60;171;334;848;394;1019
420415;202209;420;1142;310;894;61;201;138;377;199;578
420417;202209;751;2139;585;1781;126;379;283;886;409;1265
420419;202209;184;620;132;475;50;194;12;50;62;244
420420;202209;16774;41975;11837;32839;3007;9400;4161;10271;7168;19671
420425;202209;769;2022;528;1510;50;174;281;742;331;916
420430;202209;3989;10188;2529;7113;422;1361;1062;2584;1484;3945
420435;202209;355;895;208;623;35;113;101;286;136;399
420440;202209;989;2455;662;1783;194;488;243;625;437;1113
420445;202209;281;650;179;472;29;87;60;121;89;208
420450;202209;996;2812;731;2226;130;485;280;726;410;1211
420455;202209;2551;5714;1903;4755;454;1130;807;2006;1261;3136
420460;202209;11829;29640;9161;24825;1231;3861;5143;12878;6374;16739
420470;202209;766;1903;416;1159;72;229;121;270;193;499
420475;202209;80;205;36;108;4;16;10;22;14;38
420480;202209;6843;16041;4496;12103;775;2226;1964;5033;2739;7259
420490;202209;457;1211;325;927;51;170;151;389;202;559
420500;202209;1607;4147;1081;3211;183;633;505;1390;688;2023
420510;202209;187;511;109;347;21;78;31;80;52;158
420515;202209;135;361;91;266;15;53;32;83;47;136
420517;202209;860;2168;716;1905;79;225;417;1082;496;1307
420519;202209;375;914;262;728;28;84;132;361;160;445
420520;202209;342;906;193;621;27;89;11;24;38;113
420530;202209;953;2734;657;2074;119;431;225;585;344;1016
420535;202209;251;695;103;323;14;49;30;73;44;122
420540;202209;49571;114103;34674;89408;4681;14012;14664;32388;19345;46400
420543;202209;280;788;218;642;32;111;95;242;127;353
420545;202209;1699;4966;1280;4038;275;929;454;1286;729;2215
420550;202209;5000;12236;3351;9398;551;1696;1466;3917;2017;5613
420555;202209;413;1108;281;843;35;127;153;423;188;550
420560;202209;495;1123;347;914;54;132;202;526;256;658
420570;202209;3566;8639;2694;7065;426;1275;1458;3522;1884;4797
420580;202209;2115;5522;1491;4472;332;1107;462;1251;794;2358
420590;202209;3515;9162;2225;6403;369;1241;658;1485;1027;2726
420600;202209;1435;3765;1154;3253;106;403;734;1917;840;2320
420610;202209;643;1694;430;1276;91;272;206;594;297;866
420620;202209;1006;2423;696;1902;138;411;283;737;421;1148
420630;202209;1227;3551;890;2753;147;496;433;1240;580;1736
420640;202209;571;1517;304;969;83;282;50;144;133;426
420650;202209;4600;11457;3055;8335;456;1423;1390;3156;1846;4579
420660;202209;519;1280;331;884;63;188;71;153;134;341
420665;202209;863;2143;585;1671;101;320;268;667;369;987
420670;202209;1480;4028;900;2768;108;375;200;477;308;852
420675;202209;248;625;161;470;13;51;98;262;111;313
420680;202209;339;728;188;520;26;97;103;251;129;348
420690;202209;1108;3048;728;2157;106;353;250;614;356;967
420700;202209;3693;9238;2886;7821;228;713;1947;5026;2175;5739
420710;202209;1334;3592;1082;3070;131;467;634;1567;765;2034
420720;202209;1595;4098;1203;3398;184;583;717;1866;901;2449
420730;202209;4231;10426;3260;8844;554;1692;1720;4296;2274;5988
420740;202209;550;1562;317;1056;77;267;42;121;119;388
420750;202209;2561;7109;1698;5166;275;1022;634;1674;909;2696
420757;202209;123;313;59;189;8;29;26;85;34;114
420760;202209;454;1250;245;714;35;105;83;202;118;307
420765;202209;633;1733;334;1008;49;172;181;527;230;699
420768;202209;1635;4198;1416;3841;163;434;1030;2765;1193;3199
420770;202209;431;1155;193;667;19;77;42;130;61;207
420775;202209;350;922;209;636;39;133;79;200;118;333
420780;202209;1160;3140;700;2097;124;372;121;330;245;702
420785;202209;267;653;193;512;19;61;92;185;111;246
420790;202209;1360;3663;1037;3002;193;659;584;1536;777;2195
420800;202209;881;2028;543;1414;122;327;282;699;404;1026
420810;202209;1800;5085;1499;4501;355;1286;722;1840;1077;3126
420820;202209;16538;39917;12214;33006;1795;5362;6289;15750;8084;21112
420830;202209;5990;14789;4510;12207;778;2368;2037;5105;2815;7473
420840;202209;646;1930;344;1196;75;271;36;111;111;382
420845;202209;3490;8551;2401;6653;468;1545;1052;2667;1520;4212
420850;202209;1358;4068;905;2938;165;580;245;696;410;1276
420860;202209;466;1193;279;848;69;215;81;217;150;432
420870;202209;1012;2689;691;2037;145;459;247;664;392;1123
420880;202209;1396;3952;1111;3398;213;741;480;1326;693;2067
420890;202209;9695;25301;6143;17997;914;2959;2175;5462;3089;8421
420895;202209;219;600;142;414;21;64;69;186;90;250
420900;202209;1906;4546;1192;3304;156;568;552;1265;708;1833
420910;202209;41819;105900;28214;80490;4209;13789;12596;31122;16805;44911
420915;202209;577;1963;454;1645;73;299;239;869;312;1168
420917;202209;590;1443;281;710;43;87;153;386;196;473
420920;202209;110;282;47;144;4;12;11;31;15;43
420930;202209;21689;52228;16117;42633;2337;7079;8743;21014;11080;28093
420940;202209;4012;9458;2579;7065;541;1687;697;1482;1238;3169
420945;202209;230;667;137;410;24;81;58;149;82;230
420950;202209;464;1263;304;905;48;167;96;249;144;416
420960;202209;1309;3093;953;2520;149;461;459;1060;608;1521
420970;202209;2831;7209;1969;5649;409;1230;655;1852;1064;3082
420980;202209;309;1018;258;901;90;331;63;219;153;550
420985;202209;439;1149;258;797;51;175;69;177;120;352
420990;202209;437;1280;271;884;46;156;58;167;104;323
421000;202209;672;1941;474;1519;101;349;105;271;206;620
421003;202209;529;1264;189;531;13;35;15;32;28;67
421005;202209;117;328;78;243;17;51;32;103;49;154
421010;202209;4352;11092;3179;8957;569;1857;1159;2688;1728;4545
421020;202209;462;1383;371;1208;56;216;194;587;250;803
421030;202209;1243;3290;946;2692;212;669;383;995;595;1664
421040;202209;805;1851;492;1355;52;153;297;773;349;926
421050;202209;1409;3607;952;2620;143;443;383;896;526;1339
421055;202209;189;492;110;320;16;48;58;153;74;201
421060;202209;887;2394;640;1872;105;367;309;783;414;1150
421070;202209;800;2243;506;1529;83;283;223;576;306;859
421080;202209;629;1753;498;1492;85;301;219;602;304;903
421085;202209;414;1145;183;603;22;69;34;93;56;162
421090;202209;342;867;195;527;19;70;75;165;94;235
421100;202209;1048;2215;488;1312;84;243;146;322;230;565
421105;202209;1945;4913;1402;3898;223;678;654;1675;877;2353
421110;202209;1570;3718;1307;3341;119;370;849;2115;968;2485
421120;202209;1313;3780;923;2927;133;462;289;785;422;1247
421125;202209;419;1008;310;800;89;257;130;306;219;563
421130;202209;6938;18705;5715;16297;1037;3276;3052;8111;4089;11387
421140;202209;417;1085;285;821;56;169;107;270;163;439
421145;202209;501;1302;337;972;95;307;96;226;191;533
421150;202209;878;2351;602;1784;112;373;256;659;368;1032
421160;202209;735;1943;570;1610;84;290;352;906;436;1196
421165;202209;268;751;169;501;27;85;58;137;85;222
421170;202209;1423;3555;1216;3227;113;305;890;2338;1003;2643
421175;202209;1216;3020;735;2178;122;429;333;910;455;1339
421180;202209;477;1191;268;777;31;109;134;327;165;436
421185;202209;393;968;278;748;38;113;145;356;183;469
421187;202209;311;931;190;626;38;121;70;220;108;341
421189;202209;493;1339;375;1102;56;194;163;426;219;620
421190;202209;16632;42225;12168;33895;2039;6464;5482;13499;7521;19963
421200;202209;930;2420;728;2048;98;338;410;1070;508;1408
421205;202209;276;703;209;581;42;120;89;240;131;360
421210;202209;1340;3243;765;2254;169;496;248;694;417;1190
421220;202209;1746;4832;1376;4068;375;1183;486;1292;861;2475
421223;202209;461;1139;318;895;59;180;189;507;248;687
421225;202209;1212;3223;1052;2975;119;407;706;1937;825;2344
421227;202209;850;2281;557;1662;112;363;234;684;346;1047
421230;202209;714;1794;478;1360;99;318;170;460;269;778
421240;202209;321;914;149;504;25;109;29;67;54;176
421250;202209;2912;7064;2164;5858;357;969;1239;3208;1596;4177
421260;202209;285;866;74;231;17;54;9;24;26;78
421265;202209;1071;2417;925;2231;71;164;771;1841;842;2005
421270;202209;440;1169;224;716;47;157;90;264;137;421
421280;202209;2898;7264;2188;6073;327;1050;1152;2962;1479;4012
421290;202209;1318;3480;636;1842;104;316;140;345;244;661
421300;202209;367;952;187;588;33;116;33;103;66;219
421310;202209;267;741;184;568;55;178;79;228;134;406
421315;202209;361;900;232;641;49;127;77;207;126;334
421320;202209;745;2256;415;1342;41;133;59;99;100;232
421330;202209;736;2065;491;1513;109;353;138;387;247;740
421335;202209;463;1323;382;1179;59;207;188;545;247;752
421340;202209;1762;4645;1238;3700;189;628;565;1576;754;2204
421350;202209;2022;4845;1366;3769;257;761;520;1378;777;2139
421360;202209;2633;6662;1609;4637;409;1377;548;1224;957;2601
421370;202209;919;2772;595;1925;110;398;195;512;305;910
421380;202209;1047;2512;916;2317;87;268;622;1490;709;1758
421390;202209;181;481;75;254;19;68;22;64;41;132
421400;202209;734;1893;483;1405;78;265;235;593;313;858
421410;202209;225;594;115;375;30;87;29;102;59;189
421415;202209;243;638;175;470;22;72;73;164;95;236
421420;202209;738;1939;537;1504;59;191;282;731;341;922
421430;202209;108;327;71;231;9;27;14;32;23;59
421440;202209;784;2023;476;1434;89;252;198;580;287;832
421450;202209;564;1585;348;1102;52;164;49;153;101;317
421460;202209;427;1283;239;853;13;40;20;54;33;94
421470;202209;410;1093;284;851;39;125;98;292;137;417
421480;202209;3682;9415;2559;7153;364;1214;1146;2875;1510;4089
421490;202209;133;431;79;287;12;52;13;44;25;96
421500;202209;2798;7674;1963;5940;417;1460;585;1443;1002;2903
421505;202209;388;973;323;876;30;102;209;545;239;647
421507;202209;523;1367;315;920;57;180;141;369;198;549
421510;202209;496;1300;339;950;45;157;166;376;211;533
421520;202209;553;1422;336;912;48;127;137;320;185;447
421530;202209;380;1100;217;729;35;159;45;109;80;268
421535;202209;514;1266;317;868;44;130;172;434;216;564
421540;202209;408;920;229;639;28;88;81;204;109;292
421545;202209;770;2161;592;1844;114;412;298;853;412;1265
421550;202209;2755;6971;2111;5832;346;1038;1145;2997;1491;4035
421555;202209;239;659;70;227;9;30;15;26;24;56
421560;202209;107;338;65;226;9;36;22;62;31;98
421565;202209;1148;2830;821;2305;190;588;328;839;518;1427
421567;202209;620;1808;461;1388;128;420;130;383;258;803
421568;202209;379;1069;215;665;37;132;77;214;114;346
421569;202209;189;528;86;261;11;43;46;124;57;167
421570;202209;1801;4727;1321;3755;235;754;561;1366;796;2120
421575;202209;391;1066;281;775;32;113;160;397;192;510
421580;202209;5668;14630;3710;10594;520;1733;1541;3705;2061;5438
421590;202209;221;599;167;484;37;119;71;189;108;308
421600;202209;714;1798;479;1305;83;262;180;405;263;667
421605;202209;821;2083;606;1742;107;300;254;740;361;1040
421610;202209;1212;3082;835;2376;165;520;295;781;460;1301
421620;202209;4972;12443;3354;9572;648;2106;1357;3458;2005;5564
421625;202209;167;464;88;271;13;40;23;56;36;96
421630;202209;3399;8554;2276;6433;392;1260;839;2032;1231;3292
421635;202209;489;1268;318;921;27;110;180;437;207;547
421640;202209;818;2060;588;1705;129;395;287;771;416;1166
421650;202209;3141;8024;2180;6279;462;1572;780;1938;1242;3510
421660;202209;14419;37659;10625;30294;1504;4934;5302;13532;6806;18466
421670;202209;1052;2807;743;2052;139;445;348;837;487;1282
421680;202209;2157;4269;1827;3770;73;249;1574;3006;1647;3255
421690;202209;1814;4932;1247;3750;245;807;368;1008;613;1815
421700;202209;723;2034;492;1508;100;334;142;362;242;696
421710;202209;256;772;140;442;18;59;62;174;80;233
421715;202209;176;439;131;343;21;65;80;193;101;258
421720;202209;2558;6650;1532;4477;324;1056;490;1202;814;2258
421725;202209;339;802;187;521;31;95;85;196;116;291
421730;202209;629;1775;396;1135;67;195;200;511;267;706
421740;202209;995;2642;675;1992;113;368;270;669;383;1037
421750;202209;1107;2571;590;1630;124;372;215;543;339;915
421755;202209;209;568;116;345;21;73;44;108;65;181
421760;202209;1271;3166;836;2380;162;520;314;771;476;1291
421770;202209;3013;7515;2156;6050;433;1243;880;2382;1313;3625
421775;202209;252;648;152;441;20;63;57;137;77;200
421780;202209;1110;2989;736;2214;132;436;322;872;454;1308
421790;202209;1072;2795;596;1855;118;381;199;556;317;937
421795;202209;230;646;167;505;29;90;51;136;80;226
421800;202209;4004;10093;3023;8309;464;1416;1656;4252;2120;5668
421810;202209;704;1813;483;1416;58;176;250;710;308;886
421820;202209;1316;3648;872;2614;159;557;317;787;476;1344
421825;202209;1873;4355;1607;3965;116;326;1220;2929;1336;3255
421830;202209;2309;6353;1728;5163;371;1206;426;1165;797;2371
421835;202209;297;700;208;556;32;101;117;303;149;404
421840;202209;347;1045;274;887;47;186;86;254;133;440
421850;202209;459;1293;260;888;46;172;54;138;100;310
421860;202209;346;921;203;627;26;96;71;179;97;275
421870;202209;6067;14401;4633;11751;501;1587;2833;6333;3334;7920
421875;202209;370;1055;157;482;25;83;39;98;64;181
421880;202209;795;2177;531;1601;110;326;138;396;248;722
421885;202209;318;845;200;580;30;88;95;248;125;336
421890;202209;1156;3100;886;2576;131;466;537;1446;668;1912
421895;202209;509;1248;438;1137;54;128;289;774;343;902
421900;202209;1307;3324;964;2578;113;358;469;1060;582;1418
421910;202209;397;1159;222;726;33;133;51;133;84;266
421915;202209;479;1304;291;864;66;207;64;153;130;360
421917;202209;741;1623;425;1191;109;334;108;301;217;635
421920;202209;480;1401;333;1088;107;363;107;339;214;702
421930;202209;3799;9176;2202;6185;426;1310;806;1936;1232;3246
421935;202209;495;1413;404;1226;84;245;242;733;326;978
421940;202209;441;1225;211;628;31;102;71;178;102;280
421950;202209;3815;9324;2262;6356;446;1383;661;1551;1107;2934
421960;202209;188;445;105;296;10;30;40;92;50;122
421970;202209;2411;5924;1557;4199;285;895;703;1649;988;2544
421985;202209;389;1045;266;794;34;110;129;358;163;468
422000;202209;2414;5696;1962;5017;146;473;1395;3450;1541;3923
430003;202209;706;1778;491;1406;83;258;250;691;333;949
430005;202209;369;911;263;734;15;50;175;454;190;504
430010;202209;2226;4778;1666;3942;340;766;886;2111;1226;2877
430020;202209;672;1473;493;1218;61;180;309;700;370;880
430030;202209;1271;2772;730;1797;117;311;389;855;506;1166
430040;202209;11949;26515;7663;19450;1984;5334;2096;4924;4080;10258
430045;202209;651;1457;480;1168;27;84;366;851;393;935
430047;202209;287;614;113;291;23;60;36;86;59;146
430050;202209;966;2281;591;1568;108;299;274;680;382;979
430055;202209;326;767;160;433;16;54;82;192;98;246
430057;202209;105;230;46;132;12;41;13;32;25;73
430060;202209;24402;59547;19501;52026;3244;9436;10747;27443;13991;36879
430063;202209;886;2293;737;2015;141;390;422;1134;563;1524
430064;202209;1391;3442;1015;2757;174;489;548;1433;722;1922
430066;202209;130;281;99;230;8;23;79;173;87;196
430070;202209;772;1943;170;525;35;113;24;59;59;172
430080;202209;1116;2644;653;1726;97;314;350;793;447;1107
430085;202209;1070;2167;662;1543;99;251;324;714;423;965
430087;202209;1061;2413;880;2177;85;247;601;1439;686;1686
430090;202209;544;1360;207;656;33;112;46;126;79;238
430100;202209;1220;2796;723;1885;126;349;254;564;380;913
430105;202209;1665;3994;1154;3133;183;572;562;1432;745;2004
430107;202209;196;537;97;280;13;33;30;74;43;107
430110;202209;2627;6100;1968;5111;319;900;940;2341;1259;3241
430120;202209;1525;4036;1040;2901;173;474;488;1284;661;1758
430130;202209;4244;8900;3155;7425;1083;2522;666;1860;1749;4382
430140;202209;1244;3029;887;2396;134;395;461;1180;595;1575
430150;202209;663;1654;371;1075;79;250;108;282;187;532
430155;202209;283;683;129;372;22;69;24;50;46;119
430160;202209;26212;54450;21108;47535;1770;4606;14741;31556;16511;36162
430163;202209;4129;8501;2970;6830;73;247;2392;5258;2465;5505
430165;202209;362;884;132;398;13;38;26;64;39;102
430170;202209;1109;2745;387;1217;74;282;76;171;150;453
430175;202209;981;2333;840;2074;154;380;471;1125;625;1505
430180;202209;809;1904;595;1527;117;294;274;695;391;989
430185;202209;757;1869;381;1074;103;305;77;186;180;491
430187;202209;993;1937;729;1624;85;175;506;1112;591;1287
430190;202209;1750;4071;1374;3498;238;628;676;1624;914;2252
430192;202209;135;351;58;162;11;30;18;39;29;69
430195;202209;499;1378;81;258;8;24;15;38;23;62
430200;202209;1352;3584;1055;3050;314;935;277;843;591;1778
430205;202209;604;1262;558;1177;9;31;521;1068;530;1099
430210;202209;8053;19928;5134;13816;763;2263;1502;3101;2265;5364
430215;202209;398;936;248;645;37;108;106;260;143;368
430220;202209;697;1681;233;706;28;94;77;188;105;282
430222;202209;281;727;190;555;31;96;63;174;94;270
430223;202209;311;758;233;631;24;68;138;359;162;427
430225;202209;28;63;22;54;1;1;13;28;14;29
430230;202209;2422;5931;2025;5373;112;342;1620;4222;1732;4564
430235;202209;502;1309;319;932;49;154;89;206;138;360
430237;202209;634;1342;477;1099;23;66;378;836;401;902
430240;202209;1605;3591;895;2347;118;363;429;980;547;1343
430245;202209;896;2197;712;1867;120;309;430;1147;550;1456
430250;202209;1225;2767;894;2242;308;819;213;469;521;1288
430258;202209;156;391;116;313;11;32;59;154;70;186
430260;202209;835;1990;578;1540;60;184;336;865;396;1049
430265;202209;266;725;179;565;25;87;67;212;92;299
430270;202209;4011;8429;3256;7336;339;937;2419;5090;2758;6027
430280;202209;6131;13133;4441;10394;742;1801;2274;4996;3016;6797
430290;202209;2659;5528;2176;4963;138;363;1715;3776;1853;4139
430300;202209;12604;28589;9671;23822;1254;3473;5773;13296;7027;16769
430310;202209;16006;37106;11596;29294;1396;3900;6568;15283;7964;19183
430320;202209;1150;2724;659;1783;62;172;374;967;436;1139
430330;202209;780;1801;460;1181;77;202;172;397;249;599
430340;202209;741;1624;506;1259;68;170;325;773;393;943
430350;202209;10328;23327;7992;19500;1000;2611;4924;11339;5924;13950
430355;202209;394;1035;152;475;26;81;16;40;42;121
430360;202209;1022;2327;643;1678;154;448;198;451;352;899
430367;202209;420;876;262;623;40;123;152;314;192;437
430370;202209;570;1489;233;694;44;129;60;137;104;266
430380;202209;762;1804;389;1143;77;240;94;244;171;484
430390;202209;4162;9572;2733;7076;594;1662;376;722;970;2384
430400;202209;1265;2466;921;2001;162;374;447;917;609;1291
430410;202209;656;1435;475;1157;44;120;343;802;387;922
430420;202209;3591;8387;2794;6844;377;1084;1753;3870;2130;4954
430430;202209;631;1528;285;831;52;167;51;124;103;291
430435;202209;2085;4761;1552;3877;255;686;780;1866;1035;2552
430440;202209;5070;12541;4097;10998;440;1313;2615;6813;3055;8126
430450;202209;9123;19867;7474;17185;1230;3231;4270;9032;5500;12263
430460;202209;46550;107460;34523;88145;4625;13133;19536;46910;24161;60043
430461;202209;249;634;93;267;19;64;38;88;57;152
430462;202209;362;897;188;555;34;101;51;130;85;231
430463;202209;8368;20358;6243;16570;1236;3632;2849;7119;4085;10751
430465;202209;686;1565;462;1158;69;195;274;652;343;847
430466;202209;5688;13006;4600;11407;776;2067;2641;6079;3417;8146
430467;202209;614;1399;451;1152;44;130;277;653;321;783
430468;202209;1667;3744;1361;3320;101;323;1056;2468;1157;2791
430469;202209;698;1891;122;375;9;32;32;64;41;96
430470;202209;6922;16696;4642;12772;1217;3786;1265;3077;2482;6863
430471;202209;838;2088;705;1861;118;343;439;1085;557;1428
430480;202209;714;1893;457;1345;71;231;144;331;215;562
430485;202209;198;487;94;248;22;45;23;59;45;104
430490;202209;494;1196;284;785;30;92;140;324;170;416
430495;202209;451;1183;305;913;43;141;145;400;188;541
430500;202209;1169;2840;821;2282;255;790;241;584;496;1374
430510;202209;33527;81818;24512;65260;4138;12309;11309;27012;15447;39321
430511;202209;395;1056;148;463;20;52;20;48;40;100
430512;202209;1236;2547;981;2176;218;510;416;903;634;1413
430513;202209;928;2101;468;1180;62;187;265;581;327;768
430515;202209;455;1175;325;919;38;123;160;422;198;545
430517;202209;1629;4190;1251;3397;202;532;719;1934;921;2466
430520;202209;1584;3801;878;2334;144;414;240;561;384;975
430530;202209;1111;2648;469;1336;75;226;130;334;205;560
430535;202209;4312;10250;3117;8188;438;1193;1641;4047;2079;5240
430537;202209;605;1416;537;1287;47;100;420;986;467;1086
430540;202209;711;1645;433;1191;65;181;253;673;318;854
430543;202209;1254;2144;777;1589;168;322;237;538;405;860
430544;202209;827;2204;549;1606;136;426;194;545;330;971
430545;202209;3058;7089;2329;6044;378;1005;1328;3392;1706;4397
430550;202209;428;1125;320;912;83;235;97;258;180;493
430558;202209;179;394;73;188;3;7;36;88;39;95
430560;202209;340;765;178;506;28;87;61;146;89;233
430570;202209;1006;2307;712;1812;135;439;352;735;487;1174
430580;202209;959;2266;694;1867;166;450;272;783;438;1233
430583;202209;209;510;50;140;3;10;13;26;16;36
430585;202209;244;573;128;344;24;77;44;95;68;172
430587;202209;233;597;172;496;20;62;78;221;98;283
430590;202209;1609;3628;1274;3109;138;377;882;2075;1020;2452
430593;202209;32;91;24;64;6;19;11;25;17;44
430595;202209;493;1229;132;408;18;53;32;73;50;126
430597;202209;527;1257;272;757;24;69;82;171;106;240
430600;202209;2258;5653;992;2777;148;418;248;608;396;1026
430605;202209;1590;3814;1159;3079;166;467;543;1391;709;1858
430607;202209;800;1699;536;1255;31;81;368;804;399;885
430610;202209;7416;16141;5267;12972;1336;3794;1813;3981;3149;7775
430613;202209;301;673;86;235;8;23;28;62;36;85
430620;202209;900;2034;688;1665;129;371;368;749;497;1120
430630;202209;502;1316;154;447;30;85;44;108;74;193
430632;202209;501;1267;217;606;38;100;82;214;120;314
430635;202209;697;1447;516;1141;45;93;377;827;422;920
430637;202209;533;1216;413;1037;41;118;279;663;320;781
430640;202209;1313;3377;899;2559;135;408;360;899;495;1307
430642;202209;417;1120;267;768;43;144;107;274;150;418
430645;202209;193;437;99;243;11;28;36;66;47;94
430650;202209;2233;5499;1649;4574;501;1292;629;1957;1130;3249
430655;202209;363;845;219;567;28;89;121;264;149;353
430660;202209;6158;14395;4752;12204;785;2218;2543;6192;3328;8410
430670;202209;716;1628;526;1307;93;227;236;562;329;789
430673;202209;600;1304;273;727;56;147;105;255;161;402
430675;202209;283;803;73;240;13;42;11;34;24;76
430676;202209;6870;15631;5565;13662;886;2258;3375;8009;4261;10267
430680;202209;1389;3351;901;2426;287;799;298;643;585;1442
430690;202209;3802;9045;3057;7782;910;2379;1227;3024;2137;5403
430692;202209;238;687;191;607;9;32;151;487;160;519
430693;202209;1097;2752;669;1930;138;441;194;510;332;951
430695;202209;454;1042;271;681;45;118;126;292;171;410
430697;202209;568;1317;445;1146;69;182;268;695;337;877
430700;202209;9615;22130;6251;16193;1283;3659;1757;3901;3040;7560
430705;202209;434;966;216;583;25;72;94;226;119;298
430710;202209;2257;4128;1530;3188;101;272;1161;2259;1262;2531
430720;202209;947;2174;498;1383;59;182;267;674;326;856
430730;202209;1126;2890;772;2201;111;318;345;926;456;1244
430740;202209;801;2046;414;1240;76;246;122;338;198;584
430745;202209;547;1230;391;939;48;162;234;448;282;610
430750;202209;1951;4484;1266;3288;333;900;504;1216;837;2116
430755;202209;536;1266;381;967;31;98;227;516;258;614
430760;202209;2862;6546;2231;5604;453;1227;1078;2517;1531;3744
430770;202209;8815;20096;7040;17456;760;2156;4703;11122;5463;13278
430780;202209;2454;5750;1633;4401;267;782;821;2103;1088;2885
430781;202209;721;1724;472;1190;159;427;166;343;325;770
430783;202209;415;907;275;699;47;132;145;357;192;489
430786;202209;41;123;26;87;5;17;4;9;9;26
430790;202209;5769;13183;4259;10672;410;1257;2671;6131;3081;7388
430800;202209;1016;2051;773;1730;52;128;574;1222;626;1350
430805;202209;453;1040;309;763;12;43;239;548;251;591
430807;202209;693;1627;422;1121;54;178;199;441;253;619
430810;202209;887;2037;434;1181;61;203;180;413;241;616
430820;202209;1489;3956;891;2705;139;433;287;773;426;1206
430825;202209;299;701;119;297;18;42;42;99;60;141
430830;202209;2319;5438;1924;4739;132;333;1437;3368;1569;3701
430840;202209;1294;2846;909;2246;116;289;594;1429;710;1718
430843;202209;197;469;91;245;8;20;34;80;42;100
430845;202209;630;1314;435;993;49;128;288;584;337;712
430850;202209;2832;7006;1979;5469;555;1597;555;1528;1110;3125
430860;202209;1268;2957;641;1759;94;319;295;682;389;1001
430865;202209;680;1625;420;1156;99;307;113;237;212;544
430870;202209;625;1621;276;852;59;185;57;154;116;339
430880;202209;1778;3724;1258;2912;149;399;829;1783;978;2182
430885;202209;198;504;119;347;12;32;80;230;92;262
430890;202209;1291;3037;839;2277;143;467;117;271;260;738
430900;202209;3862;7442;2748;5920;133;410;2048;4055;2181;4465
430905;202209;1112;2624;761;1989;138;386;309;729;447;1115
430910;202209;2606;6666;1973;5403;313;1011;947;2233;1260;3244
430912;202209;592;1586;396;1174;52;135;235;711;287;846
430915;202209;621;1693;411;1244;116;381;109;324;225;705
430920;202209;31783;73613;25445;63476;2857;8138;16776;39732;19633;47870
430925;202209;100;215;50;131;4;13;24;62;28;75
430930;202209;14286;30673;10386;24923;1286;3343;6211;14115;7497;17458
430940;202209;1424;3453;953;2565;222;629;366;861;588;1490
430950;202209;1055;2101;700;1540;49;148;514;1025;563;1173
430955;202209;473;1190;131;365;22;59;37;89;59;148
430957;202209;216;636;192;583;38;110;111;339;149;449
430960;202209;1651;3750;962;2545;220;619;344;822;564;1441
430965;202209;1811;3939;1449;3408;61;139;1135;2669;1196;2808
430970;202209;431;991;242;648;35;99;123;302;158;401
430975;202209;597;1581;458;1284;78;243;191;483;269;726
430980;202209;504;1101;288;744;32;90;150;345;182;435
430990;202209;741;1891;509;1414;73;234;246;645;319;879
430995;202209;666;1539;479;1240;71;188;269;656;340;844
431000;202209;1610;3689;698;1967;129;371;67;161;196;532
431010;202209;3094;7630;2230;6172;427;1297;771;1832;1198;3129
431020;202209;9884;20543;5972;14599;970;2810;2771;5779;3741;8589
431030;202209;390;1022;195;622;42;148;32;99;74;247
431033;202209;4952;10982;3380;8506;732;1854;1276;3112;2008;4966
431036;202209;356;761;78;221;3;10;27;60;30;70
431040;202209;1047;2439;681;1839;76;256;368;892;444;1148
431041;202209;514;1129;357;878;66;161;171;381;237;542
431043;202209;467;1124;284;776;31;113;168;405;199;518
431046;202209;119;300;47;138;6;19;9;20;15;39
431050;202209;1538;3423;1105;2750;190;463;606;1499;796;1962
431053;202209;819;1989;446;1280;87;270;152;346;239;616
431055;202209;708;1589;553;1345;52;130;390;947;442;1077
431057;202209;242;678;146;458;31;107;54;154;85;261
431060;202209;6839;15700;4715;12265;1069;3014;1766;4192;2835;7206
431065;202209;488;1151;359;934;53;150;188;466;241;616
431070;202209;488;1249;291;837;64;206;74;198;138;404
431075;202209;295;773;168;493;36;124;66;167;102;291
431080;202209;681;1793;473;1370;74;228;162;417;236;645
431085;202209;939;2294;533;1409;57;165;261;661;318;826
431087;202209;492;1250;391;1051;55;151;235;608;290;759
431090;202209;476;1073;183;541;30;90;44;128;74;218
431100;202209;4968;9780;3587;8042;346;853;2420;5142;2766;5995
431110;202209;1747;3732;1222;2833;173;450;641;1330;814;1780
431112;202209;780;1859;650;1636;77;227;445;1055;522;1282
431113;202209;598;1421;477;1199;106;278;271;634;377;912
431115;202209;1183;3050;919;2580;93;339;636;1662;729;2001
431120;202209;3251;7715;2224;5811;513;1481;828;1944;1341;3425
431123;202209;417;1035;280;765;45;121;146;389;191;510
431125;202209;1392;3325;1004;2624;295;769;483;1270;778;2039
431127;202209;234;616;70;212;7;27;10;23;17;50
431130;202209;3948;9051;3065;7709;470;1297;1649;3953;2119;5250
431140;202209;6861;15719;4272;10981;515;1477;1937;4178;2452;5655
431142;202209;757;1690;564;1393;87;234;371;888;458;1122
431150;202209;1208;2985;879;2414;132;394;459;1197;591;1591
431160;202209;796;2000;526;1456;124;367;161;413;285;780
431162;202209;668;1582;439;1173;39;127;248;597;287;724
431164;202209;202;461;56;166;6;16;13;31;19;47
431170;202209;545;1376;402;1093;118;314;97;246;215;560
431171;202209;1047;2105;882;1904;179;354;603;1301;782;1655
431173;202209;544;1321;388;1095;117;385;121;294;238;679
431175;202209;1543;3400;951;2389;142;353;414;983;556;1336
431177;202209;1099;2648;835;2232;154;447;462;1189;616;1636
431179;202209;372;815;120;350;22;65;38;110;60;175
431180;202209;2749;6669;1704;4646;381;1062;408;947;789;2009
431190;202209;688;1668;289;816;34;102;67;149;101;251
431198;202209;488;1317;396;1146;86;259;173;508;259;767
431200;202209;386;945;115;310;23;58;16;41;39;99
431205;202209;268;678;149;427;49;139;43;117;92;256
431210;202209;766;1664;608;1431;131;308;288;704;419;1012
431213;202209;325;805;245;654;18;47;126;316;144;363
431215;202209;707;1645;364;1025;38;122;187;491;225;613
431217;202209;203;495;141;375;29;92;60;141;89;233
431220;202209;691;1622;437;1160;78;206;224;538;302;744
431225;202209;1838;3884;1419;3249;134;331;1001;2230;1135;2561
431230;202209;853;2201;640;1727;133;417;314;727;447;1144
431235;202209;199;543;28;93;0;0;7;21;7;21
431237;202209;422;1225;325;1023;48;172;165;498;213;670
431238;202209;42;118;34;103;7;19;15;38;22;57
431240;202209;6108;13747;4923;11902;522;1530;3192;7156;3714;8686
431242;202209;350;801;295;695;34;94;200;453;234;547
431244;202209;459;1071;243;623;31;89;106;236;137;325
431245;202209;1544;3411;1021;2526;85;220;541;1237;626;1457
431247;202209;327;752;210;531;30;93;103;217;133;310
431250;202209;2216;5023;1702;4343;387;952;870;2301;1257;3253
431260;202209;357;926;216;643;27;98;83;223;110;321
431261;202209;320;903;261;803;27;107;150;419;177;526
431262;202209;318;873;165;529;26;95;87;271;113;366
431265;202209;1820;4148;734;2026;119;373;218;494;337;867
431267;202209;289;696;193;505;21;64;124;298;145;362
431270;202209;3338;6955;1799;4407;403;1073;621;1418;1024;2491
431275;202209;175;449;115;313;23;69;58;138;81;207
431280;202209;288;777;123;397;22;66;18;45;40;111
431290;202209;425;1217;276;865;57;200;51;139;108;339
431295;202209;83;200;31;87;7;24;8;17;15;41
431300;202209;341;883;89;271;9;36;32;82;41;118
431301;202209;301;817;84;254;12;40;10;22;22;62
431303;202209;767;1821;463;1226;35;107;205;454;240;561
431306;202209;2665;6090;1669;4404;201;579;726;1682;927;2261
431308;202209;43;119;36;102;11;31;17;49;28;80
431310;202209;627;1552;445;1174;66;171;224;537;290;708
431320;202209;819;2145;491;1464;79;250;161;419;240;669
431330;202209;2151;4840;1191;3155;160;473;569;1319;729;1792
431333;202209;243;618;134;381;21;63;45;112;66;175
431335;202209;37;106;20;71;6;24;0;0;6;24
431337;202209;4436;9630;3666;8510;227;739;2939;6426;3166;7165
431339;202209;520;1247;374;1000;94;240;151;411;245;651
431340;202209;22412;51626;16059;41132;2224;6436;8553;20150;10777;26586
431342;202209;473;1034;350;839;47;114;237;558;284;672
431344;202209;413;1006;225;634;37;100;124;336;161;436
431346;202209;243;592;85;269;15;47;17;44;32;91
431349;202209;1121;2398;748;1689;113;290;452;938;565;1228
431350;202209;5769;13272;4494;11273;566;1609;2767;6472;3333;8081
431360;202209;662;1506;334;892;88;261;101;238;189;499
431365;202209;2760;5616;2173;4843;110;295;1786;3838;1896;4133
431370;202209;5923;13008;4404;10687;837;2206;2375;5544;3212;7750
431380;202209;1083;2689;867;2344;182;513;482;1283;664;1796
431390;202209;3213;7476;2076;5530;211;684;1136;2609;1347;3293
431395;202209;2044;4263;1572;3584;171;413;1090;2380;1261;2793
431400;202209;354;955;199;607;39;119;40;100;79;219
431402;202209;1080;2200;809;1802;102;244;551;1166;653;1410
431403;202209;224;613;175;520;42;147;74;187;116;334
431405;202209;6575;15884;5185;13609;862;2602;2616;6229;3478;8831
431406;202209;674;1720;448;1245;117;291;154;465;271;756
431407;202209;615;1550;425;1162;64;162;242;639;306;801
431410;202209;22594;51771;16133;41114;2113;6293;9545;22062;11658;28355
431413;202209;286;781;66;211;9;25;20;55;29;80
431415;202209;871;2017;578;1517;117;356;252;568;369;924
431417;202209;639;1326;416;978;66;187;232;506;298;693
431420;202209;2030;4152;1546;3514;114;311;1050;2238;1164;2549
431430;202209;666;1607;334;957;49;156;119;299;168;455
431440;202209;43019;91128;32237;75268;5073;13253;17096;35815;22169;49068
431442;202209;169;460;78;255;11;35;10;33;21;68
431445;202209;413;1139;125;405;10;36;22;54;32;90
431446;202209;332;901;256;749;29;88;136;383;165;471
431447;202209;901;2212;514;1447;88;246;160;449;248;695
431449;202209;945;2222;632;1644;99;271;324;765;423;1036
431450;202209;3012;5387;2373;4518;145;254;1918;3516;2063;3770
431454;202209;50;156;41;134;7;24;24;72;31;96
431455;202209;654;1475;336;848;30;72;177;405;207;477
431460;202209;3627;7922;2412;5859;510;1293;956;2203;1466;3496
431470;202209;1650;4212;1205;3338;235;708;466;1197;701;1905
431475;202209;295;781;60;198;4;13;8;16;12;29
431477;202209;538;1286;302;821;75;184;105;267;180;451
431478;202209;250;667;57;176;10;29;6;12;16;41
431480;202209;4037;9576;3177;8218;750;1972;1393;3555;2143;5527
431490;202209;148661;318787;115833;269731;6670;19361;88058;193238;94728;212599
431500;202209;566;1354;426;1106;60;162;226;555;286;717
431505;202209;296;674;200;530;20;55;137;359;157;414
431507;202209;361;838;141;407;42;129;22;50;64;179
431510;202209;2032;4840;1378;3589;402;1045;388;1019;790;2064
431513;202209;259;549;139;349;36;112;42;70;78;182
431514;202209;145;339;115;291;4;13;79;179;83;192
431515;202209;633;1402;471;1121;105;266;255;565;360;831
431517;202209;74;212;60;184;8;30;26;73;34;103
431520;202209;438;1038;188;535;26;89;84;188;110;277
431530;202209;6209;12990;3823;9396;774;1993;1656;3841;2430;5834
431531;202209;252;582;151;396;28;72;53;131;81;203
431532;202209;714;1519;413;998;75;197;194;450;269;647
431535;202209;326;812;150;434;30;87;32;85;62;172
431540;202209;2082;5925;1900;5686;91;286;1472;4469;1563;4755
431545;202209;399;960;87;226;11;23;34;85;45;108
431550;202209;2602;6135;1840;4748;258;755;999;2387;1257;3142
431555;202209;811;1720;484;1171;47;123;281;676;328;799
431560;202209;30592;68950;21115;54341;4093;10247;8483;22073;12576;32320
431570;202209;6449;12835;5543;11587;273;766;4665;9191;4938;9957
431575;202209;447;990;379;881;80;160;224;506;304;666
431580;202209;736;1806;484;1324;58;192;264;660;322;852
431590;202209;870;2231;616;1711;133;369;240;627;373;996
431595;202209;434;1091;276;775;55;161;100;253;155;414
431600;202209;2099;4754;1500;3821;270;769;690;1613;960;2382
431610;202209;1729;3902;1138;2884;175;443;490;1311;665;1754
431620;202209;551;1318;299;778;63;186;151;323;214;509
431630;202209;1530;3600;717;1993;154;480;235;569;389;1049
431640;202209;8283;17207;7014;15596;760;1921;4934;10547;5694;12468
431642;202209;771;1643;469;1119;97;206;208;469;305;675
431643;202209;418;987;198;543;21;53;70;178;91;231
431645;202209;2848;5141;2266;4416;41;107;1999;3769;2040;3876
431647;202209;358;821;124;341;14;40;35;82;49;122
431650;202209;165;447;120;370;17;61;53;136;70;197
431660;202209;1076;2695;519;1556;90;314;129;339;219;653
431670;202209;1432;3244;858;2225;136;366;400;930;536;1296
431673;202209;259;671;105;342;11;35;33;99;44;134
431675;202209;420;1068;117;397;18;65;18;51;36;116
431680;202209;11348;25858;8582;21011;1683;4614;4347;9652;6030;14266
431690;202209;31281;70930;22642;56174;3292;9389;12687;29243;15979;38632
431695;202209;263;611;153;409;24;95;86;188;110;283
431697;202209;549;1187;424;1001;78;181;238;551;316;732
431700;202209;1765;3969;1388;3335;220;472;746;1815;966;2287
431710;202209;17622;37039;12947;30664;1604;4197;8194;18549;9798;22746
431720;202209;8262;18804;5068;13204;1222;3354;1253;2783;2475;6137
431725;202209;43;105;32;87;9;31;16;37;25;68
431730;202209;5420;11786;3639;9119;669;1847;1824;4246;2493;6093
431740;202209;6314;14193;4260;10868;1015;2891;1310;2934;2325;5825
431750;202209;9835;23446;7316;19499;1759;4927;2681;6891;4440;11818
431755;202209;366;972;92;301;8;34;23;64;31;98
431760;202209;6321;13442;4398;10430;477;1316;2714;5920;3191;7236
431770;202209;2452;5120;1873;4347;290;628;1230;2867;1520;3495
431775;202209;243;594;134;384;31;100;31;70;62;170
431780;202209;2552;5780;1682;4258;281;755;640;1539;921;2294
431790;202209;893;2234;607;1671;138;384;252;660;390;1044
431795;202209;316;758;148;422;24;69;47;124;71;193
431800;202209;10105;22468;6491;16914;1800;5530;806;1808;2606;7338
431805;202209;321;806;70;248;3;7;4;8;7;15
431810;202209;3897;8308;2499;5879;370;951;1404;3019;1774;3970
431820;202209;2576;6276;1978;5355;480;1473;889;2263;1369;3736
431830;202209;10560;21976;7721;18149;2287;6110;1348;3240;3635;9350
431840;202209;3390;7732;2744;6751;381;1011;1744;4188;2125;5199
431842;202209;564;1358;198;579;34;115;63;159;97;274
431843;202209;366;946;252;708;57;175;108;278;165;453
431844;202209;214;575;77;247;15;48;17;52;32;100
431845;202209;576;1398;388;1029;35;99;241;615;276;714
431846;202209;356;795;309;729;16;39;274;642;290;681
431848;202209;186;469;100;285;10;33;33;77;43;110
431849;202209;412;991;81;228;11;32;16;32;27;64
431850;202209;5179;12801;3985;10609;964;2773;1340;3313;2304;6086
431860;202209;775;1716;443;1107;55;151;278;649;333;800
431861;202209;122;323;77;225;18;59;25;60;43;119
431862;202209;579;1715;476;1530;91;344;227;682;318;1026
431870;202209;27773;63726;22362;55584;2158;6213;14764;34585;16922;40798
431880;202209;4791;11300;3512;9138;435;1324;1938;4683;2373;6007
431890;202209;5992;13847;3859;9923;1089;2874;1028;2552;2117;5426
431900;202209;1244;2966;812;2200;132;399;390;935;522;1334
431910;202209;899;2019;361;939;58;150;115;235;173;385
431912;202209;647;1486;528;1296;68;180;359;856;427;1036
431915;202209;1389;2911;1107;2491;68;174;872;1883;940;2057
431920;202209;1578;3123;1309;2790;34;79;1164;2433;1198;2512
431930;202209;867;2069;593;1588;208;544;196;527;404;1071
431935;202209;99;248;71;200;12;38;17;40;29;78
431936;202209;365;941;207;563;40;115;111;288;151;403
431937;202209;185;465;124;351;27;69;44;118;71;187
431940;202209;3598;7815;2330;5635;174;489;1474;3301;1648;3790
431950;202209;2632;6146;2066;5262;513;1333;914;2249;1427;3582
431960;202209;3658;8256;2785;6766;789;2005;793;1823;1582;3828
431970;202209;490;1198;229;630;50;150;61;147;111;297
431971;202209;93;232;48;141;8;25;13;37;21;62
431973;202209;691;1933;465;1476;44;164;336;1046;380;1210
431975;202209;128;261;38;102;8;24;9;18;17;42
431980;202209;1417;3111;1141;2706;124;390;778;1653;902;2043
431990;202209;7821;17242;5526;14061;432;1356;3497;8486;3929;9842
432000;202209;17697;37978;13370;31541;1698;4538;8637;19021;10335;23559
432010;202209;3275;7176;2204;5498;499;1296;753;1723;1252;3019
432020;202209;1924;4830;1206;3358;354;1020;280;742;634;1762
432023;202209;627;1404;305;800;41;110;136;304;177;414
432026;202209;1228;3038;943;2499;270;723;353;968;623;1691
432030;202209;521;1155;299;772;22;58;178;420;200;478
432032;202209;395;960;259;685;24;74;139;327;163;401
432035;202209;831;2157;695;1926;172;444;347;996;519;1440
432040;202209;1276;2898;524;1492;51;166;234;577;285;743
432045;202209;204;530;124;368;20;65;53;147;73;212
432050;202209;666;1523;484;1217;58;184;257;617;315;801
432055;202209;821;1940;558;1469;176;439;158;424;334;863
432057;202209;177;445;149;380;7;17;104;240;111;257
432060;202209;499;1180;148;455;14;50;41;118;55;168
432065;202209;261;669;197;541;50;145;91;236;141;381
432067;202209;986;2465;825;2131;80;232;580;1447;660;1679
432070;202209;1969;4605;1424;3648;206;597;737;1699;943;2296
432080;202209;6082;12887;4543;10612;700;1986;2347;4953;3047;6939
432085;202209;470;1174;361;1007;69;212;186;487;255;699
432090;202209;3239;7621;1947;5231;446;1115;796;2009;1242;3124
432100;202209;1077;2580;536;1573;99;306;102;234;201;540
432110;202209;2661;6250;1944;5043;456;1292;494;1071;950;2363
432120;202209;4360;10762;3517;9393;561;1695;1859;4575;2420;6270
432130;202209;3324;7518;2758;6716;472;1174;1531;3710;2003;4884
432132;202209;300;758;164;470;24;76;79;192;103;268
432135;202209;1212;2578;832;1958;87;209;558;1314;645;1523
432140;202209;2291;5749;1814;4882;223;687;1211;3098;1434;3785
432143;202209;1844;4486;1401;3791;109;338;884;2314;993;2652
432145;202209;2076;5217;1365;3801;205;621;453;1031;658;1652
432146;202209;147;389;115;350;42;145;35;97;77;242
432147;202209;648;1695;344;1033;121;376;57;170;178;546
432149;202209;581;1325;274;725;31;78;116;276;147;354
432150;202209;4786;10994;3632;9138;677;1941;1841;4160;2518;6101
432160;202209;7738;17848;5897;15101;1440;3935;2309;5724;3749;9659
432162;202209;231;511;40;119;6;19;10;17;16;36
432163;202209;187;450;36;101;3;11;5;6;8;17
432166;202209;762;1966;618;1696;112;360;240;577;352;937
432170;202209;1831;4636;1263;3627;218;677;525;1353;743;2030
432180;202209;3545;7886;1949;5038;298;869;890;1967;1188;2836
432183;202209;448;1201;334;956;68;234;148;384;216;618
432185;202209;1018;2443;618;1692;118;352;272;684;390;1036
432190;202209;2581;5755;1856;4653;166;517;1236;2836;1402;3353
432195;202209;1161;2812;736;2024;136;374;261;697;397;1071
432200;202209;4441;9941;3381;8369;242;669;2425;5751;2667;6420
432210;202209;507;1185;350;907;45;130;203;461;248;591
432215;202209;781;1947;682;1797;106;265;425;1117;531;1382
432218;202209;266;619;117;311;15;47;42;81;57;128
432220;202209;4348;9450;3145;7522;536;1321;1737;3959;2273;5280
432225;202209;169;428;111;315;16;41;53;151;69;192
432230;202209;910;2072;445;1207;58;194;190;439;248;633
432232;202209;586;1374;372;1022;69;204;169;416;238;620
432234;202209;344;823;175;488;36;86;45;109;81;195
432235;202209;59;150;31;79;6;19;15;29;21;48
432237;202209;352;853;305;776;8;27;259;638;267;665
432240;202209;20866;45451;15516;38512;1383;3366;10761;26386;12144;29752
432250;202209;7854;19825;5904;16096;1113;3324;3026;7767;4139;11091
432252;202209;552;1239;358;876;44;119;192;429;236;548
432253;202209;1077;2885;738;2077;211;633;167;414;378;1047
432254;202209;725;1646;218;619;30;87;35;71;65;158
432255;202209;126;306;75;201;10;29;40;94;50;123
432260;202209;6772;15818;5123;12856;1052;2873;2432;5539;3484;8412
432270;202209;2681;6515;2153;5591;648;1753;746;1860;1394;3613
432280;202209;1540;3690;830;2339;127;406;282;646;409;1052
432285;202209;157;461;35;100;4;10;9;25;13;35
432290;202209;415;1045;263;724;59;179;85;187;144;366
432300;202209;36755;82939;28400;70160;2601;7750;19531;45255;22132;53005
432310;202209;1248;2726;961;2247;112;238;738;1727;850;1965
432320;202209;235;527;107;297;14;40;37;84;51;124
432330;202209;222;492;70;222;11;35;14;45;25;80
432335;202209;189;547;71;253;9;27;13;37;22;64
432340;202209;382;937;172;537;32;106;53;159;85;265
432345;202209;994;1878;852;1710;14;39;756;1471;770;1510
432350;202209;385;905;191;544;38;124;55;126;93;250
432360;202209;251;724;51;167;5;14;15;41;20;55
432370;202209;411;908;243;625;26;78;142;345;168;423
432375;202209;621;1427;428;1060;117;306;146;361;263;667
432377;202209;179;534;44;152;2;7;11;26;13;33
432380;202209;2359;6077;1676;4846;263;823;874;2428;1137;3251
500020;202209;3974;9062;2842;7325;249;794;1931;4767;2180;5561
500025;202209;1359;3197;868;2301;108;301;478;1204;586;1505
500060;202209;9899;25530;6972;19625;894;2747;4036;11120;4930;13867
500070;202209;6048;13956;4356;11203;787;2211;2122;5299;2909;7510
500080;202209;1881;4335;1159;3051;197;585;454;1033;651;1618
500085;202209;2453;5736;1721;4456;438;1225;666;1569;1104;2794
500090;202209;2468;6034;1683;4745;279;844;511;1537;790;2381
500100;202209;4559;10778;3444;9027;550;1581;1460;3534;2010;5115
500110;202209;12500;28385;8710;22596;1681;4661;4232;10780;5913;15441
500124;202209;2698;6930;2177;6128;331;913;1340;3819;1671;4732
500150;202209;1860;3866;1309;3134;234;640;712;1554;946;2194
500190;202209;6086;14762;3999;10898;836;2371;1409;3503;2245;5874
500200;202209;3301;7064;2229;5341;193;482;1434;3254;1627;3736
500210;202209;6167;13128;4422;10889;1171;2964;2231;5364;3402;8328
500215;202209;1726;4392;1277;3607;132;407;729;2007;861;2414
500220;202209;3935;9788;2896;8068;453;1329;1500;3898;1953;5227
500230;202209;2492;5384;1915;4606;248;637;1242;2889;1490;3526
500240;202209;5022;13652;3656;10902;541;1710;1563;4653;2104;6363
500260;202209;3922;7871;2549;6018;267;715;1555;3425;1822;4140
500270;202209;179087;396551;116622;296231;16026;46162;54232;123531;70258;169693
500280;202209;1674;3914;1104;3048;171;475;605;1669;776;2144
500290;202209;4461;10244;2761;7389;427;1312;1054;2486;1481;3798
500295;202209;4882;11085;3226;8281;564;1658;1373;3044;1937;4702
500310;202209;1247;2342;831;1829;118;215;478;1051;596;1266
500315;202209;5624;12542;4615;11181;296;797;3757;8880;4053;9677
500320;202209;24940;61214;17357;48991;4238;11985;6867;20203;11105;32188
500325;202209;7192;14834;5089;12019;615;1586;3142;7104;3757;8690
500330;202209;8332;17656;5563;13689;531;1366;3154;7709;3685;9075
500345;202209;2627;6095;1783;4744;300;844;679;1709;979;2553
500348;202209;2866;6727;2172;5591;183;535;1472;3694;1655;4229
500350;202209;1439;3742;837;2498;99;313;305;818;404;1131
500370;202209;33332;81148;24318;66657;3124;9821;12429;32571;15553;42392
500375;202209;3127;7699;2001;5467;269;797;794;1897;1063;2694
500380;202209;4302;10072;3018;7974;862;2300;541;1457;1403;3757
500390;202209;751;1508;465;1159;66;179;268;670;334;849
500400;202209;1911;4629;1265;3396;204;623;486;1149;690;1772
500410;202209;2900;6378;2022;5129;236;561;1110;2950;1346;3511
500430;202209;3382;7823;2311;6233;359;966;944;2745;1303;3711
500440;202209;1951;4416;1084;2936;178;489;411;1131;589;1620
500450;202209;2266;5312;1451;3953;283;785;377;962;660;1747
500460;202209;4590;11296;2824;7959;506;1583;714;1840;1220;3423
500470;202209;3249;8307;2143;6104;507;1583;599;1429;1106;3012
500480;202209;2386;6931;1956;6257;195;657;1402;4537;1597;5194
500490;202209;1404;3110;847;2254;160;492;226;592;386;1084
500500;202209;4895;12170;3246;9624;984;3266;371;1161;1355;4427
500510;202209;849;2016;565;1509;34;118;382;935;416;1053
500515;202209;1984;4799;1515;4079;207;610;837;2187;1044;2797
500520;202209;4178;11016;3206;9399;698;1997;1586;4820;2284;6817
500525;202209;1180;3189;933;2815;131;423;560;1645;691;2068
500540;202209;6336;15642;3870;11294;1093;3552;628;1543;1721;5095
500560;202209;6698;16341;5392;14721;235;719;4471;12225;4706;12944
500568;202209;5624;11511;3500;8371;684;1721;1512;3236;2196;4957
500570;202209;10323;22474;7141;17402;949;2711;3940;8668;4889;11379
500580;202209;3799;9169;2752;7381;661;1851;1222;3216;1883;5067
500600;202209;4490;10560;3290;8676;748;2104;1012;2575;1760;4679
500620;202209;9887;24151;6885;18621;1025;2999;3451;8654;4476;11653
500625;202209;648;1660;443;1263;71;224;182;479;253;703
500627;202209;949;2421;590;1788;98;309;172;484;270;793
500630;202209;9294;19692;5509;13747;1138;3065;1793;4157;2931;7222
500635;202209;3220;9706;2395;8562;264;838;1618;6283;1882;7121
500640;202209;2177;4390;1454;3450;69;183;1003;2251;1072;2434
500660;202209;24888;57507;17258;46707;5155;14386;5862;15949;11017;30335
500690;202209;3284;7741;2270;6165;593;1808;978;2489;1571;4297
500710;202209;3891;9651;2823;7836;674;2068;886;2320;1560;4388
500720;202209;6129;14888;4112;11516;830;2526;1382;3660;2212;6186
500730;202209;1282;2967;710;1957;141;385;217;587;358;972
500740;202209;5660;12735;3642;9649;704;1961;1561;3948;2265;5909
500750;202209;1354;3147;948;2488;133;393;428;992;561;1385
500755;202209;1366;3321;861;2396;150;462;262;633;412;1095
500769;202209;6301;14691;3549;9718;879;2500;506;1197;1385;3697
500770;202209;1736;4378;1198;3492;224;686;417;1147;641;1833
500780;202209;1544;3628;1002;2700;178;545;263;581;441;1126
500790;202209;8848;22270;6429;17978;1274;3876;2420;6617;3694;10493
500793;202209;2538;6011;1827;4821;358;1010;772;1851;1130;2861
500795;202209;3607;7698;2890;6764;212;429;2324;5541;2536;5970
500797;202209;965;2308;640;1722;196;572;195;484;391;1056
500800;202209;4244;9151;2647;6774;730;2082;561;1471;1291;3553
500830;202209;24128;56227;16549;42864;3563;9776;6187;14932;9750;24708
500840;202209;1746;3979;1088;2743;128;342;530;1217;658;1559
510010;202209;2188;4475;1556;3679;202;464;1036;2438;1238;2902
510020;202209;4969;11899;2735;7640;475;1406;799;1963;1274;3369
510025;202209;8894;20193;5824;15435;673;1948;3202;7986;3875;9934
510030;202209;3783;7772;2523;5895;252;620;1340;3026;1592;3646
510035;202209;1354;3414;871;2632;246;752;318;1042;564;1794
510040;202209;2925;6058;2208;5172;264;543;1402;3403;1666;3946
510050;202209;2754;5227;1925;4190;215;573;1375;2844;1590;3417
510060;202209;1816;4351;1231;3311;290;821;283;622;573;1443
510080;202209;1870;4512;1255;3525;217;671;556;1456;773;2127
510100;202209;827;1770;599;1435;68;191;369;812;437;1003
510120;202209;329;560;192;402;8;17;154;307;162;324
510125;202209;2492;5982;1919;5092;240;764;981;2354;1221;3118
510130;202209;1986;4585;1413;3700;300;852;693;1700;993;2552
510140;202209;3667;9050;2516;7567;922;3043;810;2485;1732;5528
510160;202209;2361;4980;1856;4347;48;138;1669;3868;1717;4006
510170;202209;6060;14581;4612;12296;893;2585;2192;5632;3085;8217
510180;202209;18276;37765;12442;29715;1985;5189;6387;15315;8372;20504
510185;202209;2111;5219;1379;4155;531;1637;334;1248;865;2885
510190;202209;2879;7536;1801;5755;464;1591;365;1240;829;2831
510250;202209;21277;49230;15918;41357;2320;6641;9226;23672;11546;30313
510260;202209;2159;8758;1812;8177;267;1156;1091;5587;1358;6743
510263;202209;4460;11775;2961;8838;553;1843;709;1822;1262;3665
510267;202209;6788;18503;4025;12362;720;2369;769;1977;1489;4346
510268;202209;1577;3863;1103;3074;307;908;289;655;596;1563
510269;202209;1212;3080;786;2318;151;502;325;890;476;1392
510270;202209;3590;9612;2518;7763;387;1316;1089;3276;1476;4592
510279;202209;2169;5366;1265;3722;181;589;388;1012;569;1601
510285;202209;1280;3194;847;2431;216;683;272;691;488;1374
510300;202209;4874;10958;3704;9462;269;713;2740;7036;3009;7749
510305;202209;1760;4544;1160;3456;240;727;353;1061;593;1788
510310;202209;1243;2904;886;2350;223;571;334;923;557;1494
510320;202209;4837;11064;3364;8715;754;2161;1090;2467;1844;4628
510325;202209;5305;14683;3614;11371;844;2801;866;2683;1710;5484
510330;202209;3155;8675;2095;6884;484;1696;801;2779;1285;4475
510335;202209;5950;15918;4528;13629;792;2606;2348;6991;3140;9597
510336;202209;604;1592;439;1342;66;189;235;783;301;972
510337;202209;1788;4821;1173;3750;420;1434;309;959;729;2393
510340;202209;118194;249542;81748;198722;16595;45781;35766;79645;52361;125426
510343;202209;1496;3364;1002;2574;128;383;563;1339;691;1722
510345;202209;1560;3964;1180;3269;202;574;625;1586;827;2160
510350;202209;3823;9009;2553;6999;764;2162;661;1747;1425;3909
510360;202209;2414;4482;1470;3402;56;104;1077;2609;1133;2713
510370;202209;2123;5618;1622;4831;246;756;995;2988;1241;3744
510380;202209;663;1521;387;1059;47;153;169;440;216;593
510385;202209;1465;4578;1087;3899;100;433;739;2718;839;3151
510390;202209;1697;3845;1181;3250;295;801;634;1794;929;2595
510395;202209;837;1712;563;1330;32;69;407;967;439;1036
510410;202209;6195;15424;4589;12775;731;2106;2793;7790;3524;9896
510420;202209;3109;5768;2168;4550;79;185;1694;3481;1773;3666
510450;202209;638;1462;375;1017;85;227;124;311;209;538
510452;202209;1072;2840;791;2309;120;374;445;1272;565;1646
510454;202209;1360;3349;983;2731;146;373;587;1750;733;2123
510455;202209;1115;2828;729;2108;145;463;279;728;424;1191
510460;202209;2386;5644;1711;4627;533;1660;642;1389;1175;3049
510480;202209;5916;13543;3919;9955;695;1945;1736;3967;2431;5912
510490;202209;2099;4855;1583;4210;250;681;1014;2705;1264;3386
510500;202209;1795;4152;1090;3055;256;760;291;774;547;1534
510510;202209;4799;12468;3404;10163;995;3240;1066;3135;2061;6375
510515;202209;6470;15603;4430;12105;874;2660;1660;4020;2534;6680
510517;202209;1854;4488;1268;3629;485;1497;304;775;789;2272
510520;202209;2771;5392;1523;3787;154;410;680;1749;834;2159
510523;202209;1426;3154;1007;2530;125;350;660;1592;785;1942
510525;202209;9851;25354;7292;20520;1213;3711;3238;8456;4451;12167
510530;202209;639;1551;473;1322;46;138;310;876;356;1014
510550;202209;3110;8312;2356;7071;439;1446;1266;3665;1705;5111
510558;202209;2732;6946;2010;5843;260;685;1062;3311;1322;3996
510560;202209;2190;5866;1379;4296;334;1091;285;916;619;2007
510562;202209;7161;16030;5329;13009;819;2082;2800;6576;3619;8658
510590;202209;3836;8744;2797;7442;265;731;2001;5362;2266;6093
510600;202209;1409;2837;1003;2274;108;276;618;1297;726;1573
510610;202209;3324;7389;2301;6036;333;1009;1354;3408;1687;4417
510615;202209;3447;7961;2421;6395;342;962;1487;3892;1829;4854
510617;202209;1273;3499;1018;3130;119;400;733;2313;852;2713
510618;202209;1524;3720;1078;3031;207;678;552;1464;759;2142
510619;202209;900;2204;501;1464;96;286;102;239;198;525
510620;202209;1595;3469;799;2199;302;928;62;127;364;1055
510621;202209;1866;4705;1114;3333;259;818;292;756;551;1574
510622;202209;6564;17088;4206;12269;1281;4018;628;1573;1909;5591
510623;202209;3377;7769;2417;6298;513;1474;951;2391;1464;3865
510624;202209;1960;4926;1042;3236;120;408;218;604;338;1012
510625;202209;4214;9622;2588;6837;500;1439;906;2311;1406;3750
510626;202209;1677;3978;1117;3105;280;854;297;816;577;1670
510627;202209;751;1828;417;1207;107;319;114;347;221;666
510628;202209;1800;3764;1158;2961;368;1061;448;1040;816;2101
510629;202209;2066;5355;1376;4106;299;967;382;1101;681;2068
510630;202209;4056;10519;2567;7877;589;1902;643;2084;1232;3986
510631;202209;714;1545;540;1298;20;40;426;1033;446;1073
510637;202209;4346;9577;3099;7844;723;2055;1166;2840;1889;4895
510642;202209;7141;18113;5540;15812;928;3043;3355;9290;4283;12333
510645;202209;1215;2255;749;1675;167;364;354;804;521;1168
510650;202209;8702;19730;6899;17775;900;1511;5024;14261;5924;15772
510665;202209;2052;4250;1290;3085;284;608;518;1352;802;1960
510670;202209;513;1046;304;767;34;83;159;397;193;480
510675;202209;7863;20328;5302;15635;1317;4331;987;2611;2304;6942
510677;202209;2715;6524;1943;5400;346;1064;1096;2964;1442;4028
510680;202209;848;2050;490;1428;94;305;135;334;229;639
510682;202209;2059;5463;1530;4628;496;1666;526;1499;1022;3165
510685;202209;633;1660;457;1332;48;131;269;793;317;924
510700;202209;5168;11376;3602;9221;348;1027;2508;6227;2856;7254
510704;202209;13488;30270;9145;23160;2195;5921;2747;6288;4942;12209
510706;202209;2874;7873;1978;6395;365;1225;819;2857;1184;4082
510710;202209;3588;8327;2266;5917;564;1442;679;1665;1243;3107
510715;202209;773;1517;511;1179;52;145;312;679;364;824
510718;202209;2720;5970;1660;4543;353;958;753;2322;1106;3280
510719;202209;566;1142;334;814;38;110;173;374;211;484
510720;202209;1104;2381;729;1856;179;490;301;708;480;1198
510724;202209;1058;2820;717;2168;100;347;334;924;434;1271
510726;202209;1097;1977;634;1426;72;168;347;762;419;930
510729;202209;694;1551;323;875;44;134;90;250;134;384
510730;202209;3590;8167;2476;6499;359;1082;1337;3251;1696;4333
510735;202209;1505;3874;1222;3491;95;261;990;2845;1085;3106
510740;202209;1188;2692;813;2051;83;247;518;1192;601;1439
510757;202209;613;1881;484;1672;150;595;191;610;341;1205
510760;202209;54624;113827;34055;83734;6729;18685;13090;28654;19819;47339
510770;202209;5039;10345;3551;8490;261;550;2473;6130;2734;6680
510774;202209;482;1179;341;962;68;188;189;553;257;741
510775;202209;804;1944;492;1444;113;353;139;377;252;730
510776;202209;835;2017;577;1535;106;319;276;717;382;1036
510777;202209;1794;4460;1292;3817;219;781;803;2244;1022;3025
510779;202209;943;2403;694;1990;80;202;435;1316;515;1518
510780;202209;5091;11712;3739;9797;723;1789;1916;5382;2639;7171
510785;202209;2499;6195;1453;4312;345;1078;383;1153;728;2231
510787;202209;3992;10549;2678;8032;1004;3135;256;706;1260;3841
510788;202209;649;1438;432;1121;63;145;198;583;261;728
510790;202209;23376;57393;14806;42422;3325;10392;1735;4379;5060;14771
510792;202209;12406;32602;7955;24148;1874;6159;1667;4437;3541;10596
510794;202209;1513;3914;1077;3224;339;1154;227;554;566;1708
510795;202209;12521;30067;8848;23859;1966;5931;3048;7421;5014;13352
510800;202209;1788;4576;1237;3666;358;1163;169;387;527;1550
510805;202209;1823;4784;1182;3611;236;790;481;1331;717;2121
510810;202209;822;1574;537;1207;167;326;256;619;423;945
510820;202209;939;1721;544;1239;30;72;362;796;392;868
510830;202209;1088;2392;827;2068;69;172;604;1557;673;1729
510835;202209;735;1596;476;1236;54;170;296;720;350;890
510840;202209;75017;147244;54167;122122;8728;19065;32362;73954;41090;93019
510850;202209;2170;5220;1416;4063;542;1767;88;130;630;1897
510860;202209;3140;7768;2047;6057;686;2207;400;1198;1086;3405
510880;202209;891;2379;640;1932;162;485;171;520;333;1005
510885;202209;736;1724;476;1324;87;235;125;329;212;564
510890;202209;994;2613;715;2107;213;672;216;612;429;1284
510895;202209;1770;4176;1212;3255;166;528;641;1519;807;2047
520005;202209;4309;10375;3444;9246;1006;2347;1468;4679;2474;7026
520010;202209;3419;8458;2548;6863;538;1600;1034;2410;1572;4010
520013;202209;4239;10002;2767;7379;693;1838;818;2319;1511;4157
520015;202209;621;1466;450;1213;105;281;165;485;270;766
520017;202209;1460;3427;1022;2740;193;588;453;1084;646;1672
520020;202209;655;1206;509;1038;44;93;398;790;442;883
520025;202209;46496;115242;39732;105777;5663;15732;25792;67812;31455;83544
520030;202209;8324;18000;6918;16143;510;1204;5333;12234;5843;13438
520050;202209;482;1112;286;751;54;137;136;348;190;485
520055;202209;2077;4862;1283;3275;205;518;577;1366;782;1884
520060;202209;2251;5438;1509;4169;300;947;381;1020;681;1967
520080;202209;2252;5320;1730;4628;331;822;865;2439;1196;3261
520082;202209;1015;2418;717;1928;123;354;322;904;445;1258
520085;202209;1236;2868;990;2517;236;601;472;1184;708;1785
520090;202209;1066;1936;778;1627;72;105;632;1358;704;1463
520110;202209;52051;129360;35821;102309;10140;31683;3536;8954;13676;40637
520120;202209;299;666;161;425;20;66;68;162;88;228
520130;202209;4666;10451;3586;8800;708;1823;1539;3610;2247;5433
520140;202209;59862;148315;41789;117944;13832;41427;5803;16556;19635;57983
520145;202209;714;1541;457;1173;99;262;171;393;270;655
520150;202209;803;1809;597;1545;74;189;328;814;402;1003
520160;202209;1044;2370;707;1786;131;307;280;726;411;1033
520170;202209;5622;11015;3744;8810;324;802;2692;6234;3016;7036
520180;202209;3297;7794;2664;6899;340;1039;1731;4279;2071;5318
520215;202209;2130;4772;1554;3942;232;643;891;2174;1123;2817
520235;202209;926;1881;621;1469;100;255;355;819;455;1074
520250;202209;2026;4780;1484;3948;589;1652;268;841;857;2493
520260;202209;899;1997;552;1451;107;284;209;536;316;820
520280;202209;1018;2152;796;1821;158;355;422;959;580;1314
520310;202209;1234;2496;803;1865;187;502;348;793;535;1295
520320;202209;2374;5707;1831;4885;239;621;1025;2785;1264;3406
520330;202209;5930;14183;4542;11891;694;2150;2539;6134;3233;8284
520340;202209;2751;5680;1624;4088;170;373;865;2266;1035;2639
520350;202209;3678;8431;2593;6789;808;2180;876;2297;1684;4477
520355;202209;2295;5841;1652;4654;476;1426;281;690;757;2116
520357;202209;1041;2252;756;1850;33;86;609;1461;642;1547
520360;202209;943;2222;734;1895;131;375;336;798;467;1173
520380;202209;1674;3952;1011;2775;164;497;347;828;511;1325
520390;202209;1406;3091;895;2410;239;698;215;605;454;1303
520393;202209;806;1774;546;1371;77;196;234;552;311;748
520396;202209;1067;2451;894;2194;57;139;641;1504;698;1643
520400;202209;1925;4255;1494;3692;91;250;1111;2729;1202;2979
520410;202209;2697;5518;1843;4298;270;721;1037;2246;1307;2967
520420;202209;453;950;353;799;22;59;266;577;288;636
520425;202209;1819;4246;1030;2764;283;829;211;480;494;1309
520430;202209;2937;6387;1782;4549;436;1176;303;705;739;1881
520440;202209;3575;8240;2039;5514;431;1296;463;1156;894;2452
520450;202209;16968;38217;11690;30055;3217;8517;3280;8464;6497;16981
520455;202209;953;2347;671;1916;199;581;183;535;382;1116
520460;202209;1284;2808;997;2442;200;424;637;1655;837;2079
520465;202209;1093;2427;902;2170;57;177;703;1651;760;1828
520470;202209;2764;6282;2114;5455;574;1514;966;2604;1540;4118
520480;202209;1125;2870;820;2351;187;555;328;892;515;1447
520485;202209;1781;4977;1396;4378;254;846;643;1926;897;2772
520490;202209;5259;12673;4054;10823;644;1914;2439;6258;3083;8172
520495;202209;1974;3813;1502;3193;113;242;1122;2377;1235;2619
520500;202209;2098;4753;1581;3885;198;584;940;2116;1138;2700
520505;202209;1160;2196;909;1897;79;148;700;1433;779;1581
520510;202209;11486;26179;8565;21856;1477;4365;4189;9877;5666;14242
520520;202209;1417;3327;1091;2844;264;743;464;1176;728;1919
520530;202209;3017;7482;2203;6065;412;1108;1085;3139;1497;4247
520540;202209;3704;9100;2455;6723;450;1305;753;1839;1203;3144
520545;202209;1691;3819;1326;3272;319;762;638;1564;957;2326
520547;202209;1580;3795;1220;3184;260;690;634;1629;894;2319
520549;202209;19757;46890;16441;42207;2002;5719;11188;27548;13190;33267
520551;202209;6017;14135;5059;12778;468;1441;3764;9064;4232;10505
520552;202209;1145;2728;886;2350;168;446;460;1275;628;1721
520570;202209;635;1357;407;1002;80;167;173;429;253;596
520580;202209;2640;5474;1985;4711;350;802;1159;2766;1509;3568
520590;202209;1654;3837;1127;2987;291;782;388;994;679;1776
520620;202209;11447;27295;9201;24095;1793;5087;4922;12499;6715;17586
520630;202209;1081;2494;755;1972;93;254;362;898;455;1152
520640;202209;2949;6647;2198;5375;515;1234;767;1969;1282;3203
520650;202209;1289;2592;931;2111;186;388;496;1168;682;1556
520660;202209;632;1500;356;1013;68;216;104;290;172;506
520670;202209;1156;2804;953;2501;117;276;626;1642;743;1918
520680;202209;995;2189;793;1901;122;256;486;1173;608;1429
520690;202209;396;927;264;715;87;218;72;200;159;418
520710;202209;537;1198;364;910;19;54;251;585;270;639
520725;202209;1714;3828;1145;2891;182;519;587;1424;769;1943
520735;202209;1101;2435;744;1874;215;482;244;633;459;1115
520740;202209;3052;6397;2242;5356;480;1109;1081;2628;1561;3737
520750;202209;887;1881;629;1510;90;220;348;797;438;1017
520753;202209;1579;3834;1178;3135;215;661;556;1352;771;2013
520760;202209;1746;3404;1472;3084;32;69;1354;2837;1386;2906
520780;202209;1791;4030;1298;3311;172;429;680;1683;852;2112
520790;202209;3914;8729;2689;6790;442;1008;1398;3715;1840;4723
520800;202209;22143;51613;17450;44843;2852;7352;10244;26547;13096;33899
520810;202209;1489;2943;1106;2508;258;570;568;1417;826;1987
520815;202209;701;2031;514;1628;101;334;156;482;257;816
520830;202209;2162;4341;1554;3617;102;244;1198;2738;1300;2982
520840;202209;3463;8503;2769;7566;812;2447;997;2736;1809;5183
520850;202209;1059;2145;811;1808;166;434;426;901;592;1335
520860;202209;11071;27095;8201;22285;1923;5401;3233;8492;5156;13893
520870;202209;177515;382575;127942;308620;24017;60840;59079;134233;83096;195073
520880;202209;11364;29877;9067;25780;1900;5559;3817;10494;5717;16053
520890;202209;5815;12115;4092;9529;620;1689;2191;4749;2811;6438
520910;202209;5781;13511;3759;10153;762;2223;1049;2572;1811;4795
520915;202209;969;2377;633;1711;128;389;244;598;372;987
520920;202209;5574;11406;4038;9545;789;1674;2152;5351;2941;7025
520929;202209;784;1764;599;1494;107;218;269;717;376;935
520940;202209;1177;2895;916;2509;72;235;696;1851;768;2086
520945;202209;571;1206;413;993;27;71;260;603;287;674
520960;202209;1355;2849;1036;2398;361;791;369;948;730;1739
520970;202209;4149;10012;3117;8396;1083;2932;600;1770;1683;4702
520980;202209;943;2026;693;1706;107;281;339;786;446;1067
520990;202209;3781;8467;3086;7610;477;1061;2105;5312;2582;6373
520993;202209;1483;3425;987;2542;160;448;452;1117;612;1565
520995;202209;3080;7117;2290;5943;481;1198;753;2055;1234;3253
521000;202209;11595;27964;7714;20929;1236;3528;2486;6201;3722;9729
521010;202209;4743;11233;3476;9084;499;1436;1872;4614;2371;6050
521015;202209;940;2172;654;1668;47;130;423;1017;470;1147
521020;202209;5054;11767;3058;8148;703;1971;742;1909;1445;3880
521030;202209;935;1634;730;1359;23;50;637;1147;660;1197
521040;202209;10223;23579;7547;19493;1833;4745;2574;6998;4407;11743
521056;202209;1233;3014;862;2387;252;676;207;613;459;1289
521060;202209;1232;3030;866;2348;176;527;312;808;488;1335
521080;202209;1288;2616;687;1713;118;304;301;703;419;1007
521090;202209;3797;9662;2549;7174;607;1842;294;784;901;2626
521100;202209;2367;4900;1782;4122;225;549;1160;2667;1385;3216
521120;202209;6067;13481;4558;11559;873;1916;1796;5369;2669;7285
521130;202209;1180;2612;564;1502;54;139;294;794;348;933
521140;202209;1906;4445;1386;3534;190;486;762;1828;952;2314
521150;202209;16536;34584;10839;26466;2543;6835;4597;10789;7140;17624
521160;202209;983;1891;635;1371;72;134;404;840;476;974
521170;202209;1316;2851;952;2314;143;378;464;1051;607;1429
521180;202209;10422;25201;8120;21404;1532;4380;3855;9779;5387;14159
521190;202209;14041;32800;8912;24523;2130;6285;2620;6862;4750;13147
521200;202209;864;1972;585;1520;73;200;295;726;368;926
521205;202209;729;1637;557;1372;21;57;440;1038;461;1095
521210;202209;942;2380;548;1547;104;318;149;321;253;639
521220;202209;4683;10290;3170;8003;763;2079;1244;3036;2007;5115
521225;202209;523;1001;391;855;36;79;305;666;341;745
521230;202209;1722;4003;1437;3634;597;1553;472;1209;1069;2762
521250;202209;46068;105324;37461;93570;8801;23466;20356;48942;29157;72408
521260;202209;643;1374;480;1137;72;197;281;619;353;816
521270;202209;2588;5522;2191;5037;232;463;1596;3773;1828;4236
521280;202209;2214;5505;1674;4645;349;1035;736;2024;1085;3059
521290;202209;682;1439;465;1161;47;123;288;691;335;814
521295;202209;1457;2982;1125;2567;153;301;756;1740;909;2041
521300;202209;2217;5083;1689;4319;343;841;903;2357;1246;3198
521305;202209;799;1743;543;1383;54;160;334;815;388;975
521308;202209;5907;14347;4118;11158;374;1107;2590;6651;2964;7758
521310;202209;12925;30247;8878;23199;1659;4738;3831;9244;5490;13982
521340;202209;482;1014;327;799;30;68;201;476;231;544
521350;202209;2306;5554;1749;4709;143;427;1248;3238;1391;3665
521370;202209;1501;3669;953;2767;300;945;163;497;463;1442
521375;202209;1800;4373;1218;3374;251;700;318;944;569;1644
521377;202209;1673;3321;1218;2761;136;255;901;2163;1037;2418
521380;202209;7573;18989;4843;14026;755;2284;1009;3032;1764;5316
521385;202209;838;1856;627;1576;92;204;340;914;432;1118
521390;202209;791;1890;544;1501;136;414;94;262;230;676
521400;202209;3569;7793;2842;6864;277;710;1981;4687;2258;5397
521405;202209;1671;4112;1120;3087;127;350;618;1633;745;1983
521410;202209;1124;2513;884;2158;218;480;460;1170;678;1650
521440;202209;1781;4016;1371;3429;432;1020;575;1507;1007;2527
521450;202209;5001;13649;3703;11169;993;3046;858;2645;1851;5691
521460;202209;7428;17687;5365;14074;1426;3902;1897;4785;3323;8687
521470;202209;958;2255;657;1715;94;225;313;765;407;990
521480;202209;598;1288;404;973;74;177;184;387;258;564
521483;202209;2821;6387;2004;5176;449;1165;842;2192;1291;3357
521486;202209;2142;4825;1629;4086;161;297;1055;2674;1216;2971
521487;202209;533;1171;379;967;60;155;244;621;304;776
521490;202209;1032;2522;760;2082;30;110;551;1415;581;1525
521500;202209;2493;5968;1891;5123;184;686;1170;2937;1354;3623
521520;202209;992;2122;775;1826;141;276;414;1028;555;1304
521523;202209;17742;47874;14589;42956;4342;13316;5215;14982;9557;28298
521525;202209;1311;2898;998;2454;88;270;679;1577;767;1847
521530;202209;2721;6703;1686;4656;332;930;455;1167;787;2097
521540;202209;973;2355;699;1909;148;464;295;762;443;1226
521550;202209;1981;4742;1098;3037;201;599;269;749;470;1348
521560;202209;6780;15908;4954;13457;1354;3605;2115;6049;3469;9654
521565;202209;813;1891;566;1486;98;257;258;677;356;934
521570;202209;4673;11822;3207;9132;631;2004;328;938;959;2942
521580;202209;623;1382;402;1022;64;171;174;395;238;566
521590;202209;1026;2091;731;1675;98;237;438;947;536;1184
521600;202209;539;1325;335;940;62;179;167;432;229;611
521630;202209;2060;4196;1287;3112;387;958;354;799;741;1757
521640;202209;2354;5222;1484;3925;324;950;469;1161;793;2111
521645;202209;635;1551;374;1064;163;450;27;58;190;508
521680;202209;1684;4296;1300;3678;355;1035;463;1295;818;2330
521690;202209;653;1508;542;1359;86;236;317;768;403;1004
521710;202209;4240;9659;2784;7258;506;1472;800;1773;1306;3245
521720;202209;2992;6240;1939;4693;242;651;1143;2684;1385;3335
521730;202209;4844;12287;3659;10328;980;3172;919;2166;1899;5338
521740;202209;5426;12899;4200;11106;1320;3739;1211;2942;2531;6681
521760;202209;22178;52247;17960;46299;3623;10325;9748;24212;13371;34537
521770;202209;3954;8723;2612;6643;603;1604;636;1566;1239;3170
521800;202209;8548;20646;6102;16665;1790;4951;1898;5671;3688;10622
521805;202209;1319;2547;884;2011;195;410;449;1092;644;1502
521810;202209;871;1899;627;1562;112;278;349;888;461;1166
521830;202209;7146;17623;5768;15517;417;1359;4200;10878;4617;12237
521839;202209;1105;2346;836;1927;75;201;608;1296;683;1497
521850;202209;8567;18495;5313;13577;1607;4015;704;1746;2311;5761
521860;202209;1976;5063;1336;3868;225;728;422;1080;647;1808
521870;202209;830;2150;590;1699;125;394;189;447;314;841
521878;202209;998;2413;653;1771;56;180;355;874;411;1054
521880;202209;27566;63158;19702;51102;4234;11660;8675;21356;12909;33016
521890;202209;4118;9756;2833;7579;750;2040;785;1921;1535;3961
521900;202209;1632;3643;846;2311;201;460;27;74;228;534
521910;202209;1728;3522;1217;2888;271;638;552;1289;823;1927
521920;202209;674;1629;520;1382;66;217;321;796;387;1013
521925;202209;933;2276;688;1895;138;421;284;740;422;1161
521930;202209;6583;14946;4400;11673;1209;2681;1756;5159;2965;7840
521935;202209;1224;2778;846;2148;71;195;503;1198;574;1393
521940;202209;1588;3241;1040;2481;181;486;538;1216;719;1702
521945;202209;795;1884;562;1480;81;214;308;804;389;1018
521950;202209;894;1981;618;1548;103;264;292;720;395;984
521960;202209;825;2013;565;1535;56;184;329;812;385;996
521970;202209;3443;7227;2599;6194;246;490;1916;4726;2162;5216
521971;202209;919;2110;643;1686;166;423;177;446;343;869
521973;202209;1876;4508;1468;3892;147;361;1020;2704;1167;3065
521975;202209;16614;39308;13467;34851;2345;6533;7921;19926;10266;26459
521980;202209;2827;6073;2137;5180;142;360;1633;3938;1775;4298
521990;202209;1653;3814;1383;3422;260;717;820;2003;1080;2720
522000;202209;3290;7952;2561;7020;606;1719;1278;3689;1884;5408
522005;202209;461;992;298;747;54;142;108;271;162;413
522010;202209;5520;12736;3946;10193;837;2308;1512;3674;2349;5982
522015;202209;1280;3093;941;2569;257;714;395;1063;652;1777
522020;202209;6643;14555;4452;11252;875;2258;1985;5050;2860;7308
522026;202209;922;2265;581;1685;92;324;178;431;270;755
522028;202209;619;1438;434;1123;83;256;216;497;299;753
522040;202209;4550;9050;3205;7259;330;815;2205;4738;2535;5553
522045;202209;24690;62332;18518;52076;4064;12133;5220;13902;9284;26035
522050;202209;1445;3446;1026;2729;189;559;448;1039;637;1598
522060;202209;3607;8870;2606;7282;449;1209;1268;3600;1717;4809
522068;202209;2272;4951;1825;4425;109;221;1498;3652;1607;3873
522070;202209;1007;1965;826;1705;20;38;738;1485;758;1523
522100;202209;1012;2393;685;1834;93;260;335;861;428;1121
522108;202209;1352;2821;1057;2409;70;157;817;1813;887;1970
522119;202209;2327;5005;1853;4413;359;734;1051;2621;1410;3355
522130;202209;626;1409;472;1205;45;96;358;934;403;1030
522140;202209;29375;70099;20701;54960;4465;12672;6733;16373;11198;29045
522145;202209;961;2143;682;1739;138;388;366;908;504;1296
522150;202209;1336;2981;870;2250;212;569;229;565;441;1134
522155;202209;1239;2970;969;2571;144;342;596;1600;740;1942
522157;202209;868;1752;707;1561;34;71;557;1232;591;1303
522160;202209;7465;17784;4778;13144;1264;3719;530;1545;1794;5264
522170;202209;3300;7875;2551;6780;319;837;1596;4246;1915;5083
522180;202209;857;1872;554;1333;97;238;172;426;269;664
522185;202209;29265;66260;21579;56038;8361;23535;4499;12436;12860;35971
522190;202209;970;2065;669;1602;144;346;285;632;429;978
522200;202209;2412;6179;1779;5064;467;1328;568;1600;1035;2928
522205;202209;1984;4540;1436;3733;414;1115;489;1245;903;2360
522220;202209;1439;3192;1053;2667;128;293;668;1745;796;2038
522230;202209;1628;3660;1279;3153;217;587;755;1822;972;2409
530010;202209;275526;673881;231664;609660;30643;87977;146037;369309;176680;457286
110001;202208;4695;12320;3139;9459;724;2427;1121;3289;1845;5716
110002;202208;16431;39711;11953;32388;3069;8912;3467;9264;6536;18176
110003;202208;862;2395;624;1922;156;510;183;497;339;1007
110004;202208;16104;38615;11087;30089;2364;6730;3981;10393;6345;17123
110005;202208;2992;7358;2118;5963;451;1271;664;1977;1115;3248
110006;202208;1764;4756;1079;3344;207;695;231;648;438;1343
110007;202208;1500;3704;981;2834;292;842;281;936;573;1778
110008;202208;4147;9880;3083;8401;547;1274;1787;5455;2334;6729
110009;202208;5343;13966;3447;10574;752;2535;1318;3865;2070;6400
110010;202208;9628;27155;7345;23134;1562;4531;3650;12861;5212;17392
110011;202208;8863;21968;6059;17066;1753;5148;1314;3590;3067;8738
110012;202208;19917;47056;12974;35574;3282;9165;2612;6999;5894;16164
110013;202208;6940;18463;4836;14455;1830;5785;817;2479;2647;8264
110014;202208;4568;11224;3115;8544;456;1383;1583;4164;2039;5547
110015;202208;7083;16949;4572;12417;916;2776;1489;3488;2405;6264
110018;202208;5013;12000;3159;8872;671;2011;820;2155;1491;4166
110020;202208;103400;223496;78127;189843;16974;41037;38854;97248;55828;138285
110025;202208;6052;13787;4129;10568;646;1793;2174;5354;2820;7147
110026;202208;659;1684;472;1375;117;360;151;455;268;815
110028;202208;8679;20821;5460;15253;1336;4140;711;1949;2047;6089
110029;202208;1811;4252;1106;3052;200;546;462;1283;662;1829
110030;202208;15958;35463;9976;26596;2719;7913;1431;4095;4150;12008
110032;202208;4262;11105;2597;7737;784;2301;516;1642;1300;3943
110033;202208;5171;14550;3883;12162;1270;4078;1189;4026;2459;8104
110034;202208;3705;8299;2511;6665;895;2629;659;1956;1554;4585
110037;202208;1874;5257;1320;4215;331;1067;480;1562;811;2629
110040;202208;3487;9062;2541;7389;618;1959;791;2194;1409;4153
110045;202208;5613;15163;4065;12426;1082;3527;1436;4439;2518;7966
110050;202208;2042;5229;1359;4039;421;1426;204;512;625;1938
110060;202208;1081;3023;710;2173;171;547;187;560;358;1107
110070;202208;1833;5323;1308;4180;358;1253;335;952;693;2205
110080;202208;7662;17124;5770;14741;1198;3043;2996;8041;4194;11084
110090;202208;676;1773;465;1387;119;401;123;345;242;746
110092;202208;1553;4200;1085;3336;225;696;540;1715;765;2411
110094;202208;3371;9290;2517;7686;1000;3226;352;1133;1352;4359
110100;202208;2085;5642;1637;4831;565;1716;559;1695;1124;3411
110110;202208;2119;5367;1508;4399;459;1427;335;1041;794;2468
110120;202208;1517;4026;1095;3224;266;825;336;980;602;1805
110130;202208;3238;7628;1950;5329;343;923;226;570;569;1493
110140;202208;2797;7437;2041;5997;377;1220;931;2603;1308;3823
110143;202208;1685;4257;1208;3405;343;1058;373;1011;716;2069
110145;202208;1143;2795;688;1958;162;455;276;811;438;1266
110146;202208;618;1520;415;1182;106;277;162;520;268;797
110147;202208;906;2201;597;1630;83;259;298;708;381;967
110148;202208;1146;2966;591;1776;152;500;73;188;225;688
110149;202208;4037;9828;2750;7841;939;2754;686;2114;1625;4868
110150;202208;3020;7307;1967;5686;634;2005;410;1293;1044;3298
110155;202208;993;2708;695;2011;143;479;282;722;425;1201
110160;202208;1698;4757;1239;3796;400;1249;274;859;674;2108
110170;202208;2471;5918;1593;4333;227;698;923;2330;1150;3028
110175;202208;2481;6543;1685;4895;307;940;716;1995;1023;2935
110180;202208;1658;4169;1168;3243;157;464;615;1654;772;2118
120001;202208;4146;10721;3352;9546;449;1500;2253;6270;2702;7770
120005;202208;2285;7936;2067;7611;215;804;1600;6026;1815;6830
120010;202208;7064;17552;6094;16195;486;1235;4781;12813;5267;14048
120013;202208;2928;8546;2520;8014;696;2128;1213;4301;1909;6429
120017;202208;3466;8865;2956;8151;414;1103;1951;5679;2365;6782
120020;202208;17704;59086;16263;56510;1063;4243;13036;45241;14099;49484
120025;202208;4443;10255;3640;9336;474;1189;2521;6749;2995;7938
120030;202208;7392;26900;6821;25947;439;2092;5248;20259;5687;22351
120032;202208;2019;8147;1908;7943;93;581;1636;6676;1729;7257
120033;202208;5096;16030;4761;15451;104;542;4220;13476;4324;14018
120034;202208;3407;10468;2946;9735;126;619;2498;8060;2624;8679
120035;202208;4914;15651;4570;15074;255;1013;3917;12788;4172;13801
120038;202208;3569;9748;3068;8996;416;1302;2028;5944;2444;7246
120039;202208;2352;9134;2183;8813;123;677;1776;7102;1899;7779
120040;202208;69151;174661;59707;160841;7517;21398;39894;106543;47411;127941
120042;202208;4214;12996;3890;12442;162;739;3297;10329;3459;11068
120043;202208;1723;6335;1505;6022;51;345;1291;5060;1342;5405
120045;202208;7099;16451;6015;15190;439;1172;4829;12216;5268;13388
120050;202208;11812;35913;10865;34591;507;1918;9207;29317;9714;31235
120060;202208;11579;39533;10592;38116;480;2313;9161;32755;9641;35068
120070;202208;4090;11432;3529;10681;518;1422;2302;7428;2820;8850
120080;202208;6252;15278;5610;14385;741;1723;4190;10972;4931;12695
130002;202208;3973;13140;3530;12543;378;988;2891;10836;3269;11824
130006;202208;3018;9735;2505;8929;584;1820;1325;5433;1909;7253
130008;202208;3162;9810;2737;9210;156;551;2219;7655;2375;8206
130010;202208;4882;12360;4165;11539;156;387;3700;10335;3856;10722
130014;202208;4478;11578;3423;9997;589;1743;2047;6195;2636;7938
130020;202208;3295;11828;2904;11258;134;744;2394;9198;2528;9942
130030;202208;17949;39248;16726;37877;190;524;15906;35771;16096;36295
130040;202208;4824;13064;3990;12001;491;1364;2955;9225;3446;10589
130050;202208;8620;28668;7259;26907;332;1207;6366;24047;6698;25254
130060;202208;8536;31437;7253;29782;412;2276;6010;24423;6422;26699
130063;202208;7485;22621;6612;21639;194;848;6009;19621;6203;20469
130068;202208;4555;13464;3830;12501;206;887;3082;9997;3288;10884
130070;202208;8946;22873;7332;21108;563;1310;5844;17462;6407;18772
130080;202208;9001;27740;7793;26394;427;1269;6734;23366;7161;24635
130083;202208;3256;9729;2853;9224;302;910;2205;7428;2507;8338
130090;202208;4732;11897;4217;11303;66;165;3818;10415;3884;10580
130100;202208;8868;25074;7446;23578;165;377;6884;22227;7049;22604
130110;202208;10382;25879;8481;23542;1528;3772;5423;16528;6951;20300
130115;202208;5968;17083;5142;16138;153;466;4516;14343;4669;14809
130120;202208;17426;52996;15395;50380;1246;4476;12732;41739;13978;46215
130130;202208;7142;18941;5545;16931;601;1709;4000;12966;4601;14675
130140;202208;8336;26458;7290;25279;312;1381;6276;21839;6588;23220
130150;202208;4621;14351;4347;14046;75;394;4031;13000;4106;13394
130160;202208;7543;20570;6497;19304;358;915;5686;17184;6044;18099
130165;202208;3892;13153;3667;12901;160;583;3269;11622;3429;12205
130170;202208;15027;37437;12267;34359;474;1584;10766;30179;11240;31763
130180;202208;5032;14924;4793;14664;38;210;4628;14119;4666;14329
130185;202208;23633;51272;19458;46801;1489;1975;16605;42058;18094;44033
130190;202208;22966;68126;18610;61964;1534;5163;14272;48250;15806;53413
130195;202208;2911;9601;2442;9023;112;455;2061;7709;2173;8164
130200;202208;3516;8403;2903;7627;163;547;2428;6277;2591;6824
130210;202208;1691;5850;1513;5630;116;561;1226;4515;1342;5076
130220;202208;2950;8491;2437;7874;68;240;2206;7239;2274;7479
130230;202208;5796;21038;5043;20031;201;1074;4452;17719;4653;18793
130240;202208;17258;39627;14450;36129;161;763;13536;33326;13697;34089
130250;202208;30932;83740;26444;78584;1568;4053;21788;66979;23356;71032
130255;202208;5887;16405;5031;14946;214;671;4174;12330;4388;13001
130260;202208;377548;891779;316230;810666;67658;174289;189531;490395;257189;664684
130270;202208;11488;36244;9491;33258;1701;5490;6056;22385;7757;27875
130280;202208;4262;14866;3883;14437;135;546;3577;13393;3712;13939
130290;202208;18482;48745;16445;46288;696;2020;14858;41929;15554;43949
130300;202208;5840;17352;5199;16505;167;731;4479;14146;4646;14877
130310;202208;9666;23963;8552;22638;465;1229;7390;19705;7855;20934
130320;202208;4077;12416;3403;11506;429;1382;2451;8606;2880;9988
130330;202208;5456;15553;4394;14306;205;784;3700;12286;3905;13070
130340;202208;29299;77771;25222;73237;1247;3502;21648;64309;22895;67811
130350;202208;4494;15026;4009;14404;140;721;3509;12541;3649;13262
130353;202208;9513;23080;7722;20834;1135;2842;5369;15065;6504;17907
130356;202208;6510;18431;5497;16919;981;2892;3383;10960;4364;13852
130360;202208;3540;10633;2866;9812;77;332;2576;8809;2653;9141
130370;202208;5979;23750;5020;22354;601;3204;3337;15026;3938;18230
130380;202208;8844;35601;8254;34712;680;3357;6666;28031;7346;31388
130390;202208;7976;28611;6986;27150;435;2013;6051;23497;6486;25510
130395;202208;2939;8442;2454;7686;184;626;1972;6086;2156;6712
130400;202208;3330;9295;2812;8606;107;317;2492;7698;2599;8015
130406;202208;13109;41959;11053;39453;1786;5955;7770;29053;9556;35008
130410;202208;5230;16448;4497;15321;1184;4150;2428;8603;3612;12753
130420;202208;17296;53625;14513;50149;1443;5337;10896;38203;12339;43540
130423;202208;5089;14758;4423;13971;214;841;3893;12226;4107;13067
130426;202208;3679;11902;3336;11517;57;198;2955;10746;3012;10944
130430;202208;5591;13128;4785;12120;191;496;4252;10668;4443;11164
130440;202208;6623;16960;5653;15813;131;424;5281;14783;5412;15207
140002;202208;2913;7787;2514;7313;154;429;2086;6207;2240;6636
140005;202208;3837;10106;3329;9509;585;1525;2370;7088;2955;8613
140010;202208;60328;155178;48432;137972;11413;34181;21300;62062;32713;96243
140015;202208;5309;12849;4460;11909;306;720;3819;10519;4125;11239
140017;202208;6810;15696;6013;14712;351;821;5125;12674;5476;13495
140020;202208;6655;16829;5733;15703;367;1120;4653;12711;5020;13831
140023;202208;3236;8462;2588;7577;377;1080;1836;5543;2213;6623
140028;202208;2396;5716;2020;5250;128;349;1585;4138;1713;4487
140030;202208;7252;15509;6538;14694;243;397;6010;13719;6253;14116
140040;202208;3274;11721;3007;11375;97;512;2772;10431;2869;10943
140045;202208;3731;12434;3183;11709;760;2199;1836;7728;2596;9927
140047;202208;7208;19043;6017;17319;696;2088;4310;12580;5006;14668
140050;202208;1887;5119;1604;4721;255;677;1110;3379;1365;4056
140060;202208;2426;5479;2141;5101;188;401;1780;4309;1968;4710
140070;202208;2368;11247;2291;11117;141;931;1981;9446;2122;10377
150010;202208;58726;127659;52869;120267;1485;2890;47194;106943;48679;109833
150013;202208;2495;5458;2086;5013;94;195;1803;4405;1897;4600
150020;202208;17623;46305;16171;44371;1661;3552;12981;37040;14642;40592
150030;202208;10299;34809;9259;33594;514;1787;8042;29864;8556;31651
150034;202208;5233;11383;4261;10205;227;543;3620;8734;3847;9277
150040;202208;18834;44787;16450;42166;1216;1539;14371;39010;15587;40549
150050;202208;9233;26150;8430;25123;217;662;7741;23270;7958;23932
150060;202208;27315;67813;22070;60171;2847;7995;14784;40681;17631;48676
150070;202208;10641;29841;9514;28537;202;769;8886;26562;9088;27331
150080;202208;108688;232561;89647;207409;24206;56144;28662;77670;52868;133814
150085;202208;10838;25760;9803;24556;127;355;9240;23206;9367;23561
150090;202208;14154;38786;13200;37232;546;1652;11615;32372;12161;34024
150095;202208;8694;19078;7677;17873;750;964;6462;15786;7212;16750
150100;202208;3373;10857;2960;10191;238;749;2340;8274;2578;9023
150110;202208;5062;18808;4664;18358;154;646;4296;17184;4450;17830
150120;202208;9366;26304;8683;25489;357;702;7730;23216;8087;23918
150125;202208;1042;2429;753;2019;100;298;474;1249;574;1547
150130;202208;28094;72369;24044;66382;4532;10954;14868;44013;19400;54967
150140;202208;340849;689835;289869;624391;32619;67055;197670;423331;230289;490386
150145;202208;4921;14316;4046;12958;1331;4082;1634;6081;2965;10163
150150;202208;21247;47500;18170;43679;1338;3008;14201;34224;15539;37232
150157;202208;4299;10714;3395;9514;426;1183;2252;6522;2678;7705
150160;202208;4749;10374;4410;9924;417;968;3537;7798;3954;8766
150170;202208;32841;87008;29148;81143;4845;11722;18961;56225;23806;67947
150172;202208;6516;15290;5285;13634;298;733;4139;10760;4437;11493
150175;202208;2062;5635;1714;5051;200;692;1185;3399;1385;4091
150178;202208;14321;31546;10776;27484;820;1245;8718;23774;9538;25019
150180;202208;32522;87289;29541;83976;2356;4332;24412;74308;26768;78640
150190;202208;8753;22803;8098;22025;144;565;7544;20343;7688;20908
150195;202208;6210;17371;5757;16733;204;702;5209;15045;5413;15747
150200;202208;6905;18073;6227;17299;32;126;5833;16211;5865;16337
150210;202208;36709;101642;34494;98969;1360;3681;30509;88813;31869;92494
150215;202208;11540;30224;9924;27724;1711;4825;5935;16708;7646;21533
150220;202208;16215;39630;14165;36884;827;2155;10887;28090;11714;30245
150230;202208;16060;39798;14242;37391;1430;3051;10254;28044;11684;31095
150240;202208;41938;104349;35155;93385;7354;20048;16674;42770;24028;62818
150250;202208;4925;16942;4597;16582;451;1670;3900;14259;4351;15929
150260;202208;3436;9376;3061;8830;95;328;2652;7573;2747;7901
150270;202208;10637;27897;7475;22289;2078;6424;2133;6575;4211;12999
150275;202208;8474;23021;7717;22004;198;734;6828;19193;7026;19927
150276;202208;2746;6797;2375;6342;299;679;1666;4876;1965;5555
150277;202208;6515;14469;5181;12966;622;1601;3737;9607;4359;11208
150280;202208;8485;29180;8156;28677;479;1534;7028;25258;7507;26792
150285;202208;3979;12239;3423;11349;245;765;2626;8829;2871;9594
150290;202208;13228;31357;11961;30011;510;746;10812;27850;11322;28596
150293;202208;11744;25769;9182;22509;1026;2478;6309;15584;7335;18062
150295;202208;8664;21332;6143;17820;1967;5693;2170;7278;4137;12971
150300;202208;3384;7912;3076;7545;33;104;2878;7037;2911;7141
150304;202208;5171;13669;4296;12354;606;1551;2974;8916;3580;10467
150307;202208;6813;19649;6150;18586;311;893;4911;14923;5222;15816
150309;202208;7722;20172;6257;17822;794;2200;4028;11690;4822;13890
150310;202208;8633;30641;8114;30009;235;1113;7237;27074;7472;28187
150320;202208;10830;26634;9810;25193;674;1739;7585;19355;8259;21094
150330;202208;16853;47485;15514;45641;1828;4305;11249;35396;13077;39701
150340;202208;2895;7812;2530;7302;293;813;1873;5445;2166;6258
150345;202208;10960;26496;9735;24913;354;1015;8632;21905;8986;22920
150350;202208;11284;24721;10270;23432;618;1137;8885;20344;9503;21481
150360;202208;29454;73521;23518;66180;2441;4745;17559;52292;20000;57037
150370;202208;13670;35956;11164;32636;1341;3288;8113;25277;9454;28565
150375;202208;4491;16773;4050;16171;228;912;3552;14350;3780;15262
150380;202208;12752;28922;10344;25805;214;638;9039;22345;9253;22983
150390;202208;8290;31066;7335;29558;1209;4166;5008;21414;6217;25580
150400;202208;7921;24973;7510;24312;121;479;6412;21312;6533;21791
150405;202208;10527;24954;9075;23249;641;1155;7297;19309;7938;20464
150410;202208;2317;6391;1966;5839;197;516;1383;4165;1580;4681
150420;202208;53076;131632;41412;114957;9739;27586;18798;55589;28537;83175
150430;202208;9664;25244;8768;24141;659;1351;7350;20722;8009;22073
150440;202208;7231;18965;6521;18041;613;1466;5127;14480;5740;15946
150442;202208;36178;74532;30460;67784;2107;4600;23933;52484;26040;57084
150445;202208;8916;22080;7920;20677;152;466;7206;18653;7358;19119
150450;202208;6697;22976;6210;22351;350;1689;5529;19579;5879;21268
150460;202208;10132;29049;9197;27899;414;1063;7818;24540;8232;25603
150470;202208;24891;59684;22265;56613;322;1121;20885;52641;21207;53762
150475;202208;6381;17766;5407;16267;827;2167;3674;11610;4501;13777
150480;202208;16780;46148;15054;43722;2818;6626;10144;32021;12962;38647
150490;202208;9743;30765;8788;29483;616;1758;7218;24924;7834;26682
150495;202208;6676;18809;6283;18303;178;675;5712;16523;5890;17198
150497;202208;3158;9168;2497;8016;494;1619;1360;4621;1854;6240
150500;202208;3765;8884;3313;8238;220;545;2628;6412;2848;6957
150503;202208;6362;15382;4565;13118;1424;3722;1841;5910;3265;9632
150506;202208;15230;38621;12943;35566;2228;5463;8677;25599;10905;31062
150510;202208;13689;39056;11886;36099;1036;3010;9163;28072;10199;31082
150520;202208;9595;30630;9175;30126;170;971;8604;28007;8774;28978
150530;202208;14099;44236;12193;41555;1009;2890;9541;33541;10550;36431
150540;202208;6291;14585;5436;13337;274;620;4622;11264;4896;11884
150543;202208;8704;21965;7208;20112;572;1619;5564;15921;6136;17540
150548;202208;12112;33899;10744;31990;367;1163;9380;28086;9747;29249
150549;202208;2312;5979;1938;5454;70;231;1596;4483;1666;4714
150550;202208;24560;66150;20013;58885;4978;14805;8323;25638;13301;40443
150553;202208;44713;113567;34332;96105;8325;23739;15103;42701;23428;66440
150555;202208;2348;5742;1833;4962;175;393;1209;3426;1384;3819
150560;202208;2252;5892;2007;5463;233;613;1321;3601;1554;4214
150563;202208;3148;8540;2545;7492;496;1533;1408;4108;1904;5641
150565;202208;5203;15323;4589;14384;121;462;3743;11798;3864;12260
150570;202208;8715;22204;7968;21216;311;919;7084;18700;7395;19619
150580;202208;13228;45900;11342;43828;1304;3952;8966;36877;10270;40829
150590;202208;9537;29470;8128;27809;172;895;7465;25458;7637;26353
150600;202208;11876;33529;10952;32403;230;800;10105;29947;10335;30747
150610;202208;3693;8846;3286;8235;126;406;2838;6939;2964;7345
150611;202208;3826;9450;3325;8766;85;299;2948;7640;3033;7939
150613;202208;17172;43548;13068;36906;2380;7154;6828;18749;9208;25903
150616;202208;4438;11458;3189;9296;624;1934;1463;4164;2087;6098
150618;202208;8302;21807;6742;19439;904;2700;4158;12197;5062;14897
150619;202208;7958;20344;6520;18389;585;1393;5030;14553;5615;15946
150620;202208;8452;25082;7337;23231;1130;3187;4506;15079;5636;18266
150630;202208;7950;18186;7237;17340;187;454;6530;15509;6717;15963
150635;202208;6383;15585;5338;13931;631;1496;3580;9428;4211;10924
150640;202208;2459;6838;2237;6554;43;123;2041;6025;2084;6148
150650;202208;14271;35077;12366;32208;3184;7852;5848;16295;9032;24147
150655;202208;6520;16817;5875;15895;116;417;5253;14029;5369;14446
150658;202208;5274;14169;3886;11860;893;2829;1795;5665;2688;8494
150660;202208;6771;17434;5917;16224;1019;2670;3660;10122;4679;12792
150670;202208;11708;23245;9354;20558;720;1415;7648;17167;8368;18582
150680;202208;89917;231552;71197;203443;15410;41537;36523;112781;51933;154318
150690;202208;3182;7068;2740;6564;122;227;2390;5807;2512;6034
150700;202208;8053;20629;7178;19545;793;1606;5488;15693;6281;17299
150710;202208;4492;13250;4025;12543;367;1109;2991;9511;3358;10620
150715;202208;6426;15714;5273;14072;286;723;4369;11655;4655;12378
150720;202208;9744;25524;8967;24464;387;1166;7840;21288;8227;22454
150730;202208;15571;42438;13204;39013;1665;5033;9462;28567;11127;33600
150740;202208;4714;11898;4090;10954;398;825;3035;8404;3433;9229
150745;202208;6602;16596;5377;14887;681;1946;3888;10953;4569;12899
150746;202208;2074;5414;1833;5064;59;181;1554;4235;1613;4416
150747;202208;5985;15994;5300;15009;407;1007;4151;11936;4558;12943
150750;202208;4330;12159;3515;10957;354;1150;2497;8067;2851;9217
150760;202208;13714;36424;12362;34593;1888;4676;8533;24918;10421;29594
150770;202208;8315;25190;7621;24415;210;482;6993;23012;7203;23494
150775;202208;1383;3306;1083;2924;137;403;763;2052;900;2455
150780;202208;5621;15341;4980;14593;301;793;4366;13113;4667;13906
150790;202208;7200;17612;6023;16335;511;1047;4072;13088;4583;14135
150795;202208;18865;50134;16258;46390;2971;8292;10249;30094;13220;38386
150796;202208;4812;10035;4146;9282;178;352;3635;8162;3813;8514
150797;202208;5278;13970;4477;12855;401;1029;3591;10437;3992;11466
150800;202208;16365;45809;14632;43583;2066;5715;10429;32111;12495;37826
150803;202208;9902;24416;9103;23342;284;834;8180;20732;8464;21566
150805;202208;4227;11744;3585;10868;307;847;2749;8553;3056;9400
150808;202208;7758;20964;5693;17570;2001;6692;1001;3419;3002;10111
150810;202208;24873;58029;18763;50727;4105;10546;9615;29188;13720;39734
150812;202208;7509;17814;6626;16504;415;1295;5314;12661;5729;13956
150815;202208;11385;30492;9510;28280;1158;3395;7381;22390;8539;25785
150820;202208;17742;37212;15526;34589;2058;3117;11544;27978;13602;31095
150830;202208;15210;45401;14118;44084;709;1829;12384;39784;13093;41613
150835;202208;3953;10669;3438;9919;362;1079;2532;7290;2894;8369
150840;202208;9898;25023;7998;22108;1103;3433;4901;13088;6004;16521
160005;202208;1600;3608;1409;3389;68;180;1206;2894;1274;3074
160010;202208;2594;6524;2396;6313;22;94;2311;6040;2333;6134
160015;202208;4412;9753;3972;9247;65;190;3768;8707;3833;8897
160020;202208;2891;7629;2502;7133;280;675;1887;5649;2167;6324
160021;202208;1490;4951;1326;4752;67;287;1019;3750;1086;4037
160023;202208;1629;5043;1447;4738;243;748;921;3161;1164;3909
160025;202208;2312;6048;2150;5870;33;75;2069;5660;2102;5735
160027;202208;12666;27907;11455;26421;703;1651;9856;22621;10559;24272
160030;202208;98974;243976;82099;222400;15495;38919;48350;139962;63845;178881
160040;202208;7085;20839;6220;19673;399;1136;5369;17253;5768;18389
160050;202208;6786;17211;5579;15684;1912;4419;2681;9131;4593;13550
160053;202208;5027;13283;4454;12517;260;647;3707;10732;3967;11379
160055;202208;1802;3562;1734;3489;27;78;1669;3321;1696;3399
160060;202208;35096;77426;29441;71061;2428;4926;23565;58865;25993;63791
160070;202208;3442;11198;2994;10526;305;914;2267;8418;2572;9332
160080;202208;3970;10586;3472;10036;56;170;3217;9417;3273;9587
170025;202208;771;1892;486;1373;93;253;164;465;257;718
170030;202208;1352;3800;994;3136;196;604;391;1276;587;1880
170035;202208;1725;4131;1262;3401;100;294;776;1987;876;2281
170040;202208;2216;5520;1730;4856;197;567;1044;3020;1241;3587
170070;202208;2250;4804;1593;3987;90;232;964;2469;1054;2701
170100;202208;2847;7292;2320;6444;315;820;1460;4123;1775;4943
170105;202208;779;2108;524;1609;126;374;160;448;286;822
170110;202208;1188;3191;911;2734;67;264;576;1638;643;1902
170130;202208;1642;4251;1241;3592;129;445;755;2111;884;2556
170190;202208;1853;4398;1427;3750;204;663;842;2075;1046;2738
170200;202208;2401;5312;1571;3992;274;719;650;1591;924;2310
170210;202208;32033;80745;24166;68092;6897;20887;4769;13762;11666;34649
170215;202208;1522;3747;1210;3324;53;192;947;2556;1000;2748
170220;202208;6770;19393;5572;17332;1956;6039;1664;5922;3620;11961
170230;202208;1436;3885;1074;3224;304;903;288;890;592;1793
170240;202208;3325;7959;2672;6962;158;503;2014;5077;2172;5580
170255;202208;4436;11911;3241;9886;582;1841;1529;4714;2111;6555
170270;202208;1007;2335;682;1851;76;197;380;1005;456;1202
170290;202208;3616;9181;3108;8518;268;540;2387;6807;2655;7347
170300;202208;2587;5941;2105;5244;166;402;1573;3830;1739;4232
170305;202208;779;1982;635;1732;77;206;344;951;421;1157
170307;202208;1245;3582;1021;3178;124;425;642;1934;766;2359
170310;202208;1856;4276;1326;3476;169;472;698;1806;867;2278
170320;202208;1210;3022;918;2552;111;344;554;1537;665;1881
170330;202208;1105;3099;1002;2948;31;135;864;2479;895;2614
170360;202208;667;1602;481;1319;21;83;326;818;347;901
170370;202208;1518;3601;1087;2915;188;515;526;1335;714;1850
170380;202208;2133;5612;1606;4800;126;412;952;2926;1078;3338
170382;202208;612;1640;496;1453;21;80;363;1017;384;1097
170384;202208;1957;6119;1609;5497;326;1085;861;2949;1187;4034
170386;202208;1096;2832;657;1989;74;257;241;665;315;922
170388;202208;853;2106;607;1699;84;249;309;820;393;1069
170389;202208;1021;2936;810;2571;87;311;508;1627;595;1938
170390;202208;2109;4274;1591;3666;38;101;1371;3167;1409;3268
170410;202208;724;1721;530;1407;28;96;369;912;397;1008
170460;202208;474;1206;386;1067;48;144;254;699;302;843
170510;202208;1061;2738;752;2213;33;135;488;1321;521;1456
170550;202208;7896;19378;5948;16381;1597;4796;1877;5018;3474;9814
170555;202208;1607;3935;1277;3441;132;287;633;1796;765;2083
170560;202208;1160;3002;883;2616;104;297;536;1653;640;1950
170600;202208;1590;3920;1239;3412;235;604;674;1925;909;2529
170610;202208;1919;4490;1432;3780;117;375;941;2379;1058;2754
170625;202208;508;1235;333;921;39;92;140;355;179;447
170650;202208;1705;4302;1386;3816;134;451;936;2466;1070;2917
170700;202208;4131;11187;3131;9307;640;1934;1371;3947;2011;5881
170710;202208;1847;4223;1403;3587;169;448;934;2353;1103;2801
170720;202208;2110;4776;1604;4001;151;457;1100;2628;1251;3085
170730;202208;1264;3081;948;2612;106;246;576;1629;682;1875
170740;202208;2360;7045;2004;6415;150;565;1494;4667;1644;5232
170755;202208;1008;2508;722;2049;124;373;326;875;450;1248
170765;202208;1324;3139;927;2525;162;426;474;1292;636;1718
170770;202208;2125;5548;1704;4914;154;476;1209;3427;1363;3903
170820;202208;4478;11896;3457;10190;669;1992;1783;5271;2452;7263
170825;202208;1210;2534;988;2254;91;195;761;1720;852;1915
170830;202208;1578;3801;1190;3179;317;943;538;1309;855;2252
170900;202208;3256;9192;2773;8513;256;756;2194;6859;2450;7615
170930;202208;4582;11581;3458;9535;800;2317;1080;2844;1880;5161
170950;202208;13404;35049;9442;28120;2779;8886;1296;4014;4075;12900
170980;202208;594;1408;426;1133;44;139;239;601;283;740
171050;202208;1911;5493;1653;5067;95;316;1311;4015;1406;4331
171070;202208;1561;4009;1331;3681;271;650;681;2190;952;2840
171090;202208;1175;2861;923;2500;144;416;490;1319;634;1735
171110;202208;661;1667;445;1276;75;225;202;526;277;751
171150;202208;1159;2692;716;1965;53;170;448;1189;501;1359
171180;202208;869;2236;559;1656;84;232;246;727;330;959
171190;202208;2294;6630;1936;6016;294;953;1189;3716;1483;4669
171195;202208;970;2780;761;2392;102;418;471;1368;573;1786
171200;202208;707;1849;513;1519;131;435;172;474;303;909
171215;202208;446;1101;345;939;38;113;197;512;235;625
171240;202208;876;2611;674;2260;22;131;463;1490;485;1621
171245;202208;890;2349;686;1953;50;164;420;1113;470;1277
171250;202208;1122;2870;799;2343;140;451;362;1043;502;1494
171270;202208;551;1797;428;1526;80;326;205;729;285;1055
171280;202208;1036;2810;831;2472;66;199;545;1640;611;1839
171320;202208;4561;11918;3541;10171;706;2010;1450;4238;2156;6248
171330;202208;3303;8414;2533;7110;619;1787;1147;3191;1766;4978
171360;202208;1727;4431;1312;3849;128;349;852;2668;980;3017
171370;202208;850;1965;643;1672;70;190;414;1047;484;1237
171380;202208;1705;4384;1406;3980;165;410;989;2970;1154;3380
171395;202208;1160;2811;784;2178;73;231;510;1368;583;1599
171420;202208;2300;5912;1741;4916;305;927;895;2441;1200;3368
171430;202208;1283;3413;1058;3015;75;239;705;1905;780;2144
171488;202208;2904;7433;2261;6412;395;1104;1187;3346;1582;4450
171500;202208;1035;2453;729;1957;76;227;457;1177;533;1404
171510;202208;956;2751;811;2495;80;267;543;1653;623;1920
171515;202208;565;1309;399;1049;31;105;261;625;292;730
171525;202208;835;2059;630;1726;59;189;409;1040;468;1229
171550;202208;379;1006;292;884;38;146;163;453;201;599
171570;202208;1259;3387;1047;3027;155;453;608;1789;763;2242
171575;202208;1954;4857;1279;3712;140;400;629;1795;769;2195
171610;202208;6926;18227;5106;15171;1208;3927;1196;3794;2404;7721
171620;202208;3344;7913;2833;7213;159;459;2373;5994;2532;6453
171630;202208;1255;3008;963;2608;136;382;623;1699;759;2081
171650;202208;2599;6829;2006;5876;499;1589;608;1811;1107;3400
171660;202208;2671;6256;1859;4966;189;509;1184;3127;1373;3636
171665;202208;1432;3769;1132;3290;235;706;519;1520;754;2226
171670;202208;2175;5415;1616;4495;231;700;743;2004;974;2704
171700;202208;1333;3445;971;2800;115;343;574;1612;689;1955
171720;202208;895;2136;686;1821;54;153;502;1308;556;1461
171750;202208;1606;4455;1123;3568;261;826;287;1086;548;1912
171780;202208;1521;3487;1079;2823;96;283;733;1858;829;2141
171790;202208;1598;4806;1270;4147;188;620;649;2091;837;2711
171800;202208;826;2075;631;1793;63;203;357;964;420;1167
171820;202208;13727;35883;10142;29984;2394;7546;2762;8518;5156;16064
171830;202208;1768;5150;1499;4697;257;795;830;2716;1087;3511
171840;202208;832;2049;624;1726;26;91;382;1010;408;1101
171845;202208;771;1728;587;1463;49;158;411;964;460;1122
171850;202208;1108;3155;929;2795;49;208;711;2059;760;2267
171855;202208;1174;3297;981;2953;84;258;608;1764;692;2022
171865;202208;574;1531;486;1400;56;180;299;818;355;998
171870;202208;929;2370;649;1891;98;298;329;936;427;1234
171875;202208;1635;4080;1340;3647;44;187;1055;2781;1099;2968
171880;202208;1632;4028;1411;3738;40;140;1140;2994;1180;3134
171884;202208;1259;3087;956;2593;231;586;448;1251;679;1837
171886;202208;1748;4438;1270;3744;329;1067;331;1040;660;2107
171888;202208;680;1845;470;1449;28;111;274;799;302;910
171889;202208;484;1359;325;1041;70;240;113;332;183;572
171890;202208;1391;3764;1033;3179;135;437;649;1960;784;2397
171900;202208;646;2032;496;1738;71;216;230;812;301;1028
172000;202208;651;1809;509;1557;116;341;195;603;311;944
172010;202208;1425;4027;1200;3672;112;329;748;2307;860;2636
172015;202208;423;1345;321;1149;57;188;140;502;197;690
172020;202208;3319;8407;2882;7861;212;602;2113;5904;2325;6506
172025;202208;824;2086;594;1732;47;147;414;1191;461;1338
172030;202208;1415;3889;1155;3466;91;303;842;2497;933;2800
172049;202208;1428;3313;941;2628;136;366;479;1390;615;1756
172065;202208;1688;3930;1332;3473;142;280;973;2782;1115;3062
172080;202208;2783;7425;2222;6464;129;420;1484;4225;1613;4645
172085;202208;518;1330;325;928;57;169;120;309;177;478
172090;202208;4709;10444;3683;9115;148;386;2959;7235;3107;7621
172093;202208;508;1449;365;1198;26;108;207;647;233;755
172097;202208;804;1954;536;1510;78;227;215;577;293;804
172100;202208;58774;135945;43505;112830;7974;22605;18381;46687;26355;69292
172110;202208;1909;6185;1628;5774;103;440;1268;4521;1371;4961
172120;202208;5858;15787;4595;13815;487;1597;2776;8254;3263;9851
172125;202208;473;1184;359;1006;30;100;209;536;239;636
172130;202208;690;1625;519;1347;23;93;349;823;372;916
172208;202208;3041;6704;2391;5874;214;463;1744;4291;1958;4754
172210;202208;3059;6975;2356;6115;259;650;1524;4114;1783;4764
210005;202208;22206;58742;16681;50004;4219;13214;7139;21897;11358;35111
210010;202208;2371;6248;2166;6013;47;224;1968;5380;2015;5604
210015;202208;3607;10051;3084;9351;159;495;2542;7740;2701;8235
210020;202208;8597;18074;7342;16617;112;320;6789;15292;6901;15612
210030;202208;5128;15850;4646;15113;483;1565;3644;12054;4127;13619
210040;202208;2497;4893;2191;4532;56;143;1959;3963;2015;4106
210043;202208;6730;17659;5632;16178;361;1105;4471;12882;4832;13987
210047;202208;7816;21526;6172;19390;155;683;5332;16709;5487;17392
210050;202208;2754;7881;2188;6904;159;681;1644;4992;1803;5673
210055;202208;2358;6414;2103;6065;55;183;1857;5367;1912;5550
210060;202208;8448;28572;7457;26831;710;2693;5222;19205;5932;21898
210070;202208;7798;19414;7193;18646;79;232;6753;17436;6832;17668
210080;202208;4944;14515;4637;14170;48;257;4306;13124;4354;13381
210083;202208;6991;16623;5901;15440;122;356;5551;14511;5673;14867
210087;202208;3146;8276;2655;7623;159;501;2120;6052;2279;6553
210090;202208;10408;29478;9597;28156;516;1313;8200;24124;8716;25437
210095;202208;7266;22181;6574;21279;466;1482;5286;17746;5752;19228
210100;202208;7337;21061;6320;19293;749;2286;4309;13250;5058;15536
210110;202208;3318;9264;3029;8907;59;283;2719;7921;2778;8204
210120;202208;31878;71645;27078;65685;1818;3455;21091;52071;22909;55526
210125;202208;5072;12541;4394;11770;729;1459;3144;9039;3873;10498
210130;202208;4821;11352;3911;10234;100;243;3431;8978;3531;9221
210135;202208;2006;4644;1662;4161;43;120;1460;3609;1503;3729
210140;202208;23839;57688;18570;50923;2802;7513;11627;32385;14429;39898
210150;202208;5333;11494;4687;10636;94;293;4128;9151;4222;9444
210160;202208;23999;56100;20595;51895;1723;3839;15976;41046;17699;44885
210170;202208;19157;50675;17603;48677;1193;2767;14774;41734;15967;44501
210173;202208;2597;9102;2433;8838;100;508;2124;7639;2224;8147
210177;202208;3671;9498;3146;8828;429;1063;2333;6803;2762;7866
210180;202208;1690;4005;1468;3737;34;89;1319;3356;1353;3445
210190;202208;6266;14754;5162;13256;90;300;4490;11351;4580;11651
210193;202208;1559;3995;1339;3660;51;140;1037;2825;1088;2965
210197;202208;2268;6537;2042;6231;139;394;1674;5216;1813;5610
210200;202208;9008;25999;7925;24366;487;1664;6288;19272;6775;20936
210203;202208;8145;21879;6804;20132;466;1416;5457;16427;5923;17843
210207;202208;4372;9811;3548;8867;139;295;2973;7490;3112;7785
210210;202208;8523;25091;7653;23892;155;810;6557;20278;6712;21088
210215;202208;2732;7999;2358;7458;137;622;1892;5882;2029;6504
210220;202208;7678;22542;7227;21901;139;861;6532;19286;6671;20147
210230;202208;6350;16764;5741;15857;153;457;5202;14335;5355;14792
210232;202208;13406;37573;10972;33978;1620;4927;7173;23303;8793;28230
210235;202208;3921;10797;3414;10080;169;586;2857;8408;3026;8994
210237;202208;4521;10396;3839;9626;26;148;3655;9047;3681;9195
210240;202208;2876;8158;2593;7718;74;270;2149;6288;2223;6558
210250;202208;6717;17772;6049;16932;110;431;5495;15313;5605;15744
210255;202208;3008;8434;2564;7676;274;899;1664;4834;1938;5733
210260;202208;5948;16591;5134;15400;381;1213;4115;12342;4496;13555
210270;202208;5682;13952;5021;13133;81;378;4559;11759;4640;12137
210275;202208;3850;9019;3265;8317;175;405;2652;6798;2827;7203
210280;202208;6796;16685;5550;14895;171;722;4502;11645;4673;12367
210290;202208;9430;21169;8453;19998;137;358;7946;18721;8083;19079
210300;202208;37033;94873;29985;84863;5276;14098;16303;50509;21579;64607
210310;202208;3472;8024;3005;7388;48;135;2743;6700;2791;6835
210312;202208;3174;7014;2816;6630;20;87;2646;6132;2666;6219
210315;202208;3989;9049;3532;8539;120;269;3228;7866;3348;8135
210317;202208;5046;14124;4573;13564;97;454;4183;12298;4280;12752
210320;202208;28100;65974;26065;63453;295;1415;24355;58262;24650;59677
210325;202208;4055;10557;3379;9664;376;1081;2577;7470;2953;8551
210330;202208;29640;72824;23795;65712;3896;8772;15461;47108;19357;55880
210340;202208;13496;31753;12090;29997;493;1203;10254;25655;10747;26858
210350;202208;10566;26860;9259;25260;127;444;8378;22727;8505;23171
210355;202208;4438;13841;3895;12993;120;534;3289;10951;3409;11485
210360;202208;14168;41462;12755;39237;499;2233;9696;28782;10195;31015
210370;202208;13975;26658;10587;23095;410;582;9626;21478;10036;22060
210375;202208;3780;9589;2781;8114;897;2792;765;2403;1662;5195
210380;202208;6306;14698;5428;13642;269;704;4641;11602;4910;12306
210390;202208;3513;9584;3264;9201;71;332;2965;8213;3036;8545
210400;202208;5249;13906;4614;13164;215;458;4099;11973;4314;12431
210405;202208;8392;20060;6790;17930;1213;2770;4005;11348;5218;14118
210407;202208;2337;6869;1942;6194;108;374;1506;4790;1614;5164
210408;202208;3049;10184;2815;9870;176;746;2240;7891;2416;8637
210409;202208;4333;13464;3882;12846;201;732;3168;10711;3369;11443
210410;202208;4076;11010;3420;9888;95;400;2811;7928;2906;8328
210420;202208;4269;12596;3770;11719;214;623;3100;9693;3314;10316
210430;202208;2479;6822;2144;6363;178;473;1718;5214;1896;5687
210440;202208;4933;12178;4268;11358;191;393;3783;10158;3974;10551
210450;202208;2606;7023;2237;6491;203;491;1717;5124;1920;5615
210455;202208;5406;12778;4161;11212;991;2744;2105;5721;3096;8465
210460;202208;4078;10929;3403;10038;108;391;2888;8456;2996;8847
210462;202208;1881;5244;1567;4765;68;195;1232;3781;1300;3976
210465;202208;3042;7990;2635;7426;120;473;2196;6029;2316;6502
210467;202208;7068;19272;6091;18012;425;1175;4972;14981;5397;16156
210470;202208;2125;5477;1573;4700;144;418;1145;3467;1289;3885
210480;202208;19316;52307;15959;48239;1881;4065;11481;38103;13362;42168
210490;202208;3848;8953;3066;7916;72;202;2610;6682;2682;6884
210500;202208;7064;24542;6498;23623;344;1591;5465;19677;5809;21268
210510;202208;7359;20491;6492;19561;216;545;5861;17978;6077;18523
210515;202208;4276;11466;3624;10691;188;599;3028;9057;3216;9656
210520;202208;2893;7832;2581;7418;123;415;2157;6115;2280;6530
210530;202208;61962;143636;48071;123771;9073;24612;18458;52739;27531;77351
210535;202208;4187;11814;3798;11261;127;459;3331;9850;3458;10309
210540;202208;17059;45476;14211;41408;1754;4616;9779;29904;11533;34520
210542;202208;7392;16136;5737;14276;509;1147;4530;11494;5039;12641
210545;202208;2494;7114;2283;6773;44;181;1986;5799;2030;5980
210547;202208;4142;13605;3638;12716;206;763;2857;10164;3063;10927
210550;202208;6615;18866;5053;16366;551;1930;3227;10711;3778;12641
210560;202208;4164;11854;3665;11063;100;372;3131;9317;3231;9689
210565;202208;1654;4684;1372;4285;84;353;1054;3290;1138;3643
210570;202208;12358;31133;10905;29344;274;792;9734;26299;10008;27091
210580;202208;3374;8101;2656;7219;215;498;1902;5453;2117;5951
210590;202208;4733;13028;4045;12167;81;409;3600;10765;3681;11174
210592;202208;3163;8083;2922;7716;28;134;2578;6650;2606;6784
210594;202208;2783;7193;2166;6258;175;475;1549;4639;1724;5114
210596;202208;3267;10085;2897;9444;338;1096;2128;7150;2466;8246
210598;202208;2227;5638;1984;5314;92;266;1720;4594;1812;4860
210600;202208;3310;8540;2674;7639;280;734;1785;5125;2065;5859
210610;202208;3442;8180;2938;7577;61;250;2572;6535;2633;6785
210620;202208;3414;7637;2779;6847;156;305;2344;5763;2500;6068
210630;202208;3562;10524;3151;9831;154;598;2539;7824;2693;8422
210632;202208;6700;15908;5972;14956;175;701;5305;12929;5480;13630
210635;202208;1871;6214;1750;5996;176;561;1334;4701;1510;5262
210637;202208;2945;8667;2468;7995;153;566;1890;6195;2043;6761
210640;202208;5394;16788;4998;16331;62;321;4640;15144;4702;15465
210650;202208;7878;20753;7031;19672;105;371;6283;17528;6388;17899
210660;202208;9185;24480;8198;22913;195;852;7112;19293;7307;20145
210663;202208;3511;8124;3111;7645;299;478;2330;6242;2629;6720
210667;202208;2231;6577;1982;6204;46;162;1709;5469;1755;5631
210670;202208;6020;16414;5409;15501;119;481;4846;13710;4965;14191
210675;202208;6201;14376;5293;13269;585;1203;4123;10710;4708;11913
210680;202208;5499;11616;4642;10626;106;184;4307;9869;4413;10053
210690;202208;9914;24050;8304;22262;273;860;7494;19941;7767;20801
210700;202208;3155;8010;2505;7078;168;435;1902;5446;2070;5881
210710;202208;5934;16108;5207;15156;107;464;4685;13500;4792;13964
210720;202208;3479;10088;3021;9527;86;399;2679;8383;2765;8782
210725;202208;1498;4443;1284;4116;53;182;915;3033;968;3215
210730;202208;1649;3435;1393;3094;70;131;1195;2669;1265;2800
210735;202208;5252;13719;4434;12691;264;633;3660;10875;3924;11508
210740;202208;5913;13932;5011;12906;110;251;4274;10947;4384;11198
210745;202208;4844;12143;4386;11580;62;207;3959;10384;4021;10591
210750;202208;28129;68530;24334;63709;3228;7438;16383;44998;19611;52436
210760;202208;6845;15446;5735;14268;138;245;5351;13507;5489;13752
210770;202208;7124;16165;6093;14996;60;242;5694;13852;5754;14094
210780;202208;8438;24126;7256;22210;492;1520;5689;17427;6181;18947
210790;202208;5113;14105;4511;13315;283;721;3743;11347;4026;12068
210800;202208;5477;13512;4666;12421;81;312;4202;11002;4283;11314
210805;202208;4632;15046;4267;14510;197;736;3649;12460;3846;13196
210810;202208;5543;14744;4995;14048;435;1036;4024;11693;4459;12729
210820;202208;8109;21502;6757;19390;923;2509;4108;12185;5031;14694
210825;202208;8991;22558;8115;21441;293;799;7260;19152;7553;19951
210830;202208;9772;23723;8838;22594;654;1245;7397;19545;8051;20790
210840;202208;4507;9171;4127;8707;34;136;3845;7914;3879;8050
210845;202208;7096;17413;6229;16453;44;145;5960;15780;6004;15925
210850;202208;7545;21118;6257;19234;443;1322;4920;15325;5363;16647
210860;202208;24115;54816;19910;49800;1001;2178;16379;42213;17380;44391
210870;202208;8573;19427;6788;17427;143;385;6110;15611;6253;15996
210880;202208;4711;12974;4207;12332;225;713;3328;9684;3553;10397
210890;202208;5513;12581;5039;12042;256;630;4400;10410;4656;11040
210900;202208;5443;14665;4238;12539;1541;4632;871;2945;2412;7577
210905;202208;2537;5571;2156;5097;47;77;2011;4781;2058;4858
210910;202208;8230;23605;6772;21276;797;2485;4506;14237;5303;16722
210920;202208;3537;10379;3091;9788;76;355;2782;8708;2858;9063
210923;202208;2116;5029;1831;4610;78;229;1500;3687;1578;3916
210927;202208;5290;16128;4557;15227;585;1888;3127;10920;3712;12808
210930;202208;3237;8821;2845;8122;98;380;2432;6717;2530;7097
210940;202208;4203;11159;3815;10680;357;1544;3139;8106;3496;9650
210945;202208;8841;21338;7861;20217;454;933;6509;17294;6963;18227
210950;202208;6161;15435;4759;13489;570;1257;3304;9990;3874;11247
210955;202208;1728;4922;1447;4480;293;860;832;2665;1125;3525
210960;202208;10486;28677;8988;26421;2572;7357;4195;13361;6767;20718
210970;202208;1891;4598;1557;4047;93;272;1290;3226;1383;3498
210975;202208;2014;5582;1812;5285;173;504;1353;3957;1526;4461
210980;202208;11858;24024;10473;22581;110;236;9932;21394;10042;21630
210990;202208;20006;50193;15513;44522;1496;3609;11070;33264;12566;36873
211000;202208;16718;43342;13758;39696;2071;5210;9589;29333;11660;34543
211003;202208;7054;17568;5909;16221;116;431;5228;14432;5344;14863
211010;202208;7660;22924;6886;21959;86;403;6273;20128;6359;20531
211020;202208;9852;24905;8580;23497;216;707;7524;20985;7740;21692
211023;202208;2372;6923;2176;6673;120;375;1807;5526;1927;5901
211027;202208;4235;10724;4018;10404;115;390;3698;9420;3813;9810
211030;202208;4375;11158;3862;10516;363;915;2865;7974;3228;8889
211040;202208;5080;16613;4651;15888;122;625;4145;14052;4267;14677
211050;202208;10724;24428;9622;23053;131;407;8807;20953;8938;21360
211060;202208;8372;21874;7585;20835;168;653;6782;18376;6950;19029
211065;202208;2826;6592;2359;6009;103;224;2044;5268;2147;5492
211070;202208;9524;26221;8085;24127;321;1069;6871;20422;7192;21491
211080;202208;1527;3755;1198;3261;31;168;929;2345;960;2513
211085;202208;2472;6233;2042;5683;192;366;1589;4700;1781;5066
211090;202208;3509;8936;3148;8523;29;132;2915;7835;2944;7967
211100;202208;8104;17787;7527;17117;34;112;7136;16177;7170;16289
211102;202208;3793;11053;3432;10530;301;947;2758;8457;3059;9404
211105;202208;2629;7610;2199;6873;120;392;1677;5149;1797;5541
211107;202208;5400;15654;4556;14416;176;598;3634;11969;3810;12567
211110;202208;7275;17330;5763;15149;252;748;4676;11988;4928;12736
211120;202208;54939;123450;44818;111648;7438;16718;28603;74710;36041;91428
211125;202208;2199;6148;1847;5616;43;190;1568;4729;1611;4919
211130;202208;215912;475635;185459;436487;26414;54753;115682;284822;142096;339575
211140;202208;5393;14792;4651;13836;182;584;3927;11739;4109;12323
211150;202208;10936;26483;9147;24264;422;982;7556;20389;7978;21371
211153;202208;3348;8272;2331;7008;392;1071;1445;4612;1837;5683
211157;202208;1399;3970;1178;3562;81;247;841;2531;922;2778
211160;202208;5975;13567;4841;12013;129;471;3984;9384;4113;9855
211163;202208;1708;5095;1532;4847;50;184;1333;4238;1383;4422
211167;202208;1895;5082;1751;4884;30;110;1623;4506;1653;4616
211170;202208;7863;16578;7248;15861;53;137;6910;14976;6963;15113
211172;202208;2917;7498;2454;6812;94;324;1972;5263;2066;5587
211174;202208;3239;8373;2923;8019;33;166;2766;7514;2799;7680
211176;202208;4822;12616;3750;11062;334;1028;2877;8460;3211;9488
211178;202208;6016;11818;5186;10936;26;106;5022;10487;5048;10593
211180;202208;4726;14162;4317;13591;165;677;3607;11235;3772;11912
211190;202208;3757;9416;3171;8580;32;172;2898;7728;2930;7900
211195;202208;1838;4302;1598;3954;60;152;1412;3461;1472;3613
211200;202208;2431;6604;1906;5777;183;580;1342;4025;1525;4605
211210;202208;6972;19694;6230;18677;449;1420;5057;15170;5506;16590
211220;202208;47798;106395;39646;96548;3741;8486;29792;73129;33533;81615
211223;202208;6062;14852;4934;13372;626;1702;3235;8830;3861;10532
211227;202208;1934;5647;1667;5269;68;269;1355;4298;1423;4567
211230;202208;9756;24311;8328;22299;342;730;7088;19148;7430;19878
211240;202208;8957;25526;8372;24769;207;778;7705;22637;7912;23415
211245;202208;8761;21891;7652;20722;148;348;7255;19723;7403;20071
211250;202208;17253;45579;15596;43130;1242;3493;12349;33987;13591;37480
211260;202208;9168;26635;7954;25179;186;786;7122;22662;7308;23448
211270;202208;11605;33315;9875;31082;401;1598;8073;25556;8474;27154
211280;202208;17513;38295;15742;36110;500;1076;14268;32704;14768;33780
211285;202208;2335;6560;2078;6229;147;488;1601;4815;1748;5303
211290;202208;8104;22426;7228;21243;289;942;5981;17496;6270;18438
211300;202208;8245;22561;7150;20773;462;1435;5461;15608;5923;17043
211400;202208;13596;34292;11090;30899;1390;3694;7407;21575;8797;25269
220005;202208;2258;5162;2035;4860;34;94;1732;4009;1766;4103
220010;202208;1670;4396;1346;3852;40;132;1048;2960;1088;3092
220020;202208;5034;11245;4359;10356;155;419;3780;8780;3935;9199
220025;202208;2644;5304;2263;4748;73;125;1872;3809;1945;3934
220027;202208;1573;3481;1349;3179;32;106;1179;2707;1211;2813
220030;202208;4261;9346;3952;8957;102;264;3481;7745;3583;8009
220040;202208;8957;24793;7748;22582;1438;3848;4438;13396;5876;17244
220045;202208;1832;4775;1521;4290;24;128;1313;3585;1337;3713
220050;202208;6021;13577;5196;12556;62;234;4859;11550;4921;11784
220060;202208;3323;5722;2871;5204;24;43;2759;4958;2783;5001
220070;202208;2768;6448;2302;5786;68;142;1940;4821;2008;4963
220080;202208;839;2198;724;2038;14;58;623;1723;637;1781
220090;202208;2001;4387;1613;3822;73;102;1309;3157;1382;3259
220095;202208;1103;2029;1047;1971;26;45;969;1811;995;1856
220100;202208;1646;3991;1307;3482;31;122;1069;2713;1100;2835
220105;202208;2381;6549;2056;6004;137;439;1541;4447;1678;4886
220110;202208;4104;9969;3564;9096;41;175;3183;7986;3224;8161
220115;202208;3231;8302;2968;7970;148;427;2588;6893;2736;7320
220117;202208;1605;3493;1257;3021;12;46;1052;2444;1064;2490
220120;202208;18994;38344;17534;36529;78;308;16716;34279;16794;34587
220130;202208;1325;3164;1100;2862;24;106;987;2489;1011;2595
220140;202208;2678;4897;2280;4446;70;137;2064;4026;2134;4163
220150;202208;7512;19433;6792;18241;150;558;5755;15068;5905;15626
220155;202208;1360;3587;1083;3095;23;83;779;2147;802;2230
220157;202208;1274;2719;1072;2426;27;65;877;1934;904;1999
220160;202208;3253;8123;2777;7293;53;187;2264;5758;2317;5945
220170;202208;1807;4405;1517;3989;27;105;1323;3422;1350;3527
220173;202208;2439;6230;1939;5369;53;195;1524;4104;1577;4299
220177;202208;2578;5971;2446;5829;7;24;2411;5728;2418;5752
220180;202208;1367;2841;1119;2452;6;31;931;1892;937;1923
220190;202208;9423;19454;8059;17707;556;1073;6308;14106;6864;15179
220191;202208;1882;5043;1704;4757;115;367;1246;3367;1361;3734
220192;202208;2351;5680;1695;4554;39;137;1385;3625;1424;3762
220194;202208;2116;5226;1848;4816;52;191;1541;3842;1593;4033
220196;202208;2463;5688;2233;5360;22;103;1954;4578;1976;4681
220198;202208;1545;3539;1308;3250;9;22;1213;3018;1222;3040
220200;202208;5778;15503;5023;14506;115;407;4262;12267;4377;12674
220202;202208;2496;6206;2113;5592;33;128;1826;4729;1859;4857
220205;202208;3020;7446;2681;6866;79;228;2266;5664;2345;5892
220207;202208;886;2421;742;2180;79;203;472;1431;551;1634
220208;202208;2036;5689;1650;4987;255;812;898;2682;1153;3494
220209;202208;1784;4737;1505;4248;27;96;1230;3421;1257;3517
220210;202208;2221;4561;1943;4160;19;65;1727;3567;1746;3632
220211;202208;2015;4194;1845;3976;22;71;1636;3462;1658;3533
220213;202208;2096;4989;1765;4437;32;113;1436;3431;1468;3544
220217;202208;2801;6791;2596;6556;158;222;2297;6033;2455;6255
220220;202208;14834;31231;12712;28238;555;1213;10371;22619;10926;23832
220225;202208;1139;2665;918;2388;2;11;860;2217;862;2228
220230;202208;6721;15019;5778;13739;116;269;5132;12144;5248;12413
220240;202208;3666;9415;3027;8350;96;380;2476;6634;2572;7014
220245;202208;2308;4274;1770;3646;12;48;1640;3323;1652;3371
220250;202208;3544;8673;3105;8132;25;106;2901;7522;2926;7628
220253;202208;1895;4663;1595;4199;36;122;1370;3520;1406;3642
220255;202208;2281;4786;1922;4289;44;155;1663;3549;1707;3704
220260;202208;5822;14762;5068;13474;269;681;4049;10718;4318;11399
220265;202208;1731;4648;1580;4451;86;311;1320;3615;1406;3926
220270;202208;6926;20517;6476;19724;177;905;5467;15993;5644;16898
220271;202208;1719;3985;1499;3682;40;115;1284;3132;1324;3247
220272;202208;2002;5285;1736;4803;56;197;1314;3456;1370;3653
220273;202208;1475;3813;1224;3371;57;193;936;2529;993;2722
220275;202208;3022;5835;2435;5060;26;54;2251;4592;2277;4646
220277;202208;2761;5837;2324;5236;101;186;1930;4282;2031;4468
220280;202208;2258;4244;1899;3804;28;50;1715;3362;1743;3412
220285;202208;1896;3916;1634;3606;11;47;1554;3374;1565;3421
220290;202208;8075;20153;6426;17913;514;1289;4584;13235;5098;14524
220300;202208;2278;5973;1775;5327;33;170;1460;4319;1493;4489
220310;202208;3694;8832;2905;7919;42;169;2535;6833;2577;7002
220320;202208;3537;9261;2729;7852;78;357;2143;5922;2221;6279
220323;202208;1908;4975;1452;4249;42;172;1187;3358;1229;3530
220325;202208;1382;3860;1157;3477;33;146;925;2717;958;2863
220327;202208;1871;4681;1634;4313;67;236;1360;3472;1427;3708
220330;202208;6168;12125;5323;11145;38;125;4961;10214;4999;10339
220335;202208;2141;5415;1941;5146;110;194;1657;4463;1767;4657
220340;202208;2086;5202;1570;4349;76;242;1009;2682;1085;2924
220342;202208;1408;3662;1257;3447;88;185;966;2695;1054;2880
220345;202208;3562;7306;2694;6130;24;83;2388;5324;2412;5407
220350;202208;3839;8999;3068;7873;215;504;2162;5514;2377;6018
220360;202208;1505;3462;1160;2925;20;60;948;2321;968;2381
220370;202208;10290;26221;9274;24669;372;1023;7830;20610;8202;21633
220375;202208;1965;4762;1739;4489;9;13;1674;4336;1683;4349
220380;202208;1834;3740;1471;3240;16;39;1306;2836;1322;2875
220385;202208;1074;2205;876;1872;7;13;781;1634;788;1647
220390;202208;13786;30710;10970;26670;1885;4602;5821;14136;7706;18738
220400;202208;1758;3802;1335;3153;20;61;1037;2311;1057;2372
220410;202208;1378;3439;1115;3002;26;90;923;2428;949;2518
220415;202208;989;2323;795;2003;24;50;628;1550;652;1600
220420;202208;2179;5765;1735;4914;77;260;1270;3505;1347;3765
220430;202208;3366;7305;3004;6830;50;130;2726;6073;2776;6203
220435;202208;2378;5134;2064;4665;29;90;1786;3899;1815;3989
220440;202208;3709;8672;3152;7878;53;249;2832;6740;2885;6989
220450;202208;3193;7178;2653;6513;47;167;2366;5714;2413;5881
220455;202208;1553;4037;1477;3944;9;51;1360;3614;1369;3665
220460;202208;1334;2722;1234;2588;32;66;1094;2224;1126;2290
220465;202208;2763;7676;2424;7158;166;485;1892;5622;2058;6107
220470;202208;4448;10794;3923;9964;178;405;3079;7670;3257;8075
220480;202208;3082;7415;2448;6441;206;415;1670;4393;1876;4808
220490;202208;2838;6443;2413;5920;26;119;2120;5082;2146;5201
220500;202208;3820;8348;3194;7407;126;241;2485;5629;2611;5870
220510;202208;3152;7641;2532;6596;109;262;2018;5273;2127;5535
220515;202208;2073;4339;1902;4101;72;95;1627;3489;1699;3584
220520;202208;5999;13737;5382;12875;138;296;4523;10877;4661;11173
220525;202208;1634;3589;1371;3273;10;32;1260;2999;1270;3031
220527;202208;1850;4090;1554;3663;46;103;1380;3258;1426;3361
220530;202208;1934;3985;1626;3597;161;347;1245;2844;1406;3191
220535;202208;1017;2428;942;2316;32;108;777;1831;809;1939
220540;202208;3750;10718;3443;10129;215;610;2795;8205;3010;8815
220545;202208;1710;4542;1552;4302;78;302;1303;3514;1381;3816
220550;202208;10126;28966;8913;26758;482;1645;6667;19503;7149;21148
220551;202208;1688;4109;1460;3730;21;79;1240;3083;1261;3162
220552;202208;1879;5011;1517;4387;21;114;1220;3388;1241;3502
220553;202208;2432;4871;2037;4361;25;49;1847;3904;1872;3953
220554;202208;1132;2532;871;2134;99;179;599;1468;698;1647
220555;202208;4269;8115;3779;7538;33;104;3399;6692;3432;6796
220556;202208;1476;3820;1292;3494;42;180;961;2441;1003;2621
220557;202208;1943;5409;1601;4696;99;362;1159;3257;1258;3619
220558;202208;1685;3947;1340;3473;25;97;1142;2860;1167;2957
220559;202208;2162;4686;1827;4172;60;100;1507;3426;1567;3526
220560;202208;2174;4213;1803;3768;23;43;1679;3477;1702;3520
220570;202208;9442;24381;8485;23009;640;1545;6713;18218;7353;19763
220580;202208;7849;19260;7075;18094;124;362;6297;16009;6421;16371
220585;202208;2384;6771;1961;6006;62;172;1587;4861;1649;5033
220590;202208;1784;4041;1478;3612;109;227;1149;2796;1258;3023
220595;202208;3241;7669;2918;7252;100;288;2497;6105;2597;6393
220600;202208;2104;3661;1842;3364;26;39;1718;3107;1744;3146
220605;202208;1715;4664;1470;4238;19;105;1180;3276;1199;3381
220610;202208;3278;8223;3050;7899;18;100;2877;7369;2895;7469
220620;202208;9950;25397;9078;24232;137;670;8334;21842;8471;22512
220630;202208;412;1123;318;958;27;84;197;562;224;646
220635;202208;2082;5608;1843;5140;65;221;1480;4006;1545;4227
220640;202208;2748;6962;2321;6351;96;314;1865;5053;1961;5367
220650;202208;2793;6346;2401;5769;117;221;1918;4642;2035;4863
220660;202208;2930;8427;2439;7613;78;367;1992;6059;2070;6426
220665;202208;1492;3982;1268;3627;35;158;1074;2970;1109;3128
220667;202208;1899;5109;1713;4796;89;294;1394;3826;1483;4120
220669;202208;1906;5070;1810;4932;40;167;1623;4312;1663;4479
220670;202208;2682;5897;2143;5152;28;84;1893;4488;1921;4572
220672;202208;3955;8740;3250;7897;93;326;2887;6819;2980;7145
220675;202208;1502;3742;1333;3451;84;235;1004;2549;1088;2784
220680;202208;3619;7845;3453;7638;261;351;2996;6884;3257;7235
220690;202208;1828;4366;1582;3994;109;303;1193;2953;1302;3256
220695;202208;1081;2708;982;2542;22;60;829;2112;851;2172
220700;202208;14192;28264;11654;24991;481;1065;9487;19660;9968;20725
220710;202208;1025;2518;744;2040;22;78;573;1510;595;1588
220720;202208;2640;5358;2371;5020;24;76;2123;4385;2147;4461
220730;202208;1550;3833;1322;3483;15;68;1145;2926;1160;2994
220735;202208;1209;2442;928;2028;40;80;734;1555;774;1635
220740;202208;1604;3731;1280;3301;56;140;1052;2737;1108;2877
220750;202208;5053;10672;4467;9893;226;383;3978;8846;4204;9229
220755;202208;1747;3606;1459;3201;27;69;1233;2635;1260;2704
220760;202208;4142;8878;3642;8236;43;146;3447;7719;3490;7865
220770;202208;31114;80831;26713;73749;6872;19858;11733;32456;18605;52314
220775;202208;1596;3342;1429;3137;6;26;1393;3025;1399;3051
220777;202208;1807;4230;1407;3630;57;110;996;2673;1053;2783
220779;202208;1414;3458;1211;3141;40;120;1011;2572;1051;2692
220780;202208;6791;14996;6092;14018;336;811;4834;11011;5170;11822
220785;202208;1691;3351;1486;3094;20;49;1399;2879;1419;2928
220790;202208;12184;30300;10885;28514;241;935;9357;24079;9598;25014
220793;202208;1159;2586;936;2222;15;34;797;1863;812;1897
220795;202208;1625;3761;1417;3465;25;85;1259;3046;1284;3131
220800;202208;24919;47517;21463;43107;1031;1898;17415;34152;18446;36050
220810;202208;3563;8913;3004;7998;83;202;2400;6466;2483;6668
220820;202208;6951;14725;6122;13571;266;477;5171;11355;5437;11832
220830;202208;8686;20222;7686;18824;371;947;6271;15034;6642;15981
220840;202208;15173;39940;12823;35646;2011;5335;7741;21229;9752;26564
220850;202208;3514;9805;3114;9303;59;276;2788;8317;2847;8593
220855;202208;975;1946;851;1791;14;51;781;1612;795;1663
220860;202208;1368;2788;1166;2513;26;77;1077;2279;1103;2356
220865;202208;2615;6596;1997;5518;48;200;1510;4001;1558;4201
220870;202208;3862;8755;3209;7931;34;153;2952;7184;2986;7337
220880;202208;7618;14122;6603;12902;140;307;6090;11782;6230;12089
220885;202208;1750;4373;1461;3944;70;228;1180;3128;1250;3356
220887;202208;1846;3527;1550;3145;37;57;1427;2882;1464;2939
220890;202208;1645;4436;1412;4105;60;202;1150;3333;1210;3535
220900;202208;2572;5139;2166;4609;26;54;1948;4058;1974;4112
220910;202208;2021;4543;1719;4102;269;413;1239;3172;1508;3585
220915;202208;1071;2677;836;2264;10;41;631;1603;641;1644
220920;202208;1802;4795;1554;4475;94;291;1295;3732;1389;4023
220930;202208;2338;5030;1980;4558;22;63;1788;4160;1810;4223
220935;202208;1222;3267;954;2704;19;82;640;1688;659;1770
220937;202208;1700;4084;1431;3653;42;126;1134;2829;1176;2955
220940;202208;2181;4747;1786;4109;35;112;1524;3353;1559;3465
220945;202208;576;1766;458;1551;23;124;310;1016;333;1140
220950;202208;1589;3413;1064;2617;14;40;860;2013;874;2053
220955;202208;1875;4251;1542;3708;21;47;1332;3148;1353;3195
220960;202208;864;2092;627;1700;35;108;398;1003;433;1111
220965;202208;2089;4966;1816;4588;30;124;1575;3858;1605;3982
220970;202208;2518;4998;1874;4091;10;32;1658;3509;1668;3541
220975;202208;887;2066;762;1915;12;55;683;1654;695;1709
220980;202208;1406;3433;1250;3228;28;93;1076;2722;1104;2815
220985;202208;1698;3659;1471;3316;96;161;1142;2566;1238;2727
220987;202208;1734;4547;1531;4214;54;190;1262;3419;1316;3609
220990;202208;1904;4828;1657;4452;26;101;1395;3690;1421;3791
220995;202208;1587;3713;1306;3248;15;45;1098;2677;1113;2722
220997;202208;2800;7450;2539;7022;51;200;2258;6090;2309;6290
221000;202208;5438;12995;4760;12057;132;465;4094;10176;4226;10641
221005;202208;1868;4216;1701;3950;23;97;1462;3235;1485;3332
221010;202208;1515;2928;1198;2539;35;54;1059;2215;1094;2269
221020;202208;1748;4920;1570;4626;25;93;1226;3577;1251;3670
221030;202208;1958;4123;1663;3762;22;57;1473;3352;1495;3409
221035;202208;1849;4128;1577;3757;30;48;1393;3339;1423;3387
221037;202208;826;2008;696;1789;12;39;527;1263;539;1302
221038;202208;597;1530;464;1309;25;83;332;905;357;988
221039;202208;977;2455;805;2177;29;114;649;1700;678;1814
221040;202208;5110;13303;4392;12122;218;603;3536;9711;3754;10314
221050;202208;5373;10828;4815;10138;90;222;4383;9136;4473;9358
221060;202208;11229;27225;9233;24036;462;1069;7408;19085;7870;20154
221062;202208;1409;3868;1203;3550;67;196;979;2853;1046;3049
221063;202208;1400;3320;1214;3063;65;184;990;2431;1055;2615
221065;202208;3383;7299;2944;6592;16;54;2660;5839;2676;5893
221070;202208;3856;10880;3101;9345;434;1254;1871;5743;2305;6997
221080;202208;4197;9240;3433;8121;52;184;2895;6581;2947;6765
221090;202208;1637;3700;1347;3270;15;48;1174;2782;1189;2830
221093;202208;1960;4459;1777;4159;181;350;1286;2954;1467;3304
221095;202208;1053;2465;869;2202;27;79;714;1785;741;1864
221097;202208;973;2283;730;1873;16;49;568;1369;584;1418
221100;202208;159799;370449;135168;331836;9452;26599;98602;229959;108054;256558
221110;202208;12602;31746;11478;30336;294;849;10167;26676;10461;27525
221120;202208;5614;14646;4982;13721;171;531;4301;11779;4472;12310
221130;202208;6860;15200;5372;12612;737;1691;3517;7846;4254;9537
221135;202208;2372;4935;2062;4546;78;150;1774;3974;1852;4124
221140;202208;1796;3439;1499;3080;45;78;1334;2717;1379;2795
221150;202208;1312;2957;990;2432;24;108;784;1798;808;1906
221160;202208;851;1942;748;1811;44;63;576;1417;620;1480
221170;202208;1182;2936;1093;2783;7;22;990;2468;997;2490
230010;202208;3550;8502;2902;7427;42;145;2397;5925;2439;6070
230015;202208;4148;11192;3587;10083;206;636;2597;7150;2803;7786
230020;202208;17742;46031;16458;44116;746;1968;14038;37559;14784;39527
230030;202208;14945;33670;12514;30481;422;1016;10528;25616;10950;26632
230040;202208;5115;11813;4234;10456;50;204;3656;8810;3706;9014
230050;202208;3017;8699;2309;7134;282;937;1157;3256;1439;4193
230060;202208;2838;6917;2217;5881;37;142;1787;4602;1824;4744
230070;202208;5145;11733;4108;9956;588;1235;2590;6404;3178;7639
230075;202208;11541;31362;10467;29598;530;1831;8592;23660;9122;25491
230080;202208;3661;6799;2814;5764;12;28;2623;5327;2635;5355
230090;202208;5445;11594;4560;10251;164;360;3808;8314;3972;8674
230100;202208;25435;55746;22162;51544;1878;4416;15885;36480;17763;40896
230110;202208;15641;42557;13094;37789;1975;5902;7251;20398;9226;26300
230120;202208;9684;22647;8376;20661;614;1559;6177;15070;6791;16629
230125;202208;3583;8550;2943;7543;78;255;2389;5883;2467;6138
230130;202208;6671;18312;5423;15757;376;1066;3754;10741;4130;11807
230140;202208;4143;11054;3457;9746;105;430;2721;7342;2826;7772
230150;202208;1886;5065;1546;4379;187;508;943;2664;1130;3172
230160;202208;8502;17787;7360;16153;215;450;6331;13591;6546;14041
230170;202208;7324;19194;5923;16445;436;1168;4136;11257;4572;12425
230180;202208;1870;4714;1565;4153;15;63;1276;3247;1291;3310
230185;202208;5408;13239;4517;11843;440;1103;3192;8474;3632;9577
230190;202208;17028;46300;14025;40813;1710;5074;8112;23070;9822;28144
230195;202208;6663;17239;5962;16098;357;967;4566;12254;4923;13221
230200;202208;5594;14394;4592;12605;278;795;3421;9127;3699;9922
230205;202208;5070;12736;4419;11837;286;740;3485;9201;3771;9941
230210;202208;12853;26499;10916;23991;509;1101;8774;18800;9283;19901
230220;202208;17936;39416;15704;36332;897;2032;12857;29249;13754;31281
230230;202208;8294;21552;7426;19933;380;1097;5848;15302;6228;16399
230240;202208;16118;37125;13703;33249;713;1573;10849;25957;11562;27530
230250;202208;10633;26710;9807;25503;429;1180;7546;18969;7975;20149
230260;202208;17921;46150;15379;41937;2289;5972;9167;24927;11456;30899
230270;202208;8711;21171;6680;17591;919;2210;3782;10374;4701;12584
230280;202208;23941;55666;19712;48910;417;1695;16184;37875;16601;39570
230290;202208;6144;14474;5150;12719;207;507;4133;9898;4340;10405
230300;202208;5919;13703;5282;12833;74;214;4664;11322;4738;11536
230310;202208;5451;14171;4558;12592;175;587;3300;8810;3475;9397
230320;202208;9004;23699;7458;21036;255;1019;5826;15894;6081;16913
230330;202208;5603;13817;4366;11550;136;445;3307;8433;3443;8878
230340;202208;4487;12662;3851;11427;231;765;2778;7976;3009;8741
230350;202208;22377;53143;19543;49188;942;2833;14423;35272;15365;38105
230360;202208;3558;8377;2784;7077;149;369;2044;5137;2193;5506
230365;202208;3673;7865;3034;6960;85;251;2626;5914;2711;6165
230370;202208;85808;194382;74693;179304;4598;12958;57987;133168;62585;146126
230380;202208;7312;18394;5750;15572;140;522;4374;11321;4514;11843
230390;202208;3986;10327;3404;9425;76;316;2714;7301;2790;7617
230393;202208;3971;10201;3156;8623;87;446;2519;6500;2606;6946
230395;202208;6618;16639;5636;15002;545;1420;3747;9848;4292;11268
230400;202208;6540;16000;5721;14745;79;383;4658;11431;4737;11814
230410;202208;14838;41398;12144;36659;874;2830;8410;25290;9284;28120
230420;202208;34974;86474;28663;76188;2834;7890;17965;45930;20799;53820
230423;202208;5332;14496;4653;13247;313;970;3370;9352;3683;10322
230425;202208;7022;19120;6418;18005;656;1764;4537;12611;5193;14375
230426;202208;3162;7535;2288;5936;47;175;1755;4351;1802;4526
230427;202208;2087;5424;1471;4199;157;458;798;2096;955;2554
230428;202208;11519;28608;9832;26199;1456;3823;5755;14987;7211;18810
230430;202208;5683;14780;4472;12700;151;533;3410;9408;3561;9941
230435;202208;7568;17195;6154;14884;864;1999;3650;8715;4514;10714
230440;202208;555677;1189648;472478;1075208;31176;79352;350378;764364;381554;843716
230445;202208;4789;12089;3855;10504;250;682;2598;6808;2848;7490
230450;202208;4346;10989;3777;10177;199;717;2879;7386;3078;8103
230460;202208;2552;6200;2185;5628;66;237;1829;4594;1895;4831
230465;202208;4979;12286;4177;10826;136;437;3257;8057;3393;8494
230470;202208;13080;38730;11710;36300;773;2898;8595;25830;9368;28728
230480;202208;1766;4444;1476;3947;58;253;1154;2869;1212;3122
230490;202208;3243;8098;2682;7050;204;635;1808;4400;2012;5035
230495;202208;7070;17845;6183;16361;734;2005;3929;10093;4663;12098
230500;202208;10510;31137;9228;28882;329;1220;7423;23182;7752;24402
230510;202208;2024;5084;1587;4233;166;436;958;2469;1124;2905
230520;202208;5537;13652;4757;12361;377;929;3468;8816;3845;9745
230523;202208;18898;51328;14905;43374;3339;9420;4266;12716;7605;22136
230526;202208;4607;11307;3866;10128;326;678;2716;7351;3042;8029
230530;202208;6244;18204;5189;16251;891;2858;3147;9813;4038;12671
230533;202208;5649;11298;4447;9546;73;200;3795;7792;3868;7992
230535;202208;5827;15299;4881;13750;348;1098;3269;9110;3617;10208
230540;202208;17552;44938;14907;40985;308;1120;12272;33251;12580;34371
230550;202208;26733;61927;21855;54177;1877;4627;15010;36069;16887;40696
230560;202208;9038;19710;7228;17005;193;408;6128;14397;6321;14805
230565;202208;3626;9016;3005;7924;99;323;2389;6103;2488;6426
230570;202208;3895;9135;3276;8283;67;213;2727;6761;2794;6974
230580;202208;14367;31584;12358;28795;597;1175;10234;23742;10831;24917
230590;202208;11109;28123;9208;24888;633;1708;6797;17980;7430;19688
230600;202208;4445;10051;3466;8445;144;332;2401;5847;2545;6179
230610;202208;7800;19191;6851;17634;464;1181;5392;13769;5856;14950
230620;202208;2412;5962;1873;4966;99;318;1231;3046;1330;3364
230625;202208;11274;27634;9615;24876;1946;5282;4561;11265;6507;16547
230630;202208;13818;34631;12114;31624;1298;3135;8145;21236;9443;24371
230640;202208;31411;87481;28271;82456;1326;4765;22693;64694;24019;69459
230650;202208;6162;14917;5187;13327;139;560;4328;10676;4467;11236
230655;202208;11187;32906;10488;31784;743;2161;8500;25941;9243;28102
230660;202208;6923;18777;5555;16417;182;817;4443;12806;4625;13623
230670;202208;6979;15186;5045;12223;150;417;4041;9432;4191;9849
230680;202208;3215;7875;2668;6978;178;366;1862;4865;2040;5231
230690;202208;8081;21917;6792;19495;460;1458;4367;12336;4827;13794
230700;202208;12670;27856;10120;23432;466;1107;7807;17462;8273;18569
230710;202208;7787;22672;6809;20697;627;1902;4635;13885;5262;15787
230720;202208;2257;6044;1860;5338;137;374;1273;3555;1410;3929
230725;202208;5404;14186;4844;13250;362;1130;3318;8719;3680;9849
230730;202208;70047;169232;54930;147875;12096;32427;20980;59201;33076;91628
230740;202208;6979;17993;5839;16194;179;539;4622;12731;4801;13270
230750;202208;9663;23660;7912;20838;151;528;6380;16249;6531;16777
230760;202208;13440;32016;11576;29278;466;1484;8887;21618;9353;23102
230763;202208;5640;13895;4616;12193;95;393;3686;9347;3781;9740
230765;202208;50866;123848;42618;111211;4588;12805;26540;66212;31128;79017
230770;202208;34420;70018;29349;63697;2005;4441;22651;47708;24656;52149
230780;202208;7634;23971;6834;22162;879;2782;4144;13526;5023;16308
230790;202208;3635;9162;3239;8562;134;449;2531;6377;2665;6826
230800;202208;10292;28714;8932;26129;1166;3458;5269;14840;6435;18298
230810;202208;12389;34606;10973;32324;511;1690;8511;24536;9022;26226
230820;202208;4056;12025;3340;10550;317;1191;2088;6245;2405;7436
230830;202208;9047;21849;7633;19603;260;678;6227;15526;6487;16204
230835;202208;4780;10427;3695;8786;127;290;2997;6950;3124;7240
230837;202208;4168;10276;3722;9563;80;317;3197;7892;3277;8209
230840;202208;11142;29638;9563;26995;776;2162;7027;19692;7803;21854
230850;202208;12119;30047;10240;26712;549;1402;7689;19768;8238;21170
230860;202208;7436;14609;6235;12969;71;189;5678;11498;5749;11687
230870;202208;21002;43248;18056;38633;881;1687;14660;30766;15541;32453
230880;202208;2332;6449;2121;6108;67;299;1664;4610;1731;4909
230890;202208;5250;15087;4716;14141;238;827;3533;10317;3771;11144
230900;202208;3798;9693;3201;8566;128;445;2363;6013;2491;6458
230910;202208;3951;9043;3090;7783;63;259;2569;6343;2632;6602
230920;202208;5471;13895;4408;12163;117;433;3422;9093;3539;9526
230930;202208;8027;20486;6566;17961;313;928;4600;12257;4913;13185
230940;202208;9728;21747;8445;19888;164;398;7276;16885;7440;17283
230945;202208;7595;19623;6440;17535;306;966;4725;12374;5031;13340
230950;202208;7305;16372;6425;15196;115;287;5533;13000;5648;13287
230960;202208;15342;40419;13193;36540;2052;5808;6837;18284;8889;24092
230970;202208;18226;43094;15452;38978;1458;3840;10391;25337;11849;29177
230980;202208;3732;8695;3221;7865;299;711;2306;5581;2605;6292
230990;202208;1965;5020;1621;4375;73;267;1175;2983;1248;3250
231000;202208;3114;7482;2449;6231;78;234;1854;4470;1932;4704
231010;202208;4548;8961;3576;7441;26;105;3234;6489;3260;6594
231020;202208;10440;27490;9229;25333;1366;3434;5752;16076;7118;19510
231025;202208;9425;22343;8278;20609;555;1331;6479;15902;7034;17233
231030;202208;8438;23162;6436;19157;841;2420;3760;11095;4601;13515
231040;202208;3654;8808;3121;7910;76;240;2616;6367;2692;6607
231050;202208;14155;31937;11541;27587;518;1356;9106;20921;9624;22277
231060;202208;3281;8365;2904;7789;83;281;2327;6291;2410;6572
231070;202208;9419;24634;8095;22351;693;1966;5558;15041;6251;17007
231080;202208;4523;11653;3735;10354;212;661;2667;7294;2879;7955
231085;202208;8633;18464;6963;16509;206;511;5678;13202;5884;13713
231090;202208;5057;12211;3694;9661;113;431;2635;6508;2748;6939
231095;202208;2550;7116;2027;6032;191;553;1335;3936;1526;4489
231100;202208;3540;9317;2893;8165;137;451;2175;5966;2312;6417
231110;202208;4246;11411;3900;10790;343;1062;2742;7267;3085;8329
231120;202208;2820;7251;2358;6497;105;311;1767;4767;1872;5078
231123;202208;2251;5359;1747;4475;104;251;1251;3152;1355;3403
231126;202208;6413;16010;5186;13774;284;737;3849;10035;4133;10772
231130;202208;28411;60489;23738;54753;1273;3623;18526;40751;19799;44374
231135;202208;4882;12512;4020;10917;167;493;2892;7686;3059;8179
231140;202208;19833;50147;16017;43975;713;2544;11855;31226;12568;33770
231150;202208;6910;17323;4913;13492;800;2197;1834;5037;2634;7234
231160;202208;8230;21395;7306;19748;771;1953;4738;12777;5509;14730
231170;202208;5456;14104;4504;12395;277;821;3245;8514;3522;9335
231180;202208;17568;44747;14274;38369;2316;6245;7352;19204;9668;25449
231190;202208;4763;12054;3731;10220;86;328;2906;7690;2992;8018
231195;202208;5818;16028;4763;14002;297;994;3466;10022;3763;11016
231200;202208;9865;25032;8542;22593;148;679;7238;18189;7386;18868
231210;202208;5637;14827;4735;13325;148;585;3770;10226;3918;10811
231220;202208;15770;34729;12470;29047;639;1370;9366;20922;10005;22292
231230;202208;11120;32324;9755;29871;696;2314;7302;22058;7998;24372
231240;202208;13918;37304;12207;34283;1673;4580;7597;21145;9270;25725
231250;202208;2417;5500;1592;3839;81;189;1068;2419;1149;2608
231260;202208;3843;9416;3265;8532;305;711;2276;5988;2581;6699
231270;202208;7566;17540;6132;15257;145;546;4754;11234;4899;11780
231280;202208;2055;5792;1793;5333;164;469;1225;3640;1389;4109
231290;202208;42854;117432;35859;104688;4851;14324;18996;53482;23847;67806
231300;202208;4856;12182;3793;10159;135;456;2683;6848;2818;7304
231310;202208;9439;20966;7475;17613;583;1482;5377;12072;5960;13554
231320;202208;8202;21197;6278;17774;145;437;4885;13697;5030;14134
231325;202208;2865;6703;2256;5749;162;298;1632;4154;1794;4452
231330;202208;12359;32246;10253;28371;1370;3602;6493;18016;7863;21618
231335;202208;6417;15588;5312;13887;143;471;4531;11687;4674;12158
231340;202208;21650;59785;19358;56013;1409;4111;14643;42463;16052;46574
231350;202208;18729;45815;16978;43365;278;904;15268;38495;15546;39399
231355;202208;5166;13666;4569;12611;204;652;3631;9775;3835;10427
231360;202208;9168;25041;7896;22962;374;1183;6230;17836;6604;19019
231370;202208;2414;6149;1921;5284;43;135;1475;3981;1518;4116
231375;202208;4720;13401;4205;12556;119;448;3484;10264;3603;10712
231380;202208;7009;16582;6218;15539;190;438;5165;12915;5355;13353
231390;202208;3912;10443;3482;9748;108;436;2631;7072;2739;7508
231395;202208;5012;13005;4191;11713;281;795;2951;8047;3232;8842
231400;202208;11592;29630;9683;26248;289;1206;7569;19651;7858;20857
231410;202208;18260;48371;16521;45734;914;2401;13447;37218;14361;39619
240010;202208;2991;7162;2339;6048;355;907;1203;3006;1558;3913
240020;202208;16145;39089;13497;34636;814;2480;9476;23202;10290;25682
240030;202208;4522;8462;4080;7850;91;261;3703;6841;3794;7102
240040;202208;912;2452;755;2170;21;82;509;1387;530;1469
240050;202208;3957;9676;3097;8149;61;176;2379;6077;2440;6253
240060;202208;1716;4078;1360;3458;49;132;1064;2642;1113;2774
240070;202208;3074;7670;2714;6951;213;597;1961;4745;2174;5342
240080;202208;3405;8406;2678;7179;117;347;1925;5040;2042;5387
240090;202208;2642;5796;2156;5025;29;68;1845;4209;1874;4277
240100;202208;13018;27696;10441;23472;229;685;8510;18061;8739;18746
240110;202208;5505;14121;4585;12472;161;589;3488;9075;3649;9664
240120;202208;3950;10217;3290;9363;250;866;2374;6567;2624;7433
240130;202208;4628;8271;3772;7183;39;82;3419;6417;3458;6499
240140;202208;2068;5782;1749;5213;202;681;1105;3184;1307;3865
240145;202208;7893;20399;6382;17874;693;2010;4093;11246;4786;13256
240150;202208;1203;2965;1009;2609;50;159;787;1953;837;2112
240160;202208;1691;4564;1384;4007;39;162;1012;2850;1051;3012
240165;202208;1121;2756;936;2423;30;97;781;1960;811;2057
240170;202208;3311;7801;2777;6912;297;728;1829;4488;2126;5216
240180;202208;3545;9678;2830;8238;612;1718;1309;3932;1921;5650
240185;202208;1561;4333;1404;4064;50;194;1111;3096;1161;3290
240190;202208;1303;3252;1097;2940;27;101;917;2422;944;2523
240200;202208;14866;32617;12082;28158;1411;3306;7453;16644;8864;19950
240210;202208;4079;8540;3367;7433;36;154;2940;6181;2976;6335
240220;202208;8502;23598;7553;22126;466;1620;5821;16810;6287;18430
240230;202208;6920;15809;5442;13468;288;598;4040;10105;4328;10703
240240;202208;2045;5543;1385;4108;175;551;489;1247;664;1798
240250;202208;3715;8388;3203;7657;53;208;2742;6324;2795;6532
240260;202208;18728;48443;16246;44434;4655;12320;7050;21231;11705;33551
240270;202208;2860;7484;2380;6720;114;339;1684;4842;1798;5181
240280;202208;1900;4494;1575;3978;75;185;1231;3069;1306;3254
240290;202208;1335;3542;1070;3014;30;131;738;1892;768;2023
240300;202208;2599;6188;1886;4958;102;254;1177;3011;1279;3265
240310;202208;9835;24267;7769;20701;999;2677;4048;10530;5047;13207
240320;202208;2252;5688;1562;4342;94;291;1085;2873;1179;3164
240325;202208;40962;97214;33548;85281;4144;11711;19792;47455;23936;59166
240330;202208;2122;5263;1640;4410;69;233;1151;2909;1220;3142
240340;202208;2460;4850;1995;4178;58;146;1674;3335;1732;3481
240350;202208;2972;6187;2647;5813;33;99;2453;5325;2486;5424
240360;202208;13821;33378;12344;31177;1899;4421;7955;20228;9854;24649
240370;202208;2585;5627;1995;4580;89;242;1500;3215;1589;3457
240375;202208;1094;2480;899;2168;37;123;702;1592;739;1715
240380;202208;2689;6864;2066;5603;204;527;1190;3165;1394;3692
240390;202208;1157;2592;786;1925;26;57;521;1180;547;1237
240400;202208;1710;3845;1281;3143;37;133;931;2127;968;2260
240410;202208;683;1896;550;1640;52;192;323;905;375;1097
240420;202208;5912;17744;5264;16493;465;1813;3619;10793;4084;12606
240430;202208;4152;9507;3467;8387;114;371;2713;6225;2827;6596
240440;202208;3278;6652;2800;5985;284;513;2107;4496;2391;5009
240450;202208;5160;12943;4045;10962;355;1149;2503;6265;2858;7414
240460;202208;3978;9419;3558;8771;295;660;2869;7110;3164;7770
240470;202208;3978;11273;3031;9362;628;1776;1425;4631;2053;6407
240480;202208;666;1668;409;1122;28;71;205;530;233;601
240485;202208;2487;6448;1989;5592;153;456;1310;3671;1463;4127
240490;202208;1917;4298;1466;3539;90;178;1063;2509;1153;2687
240500;202208;2466;6095;2123;5526;109;296;1715;4393;1824;4689
240510;202208;1895;4726;1621;4318;72;229;1291;3340;1363;3569
240520;202208;1894;3877;1444;3283;103;211;1133;2570;1236;2781
240530;202208;2766;6640;2435;6113;99;240;2044;5009;2143;5249
240540;202208;2714;6026;2421;5589;52;139;2160;4935;2212;5074
240550;202208;1003;2228;889;2042;15;53;795;1767;810;1820
240560;202208;4535;9536;3905;8725;174;324;3237;7194;3411;7518
240570;202208;3159;7873;2126;5707;298;820;780;1905;1078;2725
240580;202208;10090;25988;8895;23953;528;1503;7228;19218;7756;20721
240590;202208;1039;2112;889;1889;12;26;733;1488;745;1514
240600;202208;2063;5092;1489;3994;57;159;1039;2632;1096;2791
240610;202208;5409;12526;4607;11168;201;522;3480;8099;3681;8621
240615;202208;1486;3449;1182;2955;107;277;850;2035;957;2312
240620;202208;2229;5484;1910;4960;76;251;1581;3995;1657;4246
240630;202208;2516;6032;2263;5632;271;454;1626;4215;1897;4669
240640;202208;1079;2594;844;2204;30;96;648;1627;678;1723
240650;202208;4702;12503;3952;11046;302;820;2750;7636;3052;8456
240660;202208;4404;8691;3988;8149;56;131;3733;7533;3789;7664
240670;202208;2960;7376;2344;6185;183;512;1576;3965;1759;4477
240680;202208;1903;4442;1515;3801;47;152;1202;2877;1249;3029
240690;202208;1365;2952;1068;2462;26;94;889;1925;915;2019
240700;202208;2728;7458;2179;6471;103;329;1616;4740;1719;5069
240710;202208;22282;48458;19040;43478;1650;3846;14110;31036;15760;34882
240720;202208;6061;13890;5131;12589;589;1452;3391;8250;3980;9702
240725;202208;1278;3357;966;2793;45;126;623;1738;668;1864
240730;202208;2676;6704;2093;5644;65;214;1609;4200;1674;4414
240740;202208;2202;5534;1760;4674;69;223;1257;3130;1326;3353
240750;202208;2595;7720;2177;6844;266;928;1285;3956;1551;4884
240760;202208;1996;4115;1444;3310;111;161;1089;2573;1200;2734
240770;202208;3785;9411;3185;8589;140;476;2621;6922;2761;7398
240780;202208;6084;14969;5102;13378;702;1803;3311;8600;4013;10403
240790;202208;1043;2626;852;2304;24;109;636;1623;660;1732
240800;202208;66587;138939;53421;120066;5024;11908;34979;73889;40003;85797
240810;202208;118886;269745;102766;244995;9031;22695;74062;170562;83093;193257
240820;202208;7146;19138;6263;17595;784;2244;4009;11216;4793;13460
240830;202208;10002;25994;8684;24076;336;1173;7002;19066;7338;20239
240840;202208;1261;2904;1009;2511;47;101;708;1715;755;1816
240850;202208;1633;4130;1131;3108;90;243;646;1677;736;1920
240860;202208;1670;3829;1260;3137;34;125;1012;2400;1046;2525
240870;202208;1230;2882;933;2395;156;386;481;1266;637;1652
240880;202208;1456;4337;1268;3975;114;436;912;2794;1026;3230
240890;202208;6061;14029;4772;11824;450;1279;3096;6973;3546;8252
240895;202208;3436;9357;3093;8812;399;1060;2219;6461;2618;7521
240910;202208;4074;10003;3364;8776;56;191;2746;6940;2802;7131
240920;202208;1222;2745;984;2401;112;195;606;1525;718;1720
240930;202208;4286;8799;3485;7813;253;379;2347;5751;2600;6130
240933;202208;1866;4305;1553;3861;37;143;1321;3175;1358;3318
240940;202208;8425;17805;6721;15137;613;1387;4552;9706;5165;11093
240950;202208;1292;3481;1103;3122;39;158;879;2368;918;2526
240960;202208;803;2129;718;1953;17;62;569;1488;586;1550
240970;202208;2297;5033;1863;4353;65;206;1562;3521;1627;3727
240980;202208;4504;10759;4039;10016;70;296;3539;8459;3609;8755
240990;202208;3369;7964;2973;7292;218;670;2224;5083;2442;5753
241000;202208;1170;2673;898;2197;15;46;716;1659;731;1705
241010;202208;3606;9712;3268;9056;140;499;2622;6989;2762;7488
241020;202208;2462;5988;1871;4862;99;312;1343;3280;1442;3592
241025;202208;1898;5074;1519;4421;47;180;1093;3078;1140;3258
241030;202208;2828;8219;2270;7088;274;762;1445;4545;1719;5307
241040;202208;2478;7092;2118;6498;90;405;1622;4897;1712;5302
241050;202208;1663;4214;1332;3627;38;134;995;2620;1033;2754
241060;202208;946;2366;808;2087;48;109;556;1377;604;1486
241070;202208;813;1975;675;1759;16;40;524;1309;540;1349
241080;202208;1329;3439;1024;2823;32;112;734;1943;766;2055
241090;202208;2387;6198;1906;5393;86;325;1428;3889;1514;4214
241100;202208;1368;3488;1028;2814;52;122;694;1852;746;1974
241105;202208;1212;3249;980;2832;185;557;448;1268;633;1825
241110;202208;1071;2791;797;2234;46;125;513;1374;559;1499
241120;202208;8607;22601;7247;20344;787;2214;4655;13107;5442;15321
241140;202208;3849;9451;2939;7691;117;360;2173;5478;2290;5838
241142;202208;882;2213;663;1821;52;139;395;1016;447;1155
241150;202208;6887;16172;6025;14872;244;593;4724;11461;4968;12054
241160;202208;1344;3444;1042;2901;172;524;566;1464;738;1988
241170;202208;1538;3641;1295;3224;29;100;1073;2558;1102;2658
241180;202208;1202;2795;885;2237;87;220;505;1215;592;1435
241190;202208;1385;3213;1143;2776;18;65;858;1971;876;2036
241200;202208;28650;63306;25237;58070;2735;6637;17335;37964;20070;44601
241210;202208;1828;4306;1341;3441;106;294;826;2053;932;2347
241220;202208;11504;29316;10108;27062;2171;5791;5086;13736;7257;19527
241230;202208;3379;8086;2926;7415;98;256;2419;6056;2517;6312
241240;202208;1396;3689;836;2501;98;311;277;770;375;1081
241250;202208;7076;17312;5695;14926;153;658;4459;11033;4612;11691
241255;202208;3103;8244;2677;7464;152;510;1990;5335;2142;5845
241260;202208;5819;13653;4648;11777;177;524;3583;8711;3760;9235
241270;202208;1855;5009;1538;4422;120;372;1078;3024;1198;3396
241280;202208;2978;6093;2595;5438;89;189;2226;4552;2315;4741
241290;202208;3754;8428;2742;6847;84;237;2165;5235;2249;5472
241300;202208;1781;4331;1441;3771;30;109;1009;2519;1039;2628
241310;202208;2705;5682;2337;5176;62;110;2032;4449;2094;4559
241320;202208;1102;3290;940;2989;98;350;582;1791;680;2141
241330;202208;2022;4680;1597;4123;18;67;1413;3603;1431;3670
241335;202208;4296;10644;3748;9698;132;430;3077;7705;3209;8135
241340;202208;1992;4853;1580;4078;197;609;897;2107;1094;2716
241350;202208;2532;6225;2194;5647;110;291;1692;4265;1802;4556
241355;202208;1617;3903;1297;3312;46;97;971;2439;1017;2536
241360;202208;2389;5607;1732;4349;64;176;1286;3066;1350;3242
241370;202208;1577;3863;1202;3141;60;186;885;2140;945;2326
241380;202208;825;1997;647;1698;71;181;370;951;441;1132
241390;202208;3107;8248;2722;7679;159;476;2093;5899;2252;6375
241400;202208;4254;10718;3716;9916;222;705;2873;7475;3095;8180
241410;202208;2863;7800;2315;6717;243;773;1471;4163;1714;4936
241415;202208;2176;5328;1843;4730;49;180;1495;3636;1544;3816
241420;202208;3427;9048;3062;8466;499;1482;1937;5310;2436;6792
241430;202208;819;1902;523;1354;17;47;349;839;366;886
241440;202208;9837;26453;8805;24738;300;991;7192;19804;7492;20795
241445;202208;1605;3336;1396;3064;34;69;1246;2724;1280;2793
241450;202208;3463;7438;2828;6477;231;484;2157;4900;2388;5384
241460;202208;4565;11199;3641;9399;283;770;2483;6117;2766;6887
241470;202208;1626;3962;1313;3495;43;141;1087;2837;1130;2978
241475;202208;1437;3583;1124;3026;24;92;840;2120;864;2212
241480;202208;3577;10070;2921;8732;812;2387;1046;3367;1858;5754
241490;202208;869;1766;621;1407;15;43;502;1098;517;1141
241500;202208;942;2287;849;2180;7;17;782;2009;789;2026
250010;202208;3130;8312;2585;7229;78;246;1940;5257;2018;5503
250020;202208;1888;4515;1407;3649;94;162;1038;2688;1132;2850
250030;202208;8240;20328;7195;18766;871;2309;5017;12952;5888;15261
250040;202208;5488;14139;4786;12947;689;1809;3053;8206;3742;10015
250050;202208;4346;10284;3862;9674;166;442;3219;8108;3385;8550
250053;202208;1511;3809;1369;3600;135;303;960;2539;1095;2842
250057;202208;841;2423;769;2319;8;35;705;2118;713;2153
250060;202208;6759;15828;5953;14734;350;888;4785;11676;5135;12564
250070;202208;4690;11800;3909;10499;47;204;3140;8126;3187;8330
250073;202208;948;2242;749;1921;7;21;609;1521;616;1542
250077;202208;3147;6755;2432;5665;34;112;2065;4636;2099;4748
250080;202208;6737;13670;5600;12299;71;224;5066;10927;5137;11151
250090;202208;4441;8745;3903;8063;62;160;3476;6962;3538;7122
250100;202208;3938;11099;3515;10355;142;523;2764;7882;2906;8405
250110;202208;5893;14609;5345;13859;338;1016;4135;10511;4473;11527
250115;202208;884;1896;669;1583;8;31;536;1222;544;1253
250120;202208;2162;5772;1828;5237;29;143;1464;4070;1493;4213
250130;202208;7187;15706;6141;14314;55;244;5446;12324;5501;12568
250135;202208;1618;3772;1406;3418;61;153;1182;2832;1243;2985
250140;202208;2566;6858;2361;6609;129;420;1993;5605;2122;6025
250150;202208;5491;15618;4928;14717;179;669;3961;11520;4140;12189
250153;202208;1607;3899;1303;3453;55;146;1029;2681;1084;2827
250157;202208;2456;5909;2181;5475;43;154;1839;4478;1882;4632
250160;202208;4533;10066;3634;8864;79;199;3126;7549;3205;7748
250170;202208;2181;5132;1945;4799;38;132;1666;4003;1704;4135
250180;202208;27602;56635;23731;51838;929;2587;19514;40768;20443;43355
250190;202208;5045;11862;4242;10734;369;931;3072;7526;3441;8457
250200;202208;3069;5895;2639;5357;41;97;2380;4670;2421;4767
250205;202208;958;2790;809;2557;19;84;631;1971;650;2055
250210;202208;1692;4667;1500;4360;62;235;1170;3313;1232;3548
250215;202208;1878;4752;1582;4348;95;296;898;2482;993;2778
250220;202208;777;1967;612;1706;30;109;432;1152;462;1261
250230;202208;1912;3989;1352;3191;21;60;1064;2422;1085;2482
250240;202208;3507;7939;3125;7326;40;162;2786;6331;2826;6493
250250;202208;5627;13597;4954;12678;321;590;3887;10413;4208;11003
250260;202208;1836;4834;1538;4305;59;177;1195;3336;1254;3513
250270;202208;1425;3854;1302;3707;98;286;916;2756;1014;3042
250280;202208;4735;10326;4236;9683;261;468;3327;7711;3588;8179
250290;202208;2098;4574;1745;4074;19;56;1394;3160;1413;3216
250300;202208;7224;15784;6502;14929;195;642;5550;12297;5745;12939
250310;202208;1406;3611;1148;3192;51;128;843;2316;894;2444
250320;202208;16119;31203;14097;28942;176;508;12991;26042;13167;26550
250330;202208;3113;7136;2663;6537;76;245;2313;5474;2389;5719
250340;202208;1473;3146;1271;2879;17;43;1146;2566;1163;2609
250350;202208;4516;11849;3914;10814;321;672;2972;8474;3293;9146
250355;202208;2568;6345;2269;5978;19;84;2096;5490;2115;5574
250360;202208;2132;5054;1898;4746;55;173;1600;3871;1655;4044
250370;202208;18410;39287;15577;35185;253;773;13664;29855;13917;30628
250375;202208;1546;3294;1264;2968;6;14;1177;2781;1183;2795
250380;202208;2110;4553;1942;4353;42;140;1747;3773;1789;3913
250390;202208;2253;5091;1896;4549;142;346;1463;3474;1605;3820
250400;202208;84600;194989;64294;164608;18261;48726;19977;52264;38238;100990
250403;202208;2717;5709;2412;5378;49;263;2080;4316;2129;4579
250407;202208;1660;3494;1277;2935;153;271;796;1987;949;2258
250410;202208;819;1962;700;1768;12;34;586;1415;598;1449
250415;202208;2330;5655;2039;5228;39;144;1778;4458;1817;4602
250420;202208;1553;3512;1405;3312;14;36;1301;3034;1315;3070
250430;202208;8780;17870;7561;16288;370;684;6272;13167;6642;13851
250435;202208;1858;4814;1461;4147;20;98;1116;3033;1136;3131
250440;202208;5180;12824;4480;11924;97;249;3907;10305;4004;10554
250450;202208;2128;4999;1747;4489;98;181;1345;3569;1443;3750
250460;202208;8588;21410;7518;19905;532;1455;5840;15340;6372;16795
250470;202208;1933;4436;1587;3898;39;111;1285;3041;1324;3152
250480;202208;4484;11291;3758;10392;65;167;3231;8993;3296;9160
250485;202208;813;1726;612;1450;62;97;408;947;470;1044
250490;202208;6522;13183;5779;12347;99;319;5226;10847;5325;11166
250500;202208;2353;5938;2075;5474;54;165;1705;4408;1759;4573
250510;202208;6741;14534;5783;13256;179;278;4910;11361;5089;11639
250520;202208;2171;5350;1847;4931;87;264;1441;3749;1528;4013
250523;202208;2712;5733;2373;5287;208;463;1809;3950;2017;4413
250527;202208;2011;4469;1814;4248;16;49;1656;3831;1672;3880
250530;202208;762;1780;648;1616;19;51;534;1285;553;1336
250535;202208;1561;4171;1388;3874;30;130;1109;2991;1139;3121
250540;202208;4009;7448;3392;6777;424;467;2716;5774;3140;6241
250550;202208;880;2643;773;2446;50;166;535;1664;585;1830
250560;202208;1995;5044;1713;4640;45;177;1422;3736;1467;3913
250570;202208;3193;8435;2748;7664;150;466;2089;5745;2239;6211
250580;202208;1216;2907;1073;2718;51;198;897;2174;948;2372
250590;202208;1219;2576;1105;2418;35;83;984;2093;1019;2176
250600;202208;8934;22190;7376;20074;276;825;5740;15363;6016;16188
250610;202208;3340;8688;2966;8144;110;375;2418;6575;2528;6950
250620;202208;1047;2305;891;2057;50;137;691;1537;741;1674
250625;202208;2719;7246;2409;6748;51;227;2068;5643;2119;5870
250630;202208;14136;32600;11889;29014;1139;2932;8285;19402;9424;22334
250640;202208;4445;10268;3982;9667;96;313;3469;8258;3565;8571
250650;202208;1263;2652;1020;2336;14;51;880;1968;894;2019
250660;202208;1832;4130;1450;3592;37;114;1196;2833;1233;2947
250670;202208;2726;7610;2453;7132;49;193;2127;6037;2176;6230
250680;202208;7139;14274;6430;13478;43;174;6026;12317;6069;12491
250690;202208;8512;17002;7141;15348;186;367;6139;13015;6325;13382
250700;202208;5353;13810;4661;12746;699;1895;2958;8064;3657;9959
250710;202208;5057;13422;4391;12492;317;973;3223;9119;3540;10092
250720;202208;3272;8038;2912;7541;63;251;2599;6605;2662;6856
250730;202208;5289;12122;4658;11294;159;518;4003;9379;4162;9897
250740;202208;2398;5346;1971;4781;126;287;1500;3633;1626;3920
250750;202208;138228;305773;118184;278368;8638;22140;88165;201174;96803;223314
250760;202208;3454;6721;3086;6184;46;156;2814;5448;2860;5604
250770;202208;4745;12917;4237;12244;652;1627;2777;8456;3429;10083
250780;202208;2173;5112;1829;4528;72;196;1476;3547;1548;3743
250790;202208;3041;7976;2642;7396;98;391;2095;5648;2193;6039
250800;202208;2835;6814;2454;6222;107;224;1974;4966;2081;5190
250810;202208;1677;3747;1397;3363;138;220;1071;2702;1209;2922
250820;202208;2383;5722;2180;5490;38;130;1981;4927;2019;5057
250830;202208;7280;19563;6003;17091;233;823;4323;11676;4556;12499
250840;202208;865;2563;749;2351;38;137;554;1743;592;1880
250850;202208;2082;5513;1839;5098;37;154;1530;4128;1567;4282
250855;202208;1320;3238;1164;3014;41;128;963;2423;1004;2551
250860;202208;4098;10758;3407;9661;475;1345;1950;5447;2425;6792
250870;202208;1242;2995;1044;2689;59;143;809;2073;868;2216
250880;202208;1895;4438;1559;3946;123;298;1147;2879;1270;3177
250890;202208;13634;28846;12000;26809;315;1239;10413;21957;10728;23196
250900;202208;3878;8832;3406;8065;75;211;2958;6786;3033;6997
250905;202208;2839;7292;2607;6990;41;156;2354;6279;2395;6435
250910;202208;8591;17110;7325;15717;82;249;6635;14027;6717;14276
250915;202208;2527;5195;1828;4442;21;43;1619;3956;1640;3999
250920;202208;4488;9847;4015;9162;276;538;3318;7477;3594;8015
250930;202208;2770;6681;2469;6308;86;281;2039;5054;2125;5335
250933;202208;1472;3851;1285;3532;51;176;1010;2693;1061;2869
250937;202208;944;2258;791;2028;21;72;651;1651;672;1723
250939;202208;2406;5371;2111;4999;53;130;1760;4074;1813;4204
250940;202208;4627;10964;4027;10172;53;151;3580;8953;3633;9104
250950;202208;1983;4758;1589;4229;41;149;1269;3291;1310;3440
250960;202208;1304;3464;1148;3224;28;129;947;2561;975;2690
250970;202208;10144;23535;8832;21460;218;586;7357;17327;7575;17913
250980;202208;2821;6704;2540;6320;20;90;2228;5375;2248;5465
250990;202208;2496;6751;2117;6117;99;363;1608;4474;1707;4837
251000;202208;2326;6002;1871;5242;50;182;1513;4186;1563;4368
251010;202208;2949;7399;2616;6902;32;126;2288;5946;2320;6072
251020;202208;1832;4626;1644;4341;31;140;1430;3663;1461;3803
251030;202208;1189;2930;971;2544;65;165;653;1678;718;1843
251040;202208;2155;5400;1825;4866;25;110;1552;4071;1577;4181
251050;202208;1166;3066;968;2688;50;172;685;1798;735;1970
251060;202208;1292;2520;974;2124;33;68;738;1600;771;1668
251065;202208;544;1396;398;1119;10;34;288;759;298;793
251070;202208;880;2003;734;1796;13;41;624;1482;637;1523
251080;202208;25078;55056;20619;48659;3419;7928;11921;28487;15340;36415
251090;202208;3290;8657;2751;7742;69;195;2249;6221;2318;6416
251100;202208;931;2728;802;2470;25;77;606;1776;631;1853
251110;202208;2155;5104;1781;4437;125;270;1308;3205;1433;3475
251120;202208;9097;22071;7651;20315;538;1580;5713;14868;6251;16448
251130;202208;5687;9851;4940;9035;41;107;4643;8332;4684;8439
251140;202208;4749;12401;4187;11611;105;338;3369;9262;3474;9600
251150;202208;3226;8395;2937;7942;69;336;2524;6602;2593;6938
251160;202208;2788;6767;2420;6224;29;150;2174;5433;2203;5583
251170;202208;2132;4777;1880;4462;30;107;1698;3909;1728;4016
251180;202208;3321;7584;2752;6808;269;520;1896;4848;2165;5368
251190;202208;5892;12716;5309;12059;52;252;4807;10518;4859;10770
251200;202208;5318;13411;4664;12583;130;320;3975;10788;4105;11108
251203;202208;1142;3374;1033;3128;54;170;721;2140;775;2310
251207;202208;1305;3221;976;2681;22;99;677;1785;699;1884
251210;202208;9458;21322;7705;18929;567;1112;5499;13948;6066;15060
251220;202208;1538;3246;1157;2752;105;204;851;2082;956;2286
251230;202208;5462;13959;4699;12636;109;380;3769;9755;3878;10135
251240;202208;4313;11192;3622;10023;264;681;2474;6845;2738;7526
251250;202208;14023;32461;12343;29723;695;1793;9596;22219;10291;24012
251260;202208;639;1496;572;1393;14;62;468;1070;482;1132
251270;202208;5241;14133;4661;13338;269;710;3639;10718;3908;11428
251272;202208;1621;3870;1489;3707;54;183;1288;3106;1342;3289
251274;202208;988;2574;783;2214;67;186;491;1356;558;1542
251275;202208;1749;3901;1479;3480;78;185;1183;2688;1261;2873
251276;202208;1563;3889;1354;3607;37;151;1095;2802;1132;2953
251278;202208;763;1817;674;1681;33;105;546;1316;579;1421
251280;202208;3254;6868;2974;6488;47;159;2678;5633;2725;5792
251290;202208;9241;16807;8459;15908;251;517;7559;13848;7810;14365
251300;202208;1018;2683;896;2498;13;52;759;2100;772;2152
251310;202208;3249;8291;2773;7551;54;250;2321;6131;2375;6381
251315;202208;2140;6020;1914;5597;111;317;1489;4316;1600;4633
251320;202208;1940;4667;1466;3858;39;137;1114;2832;1153;2969
251330;202208;2520;5218;2039;4640;29;81;1798;4039;1827;4120
251335;202208;1254;3205;1129;3020;23;103;1018;2657;1041;2760
251340;202208;4548;9528;3624;8342;146;354;2880;6494;3026;6848
251350;202208;1241;3198;1124;3016;43;123;925;2442;968;2565
251360;202208;2174;5362;1712;4698;29;88;1373;3696;1402;3784
251365;202208;916;2190;671;1734;20;51;525;1335;545;1386
251370;202208;30398;72703;26045;66777;3595;8861;16538;42494;20133;51355
251380;202208;1767;3949;1531;3591;39;121;1335;3050;1374;3171
251385;202208;899;2158;694;1804;32;83;475;1193;507;1276
251390;202208;8775;21299;7786;19802;605;1603;5704;14196;6309;15799
251392;202208;1214;2981;1028;2695;41;106;808;2097;849;2203
251394;202208;781;2030;631;1771;63;180;421;1135;484;1315
251396;202208;825;2057;689;1822;28;80;475;1194;503;1274
251398;202208;1180;2831;830;2213;22;77;609;1544;631;1621
251400;202208;1707;3399;1364;2950;20;78;1151;2349;1171;2427
251410;202208;1887;3881;1502;3332;13;45;1293;2734;1306;2779
251420;202208;2369;5503;1948;5021;47;164;1561;3907;1608;4071
251430;202208;1761;4818;1583;4511;49;163;1350;3790;1399;3953
251440;202208;1254;3156;1017;2741;62;143;759;2080;821;2223
251445;202208;1941;4737;1783;4527;28;108;1550;3811;1578;3919
251450;202208;5336;13850;4745;12960;69;274;4091;10990;4160;11264
251455;202208;1014;2773;914;2598;25;94;732;2018;757;2112
251460;202208;1130;2845;914;2497;58;175;694;1866;752;2041
251465;202208;548;1432;462;1276;13;57;351;919;364;976
251470;202208;1367;3511;1011;2806;121;376;536;1349;657;1725
251480;202208;1179;2827;913;2375;18;63;687;1684;705;1747
251490;202208;2349;5516;1903;4911;112;255;1434;3679;1546;3934
251500;202208;2479;5889;2256;5601;61;175;1929;4668;1990;4843
251510;202208;3086;8527;2558;7495;109;388;1790;5011;1899;5399
251520;202208;1204;2866;907;2354;102;196;553;1434;655;1630
251530;202208;18032;37565;14740;33549;160;715;13197;29174;13357;29889
251540;202208;3507;9103;3133;8465;72;287;2595;6778;2667;7065
251550;202208;5053;9878;4123;8766;130;224;3453;7315;3583;7539
251560;202208;644;1834;573;1733;42;166;417;1193;459;1359
251570;202208;1090;2838;898;2458;19;91;709;1868;728;1959
251580;202208;2523;5226;2249;4829;31;110;1951;3977;1982;4087
251590;202208;1953;4167;1660;3816;52;123;1433;3186;1485;3309
251593;202208;1117;3030;994;2819;89;289;683;1868;772;2157
251597;202208;2649;6214;2386;5871;14;61;2197;5308;2211;5369
251600;202208;7419;18420;6432;16931;260;718;5259;13626;5519;14344
251610;202208;3799;9611;3315;8775;261;677;2422;6308;2683;6985
251615;202208;1626;3462;1294;2983;18;64;1092;2406;1110;2470
251620;202208;24052;47437;18843;41163;193;431;16530;35940;16723;36371
251630;202208;6148;12455;4985;10854;268;577;3918;8174;4186;8751
251640;202208;2560;6259;2275;5844;21;98;2055;5169;2076;5267
251650;202208;5050;11326;4364;10449;150;338;3720;8784;3870;9122
251660;202208;4163;11091;3657;10227;61;266;3066;8342;3127;8608
251670;202208;5374;12327;4777;11541;60;227;4359;10316;4419;10543
251675;202208;1022;2190;926;2071;57;130;782;1726;839;1856
251680;202208;3151;7238;2650;6591;110;196;2181;5467;2291;5663
251690;202208;3732;9593;3165;8639;117;342;2399;6492;2516;6834
251700;202208;2614;6609;2161;5984;38;153;1787;4765;1825;4918
251710;202208;929;2194;672;1710;44;120;410;961;454;1081
251720;202208;1552;3990;1238;3462;21;103;968;2590;989;2693
251740;202208;759;1924;604;1651;31;103;448;1167;479;1270
260005;202208;36186;70085;30279;62720;1711;3683;24302;48591;26013;52274
260010;202208;12157;29001;10010;25641;629;1751;6259;15574;6888;17325
260020;202208;8301;16666;6862;14698;78;324;5934;12273;6012;12597
260030;202208;8945;18975;7609;17120;84;310;6597;14347;6681;14657
260040;202208;8767;20185;7370;18294;473;1210;5483;13571;5956;14781
260050;202208;16259;37253;13830;34543;223;700;12841;31946;13064;32646
260060;202208;5010;10854;4263;9721;365;646;3214;7521;3579;8167
260070;202208;13904;29045;12052;26502;228;830;10385;21843;10613;22673
260080;202208;8177;15858;7121;14538;139;351;6146;12175;6285;12526
260090;202208;6340;13978;5622;13044;328;747;4546;10471;4874;11218
260100;202208;3673;8459;3125;7694;41;198;2739;6563;2780;6761
260105;202208;5828;14293;5208;13472;103;400;4426;11116;4529;11516
260110;202208;25819;65797;22866;61549;1041;3242;18721;49327;19762;52569
260120;202208;17941;41443;15227;37633;1678;3826;10524;26008;12202;29834
260130;202208;3923;8562;3376;7825;113;270;2697;6043;2810;6313
260140;202208;15880;31016;13799;28590;316;821;12206;24611;12522;25432
260150;202208;4546;8855;3978;8172;115;234;3579;7282;3694;7516
260160;202208;8682;17722;7483;16284;105;269;6939;15002;7044;15271
260170;202208;26429;54036;22756;49247;1104;2453;18743;39671;19847;42124
260180;202208;4121;9812;3497;8944;85;297;2977;7449;3062;7746
260190;202208;25163;42417;21637;38374;145;365;19966;34485;20111;34850
260200;202208;13041;28194;11244;25914;497;983;9768;22516;10265;23499
260210;202208;13121;33619;11005;30293;376;1209;8811;23978;9187;25187
260220;202208;14663;27946;13617;26690;426;688;12114;23491;12540;24179
260230;202208;15118;29506;13230;27146;363;693;11264;22820;11627;23513
260240;202208;3242;8715;2801;7892;74;309;2220;6065;2294;6374
260250;202208;2775;6228;2380;5649;98;248;1932;4437;2030;4685
260260;202208;16354;37026;14550;34483;1009;2273;11209;26739;12218;29012
260270;202208;5771;11261;5117;10521;80;272;4584;9160;4664;9432
260280;202208;15044;38978;13621;36980;350;1431;12008;31707;12358;33138
260290;202208;50226;114784;43235;105146;3855;9685;31065;73960;34920;83645
260300;202208;12340;27884;10629;25491;296;867;9072;21323;9368;22190
260310;202208;7656;15762;6874;14806;422;703;5681;12336;6103;13039
260320;202208;8784;23348;7388;21098;164;602;6121;17280;6285;17882
260330;202208;2857;8037;2455;7227;64;229;1976;5643;2040;5872
260340;202208;2610;5990;2268;5507;26;109;2013;4729;2039;4838
260345;202208;33490;76223;28379;69207;2926;7775;18528;42889;21454;50664
260350;202208;7424;13998;6480;12955;33;111;6028;11805;6061;11916
260360;202208;2881;6792;2526;6157;107;299;1776;4192;1883;4491
260370;202208;6478;16350;5493;14722;176;621;4382;11290;4558;11911
260380;202208;5900;15474;5024;14073;206;588;3895;10780;4101;11368
260390;202208;5375;14871;4349;12870;205;606;2919;8445;3124;9051
260392;202208;4529;11711;4085;11153;61;362;3577;9590;3638;9952
260400;202208;25926;50079;22674;45922;356;1036;19357;36997;19713;38033
260410;202208;94246;206599;75560;181220;13758;34447;37371;89643;51129;124090
260415;202208;5577;12307;4839;11222;39;156;4237;9502;4276;9658
260420;202208;16235;28103;14048;25721;65;215;13415;24183;13480;24398
260430;202208;3139;9088;2640;8127;180;601;1773;5370;1953;5971
260440;202208;5070;10550;4500;9817;38;139;4113;8785;4151;8924
260450;202208;6596;15075;5872;14129;316;631;4948;12001;5264;12632
260460;202208;6547;16682;5595;15107;454;1382;3823;9892;4277;11274
260470;202208;5931;13107;4986;12038;89;234;4489;10990;4578;11224
260480;202208;4592;10696;3867;9706;316;833;2779;6940;3095;7773
260490;202208;6743;13003;5943;11923;28;106;5508;10798;5536;10904
260500;202208;7167;16159;6135;14720;441;998;4431;10605;4872;11603
260510;202208;13040;26740;11108;24112;122;412;10021;21181;10143;21593
260515;202208;5314;12587;4205;10632;122;378;3118;7379;3240;7757
260520;202208;19122;40478;16616;37309;1006;2189;13443;29713;14449;31902
260530;202208;11639;29049;9933;26547;118;569;8788;22937;8906;23506
260540;202208;9461;17129;8459;15922;107;257;7869;14546;7976;14803
260545;202208;124;336;80;244;13;51;29;73;42;124
260550;202208;3712;9125;2988;7952;183;607;2035;5054;2218;5661
260560;202208;6818;15737;5673;14064;131;452;4854;11712;4985;12164
260570;202208;10392;22580;9161;21019;217;623;8087;18108;8304;18731
260580;202208;6014;11668;5444;10945;22;65;5084;10075;5106;10140
260590;202208;9587;16959;8285;15540;97;232;7614;13984;7711;14216
260600;202208;40496;91164;33713;81310;1105;3212;27126;62765;28231;65977
260610;202208;8958;21080;7847;19605;401;1064;5968;14656;6369;15720
260620;202208;24797;51973;22067;48397;1163;3239;17880;37165;19043;40404
260630;202208;2762;6769;2255;5989;61;175;1858;4824;1919;4999
260640;202208;30471;57445;26175;52593;796;1704;22698;44604;23494;46308
260650;202208;7365;16937;5873;15098;468;891;4812;12526;5280;13417
260660;202208;9071;19491;7973;18134;302;810;7122;15883;7424;16693
260670;202208;2712;6320;2208;5537;70;197;1700;4064;1770;4261
260680;202208;36390;77333;30821;69788;2059;4947;22930;49976;24989;54923
260690;202208;4004;9526;3303;8460;89;311;2604;6514;2693;6825
260700;202208;8528;18298;7954;17674;36;171;7745;17118;7781;17289
260710;202208;1595;3770;1339;3396;61;195;1065;2644;1126;2839
260720;202208;34051;70632;29375;64971;1807;4273;23461;50866;25268;55139
260730;202208;9543;24223;8253;22440;188;753;7172;19035;7360;19788
260740;202208;1539;3933;1254;3479;22;83;1007;2795;1029;2878
260750;202208;9459;21004;7453;18584;196;407;6508;16663;6704;17070
260760;202208;7781;15557;6796;14419;114;323;6088;12685;6202;13008
260765;202208;10417;25622;9166;23957;622;1870;6701;16999;7323;18869
260770;202208;4547;10435;3707;9100;97;306;3014;7186;3111;7492
260775;202208;6827;15732;5997;14524;149;512;4922;11303;5071;11815
260780;202208;4527;11757;4015;10946;371;1231;2633;6671;3004;7902
260790;202208;163551;325009;138083;293206;17266;36299;95549;198492;112815;234791
260795;202208;4441;8572;3866;7865;136;304;3373;6733;3509;7037
260800;202208;7525;13938;6814;13004;220;379;6066;11318;6286;11697
260805;202208;4492;10723;3849;9687;160;508;3076;7402;3236;7910
260810;202208;8229;19133;7213;17335;298;784;5823;13379;6121;14163
260820;202208;5537;11082;4909;10373;77;235;4263;8900;4340;9135
260825;202208;3485;9276;3048;8548;110;349;2367;6525;2477;6874
260830;202208;5174;13284;4310;11848;465;1066;2910;8167;3375;9233
260840;202208;5589;11768;5026;11030;276;530;4334;9427;4610;9957
260845;202208;5365;12551;4742;11552;201;587;3759;8787;3960;9374
260850;202208;5926;14374;4964;12661;354;980;3378;8116;3732;9096
260860;202208;4015;10366;3432;9357;125;391;2762;7317;2887;7708
260870;202208;5424;11100;4656;10175;134;290;4118;8956;4252;9246
260875;202208;10126;20344;8398;17947;684;1366;6094;13005;6778;14371
260880;202208;12529;29907;10967;27470;243;792;9389;22880;9632;23672
260890;202208;16091;35989;13886;32794;962;2356;9772;22620;10734;24976
260900;202208;6718;16818;5567;15208;486;1309;3656;9917;4142;11226
260910;202208;4049;9377;3539;8640;135;338;2819;6774;2954;7112
260915;202208;6603;15054;5917;14243;39;162;5585;13289;5624;13451
260920;202208;4229;8372;3620;7726;93;175;3218;6823;3311;6998
260930;202208;4828;12700;4131;11531;161;598;3281;8793;3442;9391
260940;202208;18232;38099;15864;34891;1095;2536;12269;26126;13364;28662
260950;202208;9017;20946;7285;18196;348;1110;5101;11774;5449;12884
260960;202208;102106;194275;85401;173828;7325;15166;62829;122924;70154;138090
260970;202208;6713;15657;5903;14570;398;749;4470;11189;4868;11938
260980;202208;5546;13975;4814;13064;62;177;4386;11916;4448;12093
260990;202208;20541;50988;17301;46581;745;2343;13759;36215;14504;38558
261000;202208;20669;41536;17438;37552;555;1381;14510;30231;15065;31612
261010;202208;2639;6116;2267;5622;113;271;1908;4717;2021;4988
261020;202208;8096;18432;7068;16782;330;830;5817;13348;6147;14178
261030;202208;4773;12495;4186;11510;120;454;3366;8893;3486;9347
261040;202208;6298;16198;5153;14204;163;607;4054;10729;4217;11336
261050;202208;9445;21439;8536;20149;222;503;7201;16728;7423;17231
261060;202208;17659;38686;15375;36000;369;995;13029;29841;13398;30836
261070;202208;85098;168792;71278;150994;6424;13303;51968;107565;58392;120868
261080;202208;8243;17336;7439;16371;121;229;6962;15245;7083;15474
261090;202208;24618;49451;21925;46013;560;1242;19342;39743;19902;40985
261100;202208;10391;24877;9044;22980;648;1586;6813;17134;7461;18720
261110;202208;87358;216411;73898;193032;9022;25310;46357;116886;55379;142196
261120;202208;4683;9821;4085;9018;116;249;3557;7680;3673;7929
261130;202208;9108;19098;8017;17666;124;315;7148;15418;7272;15733
261140;202208;4736;9358;4202;8669;295;566;3265;6670;3560;7236
261150;202208;6906;14836;6073;13687;232;462;5149;11523;5381;11985
261153;202208;2220;6090;1822;5353;76;227;1261;3683;1337;3910
261160;202208;291532;600774;241023;534360;56431;124941;111785;251133;168216;376074
261170;202208;9114;17949;7979;16485;260;501;6984;14057;7244;14558
261180;202208;11272;24984;9862;23213;486;1067;7610;17744;8096;18811
261190;202208;6045;14414;5417;13461;129;567;4593;10894;4722;11461
261200;202208;4155;8317;3631;7651;112;286;3102;6317;3214;6603
261210;202208;2234;4900;1908;4450;113;203;1581;3669;1694;3872
261220;202208;17750;42520;15147;38244;1430;3767;10440;25214;11870;28981
261230;202208;4589;11779;3800;10755;50;194;3197;9053;3247;9247
261240;202208;7276;14818;6434;13623;253;531;5512;11467;5765;11998
261245;202208;4464;10944;3623;9548;69;310;2979;7479;3048;7789
261247;202208;3653;9680;3013;8565;344;930;1898;5467;2242;6397
261250;202208;33783;64810;29980;60499;3859;7402;22408;45680;26267;53082
261255;202208;4759;12615;3855;10933;158;589;2941;8054;3099;8643
261260;202208;18912;38288;16856;35732;258;982;15732;32389;15990;33371
261270;202208;6168;11960;5442;11105;162;346;4863;9691;5025;10037
261280;202208;2975;7445;2572;6816;99;323;2045;5211;2144;5534
261290;202208;3516;7891;2897;7203;90;274;2385;5939;2475;6213
261300;202208;16707;38119;14342;34502;338;1226;11889;27161;12227;28387
261310;202208;11860;25622;10259;23522;796;1876;7788;17369;8584;19245
261320;202208;7215;18097;6234;16565;75;301;5339;13887;5414;14188
261330;202208;7829;15542;7099;14631;229;509;6266;12680;6495;13189
261340;202208;6587;14061;5868;13179;109;350;5312;11628;5421;11978
261350;202208;9873;26857;8579;24683;212;648;6810;19377;7022;20025
261360;202208;10498;21346;8912;19162;367;819;7295;15148;7662;15967
261370;202208;28861;65122;24458;59388;2147;5260;17330;41339;19477;46599
261380;202208;5188;12907;4427;11674;458;1199;3076;8058;3534;9257
261390;202208;20054;51680;16797;46685;1175;3714;11685;31521;12860;35235
261400;202208;5859;15205;5123;13811;258;831;3994;10261;4252;11092
261410;202208;11689;25620;9674;22664;325;953;8083;18176;8408;19129
261420;202208;9585;24221;8645;23125;581;1939;6801;17759;7382;19698
261430;202208;5199;10808;4537;9851;47;199;4105;8578;4152;8777
261440;202208;1622;4487;1322;3923;55;242;952;2693;1007;2935
261450;202208;17523;41372;15433;38325;607;1502;12308;30424;12915;31926
261460;202208;9220;22048;7927;20101;234;687;6543;16300;6777;16987
261470;202208;4588;10448;3931;9545;47;200;3358;7988;3405;8188
261480;202208;6616;17228;5663;15681;262;914;4511;12057;4773;12971
261485;202208;6315;15807;5532;14671;398;1235;4153;10689;4551;11924
261500;202208;8120;17841;7076;16467;680;1303;4892;11860;5572;13163
261510;202208;2121;5739;1828;5272;72;273;1424;4044;1496;4317
261520;202208;2796;7491;2495;6924;122;339;1855;5047;1977;5386
261530;202208;14988;37846;12272;33306;705;2605;7794;19210;8499;21815
261540;202208;11600;28523;10616;27192;2477;5698;5445;15423;7922;21121
261550;202208;4442;10430;3870;9571;201;580;2947;6973;3148;7553
261560;202208;11458;26045;10103;24153;365;1009;8446;19713;8811;20722
261570;202208;4202;10311;3293;8828;226;686;2292;5919;2518;6605
261580;202208;8081;18868;7024;17462;76;352;6450;15789;6526;16141
261590;202208;3326;7342;2702;6465;81;263;2171;4986;2252;5249
261600;202208;7213;14490;6205;13120;204;454;5178;10531;5382;10985
261610;202208;2564;6825;2042;5875;202;597;1268;3664;1470;4261
261618;202208;3392;6699;3007;6174;84;264;2617;5122;2701;5386
261620;202208;5565;13426;5097;12760;686;1517;3579;9388;4265;10905
261630;202208;7043;18446;5977;16453;459;1412;3901;10193;4360;11605
261640;202208;47210;91762;40441;83729;2090;3482;32308;67426;34398;70908
261650;202208;5419;10937;4619;9978;234;476;3732;7968;3966;8444
270010;202208;4976;15170;4278;14013;162;824;3435;10905;3597;11729
270020;202208;4974;10458;4334;9681;112;434;3836;8133;3948;8567
270030;202208;38593;98856;32369;89165;2441;7095;24087;65298;26528;72393
270040;202208;12351;29335;10525;27178;667;1825;8497;21772;9164;23597
270050;202208;6198;13228;5260;12180;158;378;4784;11026;4942;11404
270060;202208;2613;6150;2223;5691;155;402;1772;4476;1927;4878
270070;202208;6022;13890;5262;12859;90;384;4650;10911;4740;11295
270080;202208;1682;4154;1404;3715;75;197;1081;2792;1156;2989
270090;202208;2071;5639;1880;5296;40;172;1630;4487;1670;4659
270100;202208;8191;15960;7193;14634;173;419;6423;12698;6596;13117
270110;202208;3907;8299;3179;7461;199;347;2537;6198;2736;6545
270120;202208;2901;7399;2527;6904;73;261;2101;5597;2174;5858
270130;202208;5881;13725;5060;12747;162;530;4339;10758;4501;11288
270135;202208;2283;5000;1930;4618;27;124;1783;4204;1810;4328
270140;202208;10485;23507;8388;20659;335;1052;6549;15302;6884;16354
270150;202208;3338;8367;3058;7991;14;69;2918;7570;2932;7639
270160;202208;6232;16095;5343;15014;152;550;4818;13414;4970;13964
270170;202208;3748;10129;3134;9261;198;851;2292;6425;2490;7276
270180;202208;2629;7312;2388;7006;40;215;2125;6107;2165;6322
270190;202208;2805;5776;2562;5498;17;76;2431;5125;2448;5201
270200;202208;3043;8182;2638;7604;313;796;1819;5348;2132;6144
270210;202208;6813;14240;5819;13112;69;246;5412;11992;5481;12238
270220;202208;1993;4504;1619;3981;108;327;1223;2840;1331;3167
270230;202208;11411;28413;9563;25677;861;2442;7053;18602;7914;21044
270235;202208;6937;19612;6049;18228;228;776;5012;14936;5240;15712
270240;202208;14121;33559;11809;30476;976;2611;8944;22856;9920;25467
270250;202208;3676;7762;3289;7236;137;305;2902;6272;3039;6577
270255;202208;5130;13446;4077;11639;141;514;3194;8857;3335;9371
270260;202208;6043;17173;5455;16201;86;448;4749;13832;4835;14280
270270;202208;1193;2843;986;2592;118;285;732;1922;850;2207
270280;202208;4524;9769;3620;8678;280;607;2656;6580;2936;7187
270290;202208;9214;26319;8303;24929;155;742;7410;21937;7565;22679
270300;202208;4830;11489;3756;10310;181;424;3000;8379;3181;8803
270310;202208;8027;20417;6867;18723;157;571;5898;15823;6055;16394
270320;202208;6270;17196;5348;15499;225;812;4049;11203;4274;12015
270330;202208;5033;14095;4431;13222;193;866;3710;10821;3903;11687
270340;202208;1941;4598;1645;4201;89;161;1384;3549;1473;3710
270350;202208;2209;4571;1794;4091;140;287;1342;3094;1482;3381
270360;202208;3708;7458;3355;7065;37;115;3224;6721;3261;6836
270370;202208;1577;4486;1427;4223;33;161;1222;3561;1255;3722
270375;202208;4304;8207;3724;7575;12;36;3597;7264;3609;7300
270380;202208;6665;15865;5672;14669;591;1399;4278;11264;4869;12663
270390;202208;1432;3220;1142;2883;12;62;975;2435;987;2497
270400;202208;7737;18079;6472;16245;226;589;5211;12799;5437;13388
270410;202208;5530;14322;4791;13239;129;445;4081;11144;4210;11589
270420;202208;7632;18750;6927;17717;195;755;6138;15208;6333;15963
270430;202208;169870;368314;133641;322851;19198;47833;77396;185110;96594;232943
270440;202208;5403;13379;4706;12501;143;457;4143;10910;4286;11367
270450;202208;9808;21998;8726;20708;439;886;7356;17729;7795;18615
270460;202208;4546;9043;3883;8243;262;399;3403;7339;3665;7738
270470;202208;13589;33782;11831;31354;586;1796;9564;24977;10150;26773
270480;202208;3552;8335;2989;7557;160;483;2478;6083;2638;6566
270490;202208;1060;2672;920;2503;36;123;764;2028;800;2151
270500;202208;5744;15554;5113;14524;234;821;4190;11657;4424;12478
270510;202208;7491;16579;6320;15125;335;972;5088;11666;5423;12638
270520;202208;4743;12088;3779;10593;711;2073;1812;5088;2523;7161
270530;202208;1523;4066;1299;3716;78;205;900;2616;978;2821
270540;202208;2662;6553;2240;6010;70;241;1938;5116;2008;5357
270550;202208;7724;18134;6101;16337;572;1446;4563;12424;5135;13870
270560;202208;3435;8000;2857;7237;158;473;2272;5577;2430;6050
270570;202208;6318;13751;5506;12634;418;1043;4533;10066;4951;11109
270580;202208;2761;6864;2502;6515;116;303;2167;5594;2283;5897
270590;202208;1703;4770;1565;4584;13;69;1485;4329;1498;4398
270600;202208;3248;8919;2943;8467;57;222;2614;7429;2671;7651
270610;202208;4266;10157;3734;9464;87;217;3355;8414;3442;8631
270620;202208;1436;3935;1309;3712;29;113;1131;3114;1160;3227
270630;202208;21600;46653;18719;42794;748;2103;16088;35764;16836;37867
270640;202208;6331;16248;5379;14778;157;608;4541;12195;4698;12803
270642;202208;2945;8520;2592;7981;195;679;1965;5941;2160;6620
270644;202208;4628;10283;3868;9327;227;554;3166;7526;3393;8080
270650;202208;4249;10265;3717;9584;255;806;3083;7789;3338;8595
270660;202208;2293;5256;1966;4824;75;204;1552;3688;1627;3892
270670;202208;22354;43755;19058;39801;559;1253;16667;33851;17226;35104
270680;202208;7723;14325;7018;13554;372;464;6403;12607;6775;13071
270690;202208;11826;26114;9906;23682;297;866;8270;19277;8567;20143
270700;202208;650;1749;566;1615;66;189;391;1095;457;1284
270710;202208;6619;17829;5811;16607;366;1129;4569;12904;4935;14033
270720;202208;4474;11090;3978;10298;89;294;3553;9006;3642;9300
270730;202208;9553;19047;8272;17701;1035;1300;6265;14787;7300;16087
270740;202208;2606;6518;2280;6144;78;249;1919;5100;1997;5349
270750;202208;6597;15489;5795;14489;107;410;5182;12731;5289;13141
270760;202208;3930;9816;3253;8885;55;243;2763;7403;2818;7646
270770;202208;26679;60665;21780;54561;3338;8087;13744;34808;17082;42895
270780;202208;2402;5339;2220;5106;45;153;2039;4598;2084;4751
270790;202208;2020;4816;1714;4413;145;358;1337;3424;1482;3782
270800;202208;13925;32288;12583;30440;525;1350;10675;25539;11200;26889
270810;202208;3946;9863;3124;8625;170;579;2352;6291;2522;6870
270820;202208;1865;5150;1585;4713;53;226;1286;3759;1339;3985
270830;202208;6092;13346;4972;12007;162;521;4146;9748;4308;10269
270840;202208;9656;26342;8409;24481;214;1007;7171;20216;7385;21223
270850;202208;10265;21770;9037;20357;515;1395;7880;17379;8395;18774
270860;202208;17017;34571;13658;30808;606;1462;11292;24958;11898;26420
270870;202208;2646;6906;2150;6095;216;589;1431;4063;1647;4652
270880;202208;9067;25103;8087;23621;204;852;6761;19250;6965;20102
270890;202208;3968;9800;3356;8936;406;1065;2093;5538;2499;6603
270895;202208;4482;10738;4023;10167;92;358;3631;8950;3723;9308
270900;202208;1958;4595;1494;3868;23;72;1216;3064;1239;3136
270910;202208;4827;12605;4172;11644;154;413;3512;9697;3666;10110
270915;202208;11055;28440;8958;25165;742;2491;6253;16799;6995;19290
270920;202208;7137;17993;6296;16841;83;422;5545;14434;5628;14856
270930;202208;21222;44225;16664;39018;1945;3870;11911;29069;13856;32939
270940;202208;7213;17473;6042;16119;194;823;4905;12597;5099;13420
280010;202208;698;1852;540;1530;22;91;387;1000;409;1091
280020;202208;6117;13535;5176;12113;335;826;3999;9013;4334;9839
280030;202208;110145;223933;91431;198594;14643;31923;53884;114752;68527;146675
280040;202208;3642;8614;3177;7963;195;600;2429;5816;2624;6416
280050;202208;4915;12781;4111;11505;835;2352;2127;5892;2962;8244
280060;202208;8415;18930;6815;16610;975;2613;4135;9829;5110;12442
280067;202208;8608;18237;7347;16372;553;962;5441;12054;5994;13016
280070;202208;2023;5704;1850;5437;123;420;1483;4255;1606;4675
280100;202208;5090;11615;4306;10438;534;1145;2785;6988;3319;8133
280110;202208;1906;4069;1634;3685;23;72;1506;3314;1529;3386
280120;202208;9345;23096;8279;21447;1040;2377;5908;15589;6948;17966
280130;202208;10466;22156;9110;20319;546;1264;7326;16104;7872;17368
280140;202208;7295;14492;6459;13365;621;1065;4949;10443;5570;11508
280150;202208;4758;10997;4117;10096;515;1123;2938;7202;3453;8325
280160;202208;1536;3795;1310;3442;135;394;921;2294;1056;2688
280170;202208;6788;14657;6102;13807;219;538;5224;11568;5443;12106
280190;202208;1902;3271;1714;3034;37;100;1580;2709;1617;2809
280200;202208;1466;3561;1205;3188;78;233;891;2271;969;2504
280210;202208;21136;45566;18394;41801;1982;4480;12558;27805;14540;32285
280220;202208;2040;4765;1740;4380;99;238;1389;3505;1488;3743
280230;202208;4940;11391;4015;10016;275;553;2764;6903;3039;7456
280240;202208;3857;9187;3408;8536;39;198;2983;7231;3022;7429
280250;202208;1156;2342;976;2093;58;137;762;1563;820;1700
280260;202208;2904;5792;2563;5371;38;91;2376;4935;2414;5026
280270;202208;2833;6916;2480;6404;141;413;2102;5310;2243;5723
280280;202208;4544;12337;4020;11577;544;1313;2788;8303;3332;9616
280290;202208;25637;56268;22170;51583;1915;4541;14835;34637;16750;39178
280300;202208;15884;30956;13885;28816;1468;1922;10545;23479;12013;25401
280310;202208;1597;3770;1331;3353;48;131;1034;2518;1082;2649
280320;202208;10618;25136;9172;23021;1027;2531;6450;15780;7477;18311
280330;202208;5415;12244;4497;10957;325;742;3323;7956;3648;8698
280340;202208;6224;11889;5196;10747;214;338;4567;9491;4781;9829
280350;202208;36672;69897;32563;64582;912;2274;28169;53690;29081;55964
280360;202208;6584;16823;5734;15523;646;1885;3647;9702;4293;11587
280370;202208;2798;5854;2258;4981;133;237;1744;3784;1877;4021
280380;202208;1217;2888;1021;2629;84;168;725;1903;809;2071
280390;202208;4914;9923;4163;8817;239;419;3431;7173;3670;7592
280400;202208;4898;10489;4280;9698;454;910;3153;7180;3607;8090
280410;202208;3284;7809;2757;7007;261;721;1837;4400;2098;5121
280420;202208;5163;12001;4662;11383;100;266;4278;10377;4378;10643
280430;202208;2749;5676;2430;5265;62;171;2119;4420;2181;4591
280440;202208;5276;12093;4666;11203;196;544;3982;9269;4178;9813
280445;202208;2637;6334;2360;5888;51;167;1878;4488;1929;4655
280450;202208;11586;26000;10021;23886;2306;5485;4937;12111;7243;17596
280460;202208;8510;17684;7711;16625;402;867;6615;14018;7017;14885
280470;202208;1962;4993;1641;4408;114;326;1197;3104;1311;3430
280480;202208;58783;123183;51132;112843;4850;11253;36703;78247;41553;89500
280490;202208;4144;11065;3464;9915;137;552;2621;7149;2758;7701
280500;202208;1276;2596;1053;2322;25;74;877;1920;902;1994
280510;202208;4029;7253;3540;6635;54;150;3201;5755;3255;5905
280520;202208;2277;4707;1988;4321;170;276;1519;3302;1689;3578
280530;202208;2711;6300;2357;5826;132;317;1863;4563;1995;4880
280540;202208;9860;24203;8867;22817;356;981;7638;19434;7994;20415
280550;202208;8019;16566;6690;14726;124;454;5731;12035;5855;12489
280560;202208;8886;21249;8305;20422;118;401;7499;18075;7617;18476
280570;202208;8112;16879;6675;15149;310;730;5272;11691;5582;12421
280580;202208;7313;15852;6452;14668;495;983;5142;11569;5637;12552
280590;202208;3271;6983;2765;6389;150;416;2114;4650;2264;5066
280600;202208;4906;10835;4328;10022;174;412;3377;7640;3551;8052
280610;202208;3356;6806;2993;6351;115;280;2598;5325;2713;5605
280620;202208;7332;15169;6282;13850;559;876;4539;10487;5098;11363
280630;202208;4729;11201;4325;10677;271;631;3461;8618;3732;9249
280640;202208;2912;6557;2544;6142;122;251;2225;5417;2347;5668
280650;202208;1422;3424;1177;3066;119;306;824;2074;943;2380
280660;202208;4487;8644;3894;7963;144;244;3416;6941;3560;7185
280670;202208;24124;50558;20826;46338;2520;5413;14464;32043;16984;37456
280680;202208;3486;7397;3005;6718;316;554;2021;4721;2337;5275
280690;202208;1220;2551;1031;2317;57;143;853;1851;910;1994
280700;202208;1400;3003;1191;2709;35;91;980;2165;1015;2256
280710;202208;18185;36163;15455;33078;1236;1806;12914;28284;14150;30090
280720;202208;3079;6235;2523;5591;65;151;2041;4543;2106;4694
280730;202208;1191;2844;1012;2570;86;223;716;1748;802;1971
280740;202208;20550;39291;17818;35467;977;2142;14485;27604;15462;29746
280750;202208;3964;10236;3396;9260;232;671;2434;6510;2666;7181
280760;202208;8514;18709;7287;17045;720;1521;5148;12100;5868;13621
290010;202208;3725;6977;2475;5128;14;48;2143;4226;2157;4274
290020;202208;7586;15287;6946;14516;582;873;5774;12381;6356;13254
290030;202208;5594;11133;4586;10021;298;527;3704;8313;4002;8840
290035;202208;6440;11996;5278;10532;292;493;4156;8382;4448;8875
290040;202208;6636;11881;5716;10804;456;586;4696;9117;5152;9703
290050;202208;2401;7102;2029;6352;141;466;1379;4209;1520;4675
290060;202208;1780;3560;1297;2902;157;365;919;1990;1076;2355
290070;202208;49803;95390;43081;87155;2625;5129;34085;67353;36710;72482
290080;202208;7475;18110;6537;16757;708;1740;4702;12061;5410;13801
290090;202208;2648;4440;1920;3659;16;46;1779;3341;1795;3387
290100;202208;11827;27352;9553;24106;1638;3799;5095;13371;6733;17170
290110;202208;6615;15261;5764;13955;740;1679;3649;8818;4389;10497
290115;202208;4687;12649;3978;11427;324;929;3092;8833;3416;9762
290120;202208;7637;17031;6380;15304;162;538;5434;12685;5596;13223
290130;202208;5410;11695;4205;10114;217;479;3094;7612;3311;8091
290135;202208;5311;11122;4314;9520;178;424;3477;7294;3655;7718
290140;202208;5295;12287;4093;10721;189;487;3365;8865;3554;9352
290150;202208;3816;7378;3326;6815;144;354;2831;5612;2975;5966
290160;202208;4249;8374;3771;7732;198;344;3188;6473;3386;6817
290170;202208;4334;9059;3852;8544;127;268;3481;7719;3608;7987
290180;202208;3612;8679;3016;7757;76;275;2567;6422;2643;6697
290190;202208;5942;12894;5305;12082;138;384;4541;10190;4679;10574
290195;202208;3193;6569;2524;5741;102;244;2130;4816;2232;5060
290200;202208;4794;12200;3775;10476;190;484;2765;7669;2955;8153
290205;202208;4161;9532;3662;8806;160;457;2968;6900;3128;7357
290210;202208;17317;39093;15325;36153;1627;3033;11585;27998;13212;31031
290220;202208;3920;7585;3457;7028;100;229;3028;6006;3128;6235
290225;202208;3924;6971;3040;6066;49;139;2815;5497;2864;5636
290230;202208;3729;7355;3422;7008;130;193;2907;6074;3037;6267
290240;202208;5053;10265;4111;9141;76;242;3640;7930;3716;8172
290250;202208;4729;11949;3853;10690;150;359;3159;8925;3309;9284
290260;202208;6460;13969;5474;12556;287;725;4592;10236;4879;10961
290265;202208;3906;10609;3149;9237;265;819;2110;6085;2375;6904
290270;202208;12558;38748;11518;36998;755;2660;9007;28800;9762;31460
290280;202208;7145;19848;6125;17850;461;1516;4255;12044;4716;13560
290290;202208;11379;30685;9092;26628;918;2904;5919;16977;6837;19881
290300;202208;4999;12162;3630;9680;210;629;2588;6648;2798;7277
290310;202208;2666;4727;2179;4171;24;81;2028;3776;2052;3857
290320;202208;33655;77458;27297;68279;4727;11624;15747;39460;20474;51084
290323;202208;4487;10998;3806;9921;96;270;2998;7764;3094;8034
290327;202208;4996;12774;4225;11378;420;1030;2870;7678;3290;8708
290330;202208;2952;5038;2387;4437;26;42;2215;4118;2241;4160
290340;202208;7555;15928;5895;13979;548;1202;4547;10851;5095;12053
290350;202208;5466;14138;4527;12545;262;783;3256;8881;3518;9664
290360;202208;6513;13837;5700;12781;106;264;5087;11230;5193;11494
290370;202208;5738;12760;4189;10729;167;444;3018;7635;3185;8079
290380;202208;6914;15477;5747;13926;156;301;4954;12028;5110;12329
290390;202208;18078;46098;14877;41005;1423;3959;10301;28167;11724;32126
290395;202208;3486;8764;2760;7560;71;280;2160;5764;2231;6044
290400;202208;4476;11017;3570;9563;176;528;2698;7031;2874;7559
290405;202208;5225;13857;4406;12480;403;1156;2966;8491;3369;9647
290410;202208;6440;15923;4891;13547;175;665;3703;9954;3878;10619
290420;202208;3695;9006;3017;7982;102;279;2381;6248;2483;6527
290430;202208;4302;9455;3588;8425;157;492;2868;6367;3025;6859
290440;202208;3395;7626;2429;6124;170;367;1717;4370;1887;4737
290450;202208;4863;9684;3896;8353;108;266;3395;6998;3503;7264
290460;202208;14847;38648;12347;34116;2484;6981;5259;14369;7743;21350
290470;202208;5884;11955;4452;10065;443;1010;2921;6490;3364;7500
290475;202208;7703;19943;6410;17809;92;444;5398;14662;5490;15106
290480;202208;2203;4884;1806;4320;65;225;1386;3101;1451;3326
290485;202208;5462;14140;4769;13163;199;659;3888;10658;4087;11317
290490;202208;11082;22702;10022;21310;376;854;8437;17716;8813;18570
290500;202208;4841;13343;3734;11098;658;2068;1547;4416;2205;6484
290510;202208;4338;9162;3642;8285;88;222;3259;7346;3347;7568
290515;202208;4075;10365;3524;9596;35;104;3200;8782;3235;8886
290520;202208;14361;36607;11132;30555;579;1847;7408;19109;7987;20956
290530;202208;5611;14871;4699;13426;107;433;3967;11172;4074;11605
290540;202208;4533;10353;4095;9871;127;366;3661;8774;3788;9140
290550;202208;4985;11521;4323;10751;38;102;3955;9897;3993;9999
290560;202208;7484;17526;5741;15039;456;1428;3894;9645;4350;11073
290570;202208;59001;131738;52483;123642;2863;7248;43034;99264;45897;106512
290580;202208;10615;25414;9215;23498;947;2041;6731;17751;7678;19792
290590;202208;7928;22663;6593;20348;173;621;5397;16744;5570;17365
290600;202208;21747;55897;18750;51157;979;2723;14844;40091;15823;42814
290610;202208;2860;8261;2221;7010;105;348;1548;4836;1653;5184
290620;202208;6995;18628;6012;17040;411;1041;4816;13721;5227;14762
290630;202208;11557;23901;9406;21223;715;1553;7400;16685;8115;18238
290640;202208;3257;7316;2507;6273;246;479;1714;4532;1960;5011
290650;202208;19256;39204;17405;37165;1150;2646;14965;31511;16115;34157
290660;202208;4436;10445;3504;8965;158;457;2550;6463;2708;6920
290670;202208;9888;20631;8602;18800;256;679;7475;15995;7731;16674
290680;202208;13107;31800;10807;28499;247;1014;9125;23476;9372;24490
290682;202208;6517;13567;5652;12452;482;681;4230;10069;4712;10750
290685;202208;4196;8586;3040;6960;529;1026;1626;4012;2155;5038
290687;202208;9059;20339;7511;17960;1009;2207;4795;11708;5804;13915
290689;202208;3262;8292;2433;6841;273;821;1587;4430;1860;5251
290690;202208;6739;15699;5525;14024;344;907;4121;10259;4465;11166
290700;202208;3728;7717;3334;7240;46;140;3053;6495;3099;6635
290710;202208;10882;25203;9232;22982;248;739;8058;19786;8306;20525
290720;202208;24087;55910;21588;52213;1347;3115;17227;40829;18574;43944
290730;202208;8308;17822;7018;16313;406;760;5255;12462;5661;13222
290740;202208;1276;2955;980;2492;12;28;878;2200;890;2228
290750;202208;15907;32642;13718;29381;398;1033;11359;22985;11757;24018
290755;202208;2321;6103;1863;5308;119;323;1272;3624;1391;3947
290760;202208;4263;11490;3485;10111;224;553;2428;7186;2652;7739
290770;202208;3372;8575;3102;8253;105;228;2683;7213;2788;7441
290780;202208;9127;21012;7766;19199;337;678;5985;14982;6322;15660
290790;202208;6045;14497;5191;13291;285;688;4255;10951;4540;11639
290800;202208;8378;14999;6052;12352;380;603;4535;9403;4915;10006
290810;202208;6714;14765;5422;12943;228;503;4174;10048;4402;10551
290820;202208;6431;14561;5637;13431;388;763;3993;9506;4381;10269
290830;202208;5038;11276;4423;10334;89;303;3620;7980;3709;8283
290840;202208;21191;50476;17948;45596;1976;4213;12166;32092;14142;36305
290850;202208;10718;19664;9385;18239;518;761;7907;15364;8425;16125
290860;202208;7449;18308;6465;17180;357;841;5411;14676;5768;15517
290870;202208;5596;13953;4245;11477;336;842;2857;7636;3193;8478
290880;202208;1653;3669;1312;3241;197;446;742;1984;939;2430
290890;202208;11564;20508;10252;19056;469;694;9092;17009;9561;17703
290900;202208;2708;6657;2064;5558;168;438;1274;3365;1442;3803
290910;202208;6054;12854;4620;10750;50;133;4020;9229;4070;9362
290920;202208;6433;13840;5610;12863;215;282;4870;11720;5085;12002
290930;202208;8533;22058;6784;19051;258;933;5166;14030;5424;14963
290940;202208;4026;10505;3322;9448;162;558;2623;7327;2785;7885
290950;202208;1648;3818;1337;3362;115;293;889;2243;1004;2536
290960;202208;7078;15682;6291;14730;289;596;5289;12311;5578;12907
290970;202208;3615;10118;2928;8851;120;409;2252;6735;2372;7144
290980;202208;16312;34704;14108;31493;814;1981;9967;21109;10781;23090
290990;202208;11403;27105;10090;25101;321;1121;8557;20456;8878;21577
291000;202208;3868;8978;2958;7857;146;389;2389;6393;2535;6782
291005;202208;19792;43372;17462;40487;819;1978;14741;33487;15560;35465
291010;202208;3455;9893;2726;8329;146;499;1790;5273;1936;5772
291020;202208;1504;3413;1214;2931;27;82;890;1996;917;2078
291030;202208;2964;6459;2144;5149;172;377;1381;3195;1553;3572
291040;202208;6148;15255;4988;13622;234;725;3879;10586;4113;11311
291050;202208;13127;26500;11605;24494;1341;2691;8540;17799;9881;20490
291060;202208;10272;23000;9049;21441;853;1876;6932;16375;7785;18251
291070;202208;20944;47385;17681;42399;367;1207;15167;35305;15534;36512
291072;202208;33715;73716;25756;61340;3616;8915;14908;33897;18524;42812
291075;202208;6299;14201;5628;13174;106;290;4688;10537;4794;10827
291077;202208;1941;4695;1505;3958;76;144;1044;2745;1120;2889
291080;202208;154981;333138;125412;293864;27647;62892;58201;137131;85848;200023
291085;202208;6373;14877;5133;12977;184;510;4217;10473;4401;10983
291090;202208;2558;4300;1899;3579;52;95;1639;3018;1691;3113
291100;202208;3958;7450;2801;6096;124;250;2214;4769;2338;5019
291110;202208;6887;19087;5761;17209;314;1170;4428;12805;4742;13975
291120;202208;9790;20420;8397;18713;371;908;6758;14810;7129;15718
291125;202208;2746;4310;2098;3591;69;108;1829;3079;1898;3187
291130;202208;3664;9591;2733;7834;71;314;2116;5798;2187;6112
291140;202208;5651;13676;4099;10971;609;1465;2463;6526;3072;7991
291150;202208;3284;5878;2600;5133;8;19;2474;4841;2482;4860
291160;202208;5922;14856;4886;13381;530;1456;3139;8451;3669;9907
291165;202208;2409;6214;1730;4920;29;128;1211;3303;1240;3431
291170;202208;25971;59653;21690;52771;1539;3819;14382;33468;15921;37287
291180;202208;9285;16626;7275;14059;200;454;6457;12108;6657;12562
291185;202208;4143;8991;3678;8308;225;467;2900;6508;3125;6975
291190;202208;8857;19648;7314;17731;219;608;5883;14306;6102;14914
291200;202208;3165;8062;2324;6506;84;313;1549;4052;1633;4365
291210;202208;8887;16533;6593;13942;369;677;5052;10685;5421;11362
291220;202208;5681;13524;5061;12649;418;1017;3602;8862;4020;9879
291230;202208;5847;10383;4612;9043;72;106;4278;8368;4350;8474
291240;202208;4748;11295;4009;10090;77;240;3440;8497;3517;8737
291250;202208;3727;10258;2869;8726;193;577;1800;5516;1993;6093
291260;202208;1712;3588;1393;3184;41;100;1155;2641;1196;2741
291270;202208;6581;14844;5144;12868;463;1053;3709;9416;4172;10469
291280;202208;3360;7332;2500;6084;154;366;1764;4088;1918;4454
291290;202208;6555;15886;4975;13472;481;1356;3293;8702;3774;10058
291300;202208;4589;11033;3644;9516;157;441;2756;7028;2913;7469
291310;202208;5991;14482;5110;12978;135;410;4379;10905;4514;11315
291320;202208;7837;18976;6105;16067;1279;3167;3193;8663;4472;11830
291330;202208;2182;5085;1797;4454;67;182;1387;3328;1454;3510
291340;202208;4978;11604;3984;10016;221;456;2737;6854;2958;7310
291345;202208;3479;8976;3106;8429;169;494;2525;6831;2694;7325
291350;202208;8625;18078;6760;15819;143;344;5817;13496;5960;13840
291360;202208;50730;99479;40747;87918;4720;9824;27461;59913;32181;69737
291370;202208;9615;23541;8460;21806;560;1679;6476;16023;7036;17702
291380;202208;5309;10953;4750;10222;145;380;4177;8783;4322;9163
291390;202208;15839;30043;12214;26067;548;1084;10371;21889;10919;22973
291400;202208;19449;40683;16409;36324;1549;3221;11632;25832;13181;29053
291410;202208;3453;8334;2700;7081;58;189;2031;5178;2089;5367
291420;202208;2189;4851;1696;4239;25;93;1500;3699;1525;3792
291430;202208;3046;7796;2593;7047;91;339;2057;5385;2148;5724
291440;202208;7666;19583;6562;17869;483;1267;4829;13392;5312;14659
291450;202208;12932;24647;10729;22147;277;387;9641;20129;9918;20516
291460;202208;20367;45894;17789;42230;1094;2651;13660;31591;14754;34242
291465;202208;10423;23256;8240;20767;235;837;7080;17489;7315;18326
291470;202208;24080;44943;20597;41006;1180;2154;16283;32342;17463;34496
291480;202208;56959;110931;43873;93868;4569;9853;27173;55896;31742;65749
291490;202208;8286;16647;7374;15640;233;509;6748;14217;6981;14726
291500;202208;6380;12826;5351;11539;118;304;4918;10551;5036;10855
291510;202208;5501;11279;4171;9604;59;216;3652;8208;3711;8424
291520;202208;5340;11005;4073;9395;321;705;3177;7277;3498;7982
291530;202208;2800;5695;2048;4745;229;497;1391;3272;1620;3769
291535;202208;4320;11003;3666;9884;180;466;2934;7935;3114;8401
291540;202208;2535;5076;1766;4154;66;168;1508;3501;1574;3669
291550;202208;7754;14654;6077;12629;511;928;4418;9082;4929;10010
291560;202208;21196;46516;15723;39452;2935;7017;8185;21155;11120;28172
291570;202208;2824;5697;2176;4960;121;218;1854;4298;1975;4516
291580;202208;7607;17341;5995;15257;298;879;4576;11252;4874;12131
291590;202208;3129;6077;2775;5675;84;208;2508;5024;2592;5232
291600;202208;6651;13732;5131;11514;471;1129;3485;7574;3956;8703
291610;202208;8217;16283;7329;15316;541;810;5909;12862;6450;13672
291620;202208;3580;7196;2725;6268;227;430;2051;4850;2278;5280
291630;202208;4209;7887;3224;6688;458;708;2367;5094;2825;5802
291640;202208;21141;44458;16379;37941;1645;3835;9872;21938;11517;25773
291650;202208;12195;24824;10812;23220;939;1324;8771;19607;9710;20931
291660;202208;2272;5199;1654;4267;118;396;1099;2625;1217;3021
291670;202208;2333;5673;1912;5065;205;485;1304;3545;1509;4030
291680;202208;4835;10591;3925;9345;427;1013;2550;6134;2977;7147
291685;202208;5495;12425;4384;10905;183;386;3422;8493;3605;8879
291690;202208;5268;9672;3715;7590;172;342;3162;6295;3334;6637
291700;202208;11213;27181;9870;25037;338;1084;8426;20734;8764;21818
291710;202208;6461;13320;4939;11284;327;786;3738;8255;4065;9041
291720;202208;5062;14091;4168;12396;879;2638;2145;6386;3024;9024
291730;202208;9082;17790;7824;16200;400;798;6620;13615;7020;14413
291733;202208;3401;7812;2849;7086;119;232;2122;5476;2241;5708
291735;202208;3122;7977;2415;6745;72;170;1742;4840;1814;5010
291740;202208;4522;10915;3174;8448;112;245;2200;5790;2312;6035
291750;202208;25796;54115;21377;47731;2928;5722;13893;31553;16821;37275
291760;202208;13318;33762;10463;29457;3182;10298;2919;7784;6101;18082
291770;202208;8911;21383;7442;18910;355;1150;5734;13788;6089;14938
291780;202208;6004;14294;5371;13454;117;383;4671;11464;4788;11847
291790;202208;3632;8087;3307;7696;365;624;2467;5981;2832;6605
291800;202208;41815;89421;33299;77678;4184;10113;20685;46235;24869;56348
291810;202208;12780;26896;10863;24605;456;885;9098;20745;9554;21630
291820;202208;4617;10833;4010;10057;129;348;3269;8124;3398;8472
291830;202208;5568;11154;4545;9827;266;407;3614;7867;3880;8274
291835;202208;7591;20811;6086;18110;650;1955;3998;11990;4648;13945
291840;202208;58373;143018;50870;131894;5131;14005;36804;94017;41935;108022
291845;202208;4081;7909;3417;7115;238;391;2828;6038;3066;6429
291850;202208;5197;12626;4350;11315;132;328;3700;9610;3832;9938
291855;202208;2819;4648;2268;4046;26;53;2145;3802;2171;3855
291860;202208;2473;6170;1672;4642;38;110;1125;3021;1163;3131
291870;202208;1464;3428;991;2612;37;114;693;1778;730;1892
291875;202208;3357;9415;2866;8425;63;273;2119;5972;2182;6245
291880;202208;6464;16205;5402;14496;324;778;4079;11067;4403;11845
291890;202208;1993;3714;1322;2935;199;440;833;1813;1032;2253
291900;202208;1553;3351;1187;2810;31;86;948;2158;979;2244
291905;202208;2723;6460;2217;5685;106;330;1704;4179;1810;4509
291910;202208;4301;8296;3714;7611;81;178;3330;6796;3411;6974
291915;202208;8628;22104;6982;19382;256;712;5181;14616;5437;15328
291920;202208;38395;85535;33374;79058;1811;5303;26610;60439;28421;65742
291930;202208;3216;7234;2742;6599;291;645;1998;4867;2289;5512
291940;202208;4440;10315;2983;7981;261;641;1784;4708;2045;5349
291950;202208;10726;30217;8927;26939;478;1494;6016;17983;6494;19477
291955;202208;21905;48279;19663;45474;1232;3078;16327;37282;17559;40360
291960;202208;4515;9162;3822;8281;289;461;3070;6821;3359;7282
291970;202208;5841;12330;4946;11261;152;417;4054;8976;4206;9393
291980;202208;11861;30194;9581;26504;879;2245;6525;18221;7404;20466
291990;202208;2696;6204;2242;5653;26;94;2072;5180;2098;5274
291992;202208;5328;11036;4477;9986;310;616;3585;7918;3895;8534
291995;202208;2684;6198;2215;5496;76;263;1812;4309;1888;4572
292000;202208;3114;6556;2573;5913;70;209;2158;4854;2228;5063
292010;202208;6862;14079;5583;12262;89;346;4796;10153;4885;10499
292020;202208;5572;13840;4704;12422;163;581;3822;9707;3985;10288
292030;202208;2455;6454;2121;5885;141;418;1401;3768;1542;4186
292040;202208;5600;12139;4464;10531;185;435;3666;8564;3851;8999
292045;202208;5358;10956;4216;9345;26;83;3935;8688;3961;8771
292050;202208;7527;19033;6085;16632;291;936;4118;10939;4409;11875
292060;202208;15100;29522;13996;28195;463;828;12536;24823;12999;25651
292070;202208;7665;16324;6724;15225;439;886;5736;13018;6175;13904
292080;202208;4420;8593;3688;7681;40;131;3444;7071;3484;7202
292090;202208;5128;10193;3644;8382;200;515;2897;6601;3097;7116
292100;202208;15368;32948;13158;30215;2049;4545;8026;18804;10075;23349
292105;202208;3943;9209;3413;8497;48;177;2879;7087;2927;7264
292110;202208;7823;15949;5687;13012;714;1735;3741;8254;4455;9989
292120;202208;8409;19215;6911;16778;647;1392;4891;11780;5538;13172
292130;202208;4026;8687;3291;7769;191;486;2489;5786;2680;6272
292140;202208;6932;13528;5891;12099;197;381;5215;10540;5412;10921
292145;202208;3056;7430;2548;6620;122;258;1966;5165;2088;5423
292150;202208;18639;42292;16067;38289;460;1205;13617;31627;14077;32832
292160;202208;3475;7512;2644;6466;36;109;2061;5359;2097;5468
292170;202208;10423;24981;8700;22278;462;1393;6694;16582;7156;17975
292180;202208;3397;8579;2536;7025;209;575;1581;4247;1790;4822
292190;202208;3507;8243;2951;7449;283;746;2034;5146;2317;5892
292200;202208;11090;24727;8378;20981;1611;4099;4187;10698;5798;14797
292205;202208;4525;11173;3898;10252;102;310;3359;8797;3461;9107
292210;202208;8104;15813;6713;14104;81;301;6247;12868;6328;13169
292220;202208;2663;5503;2280;4945;122;232;1771;3733;1893;3965
292225;202208;3738;9775;3248;9072;60;255;2840;7796;2900;8051
292230;202208;10306;22102;9102;20597;263;732;7752;17127;8015;17859
292240;202208;5766;15020;4983;13605;283;767;3616;9811;3899;10578
292250;202208;7183;16346;6388;15233;294;786;5125;11874;5419;12660
292260;202208;3825;9201;3373;8636;67;218;2976;7547;3043;7765
292265;202208;4329;10192;3560;9022;68;279;3015;7402;3083;7681
292270;202208;5823;10899;4731;9625;217;333;3923;7943;4140;8276
292273;202208;3373;6511;2678;5671;149;243;1934;4330;2083;4573
292275;202208;2231;4965;1820;4432;56;161;1495;3576;1551;3737
292280;202208;3254;6679;2593;5919;120;206;2187;5111;2307;5317
292285;202208;3053;6486;2403;5635;100;181;1963;4639;2063;4820
292290;202208;8850;20430;7047;17937;206;539;5889;14827;6095;15366
292300;202208;12430;28105;9787;24590;1282;3228;6260;15878;7542;19106
292303;202208;3884;9103;3367;8331;73;172;2967;7264;3040;7436
292305;202208;2708;6605;2453;6258;58;192;2193;5513;2251;5705
292310;202208;8390;18155;7249;16769;107;381;6434;14515;6541;14896
292320;202208;6708;16668;5316;14295;179;580;4106;10754;4285;11334
292330;202208;3709;6528;3087;5846;205;298;2480;4828;2685;5126
292335;202208;5899;13830;5196;12801;242;535;4351;10782;4593;11317
292340;202208;6234;16232;5072;14076;309;775;3589;9929;3898;10704
292350;202208;3136;7474;2623;6804;139;384;2159;5544;2298;5928
292360;202208;5801;14016;4813;12428;245;682;3558;8978;3803;9660
292370;202208;13022;26427;11191;24052;96;349;10559;22310;10655;22659
292380;202208;8092;20356;7186;18809;448;1228;5580;14326;6028;15554
292390;202208;6016;9588;4650;8047;80;136;4285;7342;4365;7478
292400;202208;26610;67816;22878;62222;2138;5811;16015;43395;18153;49206
292405;202208;5482;11731;4563;10345;143;332;3640;8325;3783;8657
292410;202208;2836;5542;2428;5045;101;177;2133;4446;2234;4623
292420;202208;5883;11747;5306;10973;84;250;4871;9764;4955;10014
292430;202208;5768;15684;4378;13133;338;1098;2951;8700;3289;9798
292440;202208;10546;28676;9649;27401;130;625;8720;24455;8850;25080
292450;202208;4742;12205;3603;10086;94;317;2817;7723;2911;8040
292460;202208;7254;15517;6132;13851;168;440;5264;11530;5432;11970
292465;202208;3081;7040;2590;6422;146;285;1708;4582;1854;4867
292467;202208;2475;5950;2187;5575;314;650;1507;4098;1821;4748
292470;202208;3342;7980;2511;6696;140;341;1793;4790;1933;5131
292480;202208;8016;15383;6617;13730;171;343;5991;12334;6162;12677
292490;202208;3272;6416;2748;5730;89;171;2224;4633;2313;4804
292500;202208;8578;19681;6838;16961;414;952;4966;12052;5380;13004
292510;202208;16669;38560;13083;33136;919;2357;9361;23411;10280;25768
292520;202208;8818;19952;7765;18432;365;1016;6361;14717;6726;15733
292525;202208;7939;15810;6556;14242;120;276;5950;12880;6070;13156
292530;202208;39302;92541;31464;80307;6075;16302;16475;40991;22550;57293
292540;202208;5404;8784;4331;7656;127;201;3972;7021;4099;7222
292550;202208;9805;23698;7611;21074;596;1520;5347;15556;5943;17076
292560;202208;5268;11989;4402;10807;164;497;3389;8031;3553;8528
292570;202208;4466;10297;3722;9037;56;201;3189;7458;3245;7659
292575;202208;8002;20913;7282;19952;803;2091;5382;14973;6185;17064
292580;202208;9302;20026;7664;17710;323;545;6506;14914;6829;15459
292590;202208;8557;20819;7157;18363;339;1050;5835;14519;6174;15569
292593;202208;3378;7715;2679;6553;74;193;2249;5399;2323;5592
292595;202208;6720;15604;5818;14507;267;621;4878;12249;5145;12870
292600;202208;13768;32331;11883;29629;654;1461;9449;23571;10103;25032
292610;202208;5445;11986;4605;10647;166;366;3738;8481;3904;8847
292620;202208;8208;18639;6793;16946;130;315;6227;15577;6357;15892
292630;202208;11097;23544;8948;20255;943;2242;6094;13316;7037;15558
292640;202208;9448;24810;7913;22319;478;1334;5481;15504;5959;16838
292650;202208;4947;11364;4369;10608;58;183;4013;9605;4071;9788
292660;202208;12708;32290;10767;29423;655;1663;8092;22335;8747;23998
292665;202208;2362;6457;1986;5952;93;252;1571;4834;1664;5086
292670;202208;4002;10299;3096;8633;250;783;1996;5360;2246;6143
292680;202208;4677;11080;3702;9444;123;323;2861;7039;2984;7362
292690;202208;2941;7140;2025;5672;218;549;1251;3603;1469;4152
292700;202208;12362;29308;10717;26849;673;1511;8002;19929;8675;21440
292710;202208;3598;8631;3357;8338;66;179;3141;7770;3207;7949
292720;202208;10562;22023;8914;20133;470;899;6872;16021;7342;16920
292730;202208;6389;12561;5787;11705;422;655;4691;9659;5113;10314
292740;202208;448156;937316;396143;866950;42883;96263;282779;601354;325662;697617
292750;202208;8260;17871;7266;16562;264;615;6213;14014;6477;14629
292760;202208;4698;11916;4049;10830;197;583;3118;8170;3315;8753
292770;202208;8879;19670;7338;17599;889;2129;5222;12628;6111;14757
292780;202208;2500;4378;1853;3622;47;112;1570;2894;1617;3006
292790;202208;4590;8678;3471;7474;249;464;2760;6049;3009;6513
292800;202208;13809;30612;11780;27588;715;1552;9402;21894;10117;23446
292805;202208;4452;9217;3539;8088;143;346;2927;6565;3070;6911
292810;202208;15685;31481;12862;27343;568;1421;10682;21552;11250;22973
292820;202208;8056;20987;5880;17322;443;1463;4050;11664;4493;13127
292830;202208;3425;7269;2918;6682;126;260;2417;5620;2543;5880
292840;202208;11878;25118;10188;22897;168;506;9235;20269;9403;20775
292850;202208;3011;7092;2536;6448;225;555;1784;4480;2009;5035
292860;202208;21835;41494;19747;39055;432;995;17621;33968;18053;34963
292870;202208;26367;55654;22819;50829;1537;3323;16650;35833;18187;39156
292880;202208;13274;33467;11169;30209;413;1451;8318;21471;8731;22922
292890;202208;9898;22343;8755;20770;169;566;7766;17979;7935;18545
292895;202208;4129;7449;3195;6109;244;378;2494;4800;2738;5178
292900;202208;3546;7914;3201;7439;47;183;2740;6121;2787;6304
292905;202208;5347;12111;4253;10494;138;391;3351;7964;3489;8355
292910;202208;6306;14571;5569;13610;182;439;4492;10692;4674;11131
292920;202208;11702;28469;10823;27313;275;963;9478;23395;9753;24358
292925;202208;6094;16065;5003;14025;383;958;3506;9798;3889;10756
292930;202208;7907;20676;6835;18796;881;2466;4060;10946;4941;13412
292935;202208;3231;6303;2597;5608;24;69;2377;5120;2401;5189
292937;202208;3314;7646;2829;7040;250;556;2047;5188;2297;5744
292940;202208;3577;8024;2843;6935;458;917;1755;4520;2213;5437
292950;202208;10832;25708;9422;23716;502;1235;7213;17813;7715;19048
292960;202208;6382;13759;5346;12344;204;379;4271;9819;4475;10198
292970;202208;4653;11649;4098;10877;107;326;3397;9073;3504;9399
292975;202208;5174;10188;4591;9535;113;271;4209;8664;4322;8935
292980;202208;4649;8973;3877;7914;64;192;3464;6870;3528;7062
292990;202208;13579;33903;11332;30184;420;1287;8924;22976;9344;24263
293000;202208;3232;6990;2744;6251;144;306;2110;4790;2254;5096
293010;202208;22270;50443;18058;44279;2143;5450;11805;28482;13948;33932
293015;202208;10092;27888;7917;23837;659;1987;5427;16452;6086;18439
293020;202208;12117;29887;10948;28260;153;545;9949;25475;10102;26020
293030;202208;6077;14550;4702;12466;346;676;3116;8641;3462;9317
293040;202208;5153;11832;4194;10523;124;340;3568;8882;3692;9222
293050;202208;29587;60590;25974;55469;1821;3642;19751;41287;21572;44929
293060;202208;4447;10640;3578;9067;239;621;2593;6333;2832;6954
293070;202208;36882;74232;32892;69330;2135;4630;26374;54200;28509;58830
293075;202208;4288;11721;3701;10790;76;380;3173;9165;3249;9545
293076;202208;4110;8929;3699;8457;90;177;3274;7549;3364;7726
293077;202208;7654;18661;6180;16423;859;2108;3604;10194;4463;12302
293080;202208;5393;14380;4522;12882;87;368;3706;10317;3793;10685
293090;202208;3607;9891;2777;8486;218;620;1908;5816;2126;6436
293100;202208;6773;16408;5471;14188;275;639;4242;10959;4517;11598
293105;202208;4393;12798;3726;11487;244;780;2584;7932;2828;8712
293110;202208;3027;6416;2551;5757;101;238;2082;4603;2183;4841
293120;202208;6302;13367;5737;12582;512;713;4607;10523;5119;11236
293130;202208;4204;10413;3612;9657;117;404;3128;8209;3245;8613
293135;202208;37504;81503;27788;68600;5055;13185;11656;28636;16711;41821
293140;202208;3373;5866;2975;5401;80;124;2685;4782;2765;4906
293150;202208;6001;16317;4939;14413;388;1247;3405;9681;3793;10928
293160;202208;5171;10414;4566;9741;606;788;3446;8117;4052;8905
293170;202208;6590;10981;5658;9908;112;253;5027;8578;5139;8831
293180;202208;5280;13301;4350;11684;93;345;3527;9194;3620;9539
293190;202208;19499;41590;17193;38416;128;537;15747;34371;15875;34908
293200;202208;11256;22870;9255;19872;404;746;7663;16333;8067;17079
293210;202208;6081;14223;5118;12835;389;953;3885;9715;4274;10668
293220;202208;7152;14899;5396;12164;783;1701;3435;7479;4218;9180
293230;202208;5567;11312;4197;9601;296;605;3187;7304;3483;7909
293240;202208;5406;12369;4353;10767;231;389;3201;8300;3432;8689
293245;202208;4823;11394;4356;10737;213;517;3657;8906;3870;9423
293250;202208;6883;14939;5526;13122;343;849;4294;10053;4637;10902
293260;202208;5708;13024;4651;11440;199;370;3342;8286;3541;8656
293270;202208;9188;17381;7328;15411;655;809;5781;13025;6436;13834
293280;202208;5247;12241;4553;11271;312;660;3538;8840;3850;9500
293290;202208;20047;49127;17656;45508;1611;4218;12821;32559;14432;36777
293300;202208;8055;16273;6910;14624;544;1081;5272;10880;5816;11961
293305;202208;5215;10787;4410;9785;48;123;4055;8946;4103;9069
293310;202208;2570;5902;2165;5284;39;139;1774;4197;1813;4336
293315;202208;5543;10939;4607;9637;466;651;3598;7730;4064;8381
293317;202208;3428;6990;3052;6466;314;472;2263;4877;2577;5349
293320;202208;16219;32295;14482;30414;199;493;13337;27545;13536;28038
293325;202208;2202;4843;1741;4267;207;489;1160;2830;1367;3319
293330;202208;90122;211342;74691;186388;9277;25726;44790;104215;54067;129941
293340;202208;2508;6435;2041;5619;147;420;1388;3761;1535;4181
293345;202208;4504;10580;3621;9268;459;856;2371;6658;2830;7514
293350;202208;7065;17984;6025;16695;130;384;5304;14755;5434;15139
293360;202208;19046;40354;16525;37077;507;1142;14449;32534;14956;33676
310010;202208;1146;2430;775;1945;97;269;313;709;410;978
310020;202208;3389;8415;2573;7017;443;1272;1028;2603;1471;3875
310030;202208;2292;5940;1778;5057;247;740;1144;3156;1391;3896
310040;202208;969;2337;756;1982;71;240;432;986;503;1226
310050;202208;1846;4846;1572;4426;119;426;1113;2998;1232;3424
310060;202208;3799;9460;3227;8710;127;403;2487;6793;2614;7196
310070;202208;404;892;301;747;11;35;231;558;242;593
310080;202208;878;2249;645;1839;90;277;326;864;416;1141
310090;202208;6138;13548;5067;11901;201;581;4075;9201;4276;9782
310100;202208;4359;10192;3665;9133;111;386;3107;7460;3218;7846
310110;202208;5611;13544;4373;11501;606;1849;2608;6433;3214;8282
310120;202208;771;1744;503;1346;85;286;248;555;333;841
310130;202208;492;1135;419;1029;24;75;332;773;356;848
310140;202208;371;960;276;826;45;161;144;382;189;543
310150;202208;7359;16936;5603;13950;486;1486;3280;7403;3766;8889
310160;202208;11688;26425;8987;22276;1333;3754;4456;10244;5789;13998
310163;202208;1357;3738;1050;3138;224;754;316;823;540;1577
310170;202208;11588;25988;9413;22757;932;2156;6642;15915;7574;18071
310180;202208;2397;5286;1744;4277;176;508;1144;2646;1320;3154
310190;202208;3212;8565;2611;7551;621;1931;579;1563;1200;3494
310200;202208;2367;6233;1784;5211;316;1079;815;2169;1131;3248
310205;202208;1348;3379;1080;2968;135;397;683;1888;818;2285
310210;202208;2819;7082;2282;6129;121;323;1609;4155;1730;4478
310220;202208;1361;3479;1027;2848;78;232;665;1754;743;1986
310230;202208;2667;6579;2168;5684;232;737;1418;3411;1650;4148
310240;202208;1197;3142;1018;2842;52;182;710;1869;762;2051
310250;202208;1406;3113;1168;2761;34;97;958;2176;992;2273
310260;202208;4234;10263;2862;7806;709;2272;1042;2275;1751;4547
310270;202208;3496;7047;2828;6177;95;234;2376;5161;2471;5395
310280;202208;3288;6643;2610;5751;135;366;1954;4028;2089;4394
310285;202208;2167;6209;1792;5545;173;599;1121;3424;1294;4023
310290;202208;1843;4407;1562;3921;167;523;1035;2330;1202;2853
310300;202208;1958;5010;1560;4330;165;576;866;2154;1031;2730
310310;202208;384;849;259;649;43;112;141;333;184;445
310320;202208;576;1358;400;1072;16;58;234;590;250;648
310330;202208;571;1296;340;876;42;121;148;340;190;461
310340;202208;9782;22947;7680;19426;961;2373;4097;10177;5058;12550
310350;202208;15935;36215;11413;29081;1669;4723;6042;14352;7711;19075
310360;202208;695;1432;566;1272;29;73;365;787;394;860
310370;202208;1428;4188;1236;3862;231;800;411;1357;642;2157
310375;202208;1011;2300;703;1852;185;485;245;612;430;1097
310380;202208;439;969;244;669;23;64;133;341;156;405
310390;202208;658;1825;527;1575;91;304;232;624;323;928
310400;202208;14512;33068;10952;27773;759;2337;7370;17596;8129;19933
310410;202208;1221;3364;711;2275;74;268;298;839;372;1107
310420;202208;5853;14153;4361;11553;513;1550;2326;5595;2839;7145
310430;202208;2009;5111;1391;4023;235;695;585;1473;820;2168
310440;202208;756;1832;530;1436;60;185;275;683;335;868
310445;202208;1580;4113;1183;3355;98;252;808;2243;906;2495
310450;202208;5522;12150;4255;10221;244;767;3297;7530;3541;8297
310460;202208;2056;5197;1560;4320;203;628;566;1349;769;1977
310470;202208;4145;8650;3200;7406;440;921;2025;4810;2465;5731
310480;202208;1167;2807;884;2345;105;349;525;1259;630;1608
310490;202208;3444;8613;2746;7477;355;1120;1541;3823;1896;4943
310500;202208;1791;4291;1397;3675;201;574;862;2144;1063;2718
310510;202208;2729;6553;1972;5210;314;913;921;2291;1235;3204
310520;202208;1333;3208;946;2502;142;398;459;1193;601;1591
310530;202208;937;2266;678;1838;104;334;259;569;363;903
310540;202208;3562;9480;2881;8225;510;1594;1348;3526;1858;5120
310550;202208;1507;3396;1076;2697;74;250;691;1558;765;1808
310560;202208;19786;47786;14475;38349;1624;4986;7468;17291;9092;22277
310570;202208;1368;3085;1073;2686;48;161;885;2142;933;2303
310590;202208;5080;12126;4070;10316;241;715;2544;5895;2785;6610
310600;202208;1651;4397;1340;3764;168;523;713;1833;881;2356
310610;202208;564;1471;350;1094;101;345;77;215;178;560
310620;202208;262085;606877;200491;499108;20431;60806;118398;263300;138829;324106
310630;202208;5480;13912;4227;11526;506;1434;2482;6465;2988;7899
310640;202208;1738;4182;1421;3642;124;404;962;2228;1086;2632
310650;202208;2809;7056;2060;5692;141;481;1303;3370;1444;3851
310660;202208;1730;4007;1422;3588;29;76;1258;3126;1287;3202
310665;202208;1673;3745;1390;3378;29;108;1132;2717;1161;2825
310670;202208;76849;177860;64784;158307;5505;15537;45847;104979;51352;120516
310680;202208;924;1956;760;1726;24;89;640;1381;664;1470
310690;202208;2821;6215;2102;5156;175;477;1410;3221;1585;3698
310700;202208;613;1175;487;1027;8;20;403;815;411;835
310710;202208;7339;19084;5349;16082;1147;3979;977;2600;2124;6579
310720;202208;1337;2806;1056;2446;37;122;803;1775;840;1897
310730;202208;12178;28750;10396;26059;427;1357;7936;18938;8363;20295
310740;202208;8028;20248;6044;16484;742;2391;2901;7020;3643;9411
310750;202208;1564;3410;1208;2914;89;260;754;1640;843;1900
310760;202208;842;1948;608;1591;38;103;401;1007;439;1110
310770;202208;1244;3163;868;2574;127;436;400;1026;527;1462
310780;202208;5038;10611;4112;9358;250;593;3066;6880;3316;7473
310790;202208;2161;6358;1861;5740;410;1449;446;1124;856;2573
310800;202208;2741;7704;1998;6237;470;1666;135;355;605;2021
310810;202208;1677;3692;1404;3270;52;166;1086;2373;1138;2539
310820;202208;1338;3225;833;2405;159;461;232;661;391;1122
310825;202208;3163;8034;2515;7037;58;282;2083;5579;2141;5861
310830;202208;2467;6243;1865;5186;341;1064;889;2236;1230;3300
310840;202208;2609;6606;1957;5513;392;1273;670;1619;1062;2892
310850;202208;1582;3993;1296;3574;42;187;966;2521;1008;2708
310855;202208;3764;9068;2957;7818;194;539;2140;5494;2334;6033
310860;202208;8090;21206;6579;18461;761;1950;3976;11268;4737;13218
310870;202208;1072;2421;851;2114;57;162;620;1478;677;1640
310880;202208;1066;2965;805;2403;94;293;471;1370;565;1663
310890;202208;2624;7089;1737;5337;350;1169;280;713;630;1882
310900;202208;4883;12755;3572;10102;633;2018;1537;3871;2170;5889
310910;202208;2556;5866;1812;4714;262;718;491;1150;753;1868
310920;202208;2252;5324;1709;4539;183;557;1103;2799;1286;3356
310925;202208;1307;2971;1033;2566;50;166;795;1858;845;2024
310930;202208;6506;15490;4587;12497;866;2390;2203;6189;3069;8579
310940;202208;8316;17156;6796;15066;242;665;5464;11621;5706;12286
310945;202208;1595;3730;1243;3160;152;434;748;1763;900;2197
310950;202208;2168;6082;1415;4417;240;861;399;1014;639;1875
310960;202208;831;2126;496;1450;78;240;128;344;206;584
310970;202208;1365;3853;965;3036;256;828;182;538;438;1366
310980;202208;392;849;219;560;22;60;114;270;136;330
310990;202208;1755;4243;1423;3701;164;486;877;2091;1041;2577
311000;202208;4960;12471;3751;10536;618;1948;2075;5373;2693;7321
311010;202208;1169;2880;960;2530;211;589;516;1319;727;1908
311020;202208;1364;3242;900;2460;67;210;500;1285;567;1495
311030;202208;2164;5039;1562;4058;352;1059;668;1581;1020;2640
311040;202208;338;978;262;821;70;238;63;177;133;415
311050;202208;3675;8597;2805;7313;423;1274;1436;3471;1859;4745
311060;202208;4118;9694;3074;7881;375;1114;1405;3201;1780;4315
311070;202208;2902;6545;2098;5347;263;849;1112;2530;1375;3379
311080;202208;1350;2780;1079;2380;42;137;851;1752;893;1889
311090;202208;2730;7845;2223;6942;468;1560;725;2197;1193;3757
311100;202208;2877;7630;1848;5636;368;1247;524;1359;892;2606
311110;202208;4490;8889;2440;5895;542;1263;603;1444;1145;2707
311115;202208;1676;3262;1405;2920;38;85;1213;2453;1251;2538
311120;202208;8289;20353;6347;16951;948;2817;2612;6002;3560;8819
311130;202208;2193;5393;1680;4695;142;485;997;2645;1139;3130
311140;202208;1838;4241;1429;3686;133;395;973;2432;1106;2827
311150;202208;1696;5022;1344;4365;176;652;721;2214;897;2866
311160;202208;4824;12700;3559;10478;631;2143;1515;4074;2146;6217
311170;202208;1081;2590;888;2341;59;179;561;1545;620;1724
311180;202208;1755;3618;1176;2793;178;416;673;1542;851;1958
311190;202208;1002;2673;743;2157;112;365;305;747;417;1112
311200;202208;2629;6559;1956;5305;344;1054;830;1911;1174;2965
311205;202208;1083;2857;883;2499;37;123;587;1553;624;1676
311210;202208;1231;3273;1090;3082;120;299;779;2277;899;2576
311220;202208;1003;2368;866;2131;29;101;661;1491;690;1592
311230;202208;9247;25585;6990;21096;1261;3887;2716;8172;3977;12059
311240;202208;1304;3063;1026;2676;162;488;556;1342;718;1830
311250;202208;1545;3970;1187;3352;217;668;450;1138;667;1806
311260;202208;3157;7253;2074;5447;261;785;1030;2344;1291;3129
311265;202208;1624;3588;1176;2896;43;133;900;2110;943;2243
311270;202208;3549;9557;3059;8793;182;734;2170;5923;2352;6657
311280;202208;1374;3477;799;2370;187;612;181;470;368;1082
311290;202208;2113;5957;1902;5542;112;366;1302;3716;1414;4082
311300;202208;5381;13358;4441;11824;196;653;3607;9355;3803;10008
311310;202208;657;1681;552;1499;36;102;362;933;398;1035
311320;202208;3699;10457;3214;9428;289;1054;1732;4542;2021;5596
311330;202208;7370;16273;5815;13950;538;1395;3388;7971;3926;9366
311340;202208;12750;32701;10115;28214;2205;6599;3406;8861;5611;15460
311350;202208;2777;6281;2010;4952;215;583;1058;2286;1273;2869
311360;202208;1309;2972;926;2447;242;698;376;986;618;1684
311370;202208;5602;12548;4122;10253;481;1385;2362;5430;2843;6815
311380;202208;462;1327;343;1088;56;185;176;545;232;730
311390;202208;2018;5705;1616;5180;708;2498;391;1090;1099;3588
311400;202208;1882;4757;1358;3794;231;701;417;928;648;1629
311410;202208;2237;6068;1801;5367;250;849;972;2735;1222;3584
311420;202208;1905;5120;1431;4256;296;958;484;1214;780;2172
311430;202208;5359;13130;3600;9816;495;1442;1540;3913;2035;5355
311440;202208;3576;9156;2794;7908;872;2704;622;1642;1494;4346
311450;202208;2549;7016;1725;5359;462;1599;387;948;849;2547
311455;202208;1254;2650;889;2132;104;257;528;1223;632;1480
311460;202208;671;1875;447;1400;85;309;103;258;188;567
311470;202208;585;1689;404;1304;97;350;63;195;160;545
311480;202208;1336;2947;1103;2612;87;205;855;2004;942;2209
311490;202208;310;874;237;734;40;150;104;282;144;432
311500;202208;566;1305;444;1124;39;115;279;665;318;780
311510;202208;4053;9444;2896;7554;302;911;1499;3510;1801;4421
311520;202208;766;1916;665;1732;56;177;421;1068;477;1245
311530;202208;10849;23459;7487;18369;1564;4405;2778;6169;4342;10574
311535;202208;1004;2540;731;2002;119;357;325;829;444;1186
311540;202208;612;1690;535;1561;66;215;388;1104;454;1319
311545;202208;2299;6055;1984;5567;92;302;1550;4287;1642;4589
311547;202208;2019;4126;1774;3788;39;87;1506;3103;1545;3190
311550;202208;3541;8841;2899;7758;419;1266;1338;3222;1757;4488
311560;202208;357;711;218;497;32;81;89;170;121;251
311570;202208;1741;3813;1219;3095;49;136;899;2323;948;2459
311580;202208;2676;4791;1878;3837;172;333;1316;2596;1488;2929
311590;202208;722;1728;603;1562;68;206;394;975;462;1181
311600;202208;1816;4061;1485;3622;185;523;1030;2415;1215;2938
311610;202208;2693;7432;2198;6527;135;475;1439;4084;1574;4559
311615;202208;4154;9964;3341;8679;132;445;2709;6778;2841;7223
311620;202208;666;1672;503;1406;66;200;296;785;362;985
311630;202208;1516;3901;1221;3301;106;303;768;2017;874;2320
311640;202208;897;2210;710;1923;105;311;379;948;484;1259
311650;202208;2233;5078;1795;4429;211;562;1113;2605;1324;3167
311660;202208;3603;9587;2678;7806;407;1343;788;1747;1195;3090
311670;202208;1920;4450;1432;3613;154;446;743;1783;897;2229
311680;202208;2647;6538;2041;5526;147;382;1440;3932;1587;4314
311690;202208;705;1349;510;1110;34;76;367;811;401;887
311700;202208;2413;5340;1851;4540;24;100;1549;3655;1573;3755
311710;202208;1824;4912;1348;4116;331;1093;463;1373;794;2466
311720;202208;496;1374;401;1201;50;166;219;642;269;808
311730;202208;5177;12058;3649;9261;840;2287;1580;3654;2420;5941
311740;202208;1147;2780;938;2488;75;153;729;1977;804;2130
311750;202208;4696;12734;3805;11182;319;1169;2520;6900;2839;8069
311760;202208;820;2128;633;1786;101;354;250;554;351;908
311770;202208;2608;6831;2044;5861;425;1340;814;2112;1239;3452
311780;202208;1719;4492;1272;3694;224;725;475;1200;699;1925
311783;202208;2740;6454;2245;5675;51;201;1854;4469;1905;4670
311787;202208;944;2550;730;2083;117;368;302;717;419;1085
311790;202208;1759;4621;1192;3559;234;806;366;956;600;1762
311800;202208;5855;16264;4648;13750;1012;3080;868;2023;1880;5103
311810;202208;1135;2983;914;2605;57;192;642;1754;699;1946
311820;202208;1105;2394;854;2034;63;177;599;1324;662;1501
311830;202208;10283;27191;7495;21476;2122;6338;1442;3907;3564;10245
311840;202208;4510;10246;3620;9010;266;708;2695;6643;2961;7351
311850;202208;401;968;313;816;11;43;222;545;233;588
311860;202208;85314;194629;67664;165522;7119;20020;43420;98360;50539;118380
311870;202208;2188;5425;1545;4338;262;885;675;1670;937;2555
311880;202208;7450;17592;6217;15893;443;1076;4573;11788;5016;12864
311890;202208;2152;4496;1691;3874;44;160;1347;2883;1391;3043
311900;202208;803;1893;606;1632;102;248;334;925;436;1173
311910;202208;5000;11589;3883;10127;689;1875;2025;5191;2714;7066
311920;202208;2606;5965;2104;5249;102;255;1520;3739;1622;3994
311930;202208;5428;11273;4116;9544;760;2029;2239;4650;2999;6679
311940;202208;18634;45124;13541;35878;1798;5211;6240;15081;8038;20292
311950;202208;2768;6649;2066;5433;185;538;1229;3204;1414;3742
311960;202208;578;1341;450;1150;50;153;227;511;277;664
311970;202208;488;1469;363;1173;75;278;93;249;168;527
311980;202208;534;1336;288;860;31;101;108;293;139;394
311990;202208;619;1400;401;1065;63;213;173;380;236;593
311995;202208;1104;2974;583;1786;36;133;89;172;125;305
312000;202208;944;2040;718;1720;35;92;530;1240;565;1332
312010;202208;1290;3045;1031;2654;50;173;745;1812;795;1985
312015;202208;1526;4001;1342;3707;56;230;1081;2877;1137;3107
312020;202208;2052;5842;1443;4479;257;872;342;900;599;1772
312030;202208;2540;5165;2172;4747;59;171;1989;4272;2048;4443
312040;202208;975;2675;694;2122;109;334;309;896;418;1230
312050;202208;1383;3943;1124;3477;221;855;421;1149;642;2004
312060;202208;1147;2602;730;2036;164;476;305;823;469;1299
312070;202208;1069;2819;754;2180;37;144;478;1263;515;1407
312080;202208;3371;7667;2621;6573;140;408;1792;4142;1932;4550
312083;202208;1246;2683;972;2287;52;169;783;1736;835;1905
312087;202208;3012;6755;2452;5932;90;221;1984;4763;2074;4984
312090;202208;13447;31991;10622;27573;1151;3549;6348;15228;7499;18777
312100;202208;1959;4938;1524;4219;126;415;949;2430;1075;2845
312110;202208;1142;3314;936;2894;163;612;432;1190;595;1802
312120;202208;1211;3132;847;2487;212;738;281;679;493;1417
312125;202208;2283;5180;1950;4729;99;293;1582;3679;1681;3972
312130;202208;1355;2977;1001;2412;74;224;562;1185;636;1409
312140;202208;857;2352;714;2061;150;468;318;838;468;1306
312150;202208;588;1440;499;1282;33;92;339;803;372;895
312160;202208;11256;27226;8745;23026;908;2804;4750;11408;5658;14212
312170;202208;1032;2454;790;2016;50;153;530;1293;580;1446
312180;202208;1636;3991;1337;3482;145;409;780;1915;925;2324
312190;202208;936;2321;731;1969;59;196;417;1020;476;1216
312200;202208;5642;13842;4423;11930;537;1450;2661;6953;3198;8403
312210;202208;1672;3278;1270;2734;45;127;1040;2152;1085;2279
312220;202208;1941;5388;1657;4885;165;501;1084;3195;1249;3696
312230;202208;22129;51929;16021;41442;3152;9244;5629;12083;8781;21327
312235;202208;2492;5430;2005;4766;162;395;1474;3370;1636;3765
312240;202208;915;2707;701;2270;146;484;213;673;359;1157
312245;202208;3754;7395;3210;6640;28;81;2952;5953;2980;6034
312247;202208;1263;2642;887;2089;113;277;550;1231;663;1508
312250;202208;1069;2674;677;1930;96;293;237;627;333;920
312260;202208;1196;2822;965;2477;55;192;759;1839;814;2031
312270;202208;840;2162;641;1762;29;109;380;928;409;1037
312280;202208;499;1368;399;1192;85;281;139;371;224;652
312290;202208;1094;2908;913;2619;158;512;338;871;496;1383
312300;202208;1273;3589;913;2753;206;692;214;496;420;1188
312310;202208;1163;3186;913;2691;122;435;471;1284;593;1719
312320;202208;2457;5799;1795;4693;382;973;497;1253;879;2226
312330;202208;1074;2803;880;2444;108;328;525;1378;633;1706
312340;202208;285;682;203;555;31;113;114;266;145;379
312350;202208;296;570;210;474;14;36;141;283;155;319
312352;202208;1746;5045;1537;4654;275;889;735;2385;1010;3274
312360;202208;3906;10281;2953;8545;586;1853;1215;3184;1801;5037
312370;202208;2432;5639;1971;4938;220;650;1254;2936;1474;3586
312380;202208;2578;5263;2129;4700;17;45;1852;3962;1869;4007
312385;202208;1493;3671;1154;3092;376;1013;293;828;669;1841
312390;202208;2264;5930;1685;4865;247;805;532;1313;779;2118
312400;202208;3596;9489;3056;8628;940;2846;887;2544;1827;5390
312410;202208;16946;40984;13996;36375;1653;4735;9090;22464;10743;27199
312420;202208;4730;11581;3876;10222;737;2177;1982;4942;2719;7119
312430;202208;10418;23463;8533;20324;251;806;6632;14977;6883;15783
312440;202208;1187;3476;998;3111;486;1580;194;582;680;2162
312450;202208;1570;4225;1205;3577;305;975;484;1404;789;2379
312460;202208;574;1283;420;1061;24;69;282;686;306;755
312470;202208;544;1291;336;924;49;143;102;238;151;381
312480;202208;1229;2869;895;2382;77;247;506;1248;583;1495
312490;202208;3052;6195;2430;5357;180;446;1585;3303;1765;3749
312500;202208;1253;2727;1051;2460;43;146;819;1856;862;2002
312510;202208;5567;13800;3871;10644;787;2141;1134;2881;1921;5022
312520;202208;424;985;334;848;54;173;212;500;266;673
312530;202208;795;1689;669;1541;33;87;487;1128;520;1215
312540;202208;1827;4621;1249;3533;145;406;706;1896;851;2302
312550;202208;965;2278;718;1834;40;113;464;1070;504;1183
312560;202208;2098;5142;1616;4380;102;316;1148;3059;1250;3375
312570;202208;3100;6661;2331;5706;421;988;1188;2970;1609;3958
312580;202208;736;1874;512;1419;46;158;257;638;303;796
312590;202208;1782;4764;1377;3972;139;479;815;2127;954;2606
312595;202208;2461;6458;2020;5785;272;714;1200;3632;1472;4346
312600;202208;1537;3515;990;2416;140;422;318;761;458;1183
312610;202208;8369;20030;5709;15251;857;2601;2127;4905;2984;7506
312620;202208;2916;6706;2226;5752;62;250;1821;4637;1883;4887
312630;202208;381;996;282;820;46;168;129;330;175;498
312640;202208;615;1600;459;1348;56;202;224;595;280;797
312650;202208;2422;5500;1700;4220;56;199;1284;2941;1340;3140
312660;202208;1556;3438;1201;2861;92;222;844;1893;936;2115
312670;202208;6991;15086;5879;13406;137;563;4813;10189;4950;10752
312675;202208;1416;3352;1159;2987;48;159;938;2352;986;2511
312680;202208;1838;4169;1641;3884;46;174;1470;3364;1516;3538
312690;202208;3418;6644;2569;5594;111;229;2023;4347;2134;4576
312695;202208;1209;2847;1019;2550;40;79;850;2093;890;2172
312700;202208;2393;6019;1738;4861;177;577;974;2551;1151;3128
312705;202208;1948;3748;1709;3429;10;38;1620;3214;1630;3252
312707;202208;1603;4175;1124;3320;51;213;760;2087;811;2300
312710;202208;8652;18865;5597;14226;1399;3488;1786;4682;3185;8170
312720;202208;1275;3098;983;2645;98;311;657;1653;755;1964
312730;202208;1826;4080;1311;3387;127;343;822;2052;949;2395
312733;202208;1529;3810;1149;3120;48;175;782;1954;830;2129
312735;202208;914;2184;710;1811;56;157;465;1087;521;1244
312737;202208;957;1949;688;1574;62;156;481;1053;543;1209
312738;202208;925;2141;669;1702;57;176;436;1007;493;1183
312740;202208;516;1257;327;943;71;215;88;188;159;403
312750;202208;1729;4566;1261;3716;156;548;616;1651;772;2199
312760;202208;2126;5835;1541;4671;235;734;612;1751;847;2485
312770;202208;53196;120653;34626;89396;5858;16714;13952;33427;19810;50141
312780;202208;3024;7901;2548;7127;296;867;1619;4403;1915;5270
312790;202208;277;631;139;399;6;18;32;55;38;73
312800;202208;6570;16412;5209;13964;569;1851;3055;7542;3624;9393
312810;202208;1879;4786;1248;3727;344;1094;412;1125;756;2219
312820;202208;2021;4933;1629;4272;95;266;1188;3041;1283;3307
312825;202208;1795;3522;1518;3172;39;89;1323;2698;1362;2787
312830;202208;3235;8480;2105;6282;460;1482;644;1728;1104;3210
312840;202208;1707;4128;1328;3512;129;402;738;1805;867;2207
312850;202208;1266;2562;930;2096;21;78;665;1338;686;1416
312860;202208;1251;3025;862;2427;211;630;277;683;488;1313
312870;202208;6995;17754;4487;13053;749;2294;1308;3409;2057;5703
312880;202208;1721;3986;1348;3387;187;434;700;1743;887;2177
312890;202208;2734;6147;2022;5018;129;313;1216;2892;1345;3205
312900;202208;1537;3602;1260;3242;115;348;788;2014;903;2362
312910;202208;1735;3076;1028;2168;147;301;553;1126;700;1427
312920;202208;1099;2794;785;2294;133;453;283;705;416;1158
312930;202208;2843;6370;2103;5285;360;933;1049;2657;1409;3590
312940;202208;1184;2952;940;2609;86;291;533;1373;619;1664
312950;202208;3909;8716;2789;7001;422;1231;1516;3475;1938;4706
312960;202208;2051;4957;1701;4434;100;222;1239;3341;1339;3563
312965;202208;1958;4753;1596;4198;158;394;1047;2757;1205;3151
312970;202208;1817;4701;1469;4167;140;504;902;2371;1042;2875
312980;202208;30253;76808;24526;66699;4439;12916;11532;29209;15971;42125
312990;202208;613;1419;422;1108;70;218;214;504;284;722
313000;202208;552;1462;420;1234;30;122;264;711;294;833
313005;202208;2877;7608;2400;6831;120;374;1760;4833;1880;5207
313010;202208;6743;16730;5455;14686;795;2408;3344;8579;4139;10987
313020;202208;1185;3431;900;2836;157;539;193;521;350;1060
313030;202208;1414;2960;999;2387;63;190;726;1635;789;1825
313040;202208;1012;2848;845;2532;33;144;548;1553;581;1697
313050;202208;2143;5476;1501;4517;241;830;439;1150;680;1980
313055;202208;2196;5367;1913;4964;524;1477;1093;2716;1617;4193
313060;202208;1218;2778;907;2248;206;597;218;491;424;1088
313065;202208;1942;5036;1708;4659;42;188;1432;3759;1474;3947
313070;202208;1043;2601;808;2210;84;246;424;1084;508;1330
313080;202208;445;1168;328;960;58;202;127;306;185;508
313090;202208;6382;15017;5305;13349;276;794;3804;9291;4080;10085
313100;202208;1558;3744;1236;3286;54;189;905;2301;959;2490
313110;202208;1764;4350;1265;3480;120;390;664;1638;784;2028
313115;202208;3445;8868;2758;7611;288;958;1622;4014;1910;4972
313120;202208;4349;9750;3175;8204;188;500;2196;5655;2384;6155
313130;202208;38284;90853;29157;74858;2869;8457;17257;40896;20126;49353
313140;202208;881;1749;598;1386;38;101;463;1048;501;1149
313150;202208;1624;4332;1185;3554;339;1147;209;525;548;1672
313160;202208;1600;3685;1234;3141;23;79;963;2340;986;2419
313170;202208;13425;35363;10082;29169;1667;5284;3957;10173;5624;15457
313180;202208;2928;7002;2202;5556;163;452;1524;3640;1687;4092
313190;202208;5339;14059;3947;11357;694;2192;1554;3985;2248;6177
313200;202208;1358;3227;1151;2871;27;90;957;2293;984;2383
313210;202208;4768;11770;3933;10465;428;1284;2526;6392;2954;7676
313220;202208;2187;5372;1477;4014;186;558;697;1639;883;2197
313230;202208;3309;8260;2685;7468;62;208;2191;6098;2253;6306
313240;202208;13101;29753;9238;23806;936;2982;5300;12391;6236;15373
313250;202208;7283;19812;5593;16277;1015;3080;2607;7123;3622;10203
313260;202208;930;2164;669;1752;74;270;380;846;454;1116
313270;202208;7759;15986;6480;14317;477;997;5194;11468;5671;12465
313280;202208;535;1362;361;1030;44;148;169;446;213;594
313290;202208;1188;3556;920;3064;221;828;331;1044;552;1872
313300;202208;2178;5480;1665;4607;361;1067;586;1440;947;2507
313310;202208;1692;4667;1356;3970;216;753;471;1096;687;1849
313320;202208;2333;5780;1669;4725;339;1033;606;1731;945;2764
313330;202208;4875;11545;3699;9811;255;769;2460;6359;2715;7128
313340;202208;1895;3889;1446;3277;88;246;1078;2321;1166;2567
313350;202208;3506;9018;2391;6654;260;859;1083;2563;1343;3422
313360;202208;1948;4409;1339;3453;217;662;701;1615;918;2277
313370;202208;1902;4810;1489;4031;300;861;597;1439;897;2300
313375;202208;2208;5457;1433;4054;247;815;421;1022;668;1837
313380;202208;8195;19115;5988;15148;862;2566;3119;6818;3981;9384
313390;202208;927;2660;793;2427;52;219;535;1543;587;1762
313400;202208;4406;9811;3392;8359;148;445;2591;6169;2739;6614
313410;202208;1652;3915;1230;3207;329;843;617;1565;946;2408
313420;202208;18410;39145;10393;26219;2474;6871;2339;5374;4813;12245
313430;202208;1399;3317;1167;2907;78;297;850;1902;928;2199
313440;202208;8171;15891;5925;13126;202;523;4627;9920;4829;10443
313450;202208;853;2136;613;1702;99;302;217;500;316;802
313460;202208;2698;7075;2155;6200;381;1222;1031;2844;1412;4066
313470;202208;3333;7678;2675;6729;134;407;2090;5141;2224;5548
313480;202208;1298;3478;816;2462;80;274;331;884;411;1158
313490;202208;3654;8776;2021;5806;368;1166;593;1561;961;2727
313500;202208;658;1605;467;1242;52;133;221;536;273;669
313505;202208;12089;28584;10257;26076;409;1172;8278;20728;8687;21900
313507;202208;1645;3844;1305;3325;46;153;1015;2484;1061;2637
313510;202208;17968;43920;14111;36728;1330;3809;8075;19224;9405;23033
313520;202208;18359;44140;14856;38485;659;2097;11568;28705;12227;30802
313530;202208;676;1907;503;1537;65;243;217;562;282;805
313535;202208;2704;6956;2168;5959;244;624;1315;3563;1559;4187
313540;202208;997;2669;793;2205;108;340;393;966;501;1306
313545;202208;1309;3964;1105;3581;145;506;575;1810;720;2316
313550;202208;2432;6436;2024;5529;223;651;1355;3595;1578;4246
313560;202208;3526;5858;2662;4846;39;76;2385;4274;2424;4350
313570;202208;1183;3124;956;2733;181;538;461;1239;642;1777
313580;202208;7206;15839;5707;13491;360;1023;4079;9117;4439;10140
313590;202208;1335;3282;1079;2921;213;582;570;1610;783;2192
313600;202208;5222;11465;4431;10308;83;309;3967;8933;4050;9242
313610;202208;1194;2764;979;2402;80;225;645;1460;725;1685
313620;202208;6685;16426;5419;14215;507;1609;3517;8727;4024;10336
313630;202208;10569;23834;7620;19476;753;2287;4705;11419;5458;13706
313640;202208;1539;2971;1035;2329;87;228;748;1639;835;1867
313650;202208;1925;5391;1509;4688;121;407;923;2914;1044;3321
313652;202208;1032;2677;911;2471;64;223;689;1751;753;1974
313655;202208;1381;3070;1080;2700;81;212;800;1958;881;2170
313657;202208;1322;3211;1034;2753;35;136;761;1862;796;1998
313660;202208;1340;3216;1115;2853;67;246;840;2000;907;2246
313665;202208;6645;15851;5300;13536;416;1284;3632;8567;4048;9851
313670;202208;65060;149147;44651;115617;5626;16144;22800;54727;28426;70871
313680;202208;1263;2966;1025;2592;51;129;698;1667;749;1796
313690;202208;1146;3223;832;2603;161;556;232;667;393;1223
313695;202208;2119;5165;1571;4270;110;297;1055;2914;1165;3211
313700;202208;3327;9457;2867;8869;233;758;2296;7115;2529;7873
313710;202208;1713;3605;1231;2983;96;269;826;1948;922;2217
313720;202208;7356;18728;5365;14756;713;2171;2512;6130;3225;8301
313730;202208;1668;3278;1250;2738;85;173;826;1784;911;1957
313740;202208;1928;6527;1623;5795;360;1461;407;1270;767;2731
313750;202208;2685;6391;2155;5530;324;973;1274;2958;1598;3931
313753;202208;2502;5790;1673;4462;278;846;691;1729;969;2575
313760;202208;7028;17978;5581;15322;838;2596;2820;6975;3658;9571
313770;202208;4743;12325;3758;10799;186;526;2850;8291;3036;8817
313780;202208;4766;11568;3529;9656;454;1214;1198;3308;1652;4522
313790;202208;672;1799;575;1614;67;214;356;939;423;1153
313800;202208;1604;3359;1174;2771;106;292;683;1488;789;1780
313810;202208;2044;4521;1659;3987;60;203;1338;3095;1398;3298
313820;202208;20640;49769;13658;35531;2254;6105;4095;9708;6349;15813
313830;202208;475;1297;345;1026;65;224;146;395;211;619
313835;202208;1133;2868;859;2433;88;309;465;1172;553;1481
313840;202208;9518;22945;7529;19829;1721;4759;2142;5490;3863;10249
313850;202208;1168;2609;924;2273;153;426;489;1089;642;1515
313860;202208;3293;7948;2504;6588;328;975;1271;3001;1599;3976
313862;202208;1400;2912;722;1919;45;129;361;959;406;1088
313865;202208;3086;7262;2548;6434;84;255;1964;4732;2048;4987
313867;202208;1627;4594;1297;3963;250;787;680;2144;930;2931
313868;202208;1986;5460;1603;4769;59;228;1216;3445;1275;3673
313870;202208;1245;2981;835;2256;99;296;376;903;475;1199
313880;202208;2485;5955;1877;4943;213;682;1045;2424;1258;3106
313890;202208;2868;5198;2112;4245;65;146;1659;3204;1724;3350
313900;202208;6181;16100;4355;12474;1055;3267;1315;3205;2370;6472
313910;202208;889;2436;678;2027;132;421;162;474;294;895
313920;202208;3336;9119;2743;7953;468;1413;1432;4113;1900;5526
313925;202208;1976;4518;1556;3806;177;390;992;2379;1169;2769
313930;202208;5945;15015;4774;13056;347;999;3250;8734;3597;9733
313940;202208;11771;31766;9064;27286;1787;5808;2281;7339;4068;13147
313950;202208;6660;13122;5174;11299;250;622;3827;8165;4077;8787
313960;202208;6874;15308;4634;11654;707;2082;1968;4274;2675;6356
313970;202208;1852;4436;1570;3991;52;147;1072;2586;1124;2733
313980;202208;1644;4026;1155;3288;196;634;524;1385;720;2019
313990;202208;2540;6928;1977;5791;290;1074;1143;2890;1433;3964
314000;202208;12519;28795;10083;24766;675;2037;6633;15743;7308;17780
314010;202208;1614;3558;1265;3081;52;175;962;2224;1014;2399
314015;202208;2655;6630;2112;5708;222;735;1282;3156;1504;3891
314020;202208;597;1515;400;1183;134;481;43;117;177;598
314030;202208;949;2502;729;2085;105;308;326;902;431;1210
314040;202208;738;1889;620;1683;86;282;342;873;428;1155
314050;202208;2306;5575;1718;4545;103;335;1089;2626;1192;2961
314053;202208;2433;6393;1961;5512;301;786;1165;3377;1466;4163
314055;202208;2730;6167;2295;5557;87;232;1870;4534;1957;4766
314060;202208;1526;3699;1138;3080;39;127;812;2139;851;2266
314070;202208;5956;14623;4812;12673;680;1896;2703;6742;3383;8638
314080;202208;2349;5738;1695;4663;149;474;807;1972;956;2446
314085;202208;2801;6837;2239;6018;236;658;1433;3809;1669;4467
314090;202208;5976;14168;5133;12967;443;1116;3393;8752;3836;9868
314100;202208;3503;7932;2702;6830;67;194;2006;5054;2073;5248
314110;202208;5900;15262;4810;13276;527;1628;2671;6695;3198;8323
314120;202208;814;1802;387;1052;77;239;137;328;214;567
314130;202208;797;1948;555;1508;24;89;375;953;399;1042
314140;202208;5514;13638;4391;11657;445;1323;2537;6365;2982;7688
314150;202208;1695;3988;1217;3178;94;271;802;2023;896;2294
314160;202208;2812;6515;2014;5190;210;568;951;2361;1161;2929
314170;202208;1116;2792;888;2352;40;146;619;1491;659;1637
314180;202208;6604;16260;5234;14147;515;1384;2968;7936;3483;9320
314190;202208;735;1683;552;1427;66;213;332;785;398;998
314200;202208;3461;8956;2857;7973;253;696;1882;5136;2135;5832
314210;202208;2353;5714;1825;4792;289;786;688;1689;977;2475
314220;202208;1930;4886;1539;4280;211;697;751;1892;962;2589
314225;202208;1231;3308;987;2856;104;317;634;1772;738;2089
314230;202208;1050;2510;841;2217;81;233;552;1422;633;1655
314240;202208;1266;3214;989;2811;216;634;416;1168;632;1802
314250;202208;499;1374;319;979;41;135;130;350;171;485
314260;202208;1308;3116;1040;2758;270;715;448;1127;718;1842
314270;202208;3886;9795;3205;8716;93;306;2440;6470;2533;6776
314280;202208;4223;9200;2943;7342;300;849;1774;4096;2074;4945
314290;202208;5394;12533;4540;11102;254;684;3339;7817;3593;8501
314300;202208;2367;6265;1519;4483;314;993;485;1263;799;2256
314310;202208;4498;11245;3120;8956;907;2913;444;1102;1351;4015
314315;202208;1163;3280;938;2827;62;228;647;1867;709;2095
314320;202208;3852;9607;2604;7314;404;1330;1092;2743;1496;4073
314330;202208;64515;169527;49669;143681;11684;34605;13932;39541;25616;74146
314340;202208;3055;7231;2035;5456;375;1191;743;1644;1118;2835
314345;202208;1850;4670;1503;4078;114;306;1075;2810;1189;3116
314350;202208;1006;2607;685;2025;134;434;155;324;289;758
314360;202208;629;1724;431;1306;61;192;142;378;203;570
314370;202208;878;2096;712;1844;67;195;483;1189;550;1384
314380;202208;1373;3522;964;2835;209;700;303;838;512;1538
314390;202208;18184;41943;12846;32979;1773;5187;5656;12517;7429;17704
314400;202208;4697;13124;3627;11087;1119;3608;1198;3772;2317;7380
314410;202208;3481;9245;2418;7200;493;1682;570;1604;1063;3286
314420;202208;906;2077;669;1713;28;90;437;1051;465;1141
314430;202208;9523;20918;6847;16736;952;2442;3461;7993;4413;10435
314435;202208;2187;5435;1719;4702;270;766;944;2468;1214;3234
314437;202208;1044;2430;766;1990;70;196;477;1192;547;1388
314440;202208;691;1882;497;1503;133;456;124;301;257;757
314450;202208;1720;4191;1416;3696;196;553;777;1859;973;2412
314460;202208;3997;11139;3035;9242;732;2431;1079;2909;1811;5340
314465;202208;2724;6939;2213;6006;48;194;1734;4464;1782;4658
314467;202208;1134;2686;926;2354;89;255;637;1554;726;1809
314470;202208;2614;6941;2164;6094;348;1056;1066;2798;1414;3854
314480;202208;9806;25169;7505;20555;1077;3293;3427;8280;4504;11573
314490;202208;1250;3000;904;2353;69;201;595;1479;664;1680
314500;202208;2157;4843;1550;4047;393;1019;499;1309;892;2328
314505;202208;2651;5486;2170;4837;136;253;1655;3608;1791;3861
314510;202208;2461;6060;1794;5079;472;1517;703;1853;1175;3370
314520;202208;7797;21873;6236;18875;1321;4303;1542;4181;2863;8484
314530;202208;6476;17914;5777;16688;308;1138;4411;12231;4719;13369
314535;202208;3305;7321;2665;6415;135;382;2136;5049;2271;5431
314537;202208;1423;3631;1082;3085;77;210;734;2031;811;2241
314540;202208;496;1149;361;939;15;41;215;512;230;553
314545;202208;2280;4822;2032;4537;56;140;1722;3871;1778;4011
314550;202208;875;1969;592;1523;42;139;341;768;383;907
314560;202208;5656;15253;4269;12375;545;1912;1945;4841;2490;6753
314570;202208;361;956;258;773;23;77;131;384;154;461
314580;202208;558;1540;446;1321;100;297;160;457;260;754
314585;202208;809;2262;617;1868;56;187;295;825;351;1012
314587;202208;2622;6473;2042;5561;568;1489;1019;2775;1587;4264
314590;202208;5132;12762;3945;10693;461;1423;2016;4986;2477;6409
314600;202208;2178;5672;1408;4263;324;1071;179;471;503;1542
314610;202208;11241;26231;8671;22258;1011;3118;4298;11037;5309;14155
314620;202208;2894;5853;2356;5183;137;249;1906;4240;2043;4489
314625;202208;1841;4300;1561;3919;31;147;1343;3251;1374;3398
314630;202208;6057;13882;4869;12253;183;533;3934;9754;4117;10287
314640;202208;943;1932;727;1608;42;124;533;1078;575;1202
314650;202208;1010;2217;680;1700;62;195;421;934;483;1129
314655;202208;1742;4430;1224;3551;164;462;647;1869;811;2331
314660;202208;410;833;300;658;13;31;225;466;238;497
314670;202208;1916;3940;1337;3151;28;77;954;2145;982;2222
314675;202208;1957;4600;1652;4120;92;238;1289;3143;1381;3381
314690;202208;2391;6096;1828;5256;464;1331;728;2050;1192;3381
314700;202208;13714;34979;9531;27477;1509;4762;4308;11567;5817;16329
314710;202208;9868;25868;7341;20710;1084;3402;2956;7226;4040;10628
314720;202208;2724;7628;1907;5926;367;1235;392;1049;759;2284
314730;202208;2906;7149;2050;5610;367;1123;729;1745;1096;2868
314740;202208;3766;9703;2974;8340;486;1458;1552;4075;2038;5533
314750;202208;352;862;275;711;35;110;163;368;198;478
314760;202208;2159;5962;1388;4268;220;812;422;979;642;1791
314770;202208;1185;3267;697;2123;121;363;188;529;309;892
314780;202208;417;987;293;792;29;100;170;415;199;515
314790;202208;14189;35237;10223;28195;1654;5065;4455;11544;6109;16609
314795;202208;1759;4177;1492;3750;56;197;1177;2802;1233;2999
314800;202208;13549;32717;9110;24852;1512;4533;3282;7798;4794;12331
314810;202208;12212;29766;9242;24856;2268;6456;3560;8982;5828;15438
314820;202208;1521;3386;1191;2902;74;225;766;1766;840;1991
314830;202208;2045;5254;1685;4651;168;463;1021;2674;1189;3137
314840;202208;1034;2889;807;2484;64;255;555;1604;619;1859
314850;202208;3080;5555;2543;4908;31;76;2347;4463;2378;4539
314860;202208;3910;10028;3263;8909;140;527;2414;6295;2554;6822
314870;202208;8203;16450;6333;14203;283;614;4876;11020;5159;11634
314875;202208;2162;5942;1903;5585;211;530;1424;4235;1635;4765
314880;202208;938;2168;722;1835;48;137;454;1104;502;1241
314890;202208;577;1639;429;1320;57;196;202;546;259;742
314900;202208;1030;2371;797;1992;87;258;431;1012;518;1270
314910;202208;1977;5243;1473;4423;252;900;697;1907;949;2807
314915;202208;2488;6659;2024;5861;192;565;1284;3682;1476;4247
314920;202208;662;1528;471;1262;21;66;338;890;359;956
314930;202208;7221;18773;5614;15800;890;2852;2577;6446;3467;9298
314940;202208;490;1071;401;933;26;61;291;641;317;702
314950;202208;768;1775;539;1416;54;183;302;714;356;897
314960;202208;1106;2380;871;2018;64;158;626;1394;690;1552
314970;202208;1280;3553;989;2980;161;534;440;1200;601;1734
314980;202208;2263;5319;1791;4640;179;525;1218;3064;1397;3589
314990;202208;3178;8640;2304;6745;379;1157;640;1635;1019;2792
314995;202208;1960;4979;1522;4216;54;199;999;2578;1053;2777
315000;202208;1302;3049;934;2480;87;253;603;1540;690;1793
315010;202208;472;1180;381;1044;38;136;230;588;268;724
315015;202208;2885;7249;2517;6657;233;740;1782;4515;2015;5255
315020;202208;938;2529;670;2003;63;234;331;891;394;1125
315030;202208;769;1862;529;1447;176;470;120;295;296;765
315040;202208;1146;2789;961;2503;165;468;598;1442;763;1910
315050;202208;1374;3286;1022;2757;84;258;536;1377;620;1635
315053;202208;1446;3349;1078;2733;106;301;641;1520;747;1821
315057;202208;2138;5584;1692;4839;140;335;1093;3320;1233;3655
315060;202208;805;2234;590;1805;113;376;158;447;271;823
315070;202208;911;1923;717;1630;86;240;468;926;554;1166
315080;202208;3822;9365;2934;7808;135;433;2140;5369;2275;5802
315090;202208;963;2648;730;2230;98;330;338;940;436;1270
315100;202208;1673;4574;1112;3365;138;497;499;1322;637;1819
315110;202208;2602;5650;1908;4642;160;372;1117;2662;1277;3034
315120;202208;15154;32431;11222;26652;1153;2634;6805;15947;7958;18581
315130;202208;2025;5134;1720;4620;187;584;859;2079;1046;2663
315140;202208;3704;9428;2960;8167;574;1734;1549;3962;2123;5696
315150;202208;5173;12212;3744;9937;569;1747;1801;4568;2370;6315
315160;202208;2296;5128;1594;4050;249;677;861;2085;1110;2762
315170;202208;1593;4783;1135;3713;223;762;338;1061;561;1823
315180;202208;20868;48452;12399;33394;1670;5143;4688;10849;6358;15992
315190;202208;2674;5462;2031;4621;200;431;1511;3456;1711;3887
315200;202208;5394;13676;4069;11510;1107;3426;1425;3640;2532;7066
315210;202208;10491;25388;7448;19439;759;2226;3772;8612;4531;10838
315213;202208;1234;3056;1073;2831;25;98;882;2254;907;2352
315217;202208;3180;8346;2412;7075;103;442;1702;4720;1805;5162
315220;202208;10038;25276;7853;21639;635;1606;4402;12229;5037;13835
315230;202208;3528;7230;2894;6398;191;358;1949;4421;2140;4779
315240;202208;2943;7726;2431;6859;538;1595;1150;3187;1688;4782
315250;202208;17433;43610;13065;35670;1944;5854;6052;15027;7996;20881
315260;202208;1136;2876;663;1934;135;405;77;178;212;583
315270;202208;1126;2996;846;2474;128;431;359;893;487;1324
315280;202208;3643;8620;2424;6515;649;1826;571;1491;1220;3317
315290;202208;1411;3258;891;2457;197;590;348;897;545;1487
315300;202208;794;1801;589;1497;31;91;426;1058;457;1149
315310;202208;1521;3528;1166;2940;86;264;811;1847;897;2111
315320;202208;746;2062;527;1631;70;259;208;596;278;855
315330;202208;871;2618;523;1759;62;233;216;627;278;860
315340;202208;3377;7771;2334;6191;539;1422;929;2414;1468;3836
315350;202208;2170;5060;1821;4540;164;466;1328;3174;1492;3640
315360;202208;2045;5496;1608;4657;215;660;766;2040;981;2700
315370;202208;657;1704;531;1474;82;224;236;616;318;840
315380;202208;298;774;204;579;42;114;26;47;68;161
315390;202208;1453;3805;1181;3333;118;414;688;1720;806;2134
315400;202208;4917;12035;3923;10344;461;1346;2376;5874;2837;7220
315410;202208;2816;5980;2051;4867;377;1026;548;1214;925;2240
315415;202208;1744;4433;1412;3903;377;1230;350;869;727;2099
315420;202208;1774;4650;1260;3724;277;891;346;877;623;1768
315430;202208;4235;9705;2975;7860;487;1439;1462;3695;1949;5134
315440;202208;1219;2895;952;2484;86;262;599;1429;685;1691
315445;202208;2623;5283;1953;4380;105;265;1570;3437;1675;3702
315450;202208;2622;6536;2130;5749;207;578;1416;3674;1623;4252
315460;202208;53019;130783;44737;116792;4472;14081;29262;70430;33734;84511
315470;202208;799;2080;569;1557;51;150;289;719;340;869
315480;202208;1650;4271;1213;3369;179;535;560;1406;739;1941
315490;202208;3393;7908;2375;6297;337;958;963;2353;1300;3311
315500;202208;614;1551;390;1103;28;88;220;550;248;638
315510;202208;1635;3667;1344;3265;10;47;1172;2743;1182;2790
315520;202208;1286;3009;1081;2706;40;117;898;2170;938;2287
315530;202208;883;2049;738;1811;67;206;552;1256;619;1462
315540;202208;1943;4766;1307;3590;125;422;574;1439;699;1861
315550;202208;2123;5409;1461;4200;265;896;466;1321;731;2217
315560;202208;7718;20579;6649;18746;380;1055;4884;13558;5264;14613
315570;202208;2928;6941;2102;5490;269;850;1123;2561;1392;3411
315580;202208;3822;8162;3011;6941;426;1065;1331;2826;1757;3891
315590;202208;1444;2871;1197;2519;42;160;966;1825;1008;1985
315600;202208;2867;8100;2018;6477;439;1313;882;3026;1321;4339
315610;202208;1144;2679;866;2215;117;391;442;947;559;1338
315620;202208;613;1516;462;1289;44;135;243;673;287;808
315630;202208;1301;3238;988;2670;143;431;509;1235;652;1666
315640;202208;454;1039;351;911;31;99;227;546;258;645
315645;202208;1152;2814;806;2275;141;421;227;613;368;1034
315650;202208;2083;4347;1683;3798;67;152;1344;2960;1411;3112
315660;202208;2422;5845;1828;4791;178;479;1110;2805;1288;3284
315670;202208;18816;46294;14744;39114;2407;6921;7645;18757;10052;25678
315680;202208;3677;9554;2761;7911;359;1134;1446;3923;1805;5057
315690;202208;4481;10378;2709;7369;537;1402;799;2247;1336;3649
315700;202208;10246;25374;7842;20817;757;2279;4459;10796;5216;13075
315710;202208;2115;4788;1520;3923;67;210;1043;2563;1110;2773
315720;202208;5120;12979;4201;11403;198;783;3002;7663;3200;8446
315725;202208;2694;6271;2118;5397;199;486;1410;3721;1609;4207
315727;202208;691;1642;504;1326;59;189;268;637;327;826
315730;202208;720;2011;607;1793;127;404;231;606;358;1010
315733;202208;1710;3981;1325;3382;194;563;631;1436;825;1999
315737;202208;1371;3466;1007;2776;33;120;711;1856;744;1976
315740;202208;979;2550;796;2188;75;256;530;1341;605;1597
315750;202208;1540;3599;1187;3082;86;227;777;2015;863;2242
315760;202208;1441;2970;1190;2640;28;104;1020;2160;1048;2264
315765;202208;2353;5292;1935;4764;23;85;1746;4270;1769;4355
315770;202208;1421;3672;1141;3286;413;1267;263;742;676;2009
315780;202208;36917;92746;30902;82278;1981;6507;20972;52208;22953;58715
315790;202208;4099;11713;3484;10575;339;1027;2066;6567;2405;7594
315800;202208;1549;4698;1177;3869;156;609;491;1382;647;1991
315810;202208;1614;3552;1347;3131;60;166;1086;2414;1146;2580
315820;202208;3496;7781;2843;6925;258;608;2066;4986;2324;5594
315830;202208;1457;4071;991;3048;104;350;283;709;387;1059
315840;202208;1022;2291;739;1821;44;127;417;916;461;1043
315850;202208;1393;3706;1095;3216;150;474;596;1664;746;2138
315860;202208;643;1658;476;1379;91;282;161;374;252;656
315870;202208;530;1368;422;1198;24;82;300;810;324;892
315880;202208;1338;3081;975;2480;118;361;437;935;555;1296
315890;202208;2113;5449;1724;4921;467;1419;747;2145;1214;3564
315895;202208;7514;19039;5624;15485;598;1899;2828;7034;3426;8933
315900;202208;950;2360;780;2104;97;315;475;1194;572;1509
315910;202208;690;1656;595;1521;54;158;462;1155;516;1313
315920;202208;1631;3909;955;2672;162;567;346;806;508;1373
315930;202208;1322;2727;909;2164;85;216;511;1140;596;1356
315935;202208;1267;3446;1013;2977;203;601;431;1249;634;1850
315940;202208;719;1781;566;1564;88;268;298;758;386;1026
315950;202208;1401;3564;1182;3229;102;329;929;2466;1031;2795
315960;202208;6686;17424;4680;13529;1100;3544;1104;2323;2204;5867
315970;202208;656;1662;527;1488;64;198;361;1022;425;1220
315980;202208;5130;10384;3018;7065;510;1286;1486;3081;1996;4367
315990;202208;4053;9808;3185;8344;358;996;1765;4370;2123;5366
316000;202208;895;1924;715;1671;59;166;471;1030;530;1196
316010;202208;859;2253;636;1855;73;231;282;680;355;911
316020;202208;1082;2823;865;2424;88;300;542;1405;630;1705
316030;202208;3243;8066;2473;6734;374;1033;1485;4066;1859;5099
316040;202208;3114;8468;2213;6767;397;1388;590;1504;987;2892
316045;202208;2701;5607;2484;5340;154;213;2168;4770;2322;4983
316050;202208;460;1184;360;1022;45;114;205;539;250;653
316060;202208;858;1860;635;1567;32;104;466;1090;498;1194
316070;202208;6789;17102;5510;14748;821;2225;2854;7216;3675;9441
316080;202208;917;2647;721;2250;163;558;167;440;330;998
316090;202208;570;1432;475;1259;41;141;308;723;349;864
316095;202208;1481;4290;1142;3474;264;876;454;1265;718;2141
316100;202208;2836;7550;2095;6044;317;1055;901;2294;1218;3349
316105;202208;827;2024;655;1750;45;123;433;1169;478;1292
316110;202208;17016;41784;14138;37192;861;2765;10408;26079;11269;28844
316120;202208;1456;3679;935;2597;152;478;353;769;505;1247
316130;202208;1526;3191;1024;2399;75;214;652;1415;727;1629
316140;202208;1265;3206;767;2263;140;421;280;799;420;1220
316150;202208;2596;5406;2068;4646;140;397;1224;2528;1364;2925
316160;202208;1168;2867;931;2459;39;140;678;1726;717;1866
316165;202208;1053;2311;832;1994;80;205;559;1270;639;1475
316170;202208;1555;3332;1205;2842;70;226;883;1910;953;2136
316180;202208;1829;4805;1310;3841;245;781;360;931;605;1712
316190;202208;3125;8363;1804;5299;233;721;744;1867;977;2588
316200;202208;4322;11046;3434;9576;644;1966;1530;3985;2174;5951
316210;202208;6331;17387;4529;13271;1465;4668;507;1268;1972;5936
316220;202208;823;2328;573;1842;112;373;120;382;232;755
316225;202208;1925;3967;1469;3278;49;186;1162;2350;1211;2536
316230;202208;580;1421;450;1208;98;290;217;552;315;842
316240;202208;6640;17320;5780;15817;446;1315;4239;11300;4685;12615
316245;202208;3788;10626;3413;10040;164;751;2699;7510;2863;8261
316250;202208;12996;29327;9841;24244;1854;4851;4020;9658;5874;14509
316255;202208;3496;9032;3017;8267;143;395;2232;6148;2375;6543
316257;202208;1749;3705;1303;3012;105;240;892;1965;997;2205
316260;202208;3099;6267;2439;5292;263;549;1546;3288;1809;3837
316265;202208;1303;3261;1026;2797;31;88;755;1978;786;2066
316270;202208;4374;12308;3715;10945;444;1395;2082;5735;2526;7130
316280;202208;3539;8883;2966;7868;352;1025;1734;4385;2086;5410
316290;202208;4639;11560;3624;9695;446;1318;1535;3751;1981;5069
316292;202208;7061;17165;5717;15054;628;1829;3789;9464;4417;11293
316294;202208;1071;2990;824;2580;152;555;255;703;407;1258
316295;202208;4109;10605;3373;9396;250;816;2207;5788;2457;6604
316300;202208;1250;3106;978;2695;60;176;700;1881;760;2057
316310;202208;930;2358;646;1865;139;464;206;531;345;995
316320;202208;788;2072;600;1771;117;374;142;363;259;737
316330;202208;1237;2930;950;2455;62;165;714;1805;776;1970
316340;202208;1193;2950;917;2479;75;283;599;1482;674;1765
316350;202208;1613;3993;1360;3581;171;460;928;2363;1099;2823
316360;202208;762;1853;644;1666;63;156;495;1306;558;1462
316370;202208;6914;16217;5355;13642;611;1909;2937;6466;3548;8375
316380;202208;2015;4396;1606;3824;88;189;1159;2715;1247;2904
316390;202208;873;2238;651;1867;258;840;131;316;389;1156
316400;202208;1380;3649;906;2752;106;353;346;916;452;1269
316410;202208;1439;3387;1203;3034;43;140;1009;2449;1052;2589
316420;202208;2283;5651;1934;5161;33;144;1586;4058;1619;4202
316430;202208;1039;2577;719;2032;107;341;295;746;402;1087
316440;202208;1008;2908;816;2571;154;552;240;681;394;1233
316443;202208;665;1730;473;1369;108;360;136;365;244;725
316447;202208;2557;5856;2190;5313;27;92;1950;4611;1977;4703
316450;202208;2475;6694;1870;5508;212;687;1130;3213;1342;3900
316460;202208;1538;3758;1259;3305;120;350;822;2012;942;2362
316470;202208;8604;22757;6470;18619;886;2962;2995;7611;3881;10573
316480;202208;240;585;204;539;37;103;122;302;159;405
316490;202208;392;1033;282;825;53;181;96;238;149;419
316500;202208;1515;4343;1043;3253;205;672;270;744;475;1416
316510;202208;944;2829;768;2489;131;425;383;1228;514;1653
316520;202208;1626;3707;1234;3027;183;515;555;1180;738;1695
316530;202208;1255;3048;927;2483;102;367;468;1106;570;1473
316540;202208;1227;2834;987;2498;149;435;487;1098;636;1533
316550;202208;1687;4295;1420;3835;49;176;1161;3059;1210;3235
316553;202208;5560;14946;4108;11712;539;1722;1900;4670;2439;6392
316555;202208;3099;8441;2687;7906;79;301;2278;6601;2357;6902
316556;202208;633;1394;474;1127;35;101;287;570;322;671
316557;202208;1377;3839;1191;3562;412;1344;441;1254;853;2598
316560;202208;476;1336;337;1068;51;186;133;380;184;566
316570;202208;1661;4344;1394;3887;330;850;472;1423;802;2273
316580;202208;471;919;323;691;32;75;195;387;227;462
316590;202208;1533;3589;1064;2729;172;393;576;1417;748;1810
316600;202208;1146;3063;991;2776;145;452;608;1604;753;2056
316610;202208;737;2023;593;1793;60;219;360;1036;420;1255
316620;202208;2642;6059;2309;5572;152;342;1839;4392;1991;4734
316630;202208;1804;4986;1510;4448;399;1131;593;1992;992;3123
316640;202208;191;488;153;428;32;107;63;141;95;248
316650;202208;1287;3414;1046;3048;72;236;713;1991;785;2227
316660;202208;212;495;99;268;13;39;30;62;43;101
316670;202208;1948;4601;1466;3872;397;1088;483;1162;880;2250
316680;202208;2730;6540;2057;5313;159;467;1419;3526;1578;3993
316690;202208;1607;4307;1191;3541;207;684;342;887;549;1571
316695;202208;1123;3073;908;2694;20;75;608;1743;628;1818
316700;202208;560;1017;479;931;12;27;424;793;436;820
316710;202208;3951;11371;3155;9821;418;1508;1737;5013;2155;6521
316720;202208;25040;63536;19326;53099;2898;8639;9566;24338;12464;32977
316730;202208;628;1393;502;1194;55;143;286;596;341;739
316740;202208;991;2543;869;2359;114;339;601;1611;715;1950
316750;202208;470;1231;347;1031;60;193;150;400;210;593
316760;202208;4583;13041;3901;11792;1311;4370;1495;4386;2806;8756
316770;202208;1873;3826;1413;3230;39;98;1137;2618;1176;2716
316780;202208;700;1886;573;1670;212;696;129;290;341;986
316790;202208;879;2192;655;1766;87;258;214;539;301;797
316800;202208;7798;19992;6235;17343;769;2346;3231;8564;4000;10910
316805;202208;1359;2534;1108;2252;33;92;951;1875;984;1967
316810;202208;845;2117;632;1742;78;234;424;1143;502;1377
316820;202208;427;897;261;629;17;62;164;349;181;411
316830;202208;1031;2460;806;2104;83;221;510;1301;593;1522
316840;202208;3507;7971;2838;6938;153;473;2224;5164;2377;5637
316850;202208;2622;5945;2005;4945;179;529;1270;2842;1449;3371
316860;202208;26473;60801;20140;51418;2575;7725;10856;25837;13431;33562
316870;202208;10233;25161;7761;20668;908;2778;4176;9979;5084;12757
316880;202208;1256;3012;1059;2744;115;360;684;1626;799;1986
316890;202208;1363;2947;852;2276;104;338;538;1353;642;1691
316900;202208;2981;7288;2369;6210;398;1108;1046;2468;1444;3576
316905;202208;573;1605;466;1403;158;475;155;494;313;969
316910;202208;1195;2888;830;2282;221;660;226;575;447;1235
316920;202208;2277;4867;1705;4038;193;561;1142;2456;1335;3017
316930;202208;10927;28369;8623;24481;1703;5371;3666;9275;5369;14646
316935;202208;5138;12611;3848;10277;623;1854;1809;4363;2432;6217
316940;202208;7510;20394;5859;17182;884;2863;2671;7107;3555;9970
316950;202208;2325;4833;1800;4138;53;121;1530;3459;1583;3580
316960;202208;6247;12755;4573;10570;379;955;3267;7310;3646;8265
316970;202208;4835;12086;4088;10849;541;1542;2039;4962;2580;6504
316980;202208;939;2484;713;2132;215;728;239;665;454;1393
316990;202208;15372;38062;11645;30960;2622;7446;2734;6320;5356;13766
317000;202208;3050;7783;2662;7269;210;477;2015;5607;2225;6084
317005;202208;3062;7893;2401;6611;342;1034;1324;3448;1666;4482
317010;202208;32504;72581;22414;57434;3611;10046;11383;28145;14994;38191
317020;202208;84883;191860;53992;139426;9888;27801;20118;46645;30006;74446
317030;202208;794;1950;635;1728;16;60;479;1269;495;1329
317040;202208;13597;32185;9450;25312;2219;6386;2948;7975;5167;14361
317043;202208;1088;2182;801;1804;41;104;629;1376;670;1480
317047;202208;1336;2933;931;2302;55;165;665;1560;720;1725
317050;202208;1413;4140;1018;3248;149;555;396;1034;545;1589
317052;202208;2980;7116;2381;6204;204;585;1673;4179;1877;4764
317057;202208;2513;4987;1926;4146;36;108;1528;3084;1564;3192
317060;202208;578;1494;350;1028;47;149;135;343;182;492
317065;202208;1278;3513;1047;3064;78;272;654;1753;732;2025
317070;202208;9178;24319;7153;20530;1086;3529;3192;8363;4278;11892
317075;202208;1235;2920;946;2447;110;308;550;1307;660;1615
317080;202208;7816;16975;5967;14078;1133;2852;2932;6612;4065;9464
317090;202208;5557;14512;4872;13445;281;765;3656;10011;3937;10776
317100;202208;3076;6937;2076;5338;407;1086;912;2206;1319;3292
317103;202208;2839;6277;2413;5686;119;403;1976;4406;2095;4809
317107;202208;1789;4163;1347;3355;49;165;902;1920;951;2085
317110;202208;798;1783;445;1228;73;241;174;453;247;694
317115;202208;1293;3449;1062;3030;144;406;629;1793;773;2199
317120;202208;22194;53436;18376;47458;1183;3853;12630;30303;13813;34156
317130;202208;13550;29813;9430;23158;1286;3437;3785;9055;5071;12492
317140;202208;1113;2461;869;2084;63;149;619;1470;682;1619
317150;202208;1223;2613;963;2284;34;117;819;1863;853;1980
317160;202208;4059;9165;2661;6947;282;662;1344;3722;1626;4384
317170;202208;2375;5486;1826;4528;93;291;1232;2734;1325;3025
317180;202208;2191;6388;1611;5052;312;1030;437;1244;749;2274
317190;202208;1300;3320;978;2793;188;571;463;1242;651;1813
317200;202208;7477;18547;5572;14924;1159;3283;1478;3504;2637;6787
317210;202208;1444;3164;1125;2743;44;151;806;1944;850;2095
317220;202208;376;999;322;905;55;166;190;502;245;668
320010;202208;5577;15394;4277;12773;572;1867;2315;6632;2887;8499
320013;202208;2492;6291;1777;4954;289;849;833;2338;1122;3187
320016;202208;3381;8116;2607;6928;205;557;1780;4660;1985;5217
320020;202208;5526;13069;4231;10871;618;1836;2152;5277;2770;7113
320030;202208;2060;5360;1354;3967;193;612;579;1560;772;2172
320035;202208;2304;5681;1908;5048;339;1025;1093;2764;1432;3789
320040;202208;5274;13816;4402;12296;593;1768;2448;6479;3041;8247
320050;202208;2230;4679;1924;4244;207;592;1277;2567;1484;3159
320060;202208;17047;43429;12799;35211;2108;6277;5944;14903;8052;21180
320070;202208;2379;5671;1806;4633;214;717;1068;2366;1282;3083
320080;202208;6671;15970;4707;12216;807;2272;2013;4759;2820;7031
320090;202208;10013;25193;6761;18802;1391;4207;2567;6410;3958;10617
320100;202208;3963;9610;3221;8357;428;1217;1909;4765;2337;5982
320110;202208;2783;5854;2033;4727;215;610;1285;2686;1500;3296
320115;202208;2576;7481;2220;6924;710;2282;923;3011;1633;5293
320120;202208;31240;73704;22656;58906;2894;8286;11676;27843;14570;36129
320130;202208;67180;165784;55504;145783;6652;19065;34194;85204;40846;104269
320140;202208;4779;12073;3443;9515;435;1435;1753;4414;2188;5849
320150;202208;17540;42442;12685;33784;2982;8916;2231;4860;5213;13776
320160;202208;7673;19648;5721;16145;731;2284;2864;7715;3595;9999
320170;202208;2169;5746;1544;4554;401;1180;557;1707;958;2887
320180;202208;883;2582;697;2207;233;821;185;527;418;1348
320190;202208;3586;10585;2695;8674;581;2114;605;1697;1186;3811
320200;202208;1578;4053;1077;3157;216;688;311;901;527;1589
320210;202208;5604;13112;4316;10956;654;1810;2401;5653;3055;7463
320220;202208;4243;10040;3246;8454;613;1665;1533;3726;2146;5391
320225;202208;1769;5048;1218;3823;370;1272;284;865;654;2137
320230;202208;6572;16430;4986;13803;1108;3244;1564;4379;2672;7623
320240;202208;20960;49710;15763;41648;3904;11174;4960;12500;8864;23674
320245;202208;3884;10729;2838;8493;813;2589;449;1231;1262;3820
320250;202208;3373;8267;2287;5941;416;1158;973;2204;1389;3362
320255;202208;2474;6872;2149;6311;425;1314;1281;3767;1706;5081
320260;202208;1722;4572;1101;3287;252;797;287;709;539;1506
320265;202208;2773;8111;2148;6843;862;2982;311;945;1173;3927
320270;202208;2682;7104;2054;5898;510;1655;676;1869;1186;3524
320280;202208;9877;23578;8107;20731;1105;3288;5097;12136;6202;15424
320290;202208;1569;4423;1016;3166;252;872;284;815;536;1687
320300;202208;5245;14239;4210;12279;1100;3548;1500;4140;2600;7688
320305;202208;6401;16513;4862;13687;871;2737;2318;6132;3189;8869
320310;202208;2598;6596;1840;5061;317;955;830;2049;1147;3004
320313;202208;2999;6920;2050;5232;385;1090;739;1588;1124;2678
320316;202208;1903;5006;1465;4284;228;673;803;2341;1031;3014
320320;202208;26882;66253;19510;53945;4462;12914;7142;19342;11604;32256
320330;202208;3483;8684;2719;7385;429;1205;1549;4190;1978;5395
320332;202208;10304;25183;8269;21648;1578;4457;4251;10591;5829;15048
320334;202208;2265;5966;1567;4595;299;1037;402;902;701;1939
320335;202208;2066;5632;1440;4221;270;929;481;1264;751;2193
320340;202208;6675;14452;5611;12962;424;1125;3872;8689;4296;9814
320350;202208;6441;14438;4546;11214;451;1286;2575;5792;3026;7078
320360;202208;1656;4006;1203;3174;136;377;596;1469;732;1846
320370;202208;3346;9324;2591;7769;717;2383;943;2618;1660;5001
320380;202208;3592;8229;3004;7277;258;802;2079;4634;2337;5436
320390;202208;9496;23265;6978;18444;1393;3959;2916;7107;4309;11066
320400;202208;3944;10441;2937;8357;762;2369;1131;2969;1893;5338
320405;202208;6437;15242;4875;12634;681;1866;2680;6603;3361;8469
320410;202208;5803;14045;4411;11862;762;2064;2178;5874;2940;7938
320420;202208;4729;10941;3645;9266;781;2135;1377;3291;2158;5426
320425;202208;2613;5725;2002;4746;159;399;1347;3030;1506;3429
320430;202208;3807;9030;3025;7713;419;1121;1842;4509;2261;5630
320435;202208;2835;8175;2233;6946;632;2120;841;2675;1473;4795
320440;202208;1843;4740;1377;3866;240;731;598;1520;838;2251
320450;202208;2520;6309;2027;5444;319;1064;1140;2725;1459;3789
320455;202208;5220;15001;3587;11313;833;2950;888;2407;1721;5357
320460;202208;2531;7078;1854;5713;509;1740;518;1443;1027;3183
320465;202208;1853;4861;1346;3897;287;892;606;1734;893;2626
320470;202208;4909;12203;3667;9792;695;2117;1340;3108;2035;5225
320480;202208;2810;6322;2287;5469;275;657;1514;3499;1789;4156
320490;202208;30613;71616;23138;59204;4105;10657;10671;26798;14776;37455
320495;202208;1660;4235;1199;3349;274;891;247;557;521;1448
320500;202208;77769;187988;62992;163354;7250;21280;39263;95044;46513;116324
320501;202208;5967;16001;4535;13470;1310;4300;1263;3626;2573;7926
320503;202208;3011;8088;2032;6105;565;1852;549;1511;1114;3363
320506;202208;3253;9127;2438;7401;700;2290;412;1118;1112;3408
320510;202208;14662;35611;11902;31034;1427;4016;7148;17792;8575;21808
320515;202208;2156;5609;1626;4515;450;1361;526;1370;976;2731
320517;202208;2586;7135;2071;6095;580;1834;770;2186;1350;4020
320520;202208;53563;126999;41522;107220;6031;17317;20329;49134;26360;66451
320530;202208;43021;102679;34375;88181;2623;8234;22740;53690;25363;61924
330010;202208;32851;75609;27591;67406;2162;6071;20587;48041;22749;54112
330015;202208;1975;4253;1561;3647;196;568;1021;2185;1217;2753
330020;202208;25431;57694;21489;52145;2209;5986;15856;37321;18065;43307
330022;202208;2421;6068;1875;5183;353;1008;845;2284;1198;3292
330023;202208;8320;18026;6604;15482;882;2264;4318;9643;5200;11907
330025;202208;9261;19480;6234;14666;1090;2782;2601;5586;3691;8368
330030;202208;13991;32818;10960;28095;738;2443;7686;18240;8424;20683
330040;202208;21794;50605;18126;44782;850;2746;13872;32171;14722;34917
330045;202208;132516;261143;113513;237814;5157;12042;97465;199135;102622;211177
330050;202208;3968;9301;3176;8081;493;1505;1906;4339;2399;5844
330060;202208;7333;16962;5726;14276;1049;3031;2487;5578;3536;8609
330070;202208;36716;80522;30792;72408;3631;9238;20994;48091;24625;57329
330080;202208;13119;28022;11191;25398;1278;3083;7782;17355;9060;20438
330090;202208;4295;8135;3168;6638;225;433;2254;4746;2479;5179
330093;202208;3630;7744;2828;6704;136;393;2322;5330;2458;5723
330095;202208;1811;4542;1420;3842;153;461;844;2124;997;2585
330100;202208;94006;216295;81920;199408;3409;10368;66605;157347;70014;167715
330110;202208;2920;7088;2390;6260;265;806;1582;3860;1847;4666
330115;202208;3544;7745;2571;6256;437;1143;1433;3230;1870;4373
330120;202208;4579;8843;3562;7606;167;447;2862;5793;3029;6240
330130;202208;6250;15088;5156;13497;679;1836;3367;8597;4046;10433
330140;202208;5300;11307;4401;10124;210;659;3622;7945;3832;8604
330150;202208;3240;7587;2607;6598;414;1145;1546;3674;1960;4819
330160;202208;1947;4675;1521;3977;298;862;843;1995;1141;2857
330170;202208;188131;385358;159978;348795;18190;40676;118692;254104;136882;294780
330180;202208;2680;5580;2176;4902;100;303;1726;3693;1826;3996
330185;202208;15006;31105;12817;28251;438;1307;11089;23538;11527;24845
330187;202208;7013;15312;5567;13059;721;1870;3634;7981;4355;9851
330190;202208;58941;118565;51358;108501;2178;5527;43402;88715;45580;94242
330200;202208;23380;51425;19418;46551;2598;6231;13881;33003;16479;39234
330205;202208;2805;6319;2144;5277;145;422;1479;3391;1624;3813
330210;202208;4127;9199;3122;7599;374;984;1826;4084;2200;5068
330220;202208;18133;40004;13616;32798;2076;5634;6900;14915;8976;20549
330225;202208;5317;12130;4147;10423;259;780;3007;7275;3266;8055
330227;202208;24713;51630;21408;47707;526;1518;19225;41777;19751;43295
330230;202208;2386;5048;1615;4031;139;372;798;1960;937;2332
330240;202208;33977;77389;28943;69960;2288;6356;21812;50554;24100;56910
330245;202208;2124;4866;1337;3519;257;716;591;1391;848;2107
330250;202208;57195;125202;48586;113142;5584;14047;34613;78445;40197;92492
330260;202208;6921;14796;5428;12864;254;765;4406;10031;4660;10796
330270;202208;41929;91241;26811;66752;3499;9652;13181;30464;16680;40116
330280;202208;3508;7720;2783;6582;165;493;1997;4332;2162;4825
330285;202208;37484;76215;30919;67149;1285;3589;25616;53010;26901;56599
330290;202208;5910;12018;4868;10680;285;859;3931;8086;4216;8945
330300;202208;7676;15925;5722;13242;404;1052;4239;9315;4643;10367
330310;202208;3527;7571;2672;6241;142;366;1997;4443;2139;4809
330320;202208;23080;48229;18261;42277;1971;4093;13650;31399;15621;35492
330330;202208;64106;126758;52299;111334;3628;8557;40901;83920;44529;92477
330340;202208;24227;52435;18298;43639;2358;6695;10582;22854;12940;29549
330350;202208;213100;421040;181201;383193;7322;16944;158438;328579;165760;345523
330360;202208;9887;20803;8553;19207;301;706;7459;16483;7760;17189
330370;202208;7059;17488;5678;15268;973;2923;3080;7807;4053;10730
330380;202208;8712;19840;7001;16947;590;1798;4977;11212;5567;13010
330385;202208;5429;13404;4466;12030;725;2201;2501;6357;3226;8558
330390;202208;43439;99971;33790;84026;3347;10154;22652;51755;25999;61909
330395;202208;4376;9486;3618;8545;141;457;2897;6538;3038;6995
330400;202208;4645;10824;3910;9679;174;601;3043;6982;3217;7583
330410;202208;4347;9931;3257;8174;434;1386;2087;4712;2521;6098
330411;202208;3557;8886;2834;7639;171;582;1987;5023;2158;5605
330412;202208;2162;5298;1776;4693;126;407;1257;3096;1383;3503
330414;202208;32047;71611;26648;64433;1613;4455;20911;49150;22524;53605
330415;202208;5977;14684;4450;12089;424;1284;2644;6817;3068;8101
330420;202208;16494;37646;12385;31166;1232;3662;7491;17238;8723;20900
330430;202208;14610;28665;12608;26093;269;849;11006;21840;11275;22689
330440;202208;3740;8711;2918;7373;301;954;2008;4669;2309;5623
330450;202208;1887;4681;1518;4080;125;392;973;2427;1098;2819
330452;202208;24591;55851;20173;49418;1842;5350;14610;33991;16452;39341
330455;202208;896378;1816608;744316;1609468;73638;171318;549046;1147593;622684;1318911
330460;202208;1564;3823;1213;3319;203;577;661;1756;864;2333
330470;202208;7480;16330;5578;13543;1209;3244;2361;5396;3570;8640
330475;202208;12525;28257;10247;25372;1284;3704;7016;16662;8300;20366
330480;202208;7375;17219;6264;15634;472;1296;4513;10726;4985;12022
330490;202208;148945;309466;123129;275670;10357;24826;93455;203773;103812;228599
330500;202208;10812;23468;9175;21320;552;1461;7218;16294;7770;17755
330510;202208;60227;131530;47540;114338;4854;12777;34394;79823;39248;92600
330513;202208;1652;3811;1337;3386;190;512;803;2010;993;2522
330515;202208;3716;8669;3086;7818;348;1071;2035;4827;2383;5898
330520;202208;17875;40675;15117;36652;1246;3616;10974;25262;12220;28878
330530;202208;2138;4733;1555;3885;289;782;752;1826;1041;2608
330540;202208;3883;9236;3015;7808;674;1858;1377;3401;2051;5259
330550;202208;16611;35152;13243;30764;2029;5237;8410;18632;10439;23869
330555;202208;27368;49288;23318;44581;840;1812;20081;38009;20921;39821
330560;202208;5103;11892;4136;10389;543;1460;2748;6561;3291;8021
330570;202208;3906;9135;3427;8461;465;1322;2432;5797;2897;7119
330575;202208;8191;17948;7155;16266;310;881;6012;12960;6322;13841
330580;202208;28616;65965;23820;57840;3518;8902;14220;32213;17738;41115
330590;202208;2012;4599;1685;4188;216;519;1143;2878;1359;3397
330600;202208;16700;38519;13866;34148;829;2538;9976;23123;10805;25661
330610;202208;13013;29851;10765;26441;958;2706;7507;17474;8465;20180
330615;202208;2803;6607;2304;5955;375;876;1524;4041;1899;4917
330620;202208;5511;13846;4452;12122;799;2401;2300;5874;3099;8275
330630;202208;38557;84376;30194;71562;1305;4081;23053;51402;24358;55483
350010;202208;2716;6771;1666;4646;319;956;445;968;764;1924
350020;202208;863;2115;534;1502;73;224;190;475;263;699
350030;202208;4373;11238;3410;9630;677;2185;1778;4627;2455;6812
350040;202208;920;2473;561;1737;80;301;187;451;267;752
350050;202208;1768;4069;1223;3180;201;620;469;956;670;1576
350055;202208;1159;2715;938;2384;122;336;579;1346;701;1682
350060;202208;341;787;184;472;26;77;79;186;105;263
350070;202208;4240;10425;2912;8096;439;1370;1288;3141;1727;4511
350075;202208;794;2093;599;1740;203;593;122;364;325;957
350080;202208;802;1999;565;1592;54;172;279;701;333;873
350090;202208;760;1592;480;1159;70;195;281;608;351;803
350100;202208;3087;7393;2236;6016;130;467;1499;3690;1629;4157
350110;202208;590;1350;449;1117;17;54;312;732;329;786
350115;202208;1457;3984;1192;3463;189;611;613;1613;802;2224
350120;202208;764;1717;451;1186;39;125;254;603;293;728
350130;202208;4078;9986;3231;8481;443;1298;1795;4198;2238;5496
350140;202208;870;2250;627;1819;38;142;362;954;400;1096
350150;202208;567;1616;463;1426;90;312;151;384;241;696
350160;202208;15004;36094;10671;28161;1404;4079;6318;15477;7722;19556
350170;202208;3195;8228;2680;7164;362;1081;1517;3687;1879;4768
350180;202208;1206;2755;729;1923;104;292;372;900;476;1192
350190;202208;4217;11229;3063;8660;420;1438;1612;3846;2032;5284
350200;202208;621;1506;484;1265;28;90;336;800;364;890
350210;202208;7741;16642;5505;13188;428;1266;3789;8401;4217;9667
350220;202208;3695;9548;2667;7587;487;1475;1115;2829;1602;4304
350230;202208;1259;2975;1015;2637;160;483;583;1427;743;1910
350240;202208;740;1977;470;1367;82;234;133;330;215;564
350250;202208;4269;10842;3244;9194;829;2466;1087;2952;1916;5418
350260;202208;1046;2253;665;1629;72;195;404;906;476;1101
350270;202208;5425;13303;4331;11346;551;1650;2546;6108;3097;7758
350275;202208;3394;8263;2805;7401;233;779;2050;5067;2283;5846
350280;202208;22811;49668;14915;37174;2146;5733;7478;17205;9624;22938
350290;202208;4169;10741;3044;8539;486;1537;1447;3660;1933;5197
350300;202208;827;1994;633;1645;74;212;393;935;467;1147
350310;202208;1134;2960;878;2484;106;348;420;1066;526;1414
350315;202208;739;1703;526;1376;28;102;318;719;346;821
350320;202208;20129;48808;15435;40717;2582;7595;7491;17926;10073;25521
350330;202208;17389;39813;13027;31982;1130;3196;8812;20095;9942;23291
350335;202208;439;1172;335;976;38;122;149;413;187;535
350340;202208;1599;3892;995;2787;132;424;462;1150;594;1574
350350;202208;880;2055;690;1849;103;291;422;1120;525;1411
350360;202208;1366;3685;1092;3150;182;571;509;1384;691;1955
350370;202208;838;1936;605;1511;183;440;220;508;403;948
350380;202208;5808;15090;4252;11859;987;2856;1509;3921;2496;6777
350390;202208;13773;33275;10917;28660;1388;3969;6588;16130;7976;20099
350395;202208;512;1244;260;768;31;95;90;237;121;332
350400;202208;10329;24164;7369;19295;1858;5154;2262;5681;4120;10835
350410;202208;13263;34611;10006;28520;1837;5774;4380;11414;6217;17188
350420;202208;1338;3218;943;2504;164;439;327;733;491;1172
350430;202208;797;1901;615;1619;80;244;359;849;439;1093
350440;202208;2619;5891;2148;5211;116;345;1521;3438;1637;3783
350450;202208;8457;21828;6698;18846;1323;4186;3188;8155;4511;12341
350460;202208;2570;6249;1619;4466;228;669;759;1863;987;2532
350470;202208;307;702;246;610;10;28;183;428;193;456
350480;202208;1162;2757;781;2102;174;526;208;484;382;1010
350490;202208;2379;5643;1725;4623;304;905;769;1791;1073;2696
350500;202208;764;1915;554;1562;70;213;225;590;295;803
350510;202208;1437;3387;1099;2811;95;279;702;1656;797;1935
350520;202208;2848;7913;2271;6867;317;1088;1084;2934;1401;4022
350530;202208;3705;8798;2835;7187;230;681;1759;4062;1989;4743
350535;202208;1845;4540;1552;4120;230;677;981;2492;1211;3169
350540;202208;2487;5076;1902;4261;180;470;1396;2903;1576;3373
350550;202208;10805;25073;7656;19924;697;2238;4692;11033;5389;13271
350560;202208;5200;12727;4325;11342;241;811;3238;8017;3479;8828
350570;202208;36559;92895;30098;81325;4556;13577;16556;41845;21112;55422
350580;202208;2630;6557;1697;4778;457;1455;504;1100;961;2555
350590;202208;5997;15198;4498;12037;533;1607;2752;6775;3285;8382
350600;202208;40697;91128;26325;66927;3781;10956;12767;29358;16548;40314
350610;202208;8785;22202;6440;17753;795;2549;3580;9013;4375;11562
350620;202208;482;1186;310;909;31;102;178;481;209;583
350630;202208;1993;4431;1496;3635;99;309;1079;2385;1178;2694
350635;202208;12861;28657;9861;24120;1055;2905;6677;15459;7732;18364
350640;202208;1098;2836;610;1790;103;309;189;459;292;768
350650;202208;10600;26708;7671;21156;1263;3861;3386;8461;4649;12322
350660;202208;5950;14111;4668;12111;523;1397;2973;7449;3496;8846
350670;202208;2155;5466;1697;4746;247;724;975;2696;1222;3420
350680;202208;1346;3400;923;2625;142;417;404;1060;546;1477
350690;202208;1717;4164;1246;3354;203;592;662;1709;865;2301
350700;202208;6105;14205;4738;12163;851;2544;2663;6248;3514;8792
350710;202208;3662;9042;3094;8113;552;1674;1698;4062;2250;5736
350715;202208;900;2418;759;2183;150;515;379;931;529;1446
350720;202208;193;463;140;383;22;71;46;95;68;166
350730;202208;747;2035;585;1710;44;153;339;889;383;1042
350740;202208;2101;5128;1444;3845;233;682;554;1290;787;1972
350745;202208;745;1808;440;1233;38;127;217;551;255;678
350750;202208;13323;32648;10650;28206;1733;5390;5493;13063;7226;18453
350760;202208;20902;47233;15924;39100;2192;6464;9320;20178;11512;26642
350770;202208;1262;2919;795;2140;68;200;477;1210;545;1410
350775;202208;842;1822;575;1435;75;182;313;738;388;920
350780;202208;2880;6531;2125;5510;565;1300;887;2570;1452;3870
350790;202208;2585;6559;1677;4887;345;1018;493;1214;838;2232
350800;202208;4484;11572;3829;10496;253;826;2721;7078;2974;7904
350810;202208;3543;7962;2677;6689;532;1350;1283;3064;1815;4414
350820;202208;1133;2528;695;1752;66;197;388;887;454;1084
350830;202208;1037;2617;603;1719;100;313;207;461;307;774
350840;202208;4270;11772;3320;10050;597;1997;1543;4257;2140;6254
350850;202208;9956;25308;7872;21711;1239;3772;4440;11350;5679;15122
350860;202208;4492;10831;3905;10055;152;536;3053;7648;3205;8184
350870;202208;3323;8425;2445;7046;392;1150;1225;3418;1617;4568
350880;202208;1846;4727;1514;4103;387;1091;560;1371;947;2462
350890;202208;583;1475;386;1075;55;167;141;335;196;502
350900;202208;11295;27841;8213;21770;1211;3637;4500;10628;5711;14265
350910;202208;1143;2514;967;2263;79;211;764;1724;843;1935
350920;202208;15346;35209;13025;31614;450;1439;10757;24930;11207;26369
350925;202208;5062;12641;3706;10350;624;1925;1932;4867;2556;6792
350930;202208;1757;4375;1230;3378;92;283;706;1870;798;2153
350940;202208;3153;7407;2529;6432;224;672;1792;4235;2016;4907
350945;202208;1117;2859;845;2354;140;395;393;1000;533;1395
350950;202208;117004;278983;91435;232858;10586;29672;58062;138885;68648;168557
350960;202208;8163;20698;6354;17312;907;2749;3513;8940;4420;11689
350970;202208;4587;11943;3395;9761;904;2890;1088;2533;1992;5423
350980;202208;908;2185;759;1935;127;363;437;1019;564;1382
350990;202208;2488;6139;1897;5200;443;1369;776;1974;1219;3343
350995;202208;1043;2947;945;2757;79;289;642;1753;721;2042
351000;202208;3684;9229;2448;6831;545;1590;812;2128;1357;3718
351010;202208;469;1124;301;822;43;139;147;375;190;514
351015;202208;1179;3286;974;2876;188;602;416;1063;604;1665
351020;202208;10425;25863;7932;21649;1528;4440;4052;10299;5580;14739
351030;202208;3728;10062;2997;8653;459;1506;1661;4505;2120;6011
351040;202208;6650;14764;5613;13240;207;636;4674;10538;4881;11174
351050;202208;21509;49321;16459;41821;2603;7150;9167;22128;11770;29278
351060;202208;60258;141169;46593;118518;3889;11305;32483;78616;36372;89921
351070;202208;1788;4157;1042;2927;276;820;210;514;486;1334
351080;202208;3431;7723;2596;6719;280;849;1746;4232;2026;5081
351090;202208;397;1024;303;858;57;173;110;294;167;467
351100;202208;3447;8653;2272;6345;453;1402;790;2047;1243;3449
351110;202208;7343;18066;5216;14287;786;2455;2708;6890;3494;9345
351120;202208;874;2141;601;1655;113;335;213;517;326;852
351130;202208;1351;3510;644;1930;110;373;172;446;282;819
351140;202208;2771;7168;2113;5989;443;1396;954;2378;1397;3774
351150;202208;3639;9535;2592;7436;369;1215;1109;2752;1478;3967
351160;202208;1432;4146;1059;3328;217;733;265;701;482;1434
351170;202208;1862;4628;1613;4182;130;404;1150;2767;1280;3171
351190;202208;1185;3120;829;2416;189;545;275;767;464;1312
351200;202208;1988;4526;1490;3801;124;358;1043;2485;1167;2843
351210;202208;1819;4186;1213;3141;73;254;738;1706;811;1960
351220;202208;4481;10960;3867;10004;365;965;2718;6774;3083;7739
351230;202208;2655;6433;2067;5446;347;1027;1037;2414;1384;3441
351240;202208;2848;7010;1822;4963;465;1289;520;1250;985;2539
351250;202208;1244;3173;746;2148;82;260;291;787;373;1047
351260;202208;1045;2451;744;1925;155;400;289;689;444;1089
351270;202208;648;1667;449;1270;47;148;215;494;262;642
351280;202208;4739;11822;3660;9895;753;2129;1528;3808;2281;5937
351290;202208;1815;4043;1210;3030;118;333;826;1966;944;2299
351300;202208;25675;64219;18827;51801;3232;9735;9339;23799;12571;33534
351310;202208;4427;10080;3423;8497;153;527;2592;6042;2745;6569
351320;202208;1024;2835;739;2278;129;431;212;555;341;986
351330;202208;571;1350;444;1094;22;72;321;705;343;777
351340;202208;9287;22148;7797;19634;1314;3840;4760;10816;6074;14656
351350;202208;15404;35880;12770;31643;844;2440;9874;23270;10718;25710
351360;202208;4907;11719;4028;10452;744;2223;2131;4953;2875;7176
351370;202208;2476;6521;1697;4972;406;1288;469;1149;875;2437
351380;202208;56174;127290;40886;102011;4274;11827;26002;61198;30276;73025
351385;202208;479;1180;210;608;29;83;86;223;115;306
351390;202208;1684;3788;1148;3039;75;229;880;2248;955;2477
351400;202208;1339;3425;1094;2952;141;378;656;1693;797;2071
351410;202208;3170;8178;2369;6715;397;1205;1065;2820;1462;4025
351420;202208;604;1368;369;972;41;102;234;569;275;671
351430;202208;1213;2923;991;2571;53;163;758;1884;811;2047
351440;202208;4201;10408;2841;7771;559;1627;851;1961;1410;3588
351450;202208;2079;5193;1463;4117;298;988;392;839;690;1827
351460;202208;1191;2904;980;2580;113;329;646;1625;759;1954
351470;202208;1479;3499;1162;2980;73;234;783;1874;856;2108
351480;202208;2954;7805;2347;6852;374;1287;1197;3120;1571;4407
351490;202208;2664;6817;2299;6194;72;289;1861;4802;1933;5091
351492;202208;428;1050;365;925;7;20;286;704;293;724
351495;202208;269;657;216;564;22;52;126;311;148;363
351500;202208;52501;116806;40928;98652;5195;13518;27013;61376;32208;74894
351510;202208;16429;36736;12326;30085;1324;3656;8147;18773;9471;22429
351512;202208;574;1446;407;1100;80;215;137;340;217;555
351515;202208;3970;8697;2543;6351;486;1260;652;1704;1138;2964
351518;202208;2869;6944;1894;5239;279;875;849;1990;1128;2865
351519;202208;723;1906;454;1386;96;320;94;235;190;555
351520;202208;1479;3513;705;2017;71;247;354;898;425;1145
351530;202208;415;1036;252;722;43;123;111;271;154;394
351535;202208;2002;4692;1434;3727;227;630;680;1657;907;2287
351540;202208;3225;7422;2225;5738;222;682;1173;2637;1395;3319
351550;202208;8963;20993;6284;16330;630;1863;3600;8530;4230;10393
351560;202208;609;1655;488;1424;110;357;164;438;274;795
351565;202208;303;799;241;693;45;155;83;193;128;348
351570;202208;27351;67093;21509;56199;1860;5471;14417;35534;16277;41005
351580;202208;265;662;158;472;18;50;72;217;90;267
351590;202208;547;1209;285;755;25;65;160;393;185;458
351600;202208;1597;4066;1222;3361;203;581;599;1486;802;2067
351610;202208;840;1868;550;1386;48;131;306;703;354;834
351620;202208;29002;72364;21617;60334;3133;10249;10688;27064;13821;37313
351630;202208;35067;83635;28560;73218;2467;7476;20374;49230;22841;56706
351640;202208;23791;55912;19197;48252;1164;3639;14266;33712;15430;37351
351650;202208;448;1185;225;673;39;125;58;147;97;272
351660;202208;766;2064;521;1547;90;286;134;329;224;615
351670;202208;7430;18827;4966;13620;1070;2857;2084;5201;3154;8058
351680;202208;505;1317;343;988;69;203;109;259;178;462
351685;202208;542;1427;428;1251;87;258;178;459;265;717
351690;202208;1415;3451;844;2378;92;307;387;980;479;1287
351700;202208;1614;3769;1193;3069;209;613;650;1506;859;2119
351710;202208;943;2291;721;1902;54;167;428;1006;482;1173
351720;202208;1831;4426;1286;3505;217;587;598;1514;815;2101
351730;202208;1218;2867;1003;2535;66;205;650;1493;716;1698
351740;202208;4026;9512;3278;8198;458;1273;1883;4299;2341;5572
351750;202208;2002;4912;1242;3573;172;525;596;1595;768;2120
351760;202208;3990;10248;3049;8495;547;1759;1501;3709;2048;5468
351770;202208;2450;6180;2017;5410;467;1197;1099;2827;1566;4024
351780;202208;1381;3314;828;2311;111;348;356;907;467;1255
351790;202208;1809;4008;1403;3453;209;513;868;2065;1077;2578
351800;202208;577;1265;295;764;40;109;119;264;159;373
351810;202208;1348;3291;1119;2956;222;624;587;1428;809;2052
351820;202208;3588;9114;2664;7384;602;1796;919;2295;1521;4091
351830;202208;5912;14166;4556;11935;388;1212;3018;7343;3406;8555
351840;202208;11125;28209;8657;23891;962;3004;5261;13315;6223;16319
351850;202208;1805;4723;1193;3515;201;664;420;983;621;1647
351860;202208;3242;8651;2510;7376;398;1318;1434;4062;1832;5380
351870;202208;31617;75001;24431;63456;5112;13777;11447;29210;16559;42987
351880;202208;195899;449313;153718;380592;22799;65601;94930;216235;117729;281836
351885;202208;1189;2862;960;2509;50;185;691;1687;741;1872
351890;202208;1009;2500;657;1921;130;427;161;394;291;821
351900;202208;1491;3704;1140;3189;100;267;737;2018;837;2285
351905;202208;669;1773;506;1462;59;193;245;603;304;796
351907;202208;27425;67015;21700;57202;2218;6684;14354;35568;16572;42252
351910;202208;1995;4783;1444;3703;124;360;858;1938;982;2298
351920;202208;1033;2595;796;2161;117;352;330;799;447;1151
351925;202208;1168;2876;928;2475;95;314;550;1344;645;1658
351930;202208;4594;11125;4156;10384;391;1132;3313;7986;3704;9118
351940;202208;1314;3199;954;2576;149;457;434;1144;583;1601
351950;202208;1982;4023;1519;3386;66;193;1129;2369;1195;2562
351960;202208;6320;15007;4773;12399;1171;3117;1976;4764;3147;7881
351970;202208;11772;29503;9714;26198;1175;3900;6425;16021;7600;19921
351980;202208;1274;2890;850;2212;107;331;478;1125;585;1456
351990;202208;1726;3827;1275;3187;57;190;696;1533;753;1723
352000;202208;3249;8382;2818;7542;258;830;1946;4825;2204;5655
352010;202208;2876;7033;2336;6190;676;1825;683;1817;1359;3642
352020;202208;1955;4821;1565;4159;245;756;888;2133;1133;2889
352030;202208;7394;17469;5957;15227;688;2119;3919;9362;4607;11481
352040;202208;5140;12269;3721;9678;601;1727;1439;3305;2040;5032
352042;202208;4352;9684;3016;7652;372;1078;1842;4510;2214;5588
352044;202208;2518;6306;1538;4476;246;835;389;907;635;1742
352050;202208;16721;42069;11452;31929;2945;8814;2800;6462;5745;15276
352060;202208;912;2278;693;1899;118;352;325;806;443;1158
352070;202208;1115;2200;757;1734;42;112;451;938;493;1050
352080;202208;546;1354;345;972;45;115;115;298;160;413
352090;202208;1866;5083;1548;4501;176;596;789;2061;965;2657
352100;202208;4526;11807;3563;9997;598;1928;1688;4415;2286;6343
352110;202208;840;2236;626;1832;120;362;251;649;371;1011
352115;202208;674;1723;562;1562;130;405;282;713;412;1118
352120;202208;1042;2728;827;2310;83;239;516;1319;599;1558
352130;202208;2338;6215;1529;4295;215;628;701;1790;916;2418
352140;202208;1470;3794;1080;3000;211;583;457;1244;668;1827
352150;202208;1037;2546;761;2086;86;264;495;1283;581;1547
352160;202208;1146;2647;839;2147;93;271;429;1031;522;1302
352170;202208;3599;9042;2814;7546;401;1240;1530;3710;1931;4950
352180;202208;3143;7991;2433;6777;491;1468;1004;2579;1495;4047
352190;202208;1860;4393;1485;3830;254;682;826;2086;1080;2768
352200;202208;381;1115;277;914;43;145;110;346;153;491
352210;202208;26724;56620;21230;49286;1083;2980;17021;38182;18104;41162
352215;202208;761;1865;593;1579;99;286;319;812;418;1098
352220;202208;32362;71856;24491;58998;3357;9146;14899;32541;18256;41687
352230;202208;19133;50335;15156;43237;3643;11448;6032;15325;9675;26773
352240;202208;12966;30899;10110;26340;1786;5180;5311;12553;7097;17733
352250;202208;28832;75070;23866;66971;2758;8552;16195;43819;18953;52371
352260;202208;6159;14552;4371;11131;593;1768;2609;5861;3202;7629
352265;202208;1064;2831;931;2641;148;447;542;1476;690;1923
352270;202208;2321;6206;1826;5193;340;1086;758;1916;1098;3002
352280;202208;2862;6626;2185;5643;266;785;1254;2970;1520;3755
352290;202208;1778;4668;1427;3992;178;546;764;1903;942;2449
352300;202208;1129;2767;757;2045;79;238;413;1030;492;1268
352310;202208;48873;121783;37589;103430;6277;18183;21484;57543;27761;75726
352320;202208;8475;19801;6664;16638;825;2409;4074;8939;4899;11348
352330;202208;3122;7229;2465;6317;286;936;1630;3829;1916;4765
352340;202208;8623;21372;6619;17782;1036;3091;3541;8596;4577;11687
352350;202208;2916;7472;2327;6271;129;430;1662;4250;1791;4680
352360;202208;1765;4280;1419;3667;110;330;1021;2475;1131;2805
352370;202208;1256;3289;1070;2996;33;106;832;2269;865;2375
352380;202208;1073;2648;815;2218;170;471;318;796;488;1267
352390;202208;18300;42625;12811;33147;1961;5663;7324;17438;9285;23101
352400;202208;4303;11441;3416;9761;858;2673;1333;3449;2191;6122
352410;202208;4390;10345;3434;8798;350;971;2170;5245;2520;6216
352420;202208;989;2379;670;1860;147;440;217;561;364;1001
352430;202208;10687;23829;8066;19539;1095;2955;4593;10349;5688;13304
352440;202208;23477;59738;18037;49623;4016;11638;7000;18312;11016;29950
352450;202208;942;2194;527;1480;74;212;215;528;289;740
352460;202208;3666;9272;2624;7478;478;1463;1152;3028;1630;4491
352470;202208;3839;9443;2995;8079;257;819;1949;4859;2206;5678
352480;202208;5189;11607;3534;8798;458;1362;1849;4061;2307;5423
352490;202208;994;2620;792;2269;154;475;351;948;505;1423
352500;202208;13416;32684;9381;25460;3461;10929;1997;3397;5458;14326
352510;202208;5061;12749;3960;10854;491;1519;2476;6376;2967;7895
352520;202208;3472;8565;2690;7279;406;1281;1556;3746;1962;5027
352530;202208;14199;34064;10065;26591;1947;5802;3799;8353;5746;14155
352540;202208;657;1785;493;1459;79;237;215;575;294;812
352550;202208;1145;2937;781;2301;144;500;301;766;445;1266
352560;202208;758;1896;622;1660;50;176;430;1048;480;1224
352570;202208;2595;6877;1731;5193;394;1325;242;452;636;1777
352580;202208;853;2022;713;1794;126;319;399;960;525;1279
352585;202208;431;1123;312;916;33;126;167;434;200;560
352590;202208;16211;40448;11912;32640;2247;6902;6482;16268;8729;23170
352600;202208;2427;6007;1964;5220;171;531;1320;3233;1491;3764
352610;202208;3312;8321;2506;7006;410;1374;1242;3185;1652;4559
352620;202208;7179;16451;5530;14153;1242;3273;2713;6755;3955;10028
352630;202208;1025;2369;770;2019;131;379;380;934;511;1313
352640;202208;3847;9163;2835;7383;283;790;1708;4139;1991;4929
352650;202208;697;1853;481;1402;72;215;198;543;270;758
352660;202208;1286;3508;1084;3116;106;385;712;1860;818;2245
352670;202208;12995;31952;9422;25233;1610;4808;4620;11006;6230;15814
352680;202208;3903;10693;2853;8395;514;1776;1383;3407;1897;5183
352690;202208;32152;76306;25515;65651;1128;3655;18875;46096;20003;49751
352700;202208;888;2134;666;1797;118;331;305;790;423;1121
352710;202208;6687;16091;4904;12982;1151;3420;2162;5151;3313;8571
352720;202208;11876;28320;9637;24411;1672;4651;5157;12062;6829;16713
352725;202208;635;1417;370;974;19;57;218;520;237;577
352730;202208;5911;16837;5289;15422;668;2176;2557;6333;3225;8509
352740;202208;2855;6499;2171;5496;236;677;1264;3000;1500;3677
352750;202208;489;1170;323;886;39;121;161;380;200;501
352760;202208;2080;5327;1650;4550;187;510;916;2389;1103;2899
352770;202208;1095;2731;787;2178;111;325;396;1010;507;1335
352780;202208;780;2074;561;1629;122;341;169;473;291;814
352790;202208;489;1212;377;1007;49;134;164;382;213;516
352800;202208;1671;4696;1180;3626;273;858;226;531;499;1389
352810;202208;1473;3348;978;2496;148;371;538;1318;686;1689
352820;202208;531;1418;393;1182;87;268;100;264;187;532
352830;202208;664;1597;334;942;26;81;116;266;142;347
352840;202208;4855;12739;3967;11188;947;2911;1805;4845;2752;7756
352850;202208;15046;33509;11156;27499;2190;6057;5729;12664;7919;18721
352860;202208;1375;3569;1037;2981;176;561;414;1089;590;1650
352870;202208;1014;2458;708;1848;70;212;450;1106;520;1318
352880;202208;2001;4592;1420;3576;221;598;596;1355;817;1953
352885;202208;416;1052;326;902;44;146;203;524;247;670
352890;202208;832;1856;590;1388;41;120;397;817;438;937
352900;202208;23067;56400;15816;42616;2553;7160;6824;16989;9377;24149
352910;202208;446;1122;250;726;18;50;104;258;122;308
352920;202208;3339;7960;2576;6702;125;400;1874;4595;1999;4995
352930;202208;7150;17871;5478;14652;863;2660;2685;6320;3548;8980
352940;202208;31808;78705;25088;65591;3711;10730;14924;36301;18635;47031
352950;202208;666;1690;424;1240;90;286;104;250;194;536
352960;202208;874;2185;522;1467;66;200;176;375;242;575
352965;202208;304;806;211;633;47;146;59;158;106;304
352970;202208;4215;8575;3391;7339;133;352;2803;5781;2936;6133
352980;202208;1635;3850;1270;3339;281;780;712;1805;993;2585
352990;202208;5421;13134;4136;11057;675;2026;2305;5835;2980;7861
353000;202208;551;1425;319;920;49;167;111;266;160;433
353010;202208;3122;7349;2192;5663;401;1157;1023;2389;1424;3546
353020;202208;3992;9781;2484;6808;375;1155;974;2410;1349;3565
353030;202208;5762;13786;3962;10761;988;2827;1142;2916;2130;5743
353040;202208;837;1789;612;1459;79;208;381;838;460;1046
353050;202208;6241;16589;4477;13092;741;2380;2315;6340;3056;8720
353060;202208;60675;142690;50287;126651;3019;9401;38668;92681;41687;102082
353070;202208;13089;34249;9734;27258;1531;4812;4765;11888;6296;16700
353080;202208;5966;15017;4151;11596;821;2580;1709;4051;2530;6631
353090;202208;734;2023;603;1777;49;161;386;1089;435;1250
353100;202208;353;869;156;452;35;111;46;100;81;211
353110;202208;9532;22852;7681;20287;1811;4694;3784;10470;5595;15164
353120;202208;565;1361;432;1138;57;200;233;523;290;723
353130;202208;3498;7782;2371;5887;570;1543;1009;2155;1579;3698
353140;202208;3529;7962;2702;6658;234;699;1855;4268;2089;4967
353150;202208;1806;4293;1323;3525;255;745;616;1523;871;2268
353160;202208;771;1895;551;1536;75;243;261;637;336;880
353170;202208;694;1682;537;1463;95;265;278;736;373;1001
353180;202208;11674;27457;9302;23522;2048;5619;4715;11157;6763;16776
353190;202208;4143;10418;3248;8688;379;1162;1916;4699;2295;5861
353200;202208;2083;5337;1315;3844;192;650;487;1240;679;1890
353205;202208;549;1514;460;1319;47;155;257;684;304;839
353210;202208;1124;2295;756;1710;26;71;578;1226;604;1297
353215;202208;482;1194;381;1031;47;151;173;408;220;559
353220;202208;888;2321;613;1770;121;327;172;446;293;773
353230;202208;946;2495;734;2156;178;602;223;583;401;1185
353240;202208;2938;7276;2473;6560;318;980;1529;3810;1847;4790
353250;202208;1597;3401;1080;2598;147;378;605;1403;752;1781
353260;202208;1385;3078;807;2150;130;393;372;888;502;1281
353270;202208;916;2171;765;1922;84;254;504;1166;588;1420
353280;202208;824;2069;602;1710;135;397;206;568;341;965
353282;202208;2104;5539;1759;4942;153;515;1128;2949;1281;3464
353284;202208;447;1034;261;684;25;81;119;269;144;350
353286;202208;203;486;125;358;25;70;35;81;60;151
353290;202208;1665;4199;1027;2926;183;519;311;802;494;1321
353300;202208;2590;6476;1916;5216;315;971;896;2077;1211;3048
353310;202208;475;1095;358;903;29;95;228;516;257;611
353320;202208;840;2020;705;1824;28;99;529;1299;557;1398
353325;202208;897;2402;650;1886;102;296;290;782;392;1078
353330;202208;754;1791;502;1344;71;213;260;621;331;834
353340;202208;3967;10138;3075;8460;503;1607;1655;4116;2158;5723
353350;202208;4950;11554;3680;9289;860;2226;1234;2785;2094;5011
353360;202208;810;2151;662;1875;70;246;401;1052;471;1298
353370;202208;699;1867;572;1664;44;137;383;1088;427;1225
353380;202208;371;992;297;861;36;127;154;391;190;518
353390;202208;7674;18078;5776;15010;474;1417;3624;8815;4098;10232
353400;202208;655;1635;500;1360;92;287;209;441;301;728
353410;202208;625;1523;462;1226;96;266;245;614;341;880
353420;202208;571;1397;382;1025;69;187;77;162;146;349
353430;202208;2832;7231;2254;6203;405;1179;1092;2799;1497;3978
353440;202208;87690;219288;66448;178506;8774;26346;40014;99387;48788;125733
353450;202208;464;1102;324;874;41;142;165;378;206;520
353460;202208;4022;10172;3009;8344;601;1863;754;1744;1355;3607
353470;202208;11005;27020;8178;21861;1326;3978;3866;9215;5192;13193
353475;202208;1996;4681;1379;3553;141;428;794;1822;935;2250
353480;202208;1934;4671;1583;4134;94;310;1156;2856;1250;3166
353490;202208;1252;3118;906;2500;130;381;426;1073;556;1454
353500;202208;1336;3048;981;2499;207;568;534;1264;741;1832
353510;202208;1150;3103;840;2425;170;522;309;754;479;1276
353520;202208;1277;3125;835;2355;94;289;385;942;479;1231
353530;202208;3008;7313;2421;6290;275;844;1432;3387;1707;4231
353540;202208;2489;6282;2016;5572;300;910;1193;3152;1493;4062
353550;202208;7420;17310;6038;15145;823;2243;3799;8913;4622;11156
353560;202208;2740;6862;2132;5974;595;1771;734;1860;1329;3631
353570;202208;779;1954;508;1446;83;267;207;516;290;783
353580;202208;2813;6864;2207;5751;403;1046;1197;2965;1600;4011
353590;202208;874;2064;642;1693;78;201;378;957;456;1158
353600;202208;1883;4518;1434;3743;175;497;770;1917;945;2414
353610;202208;892;2448;668;2001;105;337;313;872;418;1209
353620;202208;3517;8525;2552;6963;542;1525;881;2149;1423;3674
353625;202208;724;1689;427;1161;52;166;231;580;283;746
353630;202208;1862;5131;1586;4622;232;737;875;2330;1107;3067
353640;202208;1612;3901;1275;3367;179;475;787;2004;966;2479
353650;202208;8921;22688;6933;19172;847;2624;3964;10129;4811;12753
353657;202208;430;1084;327;927;32;106;157;407;189;513
353660;202208;1637;3217;1177;2607;156;369;782;1655;938;2024
353670;202208;5220;13335;4117;11308;742;2367;2060;5034;2802;7401
353680;202208;874;2118;652;1807;88;278;396;1018;484;1296
353690;202208;524;1359;238;712;26;78;63;163;89;241
353700;202208;2550;6136;2077;5389;166;477;1468;3663;1634;4140
353710;202208;6181;13437;3829;9287;498;1255;2067;4341;2565;5596
353715;202208;513;1311;301;875;20;70;130;335;150;405
353720;202208;2429;5947;1883;5111;329;979;946;2474;1275;3453
353730;202208;5607;13738;4409;11693;513;1641;2744;6643;3257;8284
353740;202208;2456;6076;1778;4916;353;1074;717;1797;1070;2871
353750;202208;1105;3140;832;2639;194;635;252;761;446;1396
353760;202208;17445;36141;13646;31227;2438;5957;8007;17731;10445;23688
353770;202208;736;1975;436;1340;65;225;69;170;134;395
353780;202208;7818;18993;6471;16664;975;2888;3966;9481;4941;12369
353790;202208;3456;9653;2596;7920;605;2056;625;1569;1230;3625
353800;202208;22561;55030;18205;48290;2623;7108;10727;27528;13350;34636
353810;202208;1448;3667;1016;2778;159;469;438;1119;597;1588
353820;202208;2135;5373;1470;4120;347;1044;408;1002;755;2046
353830;202208;752;1745;565;1461;86;258;289;671;375;929
353850;202208;1918;4871;1487;4103;274;780;655;1691;929;2471
353860;202208;3231;8170;2490;6976;565;1835;1203;2947;1768;4782
353870;202208;36776;90652;27193;72909;3562;10572;14149;34014;17711;44586
353880;202208;3692;9480;2950;8116;213;726;1899;4854;2112;5580
353890;202208;3730;7380;2660;5821;170;485;1894;3698;2064;4183
353900;202208;852;2258;641;1866;87;291;270;701;357;992
353910;202208;3569;8707;3038;7912;224;680;2249;5678;2473;6358
353920;202208;2494;6356;1826;5168;492;1521;440;946;932;2467
353930;202208;6237;15275;4482;12008;821;2424;2041;4801;2862;7225
353940;202208;1531;4159;1113;3342;161;531;449;1193;610;1724
353950;202208;4128;10242;3220;8640;786;2298;1296;3143;2082;5441
353960;202208;933;2303;658;1821;166;428;178;469;344;897
353970;202208;760;1690;581;1428;47;146;429;988;476;1134
353980;202208;19810;46272;15450;39164;782;2450;11614;27776;12396;30226
353990;202208;1059;2446;720;1875;136;375;359;869;495;1244
354000;202208;3088;7102;1842;4794;412;1114;507;1157;919;2271
354010;202208;401;995;293;822;48;154;169;448;217;602
354020;202208;4668;11534;3775;9834;684;1992;1946;4502;2630;6494
354025;202208;867;2249;586;1706;81;264;187;480;268;744
354030;202208;601;1257;337;842;67;163;146;340;213;503
354040;202208;940;2029;624;1555;32;102;462;1068;494;1170
354050;202208;1204;3234;854;2626;158;561;362;1043;520;1604
354060;202208;4592;12004;3386;9494;552;1779;1686;4121;2238;5900
354070;202208;4893;11784;3362;8850;516;1545;1655;3799;2171;5344
354075;202208;3465;8960;2813;7857;395;1238;1737;4518;2132;5756
354080;202208;1704;4471;1201;3529;203;638;472;1222;675;1860
354085;202208;514;960;399;818;0;0;306;579;306;579
354090;202208;2055;5310;1751;4698;92;271;1368;3519;1460;3790
354100;202208;27114;67882;19778;55635;3830;11652;9625;25537;13455;37189
354105;202208;1632;3887;1195;3147;152;479;608;1444;760;1923
354110;202208;539;1440;414;1212;77;246;170;471;247;717
354120;202208;1625;4194;1137;3179;233;708;391;935;624;1643
354130;202208;7008;17249;4831;13131;1341;3767;844;1874;2185;5641
354140;202208;23709;55838;16996;43804;2430;6969;8633;19952;11063;26921
354150;202208;3334;7580;2604;6475;649;1650;894;2189;1543;3839
354160;202208;3329;8894;2661;7662;615;1942;1091;2855;1706;4797
354165;202208;844;2308;665;1963;90;327;373;998;463;1325
354170;202208;2327;6014;1909;5262;169;546;1099;2765;1268;3311
354180;202208;519;1379;406;1152;39;120;229;597;268;717
354190;202208;1842;4918;1335;3872;93;324;714;1921;807;2245
354200;202208;1107;2521;840;2092;69;204;548;1244;617;1448
354210;202208;1217;2971;986;2617;59;199;693;1691;752;1890
354220;202208;3670;9197;2801;7585;462;1352;1458;3686;1920;5038
354230;202208;938;2149;759;1936;29;103;588;1428;617;1531
354240;202208;2098;5533;1440;4204;256;804;513;1298;769;2102
354250;202208;739;1740;491;1331;106;280;169;417;275;697
354260;202208;10586;24999;8286;21203;1175;3335;4623;10990;5798;14325
354270;202208;1215;3320;996;2920;151;480;468;1229;619;1709
354280;202208;1010;2258;843;2006;45;132;630;1361;675;1493
354290;202208;1138;3356;945;2961;148;497;514;1543;662;2040
354300;202208;4268;11522;3602;10327;869;2492;1695;4704;2564;7196
354310;202208;902;2463;764;2219;157;490;388;1058;545;1548
354320;202208;1138;2616;750;1994;93;288;369;839;462;1127
354323;202208;560;1253;357;896;36;93;180;395;216;488
354325;202208;1697;4828;1126;3515;209;676;223;616;432;1292
354330;202208;11969;28061;8583;21576;910;2658;5476;12558;6386;15216
354340;202208;44459;104719;32336;84477;3996;11797;19553;48084;23549;59881
354350;202208;1408;3355;1130;2913;151;465;694;1627;845;2092
354360;202208;758;1758;479;1317;113;327;152;368;265;695
354370;202208;1184;3117;968;2772;143;434;593;1628;736;2062
354380;202208;747;1918;566;1645;88;331;200;465;288;796
354390;202208;17975;40824;12484;31498;1872;5217;6729;15562;8601;20779
354400;202208;1946;5774;1524;4842;274;917;564;1714;838;2631
354410;202208;8236;19751;6472;16594;958;2761;3695;8673;4653;11434
354420;202208;1798;4331;1304;3447;162;487;728;1711;890;2198
354425;202208;3461;7852;2558;6341;500;1287;1288;3030;1788;4317
354430;202208;1914;4650;1521;4069;108;332;1014;2549;1122;2881
354440;202208;714;1738;466;1260;54;162;241;580;295;742
354450;202208;572;1470;329;996;51;164;105;257;156;421
354460;202208;980;2376;669;1839;144;439;254;644;398;1083
354470;202208;503;1236;351;962;18;68;166;387;184;455
354480;202208;1620;3502;1090;2655;85;247;722;1617;807;1864
354490;202208;982;2709;730;2173;143;431;342;923;485;1354
354500;202208;2654;6889;2125;6053;602;1791;692;1872;1294;3663
354510;202208;901;2354;721;2016;54;186;446;1116;500;1302
354515;202208;499;1349;349;1042;54;170;123;342;177;512
354520;202208;9238;23498;6746;18411;866;2776;3879;9602;4745;12378
354530;202208;6059;15451;4813;13151;1297;3472;1703;4560;3000;8032
354540;202208;1586;3909;1184;3221;223;641;508;1299;731;1940
354550;202208;691;1791;555;1549;74;245;294;737;368;982
354560;202208;2634;6020;1455;3858;160;448;838;2020;998;2468
354570;202208;1360;3312;579;1607;131;359;88;232;219;591
354580;202208;10284;26130;7093;20114;1028;3255;3729;9830;4757;13085
354600;202208;2487;6074;1945;5109;288;763;1159;2880;1447;3643
354610;202208;543;1367;308;890;31;91;145;399;176;490
354620;202208;584;1517;368;1106;34;135;174;454;208;589
354625;202208;365;955;226;690;34;120;64;159;98;279
354630;202208;2901;7716;2412;6820;690;2014;709;1818;1399;3832
354640;202208;4544;11738;3547;9866;422;1403;1826;4514;2248;5917
354650;202208;1019;2535;828;2228;116;303;482;1251;598;1554
354660;202208;4234;9451;2452;6627;300;951;1086;2640;1386;3591
354670;202208;1315;3453;936;2676;185;576;345;872;530;1448
354680;202208;6986;16578;5464;14186;937;2616;3162;7971;4099;10587
354690;202208;630;1802;456;1436;85;275;179;524;264;799
354700;202208;1052;2632;758;2070;86;273;419;1024;505;1297
354710;202208;563;1440;383;1092;44;129;177;445;221;574
354720;202208;356;812;172;468;62;153;45;132;107;285
354730;202208;13079;34656;10314;29548;1363;4308;6227;16843;7590;21151
354740;202208;379;992;169;508;31;100;28;65;59;165
354750;202208;3176;7826;2189;5987;331;999;925;2188;1256;3187
354760;202208;2634;6596;1919;5330;417;1288;708;1731;1125;3019
354765;202208;423;1083;193;568;21;76;68;157;89;233
354770;202208;3012;7017;2230;5645;468;1197;971;2316;1439;3513
354780;202208;72629;168793;56919;139534;4064;12027;40243;91086;44307;103113
354790;202208;1166;3051;913;2639;73;241;591;1626;664;1867
354800;202208;3189;7777;2433;6560;521;1488;1079;2658;1600;4146
354805;202208;1656;3578;1209;2950;114;286;805;1799;919;2085
354810;202208;722;2024;447;1458;70;265;134;386;204;651
354820;202208;1142;3068;817;2470;164;563;284;691;448;1254
354830;202208;632;1441;369;976;80;229;136;312;216;541
354840;202208;1035;2512;641;1718;58;170;360;867;418;1037
354850;202208;26533;62964;19400;50963;1784;5618;12906;31398;14690;37016
354860;202208;2002;5172;1309;3818;209;658;492;1296;701;1954
354870;202208;78489;184028;61725;154392;4907;14402;42274;98001;47181;112403
354880;202208;7211;17041;3828;10111;445;1345;1662;3499;2107;4844
354890;202208;21208;49621;16829;42217;2196;6301;9833;23282;12029;29583
354900;202208;467;1129;309;856;63;200;116;262;179;462
354910;202208;7205;17998;4613;13431;997;3099;1260;3205;2257;6304
354920;202208;598;1524;302;929;46;145;70;167;116;312
354925;202208;335;904;197;606;17;49;52;144;69;193
354930;202208;427;997;295;767;39;104;148;353;187;457
354940;202208;2964;8200;2255;6726;664;2130;787;2027;1451;4157
354950;202208;1880;4360;1539;3924;96;332;1142;2733;1238;3065
354960;202208;1024;2567;742;2119;93;327;324;819;417;1146
354970;202208;5207;13431;4140;11692;360;1262;2829;7573;3189;8835
354980;202208;42268;95337;29787;74328;2889;8733;19389;44405;22278;53138
354990;202208;92921;214850;68763;172809;4511;14060;47789;110539;52300;124599
354995;202208;3940;7735;3080;6663;135;372;2541;5252;2676;5624
355000;202208;1892;4383;1436;3723;219;669;765;1791;984;2460
355010;202208;4939;12577;3293;9174;1075;2906;731;1989;1806;4895
355020;202208;4176;10950;3141;9202;650;2105;1378;3684;2028;5789
355030;202208;1667134;3881314;1250488;3112102;164559;455476;704058;1601474;868617;2056950
355040;202208;3944;8803;3092;7716;251;669;2356;5785;2607;6454
355050;202208;1322;2809;978;2336;232;572;448;971;680;1543
355060;202208;7883;19715;5933;16247;910;2874;3270;8113;4180;10987
355070;202208;12441;29382;10347;26153;1109;3330;6906;16221;8015;19551
355080;202208;1140;3099;727;2349;160;557;130;356;290;913
355090;202208;1589;4081;1276;3565;226;695;677;1733;903;2428
355100;202208;30259;72839;24355;64216;3179;9062;15997;40719;19176;49781
355110;202208;1134;2914;827;2467;192;630;84;213;276;843
355120;202208;880;2166;627;1802;78;249;303;815;381;1064
355130;202208;984;2102;555;1347;26;76;383;839;409;915
355140;202208;2620;5100;2225;4559;90;220;1964;3913;2054;4133
355150;202208;5682;13729;4620;11952;497;1399;3033;7451;3530;8850
355160;202208;2787;7141;2013;5825;442;1387;583;1520;1025;2907
355170;202208;14425;33796;11488;29048;1855;5123;6519;15646;8374;20769
355180;202208;3444;8245;2556;6897;458;1458;1328;3222;1786;4680
355190;202208;2280;5675;1805;4921;647;1808;650;1897;1297;3705
355200;202208;1043;2966;891;2725;251;842;321;940;572;1782
355210;202208;3765;9538;2867;7692;560;1592;1315;3310;1875;4902
355220;202208;62235;151931;50735;130765;7379;21360;28789;67539;36168;88899
355230;202208;1457;3525;807;2243;141;410;284;673;425;1083
355240;202208;29564;74304;21254;58611;2195;6860;12835;32927;15030;39787
355250;202208;47718;118372;36671;97919;7638;21605;17814;44250;25452;65855
355255;202208;758;1843;412;1217;44;123;128;366;172;489
355260;202208;1909;4187;1415;3439;108;360;992;2210;1100;2570
355270;202208;1386;3824;1102;3280;232;722;492;1352;724;2074
355280;202208;39152;92478;29009;74484;3390;9669;16795;39913;20185;49582
355290;202208;1130;2814;877;2410;160;440;425;1103;585;1543
355300;202208;1655;4480;1369;3968;243;744;613;1596;856;2340
355310;202208;1084;2802;806;2317;104;327;449;1242;553;1569
355320;202208;644;1634;490;1348;106;350;208;456;314;806
355330;202208;3601;8534;2823;7218;123;414;2147;5158;2270;5572
355340;202208;4929;10484;3792;9017;661;1586;2059;4995;2720;6581
355350;202208;1695;4420;1296;3683;245;794;575;1476;820;2270
355360;202208;1513;3562;1185;3068;137;370;702;1670;839;2040
355365;202208;429;1037;229;697;40;124;64;175;104;299
355370;202208;6630;15835;5195;13585;1109;2572;2439;6713;3548;9285
355380;202208;3484;8692;2714;7331;526;1548;1050;2438;1576;3986
355385;202208;1729;4143;1433;3727;105;353;945;2208;1050;2561
355390;202208;973;2537;704;1992;109;339;331;825;440;1164
355395;202208;2232;5958;1627;4766;266;858;680;1734;946;2592
355400;202208;11335;30337;9168;26230;1964;6376;3931;10008;5895;16384
355410;202208;29316;75758;19511;56165;3804;11971;6958;18632;10762;30603
355420;202208;742;2225;614;1986;142;521;204;600;346;1121
355430;202208;4479;10646;3472;8909;609;1657;1761;4345;2370;6002
355440;202208;890;2284;575;1657;98;280;130;318;228;598
355450;202208;4216;10252;2929;7846;424;1272;1427;3357;1851;4629
355460;202208;600;1412;396;1063;41;124;180;450;221;574
355465;202208;568;1362;457;1187;66;167;288;724;354;891
355470;202208;1396;3365;816;2224;208;625;287;695;495;1320
355475;202208;415;892;346;806;13;31;262;587;275;618
355480;202208;5085;13092;4062;11507;528;1734;2617;7139;3145;8873
355490;202208;1057;2724;607;1825;58;203;291;796;349;999
355495;202208;1068;2762;804;2321;104;376;358;891;462;1267
355500;202208;8395;20208;5515;14875;750;2285;2486;5866;3236;8151
355510;202208;1655;3912;1127;3037;202;567;470;1136;672;1703
355520;202208;403;938;215;617;46;130;61;173;107;303
355530;202208;370;816;154;410;7;21;81;191;88;212
355535;202208;646;1682;515;1467;105;328;250;633;355;961
355540;202208;15032;33982;12568;30635;1251;3475;9240;21556;10491;25031
355550;202208;749;2092;638;1886;71;239;354;940;425;1179
355560;202208;1323;3282;767;2222;162;514;33;99;195;613
355570;202208;351;898;200;579;41;129;54;139;95;268
355580;202208;1423;3266;876;2351;159;477;269;653;428;1130
355590;202208;190;481;144;405;13;37;77;204;90;241
355600;202208;1796;4248;1148;3111;200;592;355;911;555;1503
355610;202208;2313;5381;1562;4115;195;546;867;2082;1062;2628
355620;202208;6110;15283;4669;12582;507;1662;2712;6569;3219;8231
355630;202208;3064;7688;2217;6169;275;823;1291;3320;1566;4143
355635;202208;1119;3044;819;2463;126;404;303;821;429;1225
355640;202208;4093;10643;2771;8066;642;1856;648;1857;1290;3713
355645;202208;4732;12440;3443;10172;485;1598;1908;5339;2393;6937
355650;202208;8773;21904;7041;18853;1454;4104;3411;8344;4865;12448
355660;202208;1665;4116;1142;3218;210;549;309;797;519;1346
355670;202208;5027;12624;3634;9684;472;1527;1885;4251;2357;5778
355680;202208;3361;8827;1707;5114;468;1510;141;405;609;1915
355690;202208;887;2469;611;1956;182;607;12;24;194;631
355695;202208;301;788;176;520;13;43;39;82;52;125
355700;202208;9629;25246;8136;22192;993;3086;5017;12736;6010;15822
355710;202208;11809;26572;8233;20158;1109;3206;4461;9370;5570;12576
355715;202208;547;1431;299;878;71;207;57;160;128;367
355720;202208;1750;4530;1378;3908;199;624;767;1991;966;2615
355730;202208;1232;3110;988;2695;107;346;557;1382;664;1728
410010;202208;1442;3819;1099;3126;241;717;247;659;488;1376
410020;202208;1283;3499;961;2833;267;760;261;717;528;1477
410030;202208;1961;4898;1638;4406;222;609;883;2370;1105;2979
410040;202208;16975;43666;12619;35754;2631;8022;4311;11112;6942;19134
410045;202208;887;2300;644;1803;121;374;224;548;345;922
410050;202208;2613;6348;1841;5033;277;845;726;1814;1003;2659
410060;202208;2420;6436;1945;5564;477;1470;560;1487;1037;2957
410070;202208;2333;5599;1715;4526;331;959;639;1464;970;2423
410080;202208;1596;4052;1140;3271;257;764;251;658;508;1422
410090;202208;1343;3018;1101;2681;127;283;577;1499;704;1782
410100;202208;2450;6596;1705;4957;320;1001;183;492;503;1493
410105;202208;618;1464;382;1025;27;81;191;462;218;543
410110;202208;3885;9077;2800;7212;371;1095;1447;3350;1818;4445
410115;202208;658;1620;476;1301;60;184;193;462;253;646
410120;202208;3664;8907;3215;8250;503;1261;2076;5249;2579;6510
410130;202208;1544;3813;1358;3487;194;554;801;1949;995;2503
410140;202208;20519;47642;13736;35850;2558;7232;4318;10123;6876;17355
410150;202208;19392;44155;10561;27482;1811;5077;3204;7163;5015;12240
410160;202208;3498;9286;2848;8174;623;2000;1060;2846;1683;4846
410165;202208;729;1877;570;1554;77;243;306;772;383;1015
410170;202208;3451;8499;2186;5893;438;1305;288;654;726;1959
410180;202208;19922;52218;15543;43698;2471;7672;7799;19585;10270;27257
410185;202208;521;1429;395;1133;71;220;134;320;205;540
410190;202208;2616;6250;1885;4957;407;1085;495;1143;902;2228
410200;202208;6840;14816;3830;9809;750;2052;675;1552;1425;3604
410210;202208;3704;8942;2356;6577;378;1189;802;1904;1180;3093
410220;202208;630;1564;424;1187;77;233;142;352;219;585
410230;202208;2220;5637;1704;4635;247;778;746;1729;993;2507
410240;202208;6059;15147;4209;11697;842;2693;693;1644;1535;4337
410250;202208;2693;6269;1977;5130;177;536;943;2304;1120;2840
410260;202208;2289;5326;1424;3769;211;581;727;1791;938;2372
410270;202208;575;1460;415;1169;56;183;168;412;224;595
410275;202208;710;1881;491;1416;80;273;205;511;285;784
410280;202208;2786;6964;1911;5351;235;753;857;2114;1092;2867
410290;202208;3863;10195;2683;7830;772;2198;718;2069;1490;4267
410300;202208;817;1915;642;1647;59;190;342;767;401;957
410302;202208;380;916;230;652;23;77;104;273;127;350
410304;202208;1704;3773;1484;3390;139;342;1120;2422;1259;2764
410305;202208;1996;4501;1399;3642;122;341;925;2301;1047;2642
410310;202208;3457;8489;2855;7448;245;842;1886;4560;2131;5402
410315;202208;885;1914;550;1395;179;458;153;382;332;840
410320;202208;1133;3039;758;2300;105;338;129;348;234;686
410322;202208;761;1961;394;1143;57;165;147;365;204;530
410330;202208;1767;4096;1227;3119;195;511;425;983;620;1494
410335;202208;988;2482;742;2045;127;386;293;716;420;1102
410337;202208;943;2245;658;1713;96;268;234;515;330;783
410340;202208;557;1487;378;1068;29;98;170;381;199;479
410345;202208;3075;7710;1848;5172;393;1168;654;1601;1047;2769
410347;202208;899;2201;665;1800;73;195;203;544;276;739
410350;202208;1908;4430;1373;3581;146;452;758;1764;904;2216
410360;202208;4638;11233;3493;9262;620;1711;1279;3241;1899;4952
410370;202208;16555;42345;10863;29508;1260;3872;4619;10502;5879;14374
410380;202208;2050;4761;1479;3796;230;666;550;1224;780;1890
410390;202208;3376;7693;2271;5886;470;1442;922;2009;1392;3451
410395;202208;1057;2840;833;2409;158;467;316;923;474;1390
410400;202208;9040;21455;6874;17565;850;2407;4083;9579;4933;11986
410405;202208;1043;2294;733;1837;109;304;368;822;477;1126
410410;202208;1805;4312;1623;4037;130;379;1146;2781;1276;3160
410420;202208;14196;35687;10800;29294;1752;5145;4884;11809;6636;16954
410425;202208;4306;11090;2964;8419;524;1592;1128;2835;1652;4427
410430;202208;15646;37244;11155;29324;1722;5012;4379;10332;6101;15344
410440;202208;2776;7447;2388;6748;372;1164;1310;3521;1682;4685
410442;202208;2909;8052;2339;6874;640;1954;664;1838;1304;3792
410445;202208;2632;7089;1859;5633;414;1373;270;881;684;2254
410450;202208;1795;4172;1340;3486;231;642;487;1139;718;1781
410460;202208;2802;6563;2037;5244;283;823;992;2280;1275;3103
410465;202208;3467;9325;2681;7889;520;1537;945;2492;1465;4029
410470;202208;2781;7156;1959;5734;577;1877;196;585;773;2462
410480;202208;47062;108418;27090;74282;4048;12471;7774;17884;11822;30355
410490;202208;13848;35699;10108;28283;1657;4939;4555;11499;6212;16438
410500;202208;2149;5282;1417;3926;258;761;323;720;581;1481
410510;202208;2117;5040;1472;3939;339;860;443;1209;782;2069
410520;202208;3527;10256;3084;9428;955;3072;1116;3420;2071;6492
410530;202208;1819;4303;874;2412;113;342;237;517;350;859
410540;202208;3304;8385;2288;6411;359;1159;998;2521;1357;3680
410550;202208;9063;23076;6179;17152;1043;3170;1814;4185;2857;7355
410560;202208;1860;4552;1357;3578;300;857;415;910;715;1767
410570;202208;3165;7967;2269;6452;764;2501;245;668;1009;3169
410580;202208;33019;80093;25089;66107;3720;11006;13060;31426;16780;42432
410590;202208;1992;5237;1392;3879;197;594;448;1007;645;1601
410600;202208;2114;5204;1663;4359;344;911;579;1465;923;2376
410610;202208;818;1987;618;1637;56;172;306;720;362;892
410620;202208;3267;8382;2331;6422;594;1729;580;1451;1174;3180
410630;202208;3004;7324;2011;5426;374;1185;500;1015;874;2200
410640;202208;5922;13244;4106;10133;913;2482;670;1650;1583;4132
410645;202208;1478;3631;1228;3326;168;507;875;2315;1043;2822
410650;202208;2925;7500;2034;5737;374;1159;831;2090;1205;3249
410655;202208;1012;2339;707;1830;67;199;325;746;392;945
410657;202208;709;1851;442;1298;72;227;168;412;240;639
410660;202208;4346;10270;2668;6882;419;1145;984;2193;1403;3338
410670;202208;1178;2840;719;1959;116;321;261;626;377;947
410680;202208;2796;7921;1855;5662;436;1365;338;995;774;2360
410685;202208;606;1475;442;1196;97;290;182;460;279;750
410690;202208;166674;384706;116508;295500;17599;50619;51826;114463;69425;165082
410700;202208;2885;6979;2370;6193;528;1415;970;2377;1498;3792
410710;202208;1059;2554;681;1858;141;416;288;688;429;1104
410712;202208;797;2053;662;1812;95;282;367;958;462;1240
410715;202208;1033;2803;646;1966;71;241;266;738;337;979
410720;202208;4353;10215;3591;8964;534;1615;1333;3073;1867;4688
410725;202208;1364;3165;824;2215;191;564;170;371;361;935
410730;202208;947;2319;671;1822;111;342;145;389;256;731
410740;202208;1002;2657;755;2207;63;227;378;1074;441;1301
410750;202208;2278;5205;1805;4393;294;753;917;2075;1211;2828
410752;202208;452;1060;245;677;51;128;96;248;147;376
410753;202208;386;1068;270;826;38;137;85;232;123;369
410754;202208;1282;3091;1065;2776;77;197;763;2025;840;2222
410755;202208;658;1602;481;1292;71;185;214;515;285;700
410760;202208;4262;10549;3013;8303;703;2289;819;2089;1522;4378
410765;202208;20261;51980;16091;44314;3251;9908;5303;12437;8554;22345
410770;202208;1208;2747;839;2142;87;192;424;1083;511;1275
410773;202208;1537;3724;1319;3379;134;391;885;2153;1019;2544
410775;202208;1920;4119;1676;3779;48;122;1269;2710;1317;2832
410780;202208;738;1742;493;1292;89;246;160;379;249;625
410785;202208;905;2101;658;1708;85;264;278;680;363;944
410790;202208;1213;3327;1000;2930;217;679;146;344;363;1023
410800;202208;4037;8310;3239;7192;73;222;2206;4640;2279;4862
410810;202208;516;1305;377;1042;38;139;179;420;217;559
410820;202208;1184;3149;653;1828;134;402;144;313;278;715
410830;202208;51942;116239;37209;92208;6255;17616;17383;39120;23638;56736
410832;202208;1272;3190;1035;2785;99;324;645;1576;744;1900
410840;202208;10671;25462;6373;17481;1318;4048;1870;4200;3188;8248
410845;202208;1362;3103;1053;2656;151;422;543;1277;694;1699
410850;202208;2507;6652;2173;6074;379;1209;1051;2742;1430;3951
410855;202208;833;1977;526;1392;60;176;264;605;324;781
410860;202208;5571;12466;4405;10618;245;747;2991;6638;3236;7385
410865;202208;1689;4504;1434;4047;148;470;811;2338;959;2808
410870;202208;1398;3543;1114;3053;140;421;641;1678;781;2099
410880;202208;5563;13982;3885;11049;710;2102;735;2043;1445;4145
410890;202208;1295;3327;1023;2837;191;549;440;1122;631;1671
410895;202208;1177;3456;966;3009;299;1038;261;707;560;1745
410900;202208;986;2510;672;1951;92;295;162;353;254;648
410910;202208;514;1125;319;771;15;39;188;402;203;441
410920;202208;1038;2334;788;1955;112;312;415;958;527;1270
410930;202208;2046;4984;1417;3920;358;1128;251;627;609;1755
410940;202208;29068;73648;21405;60299;3989;12469;8468;22055;12457;34524
410950;202208;2322;6098;2073;5715;144;398;1636;4439;1780;4837
410960;202208;9971;22723;7039;18038;1755;5171;2921;6882;4676;12053
410965;202208;1342;3234;872;2403;107;337;453;1143;560;1480
410970;202208;4874;12397;3444;9675;868;2853;575;1272;1443;4125
410975;202208;1726;3901;1281;3219;187;532;587;1391;774;1923
410980;202208;8760;20649;5790;15548;604;1822;2786;6664;3390;8486
410990;202208;1742;3874;1196;3057;200;562;564;1387;764;1949
411000;202208;792;2071;550;1630;103;342;180;469;283;811
411005;202208;549;1285;337;869;41;115;129;281;170;396
411007;202208;2985;7481;2197;6084;430;1321;828;2120;1258;3441
411010;202208;5194;14383;4024;12109;1098;3423;624;1646;1722;5069
411020;202208;2767;7275;2276;6464;582;1724;731;1984;1313;3708
411030;202208;840;2014;576;1494;74;213;248;544;322;757
411040;202208;1191;2881;633;1719;103;292;169;375;272;667
411050;202208;2310;6823;1855;5889;406;1428;350;901;756;2329
411060;202208;2600;6554;1697;4736;359;1025;462;1158;821;2183
411065;202208;456;1100;281;760;27;85;122;296;149;381
411070;202208;9062;21349;7198;18395;847;2482;4010;9579;4857;12061
411080;202208;2346;5810;1888;5026;461;1388;533;1307;994;2695
411090;202208;928;2402;590;1735;86;276;138;348;224;624
411095;202208;2949;6682;1700;4513;248;684;312;709;560;1393
411100;202208;1431;3519;970;2692;108;364;363;923;471;1287
411110;202208;754;1898;353;1053;38;102;25;47;63;149
411120;202208;1829;4501;1496;3975;287;924;670;1552;957;2476
411125;202208;6362;17234;5612;15911;1325;3802;2454;7081;3779;10883
411130;202208;854;2143;596;1659;158;425;156;458;314;883
411140;202208;2563;7432;2099;6478;527;1697;637;1978;1164;3675
411150;202208;4783;11486;3144;8328;669;1901;339;699;1008;2600
411155;202208;1251;2944;833;2202;119;350;403;905;522;1255
411160;202208;447;961;298;729;31;86;91;218;122;304
411170;202208;945;2553;716;2083;158;514;306;819;464;1333
411180;202208;6929;16917;5549;14564;773;2289;2956;6977;3729;9266
411190;202208;2394;5883;1819;4887;247;742;816;1897;1063;2639
411200;202208;5877;14788;4412;12224;928;3002;1459;3358;2387;6360
411210;202208;4124;8771;2944;6900;416;1099;1379;2974;1795;4073
411220;202208;1119;2672;766;2041;147;404;251;615;398;1019
411230;202208;1012;2564;751;2078;163;480;240;611;403;1091
411240;202208;1859;4193;1296;3271;226;615;520;1203;746;1818
411250;202208;2692;6706;1958;5418;398;1219;613;1533;1011;2752
411260;202208;370;910;250;678;32;110;95;212;127;322
411270;202208;2334;5881;1696;4652;265;779;791;1935;1056;2714
411275;202208;1886;3975;1335;3128;135;405;786;1639;921;2044
411280;202208;1682;4281;1217;3416;307;902;295;738;602;1640
411290;202208;966;2392;630;1746;56;190;347;909;403;1099
411295;202208;1465;3512;1063;2797;144;405;484;1156;628;1561
411300;202208;1180;2846;770;2065;86;267;316;688;402;955
411310;202208;1081;2299;843;1992;127;325;436;963;563;1288
411320;202208;6653;15905;4975;13045;716;2090;2384;5448;3100;7538
411325;202208;1709;4451;1387;3857;281;791;657;1866;938;2657
411330;202208;3818;9658;2788;7843;622;1963;848;2259;1470;4222
411340;202208;966;2541;577;1701;84;261;171;431;255;692
411342;202208;1248;2901;678;1779;123;355;246;549;369;904
411345;202208;1434;3353;1047;2704;73;219;697;1733;770;1952
411350;202208;3431;8741;2276;6503;589;1770;422;1062;1011;2832
411360;202208;924;2031;698;1691;68;211;404;846;472;1057
411370;202208;70031;165029;51571;134513;4050;12640;30798;73341;34848;85981
411373;202208;1697;3979;1338;3448;153;408;654;1693;807;2101
411375;202208;1320;3131;921;2405;106;294;380;908;486;1202
411380;202208;1352;2965;916;2172;47;119;608;1319;655;1438
411390;202208;1819;4643;1421;3831;215;647;604;1359;819;2006
411400;202208;2753;6365;2080;5202;198;568;1155;2681;1353;3249
411410;202208;3330;8837;2472;7093;540;1676;621;1587;1161;3263
411420;202208;4984;11698;2695;7505;366;1112;528;1063;894;2175
411430;202208;4641;11433;3522;9444;697;2096;1267;2887;1964;4983
411435;202208;522;1343;304;910;50;155;82;213;132;368
411440;202208;3047;7885;2403;6716;493;1496;749;1895;1242;3391
411450;202208;3013;7423;2273;6232;294;806;1298;3540;1592;4346
411460;202208;5264;13052;3352;9470;511;1632;791;1824;1302;3456
411470;202208;998;2369;754;1957;119;361;358;821;477;1182
411480;202208;6383;15846;4646;12724;839;2705;1595;3758;2434;6463
411490;202208;1982;4710;1502;3974;176;539;671;1578;847;2117
411500;202208;1596;4059;1099;3029;186;556;232;493;418;1049
411510;202208;2736;6315;2166;5436;336;1005;673;1667;1009;2672
411520;202208;41601;97761;25490;66916;3023;9313;11127;25225;14150;34538
411530;202208;1093;2679;611;1768;99;324;128;338;227;662
411535;202208;604;1675;409;1243;50;163;125;334;175;497
411540;202208;3101;7152;2181;5545;98;288;1325;3235;1423;3523
411545;202208;1056;2875;880;2559;68;226;574;1631;642;1857
411550;202208;817;1921;629;1593;103;269;197;444;300;713
411560;202208;2295;6117;1260;3877;192;625;99;219;291;844
411570;202208;8794;19384;6134;15445;1411;3833;1836;4283;3247;8116
411573;202208;919;2322;738;2004;139;439;356;859;495;1298
411575;202208;2403;6040;1772;4845;327;961;569;1404;896;2365
411580;202208;5619;12788;3400;9223;519;1597;625;1366;1144;2963
411585;202208;693;1973;343;1084;65;205;63;179;128;384
411590;202208;526;1346;390;1088;42;139;210;528;252;667
411600;202208;396;931;251;695;40;114;103;251;143;365
411605;202208;1859;4092;1200;3098;156;462;578;1498;734;1960
411610;202208;3383;7079;2445;5500;55;188;1841;3786;1896;3974
411620;202208;3460;8401;2890;7546;496;1340;1456;3739;1952;5079
411630;202208;982;2372;637;1772;102;350;250;587;352;937
411640;202208;549;1364;379;1010;52;142;147;323;199;465
411650;202208;225;615;139;430;28;93;32;79;60;172
411660;202208;1048;2502;733;1917;91;247;290;673;381;920
411670;202208;1791;4006;1191;2947;106;279;697;1557;803;1836
411680;202208;1672;4241;1248;3433;247;744;444;1129;691;1873
411690;202208;4670;11179;3428;9055;714;1893;1061;2830;1775;4723
411695;202208;739;2088;513;1525;43;138;231;634;274;772
411700;202208;1942;4814;1299;3607;306;888;258;660;564;1548
411705;202208;2812;7413;2368;6683;369;1088;1483;4245;1852;5333
411710;202208;2391;5799;1644;4428;356;990;498;1200;854;2190
411720;202208;1229;2818;869;2198;128;327;325;754;453;1081
411721;202208;1130;2702;832;2165;136;364;270;656;406;1020
411722;202208;1090;2873;635;1840;107;334;218;493;325;827
411725;202208;1484;3961;965;2935;224;735;233;641;457;1376
411727;202208;1702;4470;1117;3263;245;742;140;330;385;1072
411729;202208;693;1676;399;1106;63;207;117;257;180;464
411730;202208;6493;15894;5024;13140;889;2589;2382;5872;3271;8461
411740;202208;583;1460;323;918;80;212;68;153;148;365
411745;202208;892;2420;633;1857;83;274;157;338;240;612
411750;202208;7196;17827;5364;14429;665;1994;2759;6877;3424;8871
411760;202208;8689;21243;6644;18001;2017;5648;1510;4303;3527;9951
411770;202208;3807;10314;2813;8219;617;1920;661;1703;1278;3623
411780;202208;3127;8147;2671;7389;699;2014;982;2771;1681;4785
411790;202208;3591;8174;2195;5771;321;977;773;1703;1094;2680
411800;202208;1348;3690;964;2763;193;601;216;507;409;1108
411810;202208;1793;4393;1326;3517;225;632;517;1223;742;1855
411820;202208;17549;44029;14681;39302;3251;8964;7579;19545;10830;28509
411830;202208;582;1418;428;1132;113;256;60;162;173;418
411840;202208;14753;37022;10379;28374;1643;4868;3618;8581;5261;13449
411845;202208;740;2013;458;1391;72;253;131;347;203;600
411850;202208;9327;22269;6468;17430;1655;4635;1325;3187;2980;7822
411860;202208;860;2268;649;1854;101;325;146;384;247;709
411870;202208;686;1879;497;1470;128;436;99;245;227;681
411880;202208;2858;6478;2068;5243;254;737;977;2268;1231;3005
411885;202208;1269;3198;898;2505;129;424;240;532;369;956
411890;202208;1701;4310;1235;3517;222;689;143;377;365;1066
411900;202208;985;2534;615;1775;145;442;114;314;259;756
411910;202208;1254;3526;906;2844;173;652;280;782;453;1434
411915;202208;18505;43603;12951;33720;1871;5410;5748;13333;7619;18743
411920;202208;1399;3728;1149;3276;255;798;449;1161;704;1959
411925;202208;574;1413;394;1085;66;193;182;455;248;648
411930;202208;6011;16660;5073;15038;2356;7325;598;1954;2954;9279
411940;202208;3951;10632;3102;8955;730;2186;1139;2922;1869;5108
411950;202208;18029;45166;15034;40416;1614;5038;9658;24490;11272;29528
411960;202208;7094;17633;5602;14850;1009;2965;2318;5556;3327;8521
411965;202208;570;1490;409;1162;52;163;194;490;246;653
411970;202208;1374;2862;1074;2471;203;404;497;1325;700;1729
411980;202208;1893;4194;1384;3424;287;702;623;1463;910;2165
411990;202208;47182;116234;31672;89073;5571;17272;13145;34161;18716;51433
411995;202208;5583;12727;4334;10829;1155;3209;1373;3210;2528;6419
412000;202208;2227;4816;1589;3759;42;137;1173;2565;1215;2702
412010;202208;718;2038;506;1585;59;209;132;329;191;538
412015;202208;613;1626;491;1399;75;214;256;725;331;939
412020;202208;539;1460;332;1026;52;183;107;300;159;483
412030;202208;714;1903;529;1570;70;229;231;622;301;851
412033;202208;1082;2728;755;2107;77;222;292;690;369;912
412035;202208;820;2134;524;1592;86;266;255;744;341;1010
412040;202208;812;2082;491;1438;69;188;94;243;163;431
412050;202208;1765;4195;1201;3204;288;848;256;657;544;1505
412060;202208;8626;23149;7023;20028;1818;5878;2017;5312;3835;11190
412065;202208;749;1927;552;1552;110;333;155;395;265;728
412070;202208;1526;3689;1175;3033;143;429;529;1164;672;1593
412080;202208;3011;7423;2204;5917;288;885;1023;2304;1311;3189
412085;202208;383;893;149;421;13;44;39;78;52;122
412090;202208;7540;17864;5568;14482;1202;3408;2358;5940;3560;9348
412100;202208;2164;5370;1604;4399;484;1462;415;1151;899;2613
412110;202208;1104;2772;696;1960;91;274;221;524;312;798
412120;202208;2711;7043;2092;5962;448;1427;658;1604;1106;3031
412125;202208;844;2232;531;1593;100;298;110;302;210;600
412130;202208;928;2211;616;1633;119;313;149;374;268;687
412135;202208;681;1752;339;992;44;164;126;306;170;470
412140;202208;2277;5244;1618;4132;275;769;451;1096;726;1865
412150;202208;3260;7867;2707;6910;458;1361;1429;3236;1887;4597
412160;202208;1036;3119;566;1860;49;170;45;98;94;268
412170;202208;5398;13531;4524;12165;840;2478;2135;5166;2975;7644
412175;202208;1546;4164;1270;3681;276;822;485;1350;761;2172
412180;202208;1987;5197;1474;4279;198;660;633;1662;831;2322
412190;202208;3839;9169;2758;7270;333;997;1138;2810;1471;3807
412200;202208;2248;6048;1472;4353;376;1224;297;768;673;1992
412210;202208;778;1779;481;1295;70;210;209;507;279;717
412215;202208;3901;9849;2786;7699;614;1745;1208;3338;1822;5083
412217;202208;1170;2801;964;2446;21;74;724;1697;745;1771
412220;202208;6986;19015;5592;16457;1290;3822;1758;5025;3048;8847
412230;202208;3191;8734;2497;7479;385;1335;492;1243;877;2578
412240;202208;9239;22898;6079;16906;1056;3154;1872;4515;2928;7669
412250;202208;2297;5627;1673;4487;417;1184;350;812;767;1996
412260;202208;1589;3891;1208;3169;226;620;413;990;639;1610
412265;202208;1176;2862;946;2497;117;350;582;1395;699;1745
412270;202208;1205;3182;795;2323;110;355;319;840;429;1195
412280;202208;478;1228;361;1024;84;251;90;221;174;472
412290;202208;1244;2944;898;2352;165;470;335;816;500;1286
412300;202208;2039;5010;1490;4071;263;757;443;1101;706;1858
412310;202208;793;2199;597;1815;100;364;166;435;266;799
412320;202208;865;2138;552;1522;59;210;175;442;234;652
412330;202208;1831;4583;1244;3528;264;812;413;1146;677;1958
412340;202208;1371;3577;995;2830;153;500;151;380;304;880
412350;202208;3638;9173;2423;6831;458;1363;616;1499;1074;2862
412360;202208;331;820;249;666;6;24;172;434;178;458
412370;202208;1200;3116;856;2452;179;526;223;600;402;1126
412380;202208;1757;4653;1253;3681;308;996;93;281;401;1277
412382;202208;574;1334;375;1002;45;158;197;425;242;583
412385;202208;2754;6761;2212;5808;622;1614;839;2269;1461;3883
412390;202208;2921;6675;2288;5678;418;1085;771;1857;1189;2942
412395;202208;886;2318;628;1763;87;236;300;795;387;1031
412400;202208;1113;2742;766;2093;143;420;234;554;377;974
412402;202208;2797;6520;1937;5138;423;1115;532;1395;955;2510
412405;202208;3568;9030;2332;6795;670;1935;294;828;964;2763
412410;202208;7458;18396;5526;15335;949;3065;1820;4616;2769;7681
412420;202208;623;1478;403;1055;40;118;178;413;218;531
412430;202208;642;1564;354;972;44;122;147;365;191;487
412440;202208;3479;8562;2426;6748;581;1631;730;1950;1311;3581
412450;202208;604;1692;395;1180;58;180;43;83;101;263
412460;202208;1311;3103;1023;2639;172;482;483;1172;655;1654
412470;202208;1866;5403;1530;4689;371;1260;428;1199;799;2459
412480;202208;1512;3620;1035;2706;171;486;411;925;582;1411
412490;202208;1576;3611;1202;2989;82;223;713;1614;795;1837
412500;202208;2409;5670;1807;4624;308;852;653;1467;961;2319
412510;202208;2268;6469;1645;4993;445;1465;313;736;758;2201
412520;202208;1609;3870;960;2598;201;536;167;402;368;938
412530;202208;783;2007;566;1591;81;233;111;282;192;515
412535;202208;920;2353;607;1753;124;381;90;187;214;568
412540;202208;1267;3107;902;2480;160;552;239;624;399;1176
412545;202208;787;1964;560;1524;99;294;185;469;284;763
412550;202208;43257;107908;31727;86063;4618;13815;14995;36108;19613;49923
412555;202208;339;834;227;600;31;103;74;142;105;245
412560;202208;6156;16285;4665;13122;1069;3280;1198;3029;2267;6309
412570;202208;5298;12551;3212;8745;558;1754;612;1383;1170;3137
412575;202208;1282;2954;1035;2566;181;454;542;1218;723;1672
412580;202208;1818;4381;1309;3480;111;332;749;1816;860;2148
412590;202208;519;1299;281;797;52;171;36;73;88;244
412600;202208;2000;4845;1569;4041;113;370;979;2268;1092;2638
412610;202208;980;2494;709;1933;95;274;330;772;425;1046
412620;202208;1475;3605;1136;3088;222;644;463;1166;685;1810
412625;202208;10575;26856;6891;19781;1295;3976;706;1746;2001;5722
412627;202208;1317;3492;919;2722;212;691;223;624;435;1315
412630;202208;3252;9070;2260;6981;385;1279;559;1507;944;2786
412635;202208;524;1336;325;929;41;134;114;258;155;392
412640;202208;1177;2991;673;1940;97;268;142;343;239;611
412650;202208;1939;5034;1523;4196;248;781;601;1440;849;2221
412660;202208;3104;7509;2225;5873;259;760;847;1972;1106;2732
412665;202208;472;1119;359;930;59;175;157;371;216;546
412667;202208;1987;5016;1447;3970;213;642;636;1667;849;2309
412670;202208;1024;2279;715;1808;149;395;236;516;385;911
412680;202208;2439;6176;1667;4762;201;666;525;1227;726;1893
412690;202208;1342;3282;928;2503;176;532;326;775;502;1307
412700;202208;2219;5451;1849;4877;307;881;940;2357;1247;3238
412710;202208;6701;18341;4977;14823;907;2951;1392;3499;2299;6450
412720;202208;1457;3959;1169;3380;177;570;359;825;536;1395
412730;202208;3131;7684;2281;6102;393;1157;906;2174;1299;3331
412740;202208;2354;6217;1616;4806;314;1038;269;750;583;1788
412750;202208;4654;11549;3794;10273;409;1243;2289;5814;2698;7057
412760;202208;3556;8953;2963;7985;565;1761;1639;4077;2204;5838
412770;202208;13583;34009;7648;22553;1004;3146;1739;4195;2743;7341
412780;202208;1475;3626;1089;2957;259;773;385;933;644;1706
412785;202208;2595;5692;1816;4445;276;664;1128;2687;1404;3351
412788;202208;1648;4359;1330;3811;355;1011;506;1384;861;2395
412790;202208;1606;4027;997;2873;151;492;359;847;510;1339
412795;202208;1445;3551;818;2343;139;432;171;434;310;866
412796;202208;2648;7115;2225;6384;507;1582;725;1883;1232;3465
412800;202208;4758;10633;3425;8305;371;1093;1844;3836;2215;4929
412810;202208;14991;36477;10118;27021;1172;3654;4412;10275;5584;13929
412820;202208;7431;19291;5295;15139;1254;3804;1573;4320;2827;8124
412830;202208;386;1058;294;868;37;104;73;202;110;306
412840;202208;2211;5018;1557;3813;136;393;910;1968;1046;2361
412850;202208;3207;7905;2387;6579;267;861;1217;3041;1484;3902
412853;202208;1858;4359;1542;3828;200;581;867;1848;1067;2429
412855;202208;1592;3909;876;2436;124;393;206;447;330;840
412860;202208;868;2094;570;1598;100;321;226;542;326;863
412862;202208;760;1831;511;1426;95;250;199;525;294;775
412863;202208;1474;4056;1307;3747;278;895;626;1616;904;2511
412865;202208;792;2039;573;1611;153;438;142;383;295;821
412870;202208;1081;2617;789;2160;222;686;238;630;460;1316
412880;202208;1054;2720;760;2175;148;461;256;653;404;1114
420005;202208;504;1401;295;903;27;81;147;438;174;519
420010;202208;3756;8644;2503;6545;166;480;1863;4816;2029;5296
420020;202208;554;1628;378;1188;66;247;137;332;203;579
420030;202208;133;453;93;348;26;106;21;81;47;187
420040;202208;677;1965;406;1362;89;347;35;103;124;450
420050;202208;813;1815;553;1358;115;326;307;654;422;980
420055;202208;192;559;107;350;22;83;37;108;59;191
420060;202208;188;524;135;402;24;65;55;159;79;224
420070;202208;993;2730;765;2275;171;548;370;1033;541;1581
420075;202208;96;251;54;164;8;26;17;37;25;63
420080;202208;501;1360;355;1003;71;219;133;330;204;549
420090;202208;495;1465;316;1058;70;255;75;209;145;464
420100;202208;1735;3991;1422;3503;89;235;1072;2605;1161;2840
420110;202208;321;951;276;856;42;149;147;437;189;586
420120;202208;722;1874;504;1417;72;226;252;625;324;851
420125;202208;423;1208;294;927;63;217;96;272;159;489
420127;202208;375;971;163;493;31;115;65;175;96;290
420130;202208;5180;13670;3975;11619;743;2451;1662;4277;2405;6728
420140;202208;5171;13099;3950;11024;1120;3401;1020;2640;2140;6041
420150;202208;787;1929;576;1590;50;162;340;905;390;1067
420160;202208;247;599;104;308;17;64;33;82;50;146
420165;202208;194;544;121;377;28;95;38;95;66;190
420170;202208;343;1013;259;813;45;155;100;267;145;422
420180;202208;189;583;111;392;17;79;29;82;46;161
420190;202208;244;702;142;445;29;90;46;127;75;217
420195;202208;2179;5397;1678;4598;391;1277;704;1711;1095;2988
420200;202208;8106;18566;5385;13653;727;2130;2613;5553;3340;7683
420205;202208;2455;6196;1685;4664;248;781;913;2389;1161;3170
420207;202208;2488;6085;1628;4498;283;879;694;1729;977;2608
420208;202208;407;1115;242;771;80;261;54;135;134;396
420209;202208;198;591;128;394;15;57;65;174;80;231
420210;202208;4779;11691;3466;9460;518;1625;1837;4653;2355;6278
420213;202208;955;2680;783;2336;162;528;307;871;469;1399
420215;202208;274;778;192;594;45;144;58;181;103;325
420220;202208;389;1120;264;859;43;164;101;276;144;440
420230;202208;6840;17302;5373;14670;646;2017;3064;7711;3710;9728
420240;202208;18099;48402;11881;34204;1443;4850;5653;13806;7096;18656
420243;202208;526;1295;439;1143;65;183;292;736;357;919
420245;202208;2142;5167;1641;4322;152;477;1053;2575;1205;3052
420250;202208;653;1574;576;1460;42;139;436;1037;478;1176
420253;202208;551;1272;395;1052;30;82;242;637;272;719
420257;202208;186;473;124;365;21;64;64;190;85;254
420260;202208;1425;3356;1081;2899;86;277;818;2144;904;2421
420270;202208;679;1703;347;950;39;118;149;362;188;480
420280;202208;1708;4678;1388;4028;180;624;664;1761;844;2385
420285;202208;161;435;108;317;21;83;32;56;53;139
420287;202208;539;1180;383;963;72;195;173;418;245;613
420290;202208;6469;17432;5076;14501;686;2275;2968;7722;3654;9997
420300;202208;9006;24201;5305;15736;975;3196;1708;4334;2683;7530
420310;202208;1062;2264;613;1509;49;148;358;777;407;925
420315;202208;928;2370;652;1917;76;254;373;1044;449;1298
420320;202208;7170;18255;5383;15400;1537;4740;1730;4589;3267;9329
420325;202208;394;1082;279;862;41;141;110;304;151;445
420330;202208;1157;3234;750;2358;134;481;243;669;377;1150
420340;202208;1356;3392;1061;2867;227;664;413;980;640;1644
420350;202208;1542;3567;1159;2923;130;362;757;1845;887;2207
420360;202208;3515;9209;1942;5890;372;1215;187;524;559;1739
420370;202208;1591;3906;1279;3376;113;380;873;2128;986;2508
420380;202208;5439;13529;3773;10527;702;2186;1662;4216;2364;6402
420390;202208;1252;3016;898;2333;165;483;333;607;498;1090
420395;202208;1471;3963;1049;3140;159;544;206;448;365;992
420400;202208;1341;3454;943;2692;123;391;497;1332;620;1723
420410;202208;697;1716;534;1387;50;140;357;907;407;1047
420415;202208;414;1136;305;890;63;210;130;363;193;573
420417;202208;746;2127;582;1775;127;382;285;895;412;1277
420419;202208;183;618;131;473;50;194;12;50;62;244
420420;202208;16170;40637;11385;31801;2877;9055;3973;9930;6850;18985
420425;202208;753;1990;515;1482;45;158;273;730;318;888
420430;202208;3910;10014;2469;6977;411;1330;1025;2525;1436;3855
420435;202208;348;881;202;610;34;115;99;283;133;398
420440;202208;964;2402;638;1731;176;461;240;623;416;1084
420445;202208;276;645;174;467;30;92;59;124;89;216
420450;202208;978;2755;713;2165;120;454;275;706;395;1160
420455;202208;2496;5615;1867;4679;431;1074;812;2021;1243;3095
420460;202208;11603;29225;8970;24467;1205;3802;4998;12651;6203;16453
420470;202208;739;1852;402;1133;67;215;118;275;185;490
420475;202208;81;212;37;114;6;25;8;16;14;41
420480;202208;6688;15773;4381;11906;739;2133;1907;4968;2646;7101
420490;202208;448;1194;314;907;53;179;144;373;197;552
420500;202208;1585;4108;1071;3202;181;630;497;1387;678;2017
420510;202208;185;502;106;336;19;65;31;83;50;148
420515;202208;133;360;89;264;14;53;31;85;45;138
420517;202208;831;2123;695;1880;78;225;401;1064;479;1289
420519;202208;363;888;256;706;26;76;129;354;155;430
420520;202208;332;875;189;605;28;87;12;29;40;116
420530;202208;947;2728;648;2059;115;422;224;585;339;1007
420535;202208;244;673;99;308;14;49;31;75;45;124
420540;202208;48431;112137;33797;87898;4548;13629;14041;31445;18589;45074
420543;202208;277;787;215;640;31;110;94;242;125;352
420545;202208;1635;4783;1234;3894;278;931;419;1200;697;2131
420550;202208;4851;11951;3249;9190;516;1620;1428;3852;1944;5472
420555;202208;405;1087;273;821;34;120;150;418;184;538
420560;202208;485;1118;339;909;53;133;195;527;248;660
420570;202208;3434;8418;2598;6906;410;1232;1374;3379;1784;4611
420580;202208;2082;5441;1469;4413;322;1049;457;1258;779;2307
420590;202208;3408;8903;2153;6219;360;1209;633;1437;993;2646
420600;202208;1355;3591;1089;3110;101;386;688;1835;789;2221
420610;202208;607;1611;406;1215;83;253;193;553;276;806
420620;202208;973;2349;670;1840;135;400;271;711;406;1111
420630;202208;1185;3447;866;2685;140;467;429;1238;569;1705
420640;202208;569;1517;306;979;87;291;51;149;138;440
420650;202208;4486;11244;2967;8183;432;1342;1352;3121;1784;4463
420660;202208;509;1252;327;873;62;182;71;155;133;337
420665;202208;842;2110;571;1655;97;313;260;662;357;975
420670;202208;1470;3995;902;2777;110;386;206;487;316;873
420675;202208;238;608;153;456;15;57;87;238;102;295
420680;202208;336;729;186;523;28;105;97;238;125;343
420690;202208;1074;2968;703;2099;100;327;237;584;337;911
420700;202208;3603;9089;2803;7680;218;685;1872;4902;2090;5587
420710;202208;1319;3536;1068;3017;129;464;633;1561;762;2025
420720;202208;1557;4024;1167;3324;178;565;689;1814;867;2379
420730;202208;4082;10138;3140;8605;539;1650;1648;4179;2187;5829
420740;202208;547;1557;316;1055;76;268;40;114;116;382
420750;202208;2487;6907;1645;5009;274;1019;613;1632;887;2651
420757;202208;122;311;57;184;8;29;25;82;33;111
420760;202208;436;1204;242;708;34;101;83;203;117;304
420765;202208;619;1699;329;1001;45;160;181;527;226;687
420768;202208;1603;4155;1386;3801;154;413;1013;2759;1167;3172
420770;202208;428;1148;191;663;18;73;42;130;60;203
420775;202208;345;917;207;635;37;131;78;196;115;327
420780;202208;1152;3116;696;2084;119;357;117;315;236;672
420785;202208;260;642;191;510;23;70;87;178;110;248
420790;202208;1327;3609;1012;2962;190;658;571;1518;761;2176
420800;202208;869;2017;536;1407;123;325;271;687;394;1012
420810;202208;1764;5028;1467;4455;345;1252;701;1819;1046;3071
420820;202208;16193;39165;11940;32381;1784;5368;6098;15286;7882;20654
420830;202208;5804;14405;4383;11939;748;2259;1977;4992;2725;7251
420840;202208;620;1853;333;1159;76;273;31;92;107;365
420845;202208;3438;8467;2354;6575;453;1508;1014;2609;1467;4117
420850;202208;1334;4025;885;2893;160;563;230;667;390;1230
420860;202208;464;1189;278;848;69;215;79;214;148;429
420870;202208;989;2632;683;2006;141;451;243;650;384;1101
420880;202208;1347;3822;1068;3287;203;705;463;1296;666;2001
420890;202208;9465;24813;5990;17679;882;2876;2116;5367;2998;8243
420895;202208;216;589;141;408;23;70;63;169;86;239
420900;202208;1868;4458;1167;3249;153;554;538;1256;691;1810
420910;202208;40592;103152;27367;78489;4065;13440;12138;30202;16203;43642
420915;202208;578;1968;452;1646;68;278;243;894;311;1172
420917;202208;568;1409;264;683;37;81;141;364;178;445
420920;202208;108;277;47;144;4;11;11;31;15;42
420930;202208;21071;51252;15593;41814;2305;7013;8279;20307;10584;27320
420940;202208;3903;9253;2485;6878;532;1657;632;1374;1164;3031
420945;202208;231;672;139;416;24;84;58;149;82;233
420950;202208;445;1219;288;862;45;153;89;234;134;387
420960;202208;1288;3050;939;2488;147;452;451;1044;598;1496
420970;202208;2808;7190;1958;5654;425;1286;656;1856;1081;3142
420980;202208;309;1024;259;909;92;338;65;229;157;567
420985;202208;424;1122;253;787;50;175;68;174;118;349
420990;202208;424;1249;260;855;41;138;58;168;99;306
421000;202208;667;1930;472;1516;101;349;105;271;206;620
421003;202208;527;1257;185;517;13;35;14;29;27;64
421005;202208;114;321;75;236;17;51;31;101;48;152
421010;202208;4236;10880;3099;8809;561;1842;1109;2626;1670;4468
421020;202208;455;1364;366;1193;56;216;191;580;247;796
421030;202208;1200;3194;912;2614;206;652;373;976;579;1628
421040;202208;788;1819;484;1342;52;150;286;757;338;907
421050;202208;1380;3546;939;2600;140;428;374;890;514;1318
421055;202208;190;493;111;321;16;48;59;154;75;202
421060;202208;863;2350;620;1841;101;367;298;767;399;1134
421070;202208;791;2228;503;1528;84;288;216;562;300;850
421080;202208;614;1720;483;1459;83;299;209;574;292;873
421085;202208;413;1145;186;611;23;71;35;95;58;166
421090;202208;336;852;190;515;17;61;74;168;91;229
421100;202208;1025;2180;470;1284;81;239;140;313;221;552
421105;202208;1915;4838;1376;3842;211;650;664;1706;875;2356
421110;202208;1520;3634;1259;3259;121;379;808;2040;929;2419
421120;202208;1291;3740;906;2897;131;459;280;774;411;1233
421125;202208;411;983;299;766;89;252;127;298;216;550
421130;202208;6739;18272;5545;15921;1006;3194;2973;7985;3979;11179
421140;202208;411;1069;281;810;55;164;106;271;161;435
421145;202208;500;1299;336;969;94;305;97;227;191;532
421150;202208;866;2330;590;1761;116;387;250;653;366;1040
421160;202208;708;1886;546;1564;79;283;339;880;418;1163
421165;202208;265;748;169;503;26;81;60;142;86;223
421170;202208;1383;3493;1175;3163;115;308;846;2274;961;2582
421175;202208;1203;2990;726;2155;121;428;331;903;452;1331
421180;202208;465;1163;260;756;28;102;130;319;158;421
421185;202208;386;951;272;729;35;103;145;358;180;461
421187;202208;309;922;190;623;38;121;69;216;107;337
421189;202208;488;1329;371;1091;54;186;164;436;218;622
421190;202208;15990;40893;11636;32766;1938;6207;5157;12873;7095;19080
421200;202208;912;2377;713;2009;95;330;402;1052;497;1382
421205;202208;268;686;203;569;39;114;87;233;126;347
421210;202208;1325;3207;752;2219;163;478;241;682;404;1160
421220;202208;1712;4771;1343;4014;360;1153;474;1272;834;2425
421223;202208;449;1126;309;885;55;175;188;510;243;685
421225;202208;1167;3118;1009;2874;120;408;671;1864;791;2272
421227;202208;838;2253;548;1645;104;345;230;681;334;1026
421230;202208;678;1714;449;1291;95;308;163;442;258;750
421240;202208;314;900;145;495;24;106;27;64;51;170
421250;202208;2735;6656;2010;5491;329;887;1137;2993;1466;3880
421260;202208;280;847;74;231;19;60;9;24;28;84
421265;202208;1035;2363;889;2177;63;154;741;1793;804;1947
421270;202208;433;1154;219;704;45;151;87;259;132;410
421280;202208;2779;7008;2095;5873;312;1012;1115;2915;1427;3927
421290;202208;1262;3368;622;1824;100;308;143;359;243;667
421300;202208;361;940;184;582;32;113;32;100;64;213
421310;202208;259;716;179;553;52;168;79;231;131;399
421315;202208;342;853;225;626;50;129;73;202;123;331
421320;202208;730;2220;410;1327;38;124;62;105;100;229
421330;202208;728;2039;484;1490;106;345;139;388;245;733
421335;202208;457;1312;377;1171;55;198;184;538;239;736
421340;202208;1731;4553;1215;3619;184;613;560;1561;744;2174
421350;202208;1958;4732;1315;3672;248;752;509;1359;757;2111
421360;202208;2614;6648;1605;4661;396;1338;551;1256;947;2594
421370;202208;892;2697;580;1889;102;371;192;509;294;880
421380;202208;1028;2482;899;2290;90;272;598;1450;688;1722
421390;202208;181;482;75;255;20;70;22;64;42;134
421400;202208;719;1866;474;1386;73;248;229;578;302;826
421410;202208;224;590;114;371;30;87;29;101;59;188
421415;202208;240;632;172;464;22;72;70;161;92;233
421420;202208;731;1919;535;1497;58;186;283;737;341;923
421430;202208;107;327;71;234;9;27;14;32;23;59
421440;202208;770;1984;468;1408;87;251;192;563;279;814
421450;202208;557;1590;343;1108;52;168;47;150;99;318
421460;202208;421;1272;235;845;14;45;19;53;33;98
421470;202208;391;1050;271;819;39;122;91;280;130;402
421480;202208;3566;9178;2491;7015;357;1195;1107;2802;1464;3997
421490;202208;133;431;79;287;12;52;13;44;25;96
421500;202208;2694;7425;1892;5759;407;1439;555;1388;962;2827
421505;202208;384;969;320;873;29;98;209;551;238;649
421507;202208;517;1352;314;920;57;180;140;367;197;547
421510;202208;487;1274;334;936;44;154;169;390;213;544
421520;202208;546;1406;335;915;50;130;137;324;187;454
421530;202208;371;1081;213;719;32;144;41;101;73;245
421535;202208;493;1226;296;829;41;121;151;398;192;519
421540;202208;402;912;227;638;28;88;79;202;107;290
421545;202208;755;2128;578;1814;108;395;294;854;402;1249
421550;202208;2687;6836;2062;5736;333;1010;1114;2942;1447;3952
421555;202208;228;638;72;234;9;30;15;26;24;56
421560;202208;104;327;63;216;9;36;23;60;32;96
421565;202208;1125;2771;802;2259;183;572;312;798;495;1370
421567;202208;611;1786;450;1359;123;404;124;373;247;777
421568;202208;377;1064;216;666;36;130;78;214;114;344
421569;202208;187;524;86;262;10;39;47;126;57;165
421570;202208;1743;4604;1272;3650;234;752;527;1309;761;2061
421575;202208;386;1050;283;782;33;116;158;388;191;504
421580;202208;5547;14367;3615;10385;494;1651;1494;3633;1988;5284
421590;202208;214;591;164;484;38;127;67;181;105;308
421600;202208;696;1764;471;1284;83;261;174;393;257;654
421605;202208;803;2038;592;1704;109;306;246;719;355;1025
421610;202208;1193;3034;821;2340;157;483;272;739;429;1222
421620;202208;4858;12201;3265;9370;622;2020;1314;3386;1936;5406
421625;202208;161;446;84;260;12;38;22;52;34;90
421630;202208;3304;8335;2220;6305;378;1218;840;2048;1218;3266
421635;202208;470;1232;302;890;27;110;171;427;198;537
421640;202208;786;1986;561;1636;117;360;273;742;390;1102
421650;202208;3052;7853;2113;6144;447;1528;743;1881;1190;3409
421660;202208;13892;36520;10173;29306;1426;4716;4987;12920;6413;17636
421670;202208;1005;2717;707;1989;135;435;329;813;464;1248
421680;202208;2066;4144;1744;3662;76;255;1491;2895;1567;3150
421690;202208;1759;4790;1199;3619;242;797;356;996;598;1793
421700;202208;720;2029;494;1516;101;338;147;376;248;714
421710;202208;254;760;139;434;18;59;61;167;79;226
421715;202208;172;423;127;329;22;66;78;192;100;258
421720;202208;2518;6560;1509;4421;318;1044;482;1192;800;2236
421725;202208;332;789;181;513;31;98;78;183;109;281
421730;202208;593;1678;378;1087;59;176;191;491;250;667
421740;202208;975;2600;660;1962;106;347;258;641;364;988
421750;202208;1069;2462;558;1532;115;344;209;522;324;866
421755;202208;208;567;115;347;20;72;44;111;64;183
421760;202208;1243;3112;822;2343;162;526;305;743;467;1269
421770;202208;2948;7412;2123;5999;428;1238;875;2393;1303;3631
421775;202208;252;644;153;442;20;62;63;157;83;219
421780;202208;1074;2914;712;2161;124;417;319;866;443;1283
421790;202208;1061;2770;590;1837;118;382;196;548;314;930
421795;202208;221;621;158;476;29;90;49;133;78;223
421800;202208;3895;9856;2940;8129;452;1379;1630;4215;2082;5594
421810;202208;692;1788;475;1399;54;170;254;714;308;884
421820;202208;1272;3550;845;2552;157;546;310;769;467;1315
421825;202208;1834;4306;1577;3936;102;300;1205;2916;1307;3216
421830;202208;2254;6218;1697;5080;370;1200;414;1135;784;2335
421835;202208;286;682;196;536;31;101;104;277;135;378
421840;202208;311;959;241;803;40;160;74;231;114;391
421850;202208;448;1258;255;865;44;163;55;145;99;308
421860;202208;342;915;201;626;30;110;67;169;97;279
421870;202208;5859;13976;4457;11402;481;1543;2725;6155;3206;7698
421875;202208;360;1029;157;480;24;78;41;105;65;183
421880;202208;793;2175;529;1599;108;317;142;409;250;726
421885;202208;317;843;201;584;29;87;97;253;126;340
421890;202208;1115;3034;844;2510;126;461;502;1383;628;1844
421895;202208;504;1238;433;1127;50;116;289;777;339;893
421900;202208;1271;3244;937;2517;109;354;453;1036;562;1390
421910;202208;392;1144;223;726;32;131;52;141;84;272
421915;202208;473;1286;288;850;65;199;63;154;128;353
421917;202208;734;1613;422;1188;110;337;107;304;217;641
421920;202208;472;1383;328;1077;106;354;110;363;216;717
421930;202208;3666;8930;2111;6017;413;1287;785;1913;1198;3200
421935;202208;477;1378;387;1194;73;220;234;719;307;939
421940;202208;429;1181;205;605;28;91;68;169;96;260
421950;202208;3730;9151;2204;6235;428;1325;625;1508;1053;2833
421960;202208;186;440;103;291;10;30;38;86;48;116
421970;202208;2371;5859;1532;4164;277;889;697;1644;974;2533
421985;202208;382;1032;260;785;34;107;122;347;156;454
422000;202208;2364;5633;1927;4985;139;459;1375;3448;1514;3907
430003;202208;693;1759;482;1391;82;260;245;677;327;937
430005;202208;355;888;252;714;15;50;165;441;180;491
430010;202208;2172;4710;1637;3904;338;770;874;2105;1212;2875
430020;202208;669;1470;490;1216;61;179;306;698;367;877
430030;202208;1258;2751;728;1799;120;322;383;848;503;1170
430040;202208;11862;26415;7597;19390;1969;5293;2048;4866;4017;10159
430045;202208;637;1434;468;1146;28;84;357;835;385;919
430047;202208;282;601;111;285;23;60;36;86;59;146
430050;202208;955;2273;583;1564;108;300;262;663;370;963
430055;202208;325;763;159;430;17;56;79;184;96;240
430057;202208;104;231;48;138;13;42;12;31;25;73
430060;202208;23383;57678;18616;50347;3087;9077;10159;26416;13246;35493
430063;202208;880;2296;731;2017;137;388;418;1131;555;1519
430064;202208;1358;3391;992;2714;162;465;540;1418;702;1883
430066;202208;130;281;99;230;8;23;79;173;87;196
430070;202208;774;1947;170;520;37;114;24;57;61;171
430080;202208;1096;2594;642;1706;93;305;340;774;433;1079
430085;202208;1059;2157;652;1532;95;245;324;717;419;962
430087;202208;1036;2353;857;2120;83;230;584;1408;667;1638
430090;202208;538;1351;205;652;34;116;43;117;77;233
430100;202208;1195;2760;713;1873;128;366;241;533;369;899
430105;202208;1618;3929;1116;3080;173;542;533;1403;706;1945
430107;202208;193;533;95;278;12;30;31;77;43;107
430110;202208;2581;6038;1932;5071;311;877;936;2363;1247;3240
430120;202208;1514;4024;1030;2887;173;477;484;1288;657;1765
430130;202208;4172;8799;3092;7329;1052;2456;669;1874;1721;4330
430140;202208;1226;2989;873;2365;131;386;457;1175;588;1561
430150;202208;653;1633;364;1059;75;238;108;285;183;523
430155;202208;279;675;126;364;22;66;23;54;45;120
430160;202208;25368;53416;20337;46585;1790;4640;13940;30507;15730;35147
430163;202208;4016;8411;2883;6766;76;261;2304;5175;2380;5436
430165;202208;341;827;119;365;13;34;22;57;35;91
430170;202208;1100;2733;382;1209;74;276;70;162;144;438
430175;202208;951;2299;813;2045;153;379;445;1094;598;1473
430180;202208;762;1797;568;1463;108;269;268;690;376;959
430185;202208;753;1867;387;1099;105;303;76;195;181;498
430187;202208;965;1895;707;1585;83;173;487;1078;570;1251
430190;202208;1692;3962;1333;3421;237;632;659;1603;896;2235
430192;202208;135;353;57;162;11;30;16;36;27;66
430195;202208;496;1372;82;263;8;24;15;38;23;62
430200;202208;1321;3523;1036;3013;312;934;276;844;588;1778
430205;202208;591;1247;544;1161;10;35;506;1051;516;1086
430210;202208;7738;19262;5009;13537;754;2234;1462;3017;2216;5251
430215;202208;393;924;246;641;37;102;106;265;143;367
430220;202208;700;1703;226;702;25;84;74;190;99;274
430222;202208;278;722;189;553;30;92;65;182;95;274
430223;202208;302;742;224;615;23;66;131;346;154;412
430225;202208;28;64;22;55;1;1;13;28;14;29
430230;202208;2342;5815;1952;5261;107;333;1548;4097;1655;4430
430235;202208;488;1281;310;909;48;152;88;201;136;353
430237;202208;617;1318;468;1084;23;65;369;824;392;889
430240;202208;1579;3533;884;2322;115;358;429;982;544;1340
430245;202208;866;2166;691;1850;117;314;419;1136;536;1450
430250;202208;1210;2741;882;2221;309;809;198;445;507;1254
430258;202208;155;385;115;307;10;26;59;154;69;180
430260;202208;816;1971;561;1526;60;183;324;857;384;1040
430265;202208;257;708;172;551;26;89;65;208;91;297
430270;202208;3859;8292;3116;7212;328;926;2282;4946;2610;5872
430280;202208;6049;13047;4373;10326;733;1779;2226;4963;2959;6742
430290;202208;2630;5483;2150;4924;120;332;1710;3776;1830;4108
430300;202208;12394;28379;9491;23660;1261;3496;5574;13063;6835;16559
430310;202208;15631;36490;11266;28741;1354;3804;6323;14881;7677;18685
430320;202208;1151;2727;661;1789;61;174;384;997;445;1171
430330;202208;770;1788;452;1172;72;193;170;397;242;590
430340;202208;732;1616;496;1250;68;173;319;767;387;940
430350;202208;10077;22903;7795;19163;944;2464;4818;11208;5762;13672
430355;202208;386;1020;152;472;23;72;17;43;40;115
430360;202208;1013;2308;637;1667;150;436;200;464;350;900
430367;202208;407;856;249;602;39;119;139;294;178;413
430370;202208;567;1483;232;693;44;130;58;131;102;261
430380;202208;757;1798;387;1138;81;251;90;233;171;484
430390;202208;4098;9442;2683;6973;580;1644;374;715;954;2359
430400;202208;1242;2446;900;1982;151;361;433;895;584;1256
430410;202208;643;1419;465;1144;40;110;335;792;375;902
430420;202208;3415;8100;2665;6656;359;1039;1648;3738;2007;4777
430430;202208;629;1528;284;830;53;173;49;120;102;293
430435;202208;2027;4696;1508;3833;239;650;764;1870;1003;2520
430440;202208;4886;12232;3937;10719;404;1229;2489;6595;2893;7824
430450;202208;8861;19541;7256;16920;1188;3154;4120;8845;5308;11999
430460;202208;45364;105560;33633;86714;4464;12802;18985;46137;23449;58939
430461;202208;248;633;93;268;19;64;37;85;56;149
430462;202208;357;884;183;542;31;93;49;128;80;221
430463;202208;8115;19881;6074;16274;1193;3538;2781;7031;3974;10569
430465;202208;683;1558;459;1152;71;201;274;650;345;851
430466;202208;5498;12730;4447;11188;759;2017;2513;5918;3272;7935
430467;202208;593;1360;431;1115;47;140;255;603;302;743
430468;202208;1616;3670;1311;3247;100;318;999;2381;1099;2699
430469;202208;691;1876;114;355;10;33;28;54;38;87
430470;202208;6806;16498;4572;12651;1190;3725;1251;3085;2441;6810
430471;202208;800;2027;667;1798;115;328;403;1026;518;1354
430480;202208;717;1918;458;1362;75;243;139;326;214;569
430485;202208;191;477;87;238;16;34;21;56;37;90
430490;202208;477;1178;273;777;28;98;129;308;157;406
430495;202208;445;1159;299;891;40;131;145;403;185;534
430500;202208;1160;2822;817;2272;249;769;248;606;497;1375
430510;202208;32999;80820;24092;64457;4035;12052;11092;26722;15127;38774
430511;202208;395;1055;154;479;19;47;20;46;39;93
430512;202208;1219;2531;964;2159;216;503;405;893;621;1396
430513;202208;920;2089;462;1175;65;194;257;566;322;760
430515;202208;450;1166;321;910;38;115;162;438;200;553
430517;202208;1589;4147;1223;3370;192;521;713;1939;905;2460
430520;202208;1583;3789;876;2331;138;398;241;564;379;962
430530;202208;1101;2631;463;1328;75;230;129;330;204;560
430535;202208;4229;10130;3075;8142;429;1169;1620;4051;2049;5220
430537;202208;529;1374;463;1240;38;89;358;951;396;1040
430540;202208;706;1631;430;1180;62;172;251;668;313;840
430543;202208;1224;2093;747;1539;153;289;241;554;394;843
430544;202208;827;2216;554;1633;136;418;197;557;333;975
430545;202208;2983;6939;2264;5909;364;981;1299;3342;1663;4323
430550;202208;419;1110;313;900;77;226;99;262;176;488
430558;202208;177;388;71;182;4;10;34;82;38;92
430560;202208;331;749;176;498;28;87;62;147;90;234
430570;202208;989;2289;697;1791;131;430;334;709;465;1139
430580;202208;952;2257;688;1860;162;433;278;810;440;1243
430583;202208;208;510;51;145;3;10;13;26;16;36
430585;202208;243;575;132;358;24;77;45;99;69;176
430587;202208;231;596;172;500;18;59;77;219;95;278
430590;202208;1586;3600;1259;3095;131;367;877;2071;1008;2438
430593;202208;32;91;24;64;6;19;11;25;17;44
430595;202208;483;1209;130;405;17;52;31;71;48;123
430597;202208;528;1261;273;761;24;69;81;169;105;238
430600;202208;2235;5604;975;2742;145;411;248;618;393;1029
430605;202208;1571;3793;1150;3073;156;446;550;1416;706;1862
430607;202208;792;1691;530;1250;31;77;360;803;391;880
430610;202208;7360;16140;5209;13011;1348;3813;1658;3780;3006;7593
430613;202208;299;672;84;233;10;29;26;57;36;86
430620;202208;879;1996;673;1640;127;364;360;742;487;1106
430630;202208;495;1297;153;442;31;87;43;105;74;192
430632;202208;497;1262;219;611;42;106;81;216;123;322
430635;202208;684;1438;507;1140;42;88;369;823;411;911
430637;202208;522;1203;404;1028;40;118;272;658;312;776
430640;202208;1288;3329;882;2519;130;397;354;885;484;1282
430642;202208;402;1072;269;763;44;144;109;282;153;426
430645;202208;188;428;94;234;13;32;34;66;47;98
430650;202208;2220;5483;1650;4581;494;1270;635;1979;1129;3249
430655;202208;355;830;213;554;30;92;113;251;143;343
430660;202208;6003;14178;4642;12068;768;2161;2482;6164;3250;8325
430670;202208;711;1621;522;1302;94;232;236;569;330;801
430673;202208;587;1279;264;706;49;133;102;246;151;379
430675;202208;281;797;73;241;13;42;11;34;24;76
430676;202208;6702;15314;5423;13401;784;2043;3361;8005;4145;10048
430680;202208;1363;3292;878;2370;279;773;285;627;564;1400
430690;202208;3695;8897;2966;7656;876;2325;1205;3008;2081;5333
430692;202208;235;680;188;600;9;32;148;480;157;512
430693;202208;1076;2704;655;1896;134;430;191;503;325;933
430695;202208;446;1033;273;692;42;113;131;305;173;418
430697;202208;560;1303;437;1131;68;181;265;691;333;872
430700;202208;9452;21821;6123;15944;1254;3589;1707;3822;2961;7411
430705;202208;430;958;211;573;25;75;94;224;119;299
430710;202208;2191;4058;1480;3139;104;281;1103;2191;1207;2472
430720;202208;943;2173;498;1389;62;193;262;663;324;856
430730;202208;1121;2890;770;2208;112;321;349;943;461;1264
430740;202208;793;2022;409;1220;73;231;123;351;196;582
430745;202208;535;1215;380;926;47;157;220;424;267;581
430750;202208;1900;4375;1233;3217;322;875;501;1227;823;2102
430755;202208;523;1247;366;946;30;90;209;489;239;579
430760;202208;2774;6387;2159;5468;441;1199;1041;2463;1482;3662
430770;202208;8615;19782;6852;17148;737;2107;4582;10933;5319;13040
430780;202208;2382;5614;1580;4298;254;753;794;2054;1048;2807
430781;202208;714;1717;466;1180;153;411;162;338;315;749
430783;202208;404;883;267;680;44;128;140;343;184;471
430786;202208;41;123;26;87;5;17;4;9;9;26
430790;202208;5586;12881;4102;10409;388;1227;2560;5958;2948;7185
430800;202208;1015;2054;772;1732;52;130;574;1225;626;1355
430805;202208;429;1009;292;748;12;45;218;522;230;567
430807;202208;678;1607;418;1119;51;167;200;449;251;616
430810;202208;872;2007;416;1143;58;185;168;388;226;573
430820;202208;1452;3880;872;2666;135;429;284;785;419;1214
430825;202208;297;697;118;296;17;39;42;99;59;138
430830;202208;2210;5322;1822;4634;136;336;1325;3240;1461;3576
430840;202208;1266;2795;877;2190;117;296;569;1382;686;1678
430843;202208;195;462;90;242;7;19;34;78;41;97
430845;202208;613;1284;422;974;42;117;279;572;321;689
430850;202208;2800;6957;1963;5453;539;1548;559;1560;1098;3108
430860;202208;1234;2894;622;1717;89;311;291;676;380;987
430865;202208;669;1597;416;1143;102;311;111;232;213;543
430870;202208;621;1613;273;845;58;183;55;151;113;334
430880;202208;1739;3667;1226;2878;144;392;806;1766;950;2158
430885;202208;190;482;111;325;10;29;74;210;84;239
430890;202208;1267;2991;822;2243;134;443;112;264;246;707
430900;202208;3792;7360;2698;5861;133;417;2002;4000;2135;4417
430905;202208;1085;2585;743;1960;132;375;301;721;433;1096
430910;202208;2575;6589;1959;5364;306;979;937;2227;1243;3206
430912;202208;584;1570;401;1191;47;124;240;725;287;849
430915;202208;600;1657;402;1232;120;392;105;317;225;709
430920;202208;30676;71717;24475;61809;2767;7925;16039;38545;18806;46470
430925;202208;98;211;47;126;4;13;25;66;29;79
430930;202208;13657;29692;9773;23950;1264;3314;5614;13155;6878;16469
430940;202208;1386;3373;921;2495;204;597;355;829;559;1426
430950;202208;1041;2081;686;1520;47;143;502;1011;549;1154
430955;202208;467;1181;127;356;20;54;37;89;57;143
430957;202208;210;637;189;591;37;109;109;348;146;457
430960;202208;1636;3723;955;2531;216;612;343;820;559;1432
430965;202208;1777;3907;1419;3382;61;141;1097;2624;1158;2765
430970;202208;430;989;241;646;35;99;123;303;158;402
430975;202208;581;1567;446;1272;79;249;190;493;269;742
430980;202208;495;1070;286;730;31;89;148;329;179;418
430990;202208;730;1879;504;1412;74;235;241;635;315;870
430995;202208;650;1507;468;1217;65;174;262;641;327;815
431000;202208;1598;3654;695;1954;129;366;63;150;192;516
431010;202208;3011;7493;2177;6095;423;1287;743;1808;1166;3095
431020;202208;9549;19877;5841;14358;963;2791;2667;5627;3630;8418
431030;202208;379;1001;191;611;41;141;32;99;73;240
431033;202208;4849;10790;3295;8348;699;1786;1243;3076;1942;4862
431036;202208;353;754;76;217;3;10;24;53;27;63
431040;202208;1035;2433;675;1839;76;260;364;891;440;1151
431041;202208;512;1120;356;873;61;146;173;385;234;531
431043;202208;452;1090;273;752;30;111;159;387;189;498
431046;202208;119;300;47;138;6;19;9;20;15;39
431050;202208;1524;3418;1098;2754;194;471;592;1484;786;1955
431053;202208;811;1979;440;1271;83;263;146;337;229;600
431055;202208;700;1572;550;1335;50;126;390;944;440;1070
431057;202208;242;679;145;455;31;106;55;156;86;262
431060;202208;6746;15587;4639;12179;1046;2975;1704;4121;2750;7096
431065;202208;468;1107;350;912;51;143;180;450;231;593
431070;202208;480;1236;289;835;65;207;70;191;135;398
431075;202208;288;759;164;486;35;119;65;170;100;289
431080;202208;659;1739;462;1338;75;232;160;416;235;648
431085;202208;915;2248;531;1411;60;172;262;668;322;840
431087;202208;484;1241;383;1038;51;141;228;597;279;738
431090;202208;470;1060;184;545;29;88;45;130;74;218
431100;202208;4741;9470;3402;7781;336;848;2253;4904;2589;5752
431110;202208;1713;3684;1202;2805;174;458;628;1308;802;1766
431112;202208;761;1829;638;1620;76;226;435;1041;511;1267
431113;202208;581;1395;463;1177;99;264;264;626;363;890
431115;202208;1149;2985;891;2524;86;321;617;1631;703;1952
431120;202208;3205;7638;2204;5782;515;1488;803;1904;1318;3392
431123;202208;410;1033;274;761;47;124;143;386;190;510
431125;202208;1354;3302;983;2624;295;778;463;1259;758;2037
431127;202208;234;616;70;212;7;27;10;23;17;50
431130;202208;3874;8921;2995;7586;451;1255;1608;3888;2059;5143
431140;202208;6677;15365;4195;10834;507;1441;1873;4101;2380;5542
431142;202208;743;1677;551;1382;88;235;356;870;444;1105
431150;202208;1180;2946;855;2383;127;381;438;1175;565;1556
431160;202208;791;2001;524;1461;121;356;157;406;278;762
431162;202208;689;1631;442;1196;41;140;250;607;291;747
431164;202208;197;452;53;159;6;16;12;30;18;46
431170;202208;533;1349;394;1076;117;309;99;252;216;561
431171;202208;990;2027;830;1832;170;348;560;1231;730;1579
431173;202208;537;1304;386;1086;120;388;118;290;238;678
431175;202208;1534;3388;946;2391;139;346;404;966;543;1312
431177;202208;1068;2591;819;2197;157;457;454;1175;611;1632
431179;202208;367;805;120;351;22;65;38;110;60;175
431180;202208;2720;6620;1686;4612;370;1036;411;961;781;1997
431190;202208;684;1666;290;823;35;107;65;147;100;254
431198;202208;477;1298;391;1141;92;275;166;500;258;775
431200;202208;387;946;116;311;24;61;16;40;40;101
431205;202208;268;680;151;429;49;140;43;115;92;255
431210;202208;748;1636;594;1408;128;304;289;711;417;1015
431213;202208;319;791;239;642;16;38;127;326;143;364
431215;202208;701;1634;361;1020;36;118;182;481;218;599
431217;202208;202;492;140;372;29;92;60;141;89;233
431220;202208;681;1618;428;1153;64;176;225;548;289;724
431225;202208;1806;3853;1389;3216;132;323;975;2200;1107;2523
431230;202208;836;2178;628;1716;134;421;304;723;438;1144
431235;202208;199;542;27;91;0;0;7;21;7;21
431237;202208;411;1208;320;1017;51;185;154;470;205;655
431238;202208;41;117;33;102;7;19;14;37;21;56
431240;202208;5927;13488;4757;11655;518;1517;3056;6965;3574;8482
431242;202208;337;772;285;673;32;87;202;461;234;548
431244;202208;446;1052;234;612;29;87;98;223;127;310
431245;202208;1522;3376;1007;2503;84;217;540;1244;624;1461
431247;202208;322;747;204;522;30;93;100;217;130;310
431250;202208;2151;4935;1650;4276;369;912;851;2301;1220;3213
431260;202208;353;915;214;636;26;95;84;227;110;322
431261;202208;317;907;260;809;26;102;147;419;173;521
431262;202208;324;888;167;538;26;95;90;277;116;372
431265;202208;1806;4131;729;2030;118;367;217;500;335;867
431267;202208;290;700;196;512;23;72;127;303;150;375
431270;202208;3268;6868;1762;4350;392;1045;602;1397;994;2442
431275;202208;171;443;111;307;23;69;54;131;77;200
431280;202208;269;727;108;351;21;69;13;27;34;96
431290;202208;417;1201;270;849;54;183;50;144;104;327
431295;202208;83;200;31;87;7;24;8;17;15;41
431300;202208;339;881;86;266;9;36;30;80;39;116
431301;202208;300;816;84;258;12;40;10;22;22;62
431303;202208;763;1814;462;1228;33;102;205;454;238;556
431306;202208;2627;5998;1656;4359;197;563;724;1679;921;2242
431308;202208;39;108;34;96;10;29;16;45;26;74
431310;202208;616;1536;440;1174;64;168;219;537;283;705
431320;202208;807;2130;482;1454;79;250;159;421;238;671
431330;202208;2097;4765;1147;3091;154;464;529;1262;683;1726
431333;202208;240;611;134;381;21;63;45;112;66;175
431335;202208;37;109;21;76;6;24;0;0;6;24
431337;202208;4173;9241;3416;8135;233;759;2672;5991;2905;6750
431339;202208;508;1227;368;990;91;233;152;417;243;650
431340;202208;21905;50777;15651;40443;2170;6332;8281;19748;10451;26080
431342;202208;465;1026;343;832;43;110;237;561;280;671
431344;202208;412;1008;225;638;34;92;123;337;157;429
431346;202208;241;591;84;265;14;44;16;45;30;89
431349;202208;1099;2378;734;1680;110;284;438;923;548;1207
431350;202208;5639;13048;4381;11072;528;1522;2685;6338;3213;7860
431360;202208;652;1480;332;886;90;265;97;225;187;490
431365;202208;2683;5526;2100;4757;107;290;1725;3776;1832;4066
431370;202208;5798;12849;4301;10566;818;2174;2280;5429;3098;7603
431380;202208;1070;2665;856;2325;173;482;471;1263;644;1745
431390;202208;3180;7409;2055;5479;207;680;1126;2579;1333;3259
431395;202208;1990;4165;1527;3505;166;395;1051;2322;1217;2717
431400;202208;351;950;199;609;39;122;40;100;79;222
431402;202208;1059;2167;792;1774;104;238;537;1151;641;1389
431403;202208;221;604;172;512;38;132;75;192;113;324
431405;202208;6283;15297;5018;13273;830;2504;2515;6077;3345;8581
431406;202208;663;1698;444;1241;114;285;160;486;274;771
431407;202208;605;1532;420;1153;62;162;242;645;304;807
431410;202208;22031;50789;15676;40308;2028;6101;9207;21553;11235;27654
431413;202208;284;777;67;216;9;25;20;58;29;83
431415;202208;850;1977;561;1485;113;340;252;577;365;917
431417;202208;638;1330;415;981;63;180;231;507;294;687
431420;202208;1999;4116;1527;3496;115;311;1031;2222;1146;2533
431430;202208;661;1601;330;954;48;155;118;295;166;450
431440;202208;41064;88187;30380;72410;4875;12762;15473;33445;20348;46207
431442;202208;165;457;79;265;13;43;9;32;22;75
431445;202208;414;1137;127;410;10;31;23;55;33;86
431446;202208;329;901;253;749;28;88;136;388;164;476
431447;202208;885;2183;512;1451;85;238;153;439;238;677
431449;202208;924;2192;617;1622;99;269;303;729;402;998
431450;202208;2922;5292;2297;4441;110;203;1881;3494;1991;3697
431454;202208;49;152;40;130;7;24;23;68;30;92
431455;202208;649;1465;332;841;29;73;171;388;200;461
431460;202208;3506;7749;2358;5796;504;1293;913;2138;1417;3431
431470;202208;1625;4174;1183;3304;226;687;459;1187;685;1874
431475;202208;292;778;57;189;4;16;8;16;12;32
431477;202208;522;1261;293;807;75;184;98;254;173;438
431478;202208;249;668;57;177;9;24;7;16;16;40
431480;202208;3988;9481;3133;8123;740;1941;1407;3618;2147;5559
431490;202208;140794;306497;109132;259207;6380;18861;82260;184659;88640;203520
431500;202208;557;1336;420;1093;59;160;225;553;284;713
431505;202208;293;664;196;519;19;51;135;354;154;405
431507;202208;358;834;140;409;42;130;21;49;63;179
431510;202208;2006;4792;1361;3564;376;998;388;1025;764;2023
431513;202208;249;537;134;342;36;114;39;67;75;181
431514;202208;144;337;114;289;3;8;79;180;82;188
431515;202208;619;1384;460;1108;102;257;250;566;352;823
431517;202208;71;203;57;175;6;24;26;73;32;97
431520;202208;434;1033;185;528;27;93;80;178;107;271
431530;202208;6100;12843;3739;9285;737;1921;1620;3818;2357;5739
431531;202208;250;572;152;399;25;64;54;133;79;197
431532;202208;701;1506;408;994;71;192;194;451;265;643
431535;202208;318;797;143;419;29;85;27;71;56;156
431540;202208;2036;5841;1854;5603;82;275;1448;4428;1530;4703
431545;202208;393;957;84;224;12;25;27;73;39;98
431550;202208;2605;6151;1847;4770;259;761;1005;2401;1264;3162
431555;202208;809;1722;483;1175;47;126;279;672;326;798
431560;202208;30045;67923;20741;53601;4046;10120;8263;21704;12309;31824
431570;202208;6118;12383;5249;11182;260;750;4414;8874;4674;9624
431575;202208;434;966;367;861;79;156;212;486;291;642
431580;202208;717;1771;469;1297;56;183;249;638;305;821
431590;202208;845;2177;604;1679;131;364;235;622;366;986
431595;202208;426;1078;272;769;54;157;100;255;154;412
431600;202208;2023;4567;1437;3659;260;729;662;1559;922;2288
431610;202208;1714;3892;1132;2887;173;442;497;1331;670;1773
431620;202208;546;1311;293;760;61;185;151;320;212;505
431630;202208;1501;3538;700;1941;153;464;228;558;381;1022
431640;202208;8075;16952;6847;15404;749;1896;4808;10439;5557;12335
431642;202208;764;1642;467;1129;99;203;199;465;298;668
431643;202208;415;977;199;545;22;55;69;177;91;232
431645;202208;2731;5005;2153;4284;41;113;1891;3645;1932;3758
431647;202208;356;819;124;341;14;41;37;87;51;128
431650;202208;150;401;108;334;16;59;45;118;61;177
431660;202208;1044;2620;496;1501;87;304;121;315;208;619
431670;202208;1412;3215;845;2209;138;369;388;911;526;1280
431673;202208;256;665;102;329;12;40;30;85;42;125
431675;202208;419;1060;119;396;16;56;20;56;36;112
431680;202208;10916;25172;8261;20524;1640;4523;4117;9341;5757;13864
431690;202208;30511;69605;22010;55143;3215;9208;12163;28446;15378;37654
431695;202208;261;611;153;415;23;91;84;191;107;282
431697;202208;540;1176;418;996;74;174;236;553;310;727
431700;202208;1724;3917;1365;3310;215;466;735;1810;950;2276
431710;202208;17123;36452;12493;30136;1607;4222;7747;17975;9354;22197
431720;202208;8114;18592;4969;13070;1190;3262;1228;2825;2418;6087
431725;202208;43;105;31;85;9;31;15;35;24;66
431730;202208;5291;11585;3560;8999;659;1821;1763;4156;2422;5977
431740;202208;6219;14003;4201;10743;988;2807;1291;2929;2279;5736
431750;202208;9626;23136;7213;19376;1739;4892;2636;6873;4375;11765
431755;202208;365;979;92;304;8;34;22;64;30;98
431760;202208;6228;13307;4347;10357;468;1307;2684;5896;3152;7203
431770;202208;2399;5040;1841;4299;266;588;1228;2868;1494;3456
431775;202208;237;582;130;375;28;92;29;67;57;159
431780;202208;2526;5739;1661;4222;271;729;663;1608;934;2337
431790;202208;872;2193;584;1628;140;393;215;584;355;977
431795;202208;314;765;149;433;26;78;46;122;72;200
431800;202208;9978;22293;6383;16749;1753;5417;775;1796;2528;7213
431805;202208;317;801;70;251;3;7;3;6;6;13
431810;202208;3844;8264;2460;5857;365;942;1357;2968;1722;3910
431820;202208;2529;6225;1951;5332;482;1482;861;2243;1343;3725
431830;202208;10425;21782;7645;18034;2259;6028;1348;3312;3607;9340
431840;202208;3312;7636;2681;6677;376;1002;1707;4161;2083;5163
431842;202208;554;1344;195;576;33;113;64;160;97;273
431843;202208;361;936;253;711;55;171;109;279;164;450
431844;202208;213;573;75;241;15;48;16;48;31;96
431845;202208;568;1394;381;1027;32;91;236;617;268;708
431846;202208;344;784;300;722;13;36;266;633;279;669
431848;202208;183;463;99;284;10;33;32;76;42;109
431849;202208;413;993;83;232;12;34;16;32;28;66
431850;202208;5097;12668;3930;10522;947;2733;1337;3318;2284;6051
431860;202208;765;1695;435;1092;52;144;274;645;326;789
431861;202208;122;323;77;225;18;59;25;60;43;119
431862;202208;566;1696;465;1510;94;355;221;669;315;1024
431870;202208;27036;62551;21747;54567;2119;6184;14247;33748;16366;39932
431880;202208;4694;11167;3424;9013;428;1323;1866;4572;2294;5895
431890;202208;5898;13742;3792;9867;1068;2855;988;2510;2056;5365
431900;202208;1202;2888;786;2147;130;392;374;909;504;1301
431910;202208;888;2000;356;922;54;139;115;235;169;374
431912;202208;623;1470;507;1280;67;185;336;824;403;1009
431915;202208;1359;2873;1083;2462;69;174;844;1844;913;2018
431920;202208;1550;3096;1285;2767;31;75;1141;2411;1172;2486
431930;202208;839;2014;575;1553;198;518;194;535;392;1053
431935;202208;99;247;71;199;12;38;17;39;29;77
431936;202208;357;927;205;560;40;114;106;277;146;391
431937;202208;183;457;121;342;26;66;45;121;71;187
431940;202208;3545;7750;2280;5571;173;482;1428;3251;1601;3733
431950;202208;2569;6054;2021;5197;520;1338;882;2217;1402;3555
431960;202208;3604;8164;2748;6706;785;1997;802;1859;1587;3856
431970;202208;480;1162;222;603;54;152;55;135;109;287
431971;202208;88;218;43;127;6;20;11;31;17;51
431973;202208;679;1922;456;1468;44;165;330;1044;374;1209
431975;202208;127;257;37;98;6;20;9;18;15;38
431980;202208;1375;3069;1108;2676;127;405;748;1619;875;2024
431990;202208;7206;16359;5353;13766;428;1351;3373;8279;3801;9630
432000;202208;16912;36715;12716;30471;1650;4428;8060;18124;9710;22552
432010;202208;3226;7097;2168;5425;483;1247;744;1710;1227;2957
432020;202208;1910;4809;1194;3331;334;980;287;759;621;1739
432023;202208;621;1394;301;792;41;104;136;306;177;410
432026;202208;1210;3014;926;2476;264;714;346;958;610;1672
432030;202208;515;1145;297;770;20;53;177;416;197;469
432032;202208;388;943;254;671;23;73;136;320;159;393
432035;202208;803;2115;670;1893;167;436;333;984;500;1420
432040;202208;1254;2853;508;1461;53;173;221;555;274;728
432045;202208;198;516;123;365;18;55;54;151;72;206
432050;202208;659;1506;480;1207;61;192;255;611;316;803
432055;202208;805;1920;556;1471;171;432;157;414;328;846
432057;202208;183;462;154;394;6;16;103;237;109;253
432060;202208;494;1169;146;451;14;50;39;114;53;164
432065;202208;257;660;192;529;49;141;86;225;135;366
432067;202208;964;2439;806;2110;76;227;569;1438;645;1665
432070;202208;1945;4597;1403;3640;203;601;723;1698;926;2299
432080;202208;5984;12741;4474;10510;673;1890;2333;4982;3006;6872
432085;202208;465;1168;356;1003;68;215;183;482;251;697
432090;202208;3167;7481;1900;5144;395;1045;797;2016;1192;3061
432100;202208;1071;2580;535;1581;94;289;108;254;202;543
432110;202208;2587;6151;1885;4957;442;1269;451;997;893;2266
432120;202208;4285;10613;3457;9271;543;1631;1826;4543;2369;6174
432130;202208;3266;7448;2709;6649;449;1136;1517;3706;1966;4842
432132;202208;290;747;162;469;24;78;76;185;100;263
432135;202208;1196;2565;820;1949;85;207;560;1331;645;1538
432140;202208;2223;5669;1754;4815;206;660;1168;3047;1374;3707
432143;202208;1791;4401;1355;3715;105;328;849;2260;954;2588
432145;202208;2040;5154;1340;3768;203;628;447;1031;650;1659
432146;202208;136;361;106;326;39;138;32;89;71;227
432147;202208;642;1682;343;1034;120;370;59;176;179;546
432149;202208;578;1319;276;731;31;78;116;274;147;352
432150;202208;4631;10710;3509;8890;653;1862;1762;4068;2415;5930
432160;202208;7575;17543;5708;14767;1404;3836;2227;5607;3631;9443
432162;202208;240;527;43;127;8;27;9;15;17;42
432163;202208;183;435;35;96;3;9;5;6;8;15
432166;202208;750;1947;611;1690;104;337;234;569;338;906
432170;202208;1798;4578;1249;3605;216;677;517;1335;733;2012
432180;202208;3500;7822;1917;4981;292;862;871;1927;1163;2789
432183;202208;444;1195;329;949;71;247;141;364;212;611
432185;202208;994;2418;596;1667;113;335;259;676;372;1011
432190;202208;2498;5622;1780;4532;154;488;1179;2764;1333;3252
432195;202208;1143;2776;736;2022;137;370;267;721;404;1091
432200;202208;4332;9791;3281;8223;243;677;2327;5599;2570;6276
432210;202208;498;1170;342;892;44;124;198;453;242;577
432215;202208;765;1921;673;1780;101;262;429;1123;530;1385
432218;202208;267;621;119;318;16;50;42;81;58;131
432220;202208;4258;9322;3075;7426;527;1320;1703;3909;2230;5229
432225;202208;164;420;106;305;16;41;48;139;64;180
432230;202208;926;2120;459;1259;60;201;199;469;259;670
432232;202208;570;1337;361;994;67;200;159;389;226;589
432234;202208;344;821;176;489;36;86;46;110;82;196
432235;202208;57;147;30;77;5;16;14;28;19;44
432237;202208;349;853;303;776;8;27;258;640;266;667
432240;202208;20417;44886;15132;38040;1330;3243;10431;26001;11761;29244
432250;202208;7521;19256;5654;15671;1076;3228;2834;7453;3910;10681
432252;202208;543;1225;350;864;41;108;193;434;234;542
432253;202208;1044;2835;716;2052;201;607;142;366;343;973
432254;202208;720;1643;216;618;29;84;35;73;64;157
432255;202208;123;302;72;197;9;28;39;93;48;121
432260;202208;6573;15491;4953;12573;1009;2787;2321;5361;3330;8148
432270;202208;2632;6428;2118;5526;628;1710;738;1847;1366;3557
432280;202208;1525;3671;819;2333;124;396;274;635;398;1031
432285;202208;153;451;31;88;4;10;8;22;12;32
432290;202208;407;1035;256;714;62;188;79;177;141;365
432300;202208;35261;80567;27059;68006;2572;7702;18285;43246;20857;50948
432310;202208;1204;2678;926;2206;106;224;713;1697;819;1921
432320;202208;229;514;102;285;13;39;37;87;50;126
432330;202208;198;463;68;219;10;32;13;41;23;73
432335;202208;187;543;70;252;8;24;12;36;20;60
432340;202208;372;902;169;524;31;103;53;158;84;261
432345;202208;959;1835;816;1666;14;39;724;1438;738;1477
432350;202208;384;902;193;546;37;117;55;128;92;245
432360;202208;244;709;48;158;4;12;13;34;17;46
432370;202208;407;894;239;610;25;74;139;338;164;412
432375;202208;618;1420;426;1054;116;301;150;371;266;672
432377;202208;179;532;43;148;1;3;11;26;12;29
432380;202208;2300;5960;1635;4767;260;805;844;2373;1104;3178
500020;202208;3874;8885;2748;7159;248;797;1837;4595;2085;5392
500025;202208;1349;3171;865;2283;110;299;471;1181;581;1480
500060;202208;9666;25206;6776;19351;857;2672;3908;10973;4765;13645
500070;202208;5944;13777;4282;11077;784;2185;2075;5241;2859;7426
500080;202208;1851;4284;1139;3019;192;572;450;1034;642;1606
500085;202208;2432;5714;1710;4445;437;1233;660;1557;1097;2790
500090;202208;2416;5961;1647;4699;280;870;509;1545;789;2415
500100;202208;4557;10792;3460;9081;532;1582;1636;4012;2168;5594
500110;202208;12253;27982;8513;22282;1625;4541;4085;10572;5710;15113
500124;202208;2639;6840;2124;6039;321;898;1302;3748;1623;4646
500150;202208;1825;3808;1284;3094;236;641;700;1544;936;2185
500190;202208;6031;14709;3954;10850;815;2319;1384;3484;2199;5803
500200;202208;3240;6989;2205;5324;194;495;1421;3244;1615;3739
500210;202208;5991;12876;4289;10690;1152;2913;2131;5235;3283;8148
500215;202208;1709;4352;1271;3585;127;389;738;2031;865;2420
500220;202208;3802;9523;2791;7851;433;1314;1437;3758;1870;5072
500230;202208;2411;5258;1859;4521;235;609;1214;2868;1449;3477
500240;202208;4929;13471;3598;10790;532;1697;1534;4624;2066;6321
500260;202208;3862;7792;2516;5974;263;713;1529;3392;1792;4105
500270;202208;175005;389804;113751;291305;15629;45208;52256;120471;67885;165679
500280;202208;1652;3872;1095;3033;166;468;596;1643;762;2111
500290;202208;4397;10136;2714;7313;416;1285;1046;2478;1462;3763
500295;202208;4767;10871;3165;8155;540;1589;1352;3034;1892;4623
500310;202208;1214;2278;809;1777;121;225;458;1003;579;1228
500315;202208;5230;12145;4241;10800;279;784;3374;8440;3653;9224
500320;202208;24541;60602;17043;48504;4163;11896;6688;19927;10851;31823
500325;202208;7047;14595;4989;11839;583;1511;3070;7012;3653;8523
500330;202208;8192;17453;5463;13552;519;1349;3058;7560;3577;8909
500345;202208;2591;6032;1756;4700;295;838;674;1712;969;2550
500348;202208;2807;6647;2121;5515;187;548;1421;3618;1608;4166
500350;202208;1430;3727;833;2489;100;318;309;840;409;1158
500370;202208;32601;79685;23788;65583;3001;9478;12262;32463;15263;41941
500375;202208;3077;7609;1989;5442;267;789;796;1918;1063;2707
500380;202208;4233;9976;2976;7922;842;2278;527;1444;1369;3722
500390;202208;743;1505;457;1150;62;171;263;658;325;829
500400;202208;1883;4577;1250;3371;203;625;484;1153;687;1778
500410;202208;2870;6355;2006;5121;233;555;1103;2953;1336;3508
500430;202208;3340;7731;2290;6180;357;953;945;2760;1302;3713
500440;202208;1907;4327;1057;2885;172;461;402;1132;574;1593
500450;202208;2213;5197;1416;3863;279;772;376;962;655;1734
500460;202208;4503;11154;2786;7901;496;1563;737;1932;1233;3495
500470;202208;3153;8091;2065;5925;494;1545;568;1385;1062;2930
500480;202208;2360;6873;1940;6220;182;618;1405;4559;1587;5177
500490;202208;1378;3061;831;2220;160;500;222;584;382;1084
500500;202208;4854;12143;3215;9607;952;3162;383;1226;1335;4388
500510;202208;844;2019;560;1512;34;117;376;932;410;1049
500515;202208;1968;4764;1509;4053;210;615;847;2213;1057;2828
500520;202208;4103;10859;3150;9282;688;1982;1563;4769;2251;6751
500525;202208;1157;3159;921;2805;129;417;553;1644;682;2061
500540;202208;6228;15417;3818;11163;1083;3514;624;1557;1707;5071
500560;202208;6416;15901;5148;14336;228;714;4266;11908;4494;12622
500568;202208;5496;11298;3411;8227;664;1671;1466;3190;2130;4861
500570;202208;10064;22034;6941;17049;939;2701;3763;8347;4702;11048
500580;202208;3756;9099;2721;7338;655;1844;1210;3190;1865;5034
500600;202208;4416;10422;3236;8568;751;2114;999;2569;1750;4683
500620;202208;9656;23774;6726;18379;1016;2999;3342;8505;4358;11504
500625;202208;638;1637;436;1248;68;212;176;469;244;681
500627;202208;941;2399;580;1767;100;315;177;504;277;819
500630;202208;9096;19345;5355;13463;1093;2974;1738;4075;2831;7049
500635;202208;3188;9659;2390;8561;261;838;1627;6320;1888;7158
500640;202208;2150;4350;1439;3424;67;187;988;2219;1055;2406
500660;202208;24430;56785;16932;46148;5017;14091;5747;15760;10764;29851
500690;202208;3200;7645;2209;6098;498;1588;1047;2685;1545;4273
500710;202208;3828;9508;2796;7767;665;2048;884;2322;1549;4370
500720;202208;6162;14847;4096;11450;834;2528;1391;3677;2225;6205
500730;202208;1273;2955;704;1946;139;388;213;580;352;968
500740;202208;5612;12659;3608;9583;680;1905;1591;4028;2271;5933
500750;202208;1328;3105;934;2470;133;388;409;957;542;1345
500755;202208;1349;3297;852;2386;148;463;260;631;408;1094
500769;202208;6214;14548;3509;9656;823;2370;527;1267;1350;3637
500770;202208;1697;4291;1165;3416;222;680;395;1114;617;1794
500780;202208;1517;3569;984;2663;181;558;259;575;440;1133
500790;202208;8683;21937;6350;17799;1251;3799;2414;6636;3665;10435
500793;202208;2485;5895;1792;4740;360;1017;758;1825;1118;2842
500795;202208;3507;7616;2794;6687;220;444;2216;5440;2436;5884
500797;202208;949;2292;631;1715;193;568;191;480;384;1048
500800;202208;4174;9035;2618;6730;724;2066;531;1418;1255;3484
500830;202208;23594;55301;16127;42090;3475;9574;5933;14537;9408;24111
500840;202208;1725;3933;1071;2706;129;342;514;1196;643;1538
510010;202208;2159;4454;1534;3668;200;459;1016;2423;1216;2882
510020;202208;4941;11856;2726;7625;478;1420;798;1956;1276;3376
510025;202208;8699;19841;5683;15166;665;1918;3069;7760;3734;9678
510030;202208;3729;7692;2493;5855;252;617;1335;3034;1587;3651
510035;202208;1334;3356;865;2601;242;733;314;1037;556;1770
510040;202208;2883;5997;2172;5112;267;558;1374;3346;1641;3904
510050;202208;2713;5153;1887;4116;220;580;1322;2755;1542;3335
510060;202208;1769;4266;1193;3241;277;798;274;614;551;1412
510080;202208;1837;4451;1235;3489;206;651;554;1469;760;2120
510100;202208;813;1769;593;1441;69;190;354;799;423;989
510120;202208;329;564;191;405;9;23;155;313;164;336
510125;202208;2444;5857;1898;5020;237;748;979;2355;1216;3103
510130;202208;1932;4515;1378;3655;309;872;646;1628;955;2500
510140;202208;3601;8885;2454;7410;874;2896;812;2524;1686;5420
510160;202208;2303;4936;1800;4304;53;146;1609;3815;1662;3961
510170;202208;5907;14312;4482;12072;877;2545;2110;5494;2987;8039
510180;202208;17933;37317;12207;29418;1989;5230;6183;15044;8172;20274
510185;202208;2085;5180;1368;4142;535;1654;327;1236;862;2890
510190;202208;2837;7428;1784;5691;461;1570;368;1255;829;2825
510250;202208;20907;48635;15657;40935;2267;6494;9098;23564;11365;30058
510260;202208;2131;8675;1792;8106;262;1143;1076;5519;1338;6662
510263;202208;4300;11456;2843;8590;539;1819;659;1711;1198;3530
510267;202208;6674;18247;3951;12190;703;2336;742;1932;1445;4268
510268;202208;1557;3837;1088;3053;295;879;286;659;581;1538
510269;202208;1200;3068;781;2319;152;501;325;901;477;1402
510270;202208;3538;9487;2479;7666;381;1307;1070;3237;1451;4544
510279;202208;2142;5312;1258;3709;183;598;388;1006;571;1604
510285;202208;1265;3163;839;2419;212;681;269;679;481;1360
510300;202208;4679;10685;3552;9240;283;749;2581;6783;2864;7532
510305;202208;1727;4483;1130;3395;233;710;331;1023;564;1733
510310;202208;1202;2813;843;2246;200;524;327;899;527;1423
510320;202208;4717;10864;3299;8595;727;2090;1072;2460;1799;4550
510325;202208;5173;14380;3546;11215;827;2750;882;2754;1709;5504
510330;202208;3105;8613;2063;6840;478;1682;795;2816;1273;4498
510335;202208;5923;15909;4524;13643;787;2595;2340;6994;3127;9589
510336;202208;589;1554;424;1306;65;187;226;761;291;948
510337;202208;1752;4765;1160;3746;416;1424;307;978;723;2402
510340;202208;115686;245529;79747;195326;16286;44812;34308;77607;50594;122419
510343;202208;1455;3298;968;2512;119;359;537;1295;656;1654
510345;202208;1502;3900;1135;3212;183;518;596;1571;779;2089
510350;202208;3771;8908;2513;6917;741;2114;678;1802;1419;3916
510360;202208;2380;4451;1461;3400;58;108;1066;2599;1124;2707
510370;202208;2087;5538;1591;4758;234;727;979;2950;1213;3677
510380;202208;666;1531;390;1068;50;159;168;441;218;600
510385;202208;1424;4504;1057;3844;103;445;707;2637;810;3082
510390;202208;1656;3809;1146;3220;289;802;601;1751;890;2553
510395;202208;828;1705;552;1320;33;70;390;941;423;1011
510410;202208;6078;15242;4485;12611;736;2127;2669;7562;3405;9689
510420;202208;3054;5711;2123;4508;80;184;1642;3432;1722;3616
510450;202208;632;1465;374;1026;80;221;123;312;203;533
510452;202208;1055;2804;784;2297;117;370;443;1268;560;1638
510454;202208;1313;3278;972;2724;142;368;587;1758;729;2126
510455;202208;1110;2826;723;2101;148;475;269;703;417;1178
510460;202208;2375;5621;1704;4618;399;1204;772;1849;1171;3053
510480;202208;5848;13453;3898;9973;689;1919;1718;3984;2407;5903
510490;202208;2076;4830;1562;4187;246;677;1007;2696;1253;3373
510500;202208;1771;4108;1072;3024;249;742;293;798;542;1540
510510;202208;4703;12270;3342;10017;964;3147;1052;3123;2016;6270
510515;202208;6332;15263;4323;11827;865;2627;1590;3841;2455;6468
510517;202208;1806;4408;1231;3564;478;1468;269;713;747;2181
510520;202208;2739;5328;1492;3727;145;389;673;1745;818;2134
510523;202208;1426;3170;1009;2546;120;335;661;1607;781;1942
510525;202208;9550;24740;7106;20143;1173;3599;3182;8400;4355;11999
510530;202208;621;1519;458;1294;48;144;295;847;343;991
510550;202208;3057;8222;2315;7002;429;1424;1239;3625;1668;5049
510558;202208;2718;6916;1999;5829;257;682;1058;3301;1315;3983
510560;202208;2146;5760;1358;4225;324;1054;284;911;608;1965
510562;202208;7065;15955;5247;12961;810;2073;2727;6526;3537;8599
510590;202208;3763;8617;2735;7328;267;741;1930;5227;2197;5968
510600;202208;1378;2805;972;2236;106;273;586;1256;692;1529
510610;202208;3270;7310;2254;5970;333;1019;1308;3343;1641;4362
510615;202208;3403;7877;2391;6334;325;931;1483;3884;1808;4815
510617;202208;1253;3462;997;3093;113;391;722;2289;835;2680
510618;202208;1492;3661;1058;2996;205;660;537;1446;742;2106
510619;202208;881;2170;487;1430;83;256;99;230;182;486
510620;202208;1590;3465;798;2206;295;910;63;126;358;1036
510621;202208;1842;4664;1100;3301;252;803;291;748;543;1551
510622;202208;6445;16821;4192;12239;1284;4013;647;1640;1931;5653
510623;202208;3318;7661;2380;6222;515;1480;924;2346;1439;3826
510624;202208;1909;4809;1014;3161;120;405;218;606;338;1011
510625;202208;4088;9389;2504;6660;459;1333;896;2301;1355;3634
510626;202208;1667;3952;1105;3075;277;842;307;854;584;1696
510627;202208;743;1814;410;1193;106;319;113;348;219;667
510628;202208;1780;3732;1151;2947;357;1026;446;1052;803;2078
510629;202208;2005;5231;1350;4052;285;928;387;1132;672;2060
510630;202208;4005;10446;2551;7854;589;1912;638;2071;1227;3983
510631;202208;711;1545;536;1298;22;43;417;1021;439;1064
510637;202208;4304;9524;3071;7814;706;1995;1159;2865;1865;4860
510642;202208;7045;17942;5462;15671;918;3036;3318;9255;4236;12291
510645;202208;1202;2232;738;1655;174;372;332;769;506;1141
510650;202208;8503;19520;6724;17591;909;1524;4857;14082;5766;15606
510665;202208;2043;4253;1290;3100;282;606;517;1358;799;1964
510670;202208;501;1030;296;756;34;89;157;399;191;488
510675;202208;7743;20065;5228;15463;1311;4305;955;2561;2266;6866
510677;202208;2670;6437;1904;5325;322;997;1087;2963;1409;3960
510680;202208;833;2015;480;1399;95;311;129;316;224;627
510682;202208;2009;5346;1492;4538;481;1617;514;1482;995;3099
510685;202208;621;1636;445;1305;41;121;268;788;309;909
510700;202208;5096;11278;3539;9138;345;1023;2468;6193;2813;7216
510704;202208;13195;29756;8951;22803;2160;5831;2631;6151;4791;11982
510706;202208;2793;7697;1928;6278;355;1194;812;2861;1167;4055
510710;202208;3544;8231;2247;5861;566;1440;668;1645;1234;3085
510715;202208;755;1489;500;1162;48;133;302;659;350;792
510718;202208;2683;5908;1636;4499;346;940;755;2338;1101;3278
510719;202208;549;1111;323;790;38;113;168;363;206;476
510720;202208;1089;2355;717;1837;178;479;289;693;467;1172
510724;202208;1041;2774;709;2141;102;359;333;923;435;1282
510726;202208;1090;1975;627;1423;73;171;338;750;411;921
510729;202208;686;1531;318;868;42;126;89;249;131;375
510730;202208;3539;8076;2432;6420;344;1045;1312;3225;1656;4270
510735;202208;1459;3770;1175;3388;95;264;948;2751;1043;3015
510740;202208;1153;2647;784;2011;77;240;498;1167;575;1407
510757;202208;575;1781;450;1584;146;586;164;534;310;1120
510760;202208;53702;112280;33459;82724;6634;18378;12631;27973;19265;46351
510770;202208;4941;10241;3474;8407;251;538;2426;6075;2677;6613
510774;202208;471;1160;332;950;62;173;185;545;247;718
510775;202208;789;1925;484;1434;112;349;139;380;251;729
510776;202208;826;1995;570;1517;102;308;269;692;371;1000
510777;202208;1785;4456;1299;3836;219;786;818;2298;1037;3084
510779;202208;923;2359;676;1951;75;189;429;1304;504;1493
510780;202208;5010;11593;3683;9720;714;1784;1890;5355;2604;7139
510785;202208;2477;6168;1433;4288;346;1082;369;1138;715;2220
510787;202208;3912;10390;2623;7929;973;3060;252;705;1225;3765
510788;202208;639;1413;427;1104;63;143;196;577;259;720
510790;202208;23040;56688;14725;42205;3374;10525;1846;4695;5220;15220
510792;202208;12173;32136;7816;23863;1806;5984;1633;4415;3439;10399
510794;202208;1500;3903;1074;3229;342;1177;227;560;569;1737
510795;202208;12167;29378;8576;23309;1910;5774;2925;7246;4835;13020
510800;202208;1775;4549;1232;3648;350;1133;170;394;520;1527
510805;202208;1805;4753;1176;3599;234;786;476;1326;710;2112
510810;202208;817;1568;537;1210;164;317;256;619;420;936
510820;202208;930;1705;546;1240;32;70;357;792;389;862
510830;202208;1081;2381;822;2059;68;168;602;1556;670;1724
510835;202208;723;1581;471;1228;56;178;287;697;343;875
510840;202208;73054;144671;52439;119829;8537;18764;30916;72067;39453;90831
510850;202208;2176;5221;1409;4045;554;1804;94;141;648;1945
510860;202208;3086;7653;2009;5963;661;2114;392;1181;1053;3295
510880;202208;884;2363;640;1930;165;491;171;519;336;1010
510885;202208;728;1709;474;1321;87;232;122;331;209;563
510890;202208;980;2561;704;2065;209;654;220;620;429;1274
510895;202208;1722;4096;1176;3189;160;516;612;1463;772;1979
520005;202208;4187;10096;3333;8985;972;2279;1430;4575;2402;6854
520010;202208;3335;8339;2471;6748;523;1572;990;2358;1513;3930
520013;202208;4157;9841;2717;7282;674;1792;821;2329;1495;4121
520015;202208;611;1455;446;1211;101;278;171;499;272;777
520017;202208;1440;3401;1012;2732;187;568;454;1107;641;1675
520020;202208;622;1174;477;1006;38;87;381;780;419;867
520025;202208;45193;113169;38555;103878;5379;15169;25152;67051;30531;82220
520030;202208;7961;17552;6586;15728;459;1127;5061;11878;5520;13005
520050;202208;475;1109;284;761;44;116;150;393;194;509
520055;202208;2072;4843;1290;3297;206;523;577;1373;783;1896
520060;202208;2194;5342;1488;4126;302;949;378;1025;680;1974
520080;202208;2216;5284;1702;4598;324;805;852;2431;1176;3236
520082;202208;1012;2417;717;1924;120;343;320;907;440;1250
520085;202208;1219;2838;976;2492;211;544;486;1222;697;1766
520090;202208;1043;1901;754;1591;67;97;611;1328;678;1425
520110;202208;50651;126479;35025;100475;9937;31278;3632;9312;13569;40590
520120;202208;293;649;156;409;19;60;64;150;83;210
520130;202208;4600;10375;3532;8733;671;1712;1536;3678;2207;5390
520140;202208;58494;145481;40882;115910;13536;40663;5742;16604;19278;57267
520145;202208;709;1535;457;1172;99;273;178;409;277;682
520150;202208;776;1766;570;1502;73;190;302;767;375;957
520160;202208;1034;2352;701;1770;132;299;266;704;398;1003
520170;202208;5524;10876;3667;8702;295;760;2659;6211;2954;6971
520180;202208;3220;7690;2600;6813;332;1034;1669;4183;2001;5217
520215;202208;2097;4734;1523;3904;243;669;849;2111;1092;2780
520235;202208;914;1878;616;1475;98;251;350;819;448;1070
520250;202208;2011;4757;1470;3920;580;1637;266;839;846;2476
520260;202208;894;1988;552;1449;109;286;207;528;316;814
520280;202208;1014;2156;792;1823;161;365;421;964;582;1329
520310;202208;1214;2462;786;1833;188;503;330;760;518;1263
520320;202208;2329;5629;1790;4810;227;595;1004;2755;1231;3350
520330;202208;5801;13986;4421;11698;669;2079;2431;5966;3100;8045
520340;202208;2738;5681;1658;4173;180;390;887;2310;1067;2700
520350;202208;3634;8337;2556;6702;769;2086;881;2316;1650;4402
520355;202208;2255;5759;1620;4582;465;1408;273;658;738;2066
520357;202208;1018;2219;735;1820;35;89;591;1443;626;1532
520360;202208;931;2213;725;1894;126;359;329;800;455;1159
520380;202208;1646;3912;993;2747;161;491;350;851;511;1342
520390;202208;1389;3071;888;2404;241;701;221;628;462;1329
520393;202208;797;1764;536;1357;75;194;227;540;302;734
520396;202208;1044;2432;874;2182;51;130;622;1484;673;1614
520400;202208;1903;4225;1474;3666;95;267;1093;2695;1188;2962
520410;202208;2644;5442;1803;4236;269;716;1004;2197;1273;2913
520420;202208;439;930;339;780;19;51;260;576;279;627
520425;202208;1797;4221;1022;2761;281;828;196;458;477;1286
520430;202208;2872;6293;1750;4512;422;1148;291;679;713;1827
520440;202208;3536;8156;2016;5461;435;1311;455;1139;890;2450
520450;202208;16506;37309;11384;29437;3160;8418;3219;8381;6379;16799
520455;202208;939;2321;660;1895;200;583;168;505;368;1088
520460;202208;1255;2759;976;2405;173;381;638;1654;811;2035
520465;202208;1072;2402;884;2148;58;179;689;1631;747;1810
520470;202208;2721;6221;2096;5417;528;1366;1007;2770;1535;4136
520480;202208;1100;2825;794;2302;176;532;309;848;485;1380
520485;202208;1745;4897;1368;4310;238;799;655;1953;893;2752
520490;202208;5183;12574;3990;10743;662;1962;2351;6120;3013;8082
520495;202208;1934;3781;1468;3168;109;228;1093;2370;1202;2598
520500;202208;2030;4665;1523;3810;193;571;887;2054;1080;2625
520505;202208;1118;2152;871;1856;65;133;673;1399;738;1532
520510;202208;10949;25232;8116;21038;1420;4230;3864;9348;5284;13578
520520;202208;1403;3306;1080;2829;250;707;461;1180;711;1887
520530;202208;2989;7437;2177;6022;403;1087;1072;3117;1475;4204
520540;202208;3660;9030;2426;6686;446;1290;735;1827;1181;3117
520545;202208;1652;3750;1295;3218;299;722;632;1564;931;2286
520547;202208;1543;3706;1187;3103;246;657;618;1594;864;2251
520549;202208;19092;45847;15880;41301;1905;5494;10822;27091;12727;32585
520551;202208;5825;13924;4888;12595;446;1409;3610;8888;4056;10297
520552;202208;1127;2692;868;2317;171;455;446;1254;617;1709
520570;202208;626;1345;400;994;79;168;171;429;250;597
520580;202208;2618;5455;1966;4699;338;783;1158;2787;1496;3570
520590;202208;1623;3778;1104;2948;285;774;372;966;657;1740
520620;202208;11059;26681;8875;23552;1743;4970;4695;12179;6438;17149
520630;202208;1063;2446;744;1935;92;251;353;870;445;1121
520640;202208;2881;6489;2150;5263;492;1180;772;1989;1264;3169
520650;202208;1264;2570;906;2088;181;384;475;1136;656;1520
520660;202208;616;1460;340;974;59;188;96;271;155;459
520670;202208;1136;2790;936;2492;114;273;601;1613;715;1886
520680;202208;974;2174;777;1889;122;263;475;1164;597;1427
520690;202208;392;912;260;702;87;215;72;203;159;418
520710;202208;523;1174;353;891;18;50;238;564;256;614
520725;202208;1694;3806;1134;2880;180;515;584;1426;764;1941
520735;202208;1087;2422;732;1863;203;464;244;638;447;1102
520740;202208;3001;6312;2218;5312;476;1088;1069;2630;1545;3718
520750;202208;857;1830;605;1468;86;220;331;765;417;985
520753;202208;1552;3796;1160;3113;215;666;542;1325;757;1991
520760;202208;1696;3358;1432;3047;31;66;1307;2788;1338;2854
520780;202208;1784;4016;1292;3301;174;430;674;1679;848;2109
520790;202208;3872;8687;2666;6773;448;1038;1382;3690;1830;4728
520800;202208;21660;50739;17057;44103;2733;7035;10065;26341;12798;33376
520810;202208;1479;2932;1102;2506;251;552;570;1425;821;1977
520815;202208;691;2016;511;1626;95;321;154;484;249;805
520830;202208;2135;4311;1528;3588;100;245;1182;2722;1282;2967
520840;202208;3366;8297;2690;7386;805;2425;966;2695;1771;5120
520850;202208;1011;2089;773;1764;161;433;390;845;551;1278
520860;202208;10863;26679;8050;21978;1874;5281;3185;8432;5059;13713
520870;202208;170880;370761;122580;298691;22845;58408;55986;128984;78831;187392
520880;202208;10985;29022;8743;25025;1827;5375;3659;10148;5486;15523
520890;202208;5635;11876;3950;9338;592;1611;2090;4638;2682;6249
520910;202208;5638;13262;3681;10021;757;2225;1023;2531;1780;4756
520915;202208;951;2339;616;1676;119;363;238;590;357;953
520920;202208;5465;11265;3940;9417;773;1624;2070;5264;2843;6888
520929;202208;783;1769;599;1500;106;218;269;721;375;939
520940;202208;1171;2900;912;2519;73;242;692;1857;765;2099
520945;202208;571;1209;413;996;27;71;261;607;288;678
520960;202208;1321;2821;1016;2391;341;759;359;944;700;1703
520970;202208;4029;9798;3016;8206;1015;2805;590;1764;1605;4569
520980;202208;921;1998;670;1677;108;277;320;757;428;1034
520990;202208;3718;8448;3029;7596;455;1044;2069;5299;2524;6343
520993;202208;1461;3392;971;2515;156;440;454;1119;610;1559
520995;202208;3011;7001;2248;5882;445;1117;770;2110;1215;3227
521000;202208;11362;27604;7544;20660;1214;3515;2355;5945;3569;9460
521010;202208;4611;11024;3390;8961;468;1349;1826;4573;2294;5922
521015;202208;935;2166;649;1664;51;140;417;1011;468;1151
521020;202208;4938;11554;2957;7956;696;1975;665;1757;1361;3732
521030;202208;901;1597;699;1326;23;53;606;1109;629;1162
521040;202208;10033;23206;7414;19214;1790;4657;2550;6976;4340;11633
521056;202208;1221;2988;864;2392;253;677;222;661;475;1338
521060;202208;1226;3018;864;2349;172;511;315;823;487;1334
521080;202208;1270;2577;672;1679;110;286;300;691;410;977
521090;202208;3724;9530;2508;7091;608;1856;294;802;902;2658
521100;202208;2304;4818;1728;4045;220;542;1126;2627;1346;3169
521120;202208;5967;13268;4488;11385;835;1813;1806;5405;2641;7218
521130;202208;1171;2582;562;1488;52;127;289;780;341;907
521140;202208;1856;4361;1348;3462;184;468;726;1769;910;2237
521150;202208;16217;34014;10584;25983;2390;6462;4531;10768;6921;17230
521160;202208;940;1831;616;1350;67;128;390;818;457;946
521170;202208;1287;2813;928;2282;130;350;463;1062;593;1412
521180;202208;10221;24940;8011;21265;1499;4324;3818;9741;5317;14065
521190;202208;13826;32338;8748;24175;2086;6162;2547;6761;4633;12923
521200;202208;851;1947;575;1503;72;202;299;738;371;940
521205;202208;733;1644;559;1376;22;60;441;1039;463;1099
521210;202208;923;2337;535;1518;100;307;143;310;243;617
521220;202208;4568;10127;3129;7990;715;1966;1264;3169;1979;5135
521225;202208;507;984;373;836;37;81;285;644;322;725
521230;202208;1693;3939;1411;3574;591;1534;466;1208;1057;2742
521250;202208;45268;104077;36781;92476;8678;23249;19913;48312;28591;71561
521260;202208;627;1358;471;1130;73;203;274;614;347;817
521270;202208;2502;5419;2140;4977;217;446;1563;3743;1780;4189
521280;202208;2197;5481;1660;4622;351;1045;726;2010;1077;3055
521290;202208;672;1427;462;1159;49;127;282;683;331;810
521295;202208;1417;2932;1091;2528;149;293;737;1728;886;2021
521300;202208;2201;5056;1673;4291;345;845;896;2354;1241;3199
521305;202208;800;1757;546;1400;54;165;336;823;390;988
521308;202208;5848;14269;4089;11130;383;1138;2550;6602;2933;7740
521310;202208;12623;29703;8660;22799;1604;4590;3738;9149;5342;13739
521340;202208;476;1004;325;796;32;72;198;474;230;546
521350;202208;2291;5543;1738;4709;142;423;1236;3236;1378;3659
521370;202208;1477;3610;938;2724;291;919;158;482;449;1401
521375;202208;1761;4263;1189;3292;244;683;312;935;556;1618
521377;202208;1662;3312;1210;2757;132;248;898;2166;1030;2414
521380;202208;7451;18760;4757;13855;733;2202;974;2979;1707;5181
521385;202208;832;1850;621;1568;92;204;336;913;428;1117
521390;202208;779;1855;536;1472;132;395;94;261;226;656
521400;202208;3501;7691;2778;6770;280;706;1921;4615;2201;5321
521405;202208;1654;4078;1113;3073;123;336;618;1638;741;1974
521410;202208;1107;2496;873;2147;212;472;458;1172;670;1644
521440;202208;1753;3957;1348;3382;421;987;568;1497;989;2484
521450;202208;4854;13320;3577;10880;964;2971;842;2623;1806;5594
521460;202208;7274;17441;5278;13972;1405;3854;1874;4784;3279;8638
521470;202208;943;2233;650;1708;88;217;312;762;400;979
521480;202208;584;1268;396;960;77;179;173;372;250;551
521483;202208;2773;6299;1968;5105;423;1100;856;2238;1279;3338
521486;202208;2119;4797;1607;4065;158;297;1046;2666;1204;2963
521487;202208;519;1142;365;938;59;153;232;598;291;751
521490;202208;1028;2527;762;2099;32;116;544;1407;576;1523
521500;202208;2456;5881;1866;5060;186;694;1168;2940;1354;3634
521520;202208;950;2076;742;1790;128;255;403;1012;531;1267
521523;202208;17272;46894;14228;42196;4164;12862;5124;14879;9288;27741
521525;202208;1300;2890;990;2450;83;255;674;1578;757;1833
521530;202208;2704;6669;1672;4630;335;945;450;1154;785;2099
521540;202208;962;2331;687;1883;141;446;290;751;431;1197
521550;202208;1962;4705;1088;3018;198;591;272;759;470;1350
521560;202208;6601;15554;4806;13145;1295;3420;2082;6048;3377;9468
521565;202208;813;1895;569;1498;95;254;263;696;358;950
521570;202208;4542;11565;3120;8943;614;1980;289;829;903;2809
521580;202208;599;1349;384;991;60;158;169;394;229;552
521590;202208;997;2054;708;1647;98;238;408;894;506;1132
521600;202208;530;1309;333;941;60;167;166;448;226;615
521630;202208;2018;4147;1270;3095;379;937;349;809;728;1746
521640;202208;2340;5204;1482;3925;327;954;467;1164;794;2118
521645;202208;622;1520;371;1054;159;442;28;60;187;502
521680;202208;1645;4240;1272;3633;356;1038;427;1219;783;2257
521690;202208;644;1497;534;1349;86;234;311;762;397;996
521710;202208;4180;9567;2729;7180;506;1477;799;1803;1305;3280
521720;202208;2942;6175;1901;4645;240;645;1109;2639;1349;3284
521730;202208;4729;12043;3580;10145;949;3089;914;2178;1863;5267
521740;202208;5234;12558;4040;10822;1286;3658;1107;2827;2393;6485
521760;202208;21264;50858;17146;45022;3530;10056;8940;23081;12470;33137
521770;202208;3886;8618;2605;6643;610;1631;655;1647;1265;3278
521800;202208;8377;20406;5992;16512;1710;4757;1925;5804;3635;10561
521805;202208;1299;2509;880;2000;192;402;454;1099;646;1501
521810;202208;849;1875;612;1550;110;280;343;888;453;1168
521830;202208;6973;17369;5615;15297;374;1268;4113;10803;4487;12071
521839;202208;1075;2298;810;1888;70;199;585;1251;655;1450
521850;202208;8314;18044;5181;13307;1551;3877;705;1751;2256;5628
521860;202208;1932;4978;1308;3818;223;719;411;1071;634;1790
521870;202208;816;2123;580;1680;125;398;183;434;308;832
521878;202208;1025;2484;681;1846;62;201;364;892;426;1093
521880;202208;26521;61210;18846;49430;4101;11350;8129;20410;12230;31760
521890;202208;4074;9711;2805;7551;743;2038;776;1910;1519;3948
521900;202208;1609;3614;831;2287;197;446;28;83;225;529
521910;202208;1694;3472;1199;2870;267;636;540;1282;807;1918
521920;202208;664;1617;511;1372;67;218;314;788;381;1006
521925;202208;913;2236;674;1864;137;423;289;759;426;1182
521930;202208;6532;14858;4365;11605;1180;2614;1757;5177;2937;7791
521935;202208;1217;2765;839;2134;73;199;491;1175;564;1374
521940;202208;1566;3208;1029;2465;183;490;527;1198;710;1688
521945;202208;780;1851;547;1449;80;215;296;774;376;989
521950;202208;878;1974;611;1553;104;270;285;715;389;985
521960;202208;817;2004;557;1526;54;184;324;804;378;988
521970;202208;3385;7148;2539;6113;258;517;1846;4623;2104;5140
521971;202208;917;2115;640;1688;161;412;178;451;339;863
521973;202208;1820;4408;1435;3836;143;352;1011;2715;1154;3067
521975;202208;16149;38596;13086;34290;2278;6342;7663;19653;9941;25995
521980;202208;2806;6059;2118;5160;146;365;1610;3921;1756;4286
521990;202208;1553;3713;1298;3334;251;703;759;1934;1010;2637
522000;202208;3248;7886;2539;6980;587;1661;1287;3723;1874;5384
522005;202208;448;970;290;733;52;136;110;277;162;413
522010;202208;5369;12469;3861;10035;812;2256;1493;3657;2305;5913
522015;202208;1266;3083;933;2570;251;706;388;1052;639;1758
522020;202208;6540;14401;4363;11116;860;2212;1934;4994;2794;7206
522026;202208;915;2271;580;1701;92;326;175;433;267;759
522028;202208;603;1408;418;1094;84;256;197;461;281;717
522040;202208;4436;8912;3130;7180;342;841;2135;4660;2477;5501
522045;202208;23987;60888;18017;51000;3960;11901;5206;13947;9166;25848
522050;202208;1431;3416;1011;2695;186;553;440;1020;626;1573
522060;202208;3537;8748;2563;7203;434;1187;1270;3610;1704;4797
522068;202208;2228;4923;1783;4399;100;209;1467;3630;1567;3839
522070;202208;986;1953;808;1697;22;40;716;1469;738;1509
522100;202208;997;2364;674;1812;93;262;331;853;424;1115
522108;202208;1326;2801;1035;2393;70;155;802;1818;872;1973
522119;202208;2242;4883;1786;4310;331;717;1009;2557;1340;3274
522130;202208;601;1356;455;1164;42;90;347;907;389;997
522140;202208;28819;69019;20339;54227;4390;12502;6648;16266;11038;28768
522145;202208;949;2128;670;1726;134;377;355;894;489;1271
522150;202208;1323;2975;869;2263;215;574;230;577;445;1151
522155;202208;1227;2967;960;2573;144;337;596;1629;740;1966
522157;202208;855;1733;699;1549;34;74;557;1234;591;1308
522160;202208;7322;17524;4695;12980;1239;3660;523;1549;1762;5209
522170;202208;3254;7834;2516;6748;301;801;1582;4249;1883;5050
522180;202208;750;1685;488;1211;84;221;149;375;233;596
522185;202208;28511;64766;21003;54777;7994;22489;4513;12584;12507;35073
522190;202208;953;2039;661;1583;132;319;297;668;429;987
522200;202208;2354;6065;1726;4964;451;1295;534;1530;985;2825
522205;202208;1959;4493;1422;3702;388;1047;516;1323;904;2370
522220;202208;1408;3164;1036;2655;123;290;661;1745;784;2035
522230;202208;1609;3629;1261;3126;221;599;725;1759;946;2358
530010;202208;261087;646032;218956;584720;28482;83029;138642;356881;167124;439910
110001;202207;4626;12183;3091;9361;710;2375;1100;3273;1810;5648
110002;202207;16125;39169;11732;31995;2996;8675;3468;9417;6464;18092
110003;202207;839;2327;604;1861;151;492;184;502;335;994
110004;202207;15658;37883;10769;29538;2242;6492;3853;10203;6095;16695
110005;202207;2950;7288;2087;5906;429;1208;671;2004;1100;3212
110006;202207;1778;4806;1077;3350;199;675;232;661;431;1336
110007;202207;1488;3675;973;2812;297;857;285;948;582;1805
110008;202207;4087;9794;3034;8340;498;1153;1819;5564;2317;6717
110009;202207;5274;13842;3404;10491;731;2482;1299;3828;2030;6310
110010;202207;9460;26972;7203;22976;1486;4408;3649;12949;5135;17357
110011;202207;8708;21712;5967;16935;1727;5123;1286;3590;3013;8713
110012;202207;19443;46203;12610;34894;3167;8957;2405;6547;5572;15504
110013;202207;6803;18181;4741;14239;1817;5755;785;2435;2602;8190
110014;202207;4519;11162;3086;8511;445;1352;1572;4171;2017;5523
110015;202207;6911;16668;4437;12162;872;2653;1450;3469;2322;6122
110018;202207;4896;11778;3065;8690;643;1953;799;2140;1442;4093
110020;202207;99599;217723;74850;184827;16268;39519;36760;94462;53028;133981
110025;202207;5959;13648;4058;10460;638;1786;2102;5230;2740;7016
110026;202207;653;1672;472;1380;114;351;158;484;272;835
110028;202207;8534;20525;5363;15035;1308;4063;735;2040;2043;6103
110029;202207;1791;4224;1097;3039;201;555;461;1289;662;1844
110030;202207;15776;35472;9877;26742;2606;7623;1447;4508;4053;12131
110032;202207;4159;10938;2564;7712;764;2261;549;1736;1313;3997
110033;202207;5007;14216;3761;11919;1226;3987;1176;4023;2402;8010
110034;202207;3692;8305;2503;6685;886;2611;674;2020;1560;4631
110037;202207;1865;5230;1326;4228;326;1048;501;1633;827;2681
110040;202207;3494;9088;2552;7422;623;1975;801;2223;1424;4198
110045;202207;5569;15099;4037;12391;1049;3421;1439;4511;2488;7932
110050;202207;2018;5194;1350;4031;405;1373;214;559;619;1932
110060;202207;1056;2982;695;2151;171;561;184;550;355;1111
110070;202207;1827;5336;1314;4216;366;1290;332;947;698;2237
110080;202207;7513;16790;5683;14523;1135;2844;3031;8190;4166;11034
110090;202207;672;1763;466;1393;117;398;130;370;247;768
110092;202207;1534;4158;1067;3289;211;643;529;1698;740;2341
110094;202207;3389;9357;2532;7739;1006;3237;361;1170;1367;4407
110100;202207;2039;5565;1603;4779;539;1654;574;1756;1113;3410
110110;202207;2077;5284;1477;4333;452;1417;331;1044;783;2461
110120;202207;1506;4011;1094;3230;264;819;346;1012;610;1831
110130;202207;3204;7571;1932;5304;327;867;207;520;534;1387
110140;202207;2702;7308;1953;5863;367;1206;844;2428;1211;3634
110143;202207;1647;4181;1184;3355;327;1022;364;991;691;2013
110145;202207;1137;2794;681;1957;162;460;273;814;435;1274
110146;202207;607;1501;411;1174;98;252;169;538;267;790
110147;202207;894;2181;590;1618;81;248;290;697;371;945
110148;202207;1130;2941;582;1769;142;477;78;209;220;686
110149;202207;3966;9730;2695;7775;906;2693;690;2135;1596;4828
110150;202207;3030;7307;1967;5673;620;1957;430;1362;1050;3319
110155;202207;968;2651;674;1967;139;460;274;717;413;1177
110160;202207;1663;4679;1215;3731;390;1215;281;883;671;2098
110170;202207;2416;5845;1555;4291;219;671;890;2298;1109;2969
110175;202207;2450;6517;1665;4881;299;925;685;1939;984;2864
110180;202207;1650;4176;1162;3249;150;444;606;1647;756;2091
120001;202207;4093;10640;3306;9483;440;1463;2221;6246;2661;7709
120005;202207;2246;7880;2032;7565;203;775;1581;6018;1784;6793
120010;202207;6831;17287;5877;15952;471;1239;4593;12595;5064;13834
120013;202207;2871;8525;2472;8008;624;1915;1276;4573;1900;6488
120017;202207;3328;8746;2833;8046;384;1060;1876;5627;2260;6687
120020;202207;17490;59083;16060;56515;1027;4199;12924;45459;13951;49658
120025;202207;4300;10071;3523;9181;431;1100;2506;6774;2937;7874
120030;202207;7315;26797;6752;25848;416;2018;5212;20245;5628;22263
120032;202207;1994;8113;1884;7912;90;566;1621;6675;1711;7241
120033;202207;5023;15994;4691;15417;101;546;4156;13449;4257;13995
120034;202207;3344;10454;2890;9726;120;627;2450;8047;2570;8674
120035;202207;4733;15547;4398;14981;250;1050;3758;12661;4008;13711
120038;202207;3529;9757;3035;9010;424;1345;1982;5890;2406;7235
120039;202207;2327;9110;2171;8823;125;697;1756;7086;1881;7783
120040;202207;65452;169637;56421;156371;7034;20703;37635;103697;44669;124400
120042;202207;4229;13099;3913;12564;162;748;3328;10455;3490;11203
120043;202207;1700;6288;1492;5988;48;329;1288;5085;1336;5414
120045;202207;7031;16455;5967;15225;391;1061;4873;12451;5264;13512
120050;202207;11653;35824;10715;34512;517;1933;9056;29216;9573;31149
120060;202207;11411;39306;10437;37903;485;2372;9027;32567;9512;34939
120070;202207;4009;11282;3455;10540;492;1346;2289;7434;2781;8780
120080;202207;6046;15111;5429;14252;735;1735;4012;10818;4747;12553
130002;202207;3917;13273;3492;12699;344;922;2894;11077;3238;11999
130006;202207;2982;9710;2475;8906;517;1638;1365;5619;1882;7257
130008;202207;3114;9807;2699;9220;146;535;2199;7676;2345;8211
130010;202207;4604;12170;3901;11368;150;383;3436;10130;3586;10513
130014;202207;4379;11440;3366;9913;557;1674;2040;6207;2597;7881
130020;202207;3273;11785;2888;11224;136;745;2372;9157;2508;9902
130030;202207;17272;38797;16056;37432;200;533;15202;35280;15402;35813
130040;202207;4771;13005;3949;11958;465;1272;2960;9309;3425;10581
130050;202207;8532;28552;7176;26805;316;1165;6328;24091;6644;25256
130060;202207;8506;31450;7230;29805;399;2278;6022;24548;6421;26826
130063;202207;7421;22597;6565;21635;193;857;5968;19631;6161;20488
130068;202207;4496;13514;3782;12566;185;879;3061;10082;3246;10961
130070;202207;8860;22715;7253;20960;517;1207;5838;17476;6355;18683
130080;202207;8902;27728;7721;26412;430;1293;6666;23379;7096;24672
130083;202207;3202;9634;2808;9144;294;892;2171;7359;2465;8251
130090;202207;4571;11872;4064;11286;67;169;3720;10435;3787;10604
130100;202207;8789;25019;7379;23541;164;357;6831;22262;6995;22619
130110;202207;10040;25565;8170;23263;1392;3552;5393;16688;6785;20240
130115;202207;5851;17020;5034;16087;154;467;4417;14309;4571;14776
130120;202207;16522;51951;14531;49380;1153;4347;11978;40886;13131;45233
130130;202207;7081;18898;5498;16905;588;1699;3980;12959;4568;14658
130140;202207;8255;26416;7211;25238;321;1408;6178;21760;6499;23168
130150;202207;4546;14324;4274;14021;80;415;3955;12953;4035;13368
130160;202207;7287;20338;6264;19092;366;944;5441;16924;5807;17868
130165;202207;3844;13076;3620;12825;161;580;3226;11564;3387;12144
130170;202207;14549;36961;11832;33931;492;1644;10317;29688;10809;31332
130180;202207;4991;14946;4753;14687;38;211;4589;14142;4627;14353
130185;202207;23079;50715;18966;46307;1464;1968;16156;41589;17620;43557
130190;202207;22495;67538;18186;61426;1541;5260;13876;47748;15417;53008
130195;202207;2887;9558;2420;8983;107;451;2047;7675;2154;8126
130200;202207;3469;8362;2866;7600;163;534;2393;6265;2556;6799
130210;202207;1597;5652;1432;5448;107;557;1175;4398;1282;4955
130220;202207;2854;8358;2353;7754;65;228;2127;7130;2192;7358
130230;202207;5693;20909;4946;19909;198;1079;4363;17600;4561;18679
130240;202207;16685;39415;13912;35953;163;793;13002;33132;13165;33925
130250;202207;30394;83315;25955;78223;1516;4043;21383;66665;22899;70708
130255;202207;5785;16338;4951;14919;193;652;4104;12289;4297;12941
130260;202207;357676;861983;297771;782496;65459;170945;174209;466796;239668;637741
130270;202207;11369;36136;9382;33177;1653;5385;6023;22425;7676;27810
130280;202207;4143;14804;3769;14382;117;492;3481;13395;3598;13887
130290;202207;17469;48062;15466;45647;692;2122;13863;41080;14555;43202
130300;202207;5709;17304;5086;16480;169;768;4379;14105;4548;14873
130310;202207;9304;23714;8214;22416;468;1236;7020;19417;7488;20653
130320;202207;4018;12340;3357;11449;413;1322;2440;8642;2853;9964
130330;202207;5428;15552;4375;14315;211;807;3673;12270;3884;13077
130340;202207;28816;77427;24802;72962;1154;3390;21434;64327;22588;67717
130350;202207;4472;15066;3994;14450;140;712;3496;12608;3636;13320
130353;202207;9344;22851;7577;20639;1077;2741;5307;15001;6384;17742
130356;202207;6249;18073;5254;16587;890;2689;3300;10923;4190;13612
130360;202207;3505;10575;2837;9762;72;324;2559;8808;2631;9132
130370;202207;5927;23621;4985;22262;581;3111;3369;15212;3950;18323
130380;202207;8688;35167;8107;34293;658;3247;6572;27827;7230;31074
130390;202207;7526;27943;6694;26683;464;2106;5734;22949;6198;25055
130395;202207;2898;8408;2419;7656;184;618;1937;6057;2121;6675
130400;202207;3301;9276;2789;8596;103;311;2472;7689;2575;8000
130406;202207;12663;41027;10633;38551;1580;5508;7622;28798;9202;34306
130410;202207;5148;16372;4423;15251;1154;4096;2382;8549;3536;12645
130420;202207;16968;53146;14214;49716;1310;5057;10836;38333;12146;43390
130423;202207;5063;14754;4403;13975;204;823;3885;12266;4089;13089
130426;202207;3618;11842;3295;11474;69;227;2910;10683;2979;10910
130430;202207;5478;13097;4680;12101;179;479;4158;10672;4337;11151
130440;202207;6308;16827;5344;15686;124;424;4971;14637;5095;15061
140002;202207;2878;7723;2486;7256;141;406;2080;6191;2221;6597
140005;202207;3801;10059;3295;9466;546;1448;2378;7132;2924;8580
140010;202207;59820;154203;48042;137187;11256;33814;21351;62401;32607;96215
140015;202207;5114;12653;4286;11729;297;737;3651;10323;3948;11060
140017;202207;6722;15594;5939;14628;339;807;5070;12609;5409;13416
140020;202207;6553;16684;5653;15582;364;1103;4574;12609;4938;13712
140023;202207;3126;8309;2496;7444;371;1056;1759;5434;2130;6490
140028;202207;2356;5662;1992;5212;125;340;1568;4127;1693;4467
140030;202207;6863;15117;6161;14315;218;379;5676;13375;5894;13754
140040;202207;3209;11543;2958;11223;97;517;2730;10284;2827;10801
140045;202207;3475;11819;2943;11108;683;2022;1728;7422;2411;9444
140047;202207;7167;19002;5982;17292;686;2075;4299;12609;4985;14684
140050;202207;1838;5053;1557;4657;237;646;1085;3355;1322;4001
140060;202207;2293;5333;2014;4961;160;368;1690;4202;1850;4570
140070;202207;2273;10920;2196;10790;132;881;1908;9216;2040;10097
150010;202207;56632;126137;50968;118987;1428;2872;45389;105702;46817;108574
150013;202207;2445;5426;2035;4982;95;200;1744;4358;1839;4558
150020;202207;17195;45918;15781;44033;1614;3523;12679;36802;14293;40325
150030;202207;10085;34583;9086;33415;473;1745;7948;29776;8421;31521
150034;202207;5180;11355;4209;10177;227;539;3572;8712;3799;9251
150040;202207;18593;44527;16237;41943;1250;1560;14165;38818;15415;40378
150050;202207;9050;26030;8272;25044;208;647;7597;23213;7805;23860
150060;202207;26582;66616;21457;59129;2686;7663;14567;40474;17253;48137
150070;202207;10498;29666;9395;28382;206;777;8773;26422;8979;27199
150080;202207;107178;230061;88353;205197;23615;54933;28206;77195;51821;132128
150085;202207;10464;25476;9453;24303;127;360;8900;22957;9027;23317
150090;202207;13805;38650;12890;37158;567;1751;11289;32183;11856;33934
150095;202207;8652;19109;7646;17919;742;960;6441;15838;7183;16798
150100;202207;3307;10759;2898;10092;227;731;2284;8182;2511;8913
150110;202207;4901;18571;4512;18131;147;639;4167;16989;4314;17628
150120;202207;9285;26306;8609;25495;350;696;7665;23221;8015;23917
150125;202207;1033;2434;745;2030;99;297;465;1254;564;1551
150130;202207;27001;70608;23089;64815;4267;10474;14395;43330;18662;53804
150140;202207;332087;681891;281829;617190;32916;67942;188623;413541;221539;481483
150145;202207;4853;14195;3992;12859;1265;3875;1681;6251;2946;10126
150150;202207;20974;47093;17946;43323;1292;2901;14071;34097;15363;36998
150157;202207;4275;10692;3377;9500;415;1148;2256;6573;2671;7721
150160;202207;4652;10277;4323;9840;405;946;3461;7725;3866;8671
150170;202207;32221;86652;28590;80874;4678;11530;18633;56151;23311;67681
150172;202207;6318;15140;5122;13530;288;701;3983;10664;4271;11365
150175;202207;2010;5596;1664;5009;201;689;1131;3351;1332;4040
150178;202207;13555;30760;10369;27098;713;1163;8543;23595;9256;24758
150180;202207;31963;86854;29056;83619;2323;4363;24007;74007;26330;78370
150190;202207;8602;22946;7978;22208;157;621;7414;20470;7571;21091
150195;202207;6091;17251;5650;16629;221;717;5078;14909;5299;15626
150200;202207;6815;18005;6146;17243;33;129;5758;16161;5791;16290
150210;202207;36038;101121;33835;98453;1447;3849;29720;88041;31167;91890
150215;202207;11463;30107;9862;27633;1685;4752;5881;16654;7566;21406
150220;202207;15811;39195;13785;36480;839;2210;10492;27609;11331;29819
150230;202207;15707;39420;13936;37066;1488;3180;9899;27574;11387;30754
150240;202207;41305;103473;34646;92720;7283;19975;16343;42434;23626;62409
150250;202207;4893;16921;4569;16565;456;1688;3864;14219;4320;15907
150260;202207;3361;9277;3007;8764;94;332;2599;7504;2693;7836
150270;202207;10555;27803;7440;22277;2057;6430;2164;6694;4221;13124
150275;202207;8266;22787;7523;21788;196;752;6637;18959;6833;19711
150276;202207;2689;6706;2321;6252;297;658;1612;4802;1909;5460
150277;202207;6364;14314;5056;12836;625;1612;3588;9427;4213;11039
150280;202207;8235;29019;7916;28528;436;1463;6859;25175;7295;26638
150285;202207;3951;12213;3396;11326;258;793;2583;8768;2841;9561
150290;202207;13082;31215;11828;29884;515;755;10670;27706;11185;28461
150293;202207;11548;25530;9017;22311;1048;2522;6114;15307;7162;17829
150295;202207;8582;21256;6100;17811;1957;5703;2178;7383;4135;13086
150300;202207;3137;7693;2833;7330;34;114;2626;6797;2660;6911
150304;202207;5117;13571;4251;12266;600;1537;2916;8826;3516;10363
150307;202207;6794;19718;6144;18673;317;919;4914;15043;5231;15962
150309;202207;7631;20117;6172;17766;767;2171;4002;11721;4769;13892
150310;202207;8494;30501;7988;29891;236;1147;7122;26936;7358;28083
150320;202207;10791;26651;9774;25212;655;1725;7572;19397;8227;21122
150330;202207;16582;47152;15282;45352;1742;4159;11141;35289;12883;39448
150340;202207;2881;7806;2522;7307;287;799;1865;5452;2152;6251
150345;202207;10741;26367;9550;24826;365;1048;8434;21791;8799;22839
150350;202207;11048;24489;10086;23269;561;1053;8780;20322;9341;21375
150360;202207;28882;72726;23029;65501;2394;4748;17141;51648;19535;56396
150370;202207;13398;35634;10928;32359;1297;3186;7936;25133;9233;28319
150375;202207;4398;16548;3970;15963;217;881;3497;14217;3714;15098
150380;202207;12665;28968;10280;25866;215;648;8979;22411;9194;23059
150390;202207;8162;30783;7229;29312;1090;3798;5075;21742;6165;25540
150400;202207;7816;24880;7415;24228;117;480;6373;21298;6490;21778
150405;202207;10411;24846;8982;23167;612;1132;7258;19308;7870;20440
150410;202207;2289;6371;1943;5824;197;525;1370;4179;1567;4704
150420;202207;51716;129423;40239;113001;9434;26815;18016;54552;27450;81367
150430;202207;9599;25186;8718;24097;685;1413;7277;20628;7962;22041
150440;202207;7015;18795;6324;17893;621;1533;4915;14235;5536;15768
150442;202207;35370;73584;29746;66944;2151;4664;23160;51554;25311;56218
150445;202207;8600;21806;7628;20428;156;479;6906;18370;7062;18849
150450;202207;6612;22957;6133;22342;363;1742;5435;19521;5798;21263
150460;202207;10037;29085;9114;27951;410;1053;7749;24631;8159;25684
150470;202207;24433;59099;21896;56157;282;1014;20637;52512;20919;53526
150475;202207;6290;17682;5331;16218;793;2102;3647;11654;4440;13756
150480;202207;16555;46038;14857;43651;2665;6277;10119;32294;12784;38571
150490;202207;9688;30718;8744;29459;607;1764;7202;24954;7809;26718
150495;202207;6607;18773;6231;18289;175;682;5664;16507;5839;17189
150497;202207;3145;9225;2498;8085;476;1567;1370;4709;1846;6276
150500;202207;3766;8920;3319;8286;218;522;2628;6467;2846;6989
150503;202207;6164;14998;4407;12772;1363;3633;1780;5754;3143;9387
150506;202207;14684;37881;12440;34880;2126;5323;8368;25183;10494;30506
150510;202207;13064;38560;11315;35670;1019;3101;8644;27524;9663;30625
150520;202207;9247;30334;8837;29841;175;1001;8260;27674;8435;28675
150530;202207;13952;44077;12065;41420;998;2887;9434;33448;10432;36335
150540;202207;6143;14444;5300;13212;282;638;4490;11134;4772;11772
150543;202207;8511;21567;7031;19738;540;1545;5438;15674;5978;17219
150548;202207;11842;33639;10525;31800;317;1066;9259;28091;9576;29157
150549;202207;2298;5984;1928;5465;65;210;1589;4501;1654;4711
150550;202207;24295;65741;19820;58623;4779;14251;8495;26309;13274;40560
150553;202207;44182;112736;33972;95550;8218;23433;14925;42574;23143;66007
150555;202207;2303;5658;1791;4880;175;385;1160;3326;1335;3711
150560;202207;2226;5899;1983;5467;238;632;1299;3600;1537;4232
150563;202207;3079;8437;2491;7413;481;1498;1379;4093;1860;5591
150565;202207;5115;15218;4515;14298;118;465;3712;11787;3830;12252
150570;202207;8414;21999;7698;21049;327;945;6791;18473;7118;19418
150580;202207;13079;45590;11224;43549;1309;3983;8842;36576;10151;40559
150590;202207;9378;29373;7979;27723;169;900;7314;25347;7483;26247
150600;202207;11504;33376;10596;32269;211;799;9789;29838;10000;30637
150610;202207;3607;8788;3209;8190;119;392;2763;6888;2882;7280
150611;202207;3787;9413;3299;8745;90;311;2916;7612;3006;7923
150613;202207;17006;43233;12945;36653;2329;7014;6818;18789;9147;25803
150616;202207;4379;11327;3143;9192;619;1917;1427;4092;2046;6009
150618;202207;8127;21568;6608;19257;858;2548;4097;12210;4955;14758
150619;202207;7862;20175;6452;18274;536;1303;5041;14597;5577;15900
150620;202207;7934;23997;6875;22256;902;2589;4508;15237;5410;17826
150630;202207;7855;18296;7148;17456;197;510;6429;15567;6626;16077
150635;202207;6287;15480;5258;13842;604;1441;3532;9394;4136;10835
150640;202207;2437;6843;2220;6567;42;122;2029;6041;2071;6163
150650;202207;14027;34729;12160;31920;3091;7656;5799;16329;8890;23985
150655;202207;6314;16636;5689;15741;123;430;5057;13851;5180;14281
150658;202207;5219;14075;3847;11779;855;2696;1805;5753;2660;8449
150660;202207;6701;17353;5865;16173;936;2449;3718;10353;4654;12802
150670;202207;11346;22873;9044;20246;669;1321;7460;17060;8129;18381
150680;202207;86952;227472;68774;200162;14743;40740;35069;110895;49812;151635
150690;202207;3126;7039;2686;6537;113;230;2347;5784;2460;6014
150700;202207;7917;20433;7061;19374;756;1549;5435;15609;6191;17158
150710;202207;4412;13226;3958;12534;334;1031;2966;9573;3300;10604
150715;202207;6390;15740;5242;14098;284;716;4341;11687;4625;12403
150720;202207;9423;25388;8670;24364;437;1247;7457;21035;7894;22282
150730;202207;15280;41942;12937;38545;1594;4868;9301;28344;10895;33212
150740;202207;4648;11814;4036;10889;365;774;3037;8434;3402;9208
150745;202207;6436;16370;5228;14682;654;1881;3805;10870;4459;12751
150746;202207;2038;5376;1799;5028;60;185;1521;4206;1581;4391
150747;202207;5887;15937;5211;14968;416;1044;4056;11859;4472;12903
150750;202207;4225;12054;3426;10867;322;1094;2460;8046;2782;9140
150760;202207;13514;36235;12184;34433;1807;4536;8495;25011;10302;29547
150770;202207;8112;24976;7440;24229;209;498;6825;22829;7034;23327
150775;202207;1355;3264;1058;2886;131;396;744;2015;875;2411
150780;202207;5397;14942;4773;14211;284;743;4175;12789;4459;13532
150790;202207;7080;17510;5917;16251;508;1053;4006;13045;4514;14098
150795;202207;18400;49503;15842;45832;2892;8180;10023;29861;12915;38041
150796;202207;4736;9981;4083;9244;177;353;3573;8116;3750;8469
150797;202207;5104;13772;4329;12693;391;1002;3457;10291;3848;11293
150800;202207;16068;45428;14358;43239;1886;5300;10445;32413;12331;37713
150803;202207;9631;24246;8850;23192;288;864;7922;20547;8210;21411
150805;202207;4184;11709;3550;10840;303;850;2733;8564;3036;9414
150808;202207;7711;20936;5671;17584;1986;6693;1007;3468;2993;10161
150810;202207;24508;57729;18487;50528;3996;10306;9475;29232;13471;39538
150812;202207;7244;17521;6378;16238;420;1297;5074;12429;5494;13726
150815;202207;11224;30245;9373;28065;1096;3233;7303;22332;8399;25565
150820;202207;17078;36602;14876;33996;2101;3196;10829;27222;12930;30418
150830;202207;14866;45355;13785;44053;725;1879;12015;39663;12740;41542
150835;202207;3835;10495;3332;9755;343;1031;2474;7224;2817;8255
150840;202207;9757;24836;7868;21937;1092;3407;4806;12997;5898;16404
160005;202207;1500;3509;1323;3303;60;172;1137;2822;1197;2994
160010;202207;2594;6554;2398;6345;22;94;2312;6070;2334;6164
160015;202207;4199;9606;3767;9106;59;190;3566;8555;3625;8745
160020;202207;2808;7541;2429;7058;259;654;1860;5635;2119;6289
160021;202207;1467;4943;1313;4757;67;291;1022;3806;1089;4097
160023;202207;1592;5008;1419;4714;222;701;912;3184;1134;3885
160025;202207;2226;5972;2067;5797;29;62;1992;5594;2021;5656
160027;202207;11968;27382;10793;25942;659;1616;9239;22127;9898;23743
160030;202207;96025;240125;79417;218835;14933;38045;46616;137808;61549;175853
160040;202207;6915;20659;6071;19532;363;1060;5268;17210;5631;18270
160050;202207;6606;16994;5406;15468;1825;4338;2603;8992;4428;13330
160053;202207;4926;13160;4368;12419;257;636;3615;10630;3872;11266
160055;202207;1585;3350;1523;3284;24;71;1462;3119;1486;3190
160060;202207;33979;76195;28408;69926;2218;4671;22747;57999;24965;62670
160070;202207;3243;10930;2803;10265;245;823;2163;8277;2408;9100
160080;202207;3920;10603;3433;10067;56;182;3183;9449;3239;9631
170025;202207;762;1868;491;1376;92;245;173;495;265;740
170030;202207;1348;3800;991;3132;190;582;389;1275;579;1857
170035;202207;1705;4106;1249;3386;98;287;772;1996;870;2283
170040;202207;2199;5529;1723;4881;183;547;1054;3061;1237;3608
170070;202207;2227;4769;1578;3963;86;219;954;2453;1040;2672
170100;202207;2814;7288;2301;6457;298;789;1450;4143;1748;4932
170105;202207;777;2107;525;1610;129;382;159;445;288;827
170110;202207;1182;3186;909;2731;67;262;575;1634;642;1896
170130;202207;1597;4183;1203;3527;132;456;722;2069;854;2525
170190;202207;1837;4383;1413;3738;208;672;821;2041;1029;2713
170200;202207;2387;5288;1567;3980;267;692;645;1586;912;2278
170210;202207;31488;79727;23730;67245;6775;20644;4747;13827;11522;34471
170215;202207;1521;3755;1211;3336;55;196;947;2564;1002;2760
170220;202207;6728;19340;5539;17286;1894;5828;1705;6106;3599;11934
170230;202207;1429;3883;1065;3215;311;916;281;882;592;1798
170240;202207;3205;7850;2567;6868;147;471;1938;5009;2085;5480
170255;202207;4391;11842;3201;9829;592;1888;1491;4631;2083;6519
170270;202207;1000;2339;677;1861;77;200;374;1009;451;1209
170290;202207;3510;9088;3024;8459;252;531;2337;6795;2589;7326
170300;202207;2559;5931;2076;5231;162;399;1550;3835;1712;4234
170305;202207;763;1966;625;1728;76;209;333;932;409;1141
170307;202207;1214;3547;999;3157;114;392;633;1944;747;2336
170310;202207;1834;4251;1311;3455;165;458;694;1815;859;2273
170320;202207;1203;3016;912;2546;111;344;550;1536;661;1880
170330;202207;1081;3049;980;2904;30;133;842;2435;872;2568
170360;202207;659;1597;476;1315;21;83;326;833;347;916
170370;202207;1500;3590;1071;2903;183;504;509;1312;692;1816
170380;202207;2113;5588;1596;4797;122;406;944;2918;1066;3324
170382;202207;611;1642;497;1461;23;85;366;1029;389;1114
170384;202207;1933;6088;1593;5477;327;1121;853;2935;1180;4056
170386;202207;1096;2834;658;1990;71;253;243;671;314;924
170388;202207;840;2090;591;1681;77;232;304;820;381;1052
170389;202207;1024;2959;814;2597;87;312;511;1645;598;1957
170390;202207;2065;4249;1548;3641;35;93;1330;3146;1365;3239
170410;202207;711;1726;520;1416;26;89;361;921;387;1010
170460;202207;469;1203;384;1068;49;151;254;702;303;853
170510;202207;1055;2726;745;2198;35;136;480;1311;515;1447
170550;202207;7780;19217;5871;16286;1558;4701;1836;4991;3394;9692
170555;202207;1582;3898;1254;3408;129;286;625;1788;754;2074
170560;202207;1154;3007;878;2627;102;296;531;1654;633;1950
170600;202207;1570;3889;1222;3387;234;603;658;1901;892;2504
170610;202207;1888;4453;1401;3743;122;387;911;2337;1033;2724
170625;202207;504;1227;330;914;37;86;139;354;176;440
170650;202207;1663;4250;1351;3773;129;431;905;2439;1034;2870
170700;202207;4076;11102;3091;9263;642;1946;1342;3920;1984;5866
170710;202207;1816;4190;1388;3575;166;437;922;2347;1088;2784
170720;202207;2073;4729;1576;3965;153;468;1073;2583;1226;3051
170730;202207;1244;3067;931;2600;101;247;564;1608;665;1855
170740;202207;2342;7041;1992;6425;156;585;1473;4648;1629;5233
170755;202207;993;2482;708;2021;126;385;307;833;433;1218
170765;202207;1319;3150;926;2543;165;437;468;1287;633;1724
170770;202207;2108;5542;1690;4915;149;470;1199;3428;1348;3898
170820;202207;4402;11768;3395;10077;651;1949;1751;5234;2402;7183
170825;202207;1185;2502;964;2223;84;188;744;1697;828;1885
170830;202207;1558;3792;1188;3197;346;1003;497;1246;843;2249
170900;202207;3196;9094;2716;8416;233;710;2168;6824;2401;7534
170930;202207;4474;11402;3382;9428;775;2253;1054;2840;1829;5093
170950;202207;13188;34625;9286;27823;2672;8624;1275;4035;3947;12659
170980;202207;593;1417;424;1141;47;146;232;597;279;743
171050;202207;1881;5462;1627;5041;83;293;1293;3992;1376;4285
171070;202207;1542;3993;1316;3672;256;616;681;2210;937;2826
171090;202207;1163;2829;915;2474;138;404;496;1326;634;1730
171110;202207;654;1659;440;1267;78;233;197;516;275;749
171150;202207;1161;2707;727;1997;51;164;458;1223;509;1387
171180;202207;859;2220;554;1659;85;231;246;732;331;963
171190;202207;2249;6574;1913;6001;292;946;1178;3745;1470;4691
171195;202207;953;2758;748;2375;103;414;460;1369;563;1783
171200;202207;702;1838;512;1517;132;437;172;474;304;911
171215;202207;443;1098;346;943;38;115;195;506;233;621
171240;202207;872;2610;672;2264;22;131;462;1497;484;1628
171245;202207;887;2352;682;1951;53;171;416;1112;469;1283
171250;202207;1113;2855;800;2346;138;438;362;1045;500;1483
171270;202207;543;1789;420;1516;80;326;198;728;278;1054
171280;202207;1028;2803;820;2459;71;215;532;1621;603;1836
171320;202207;4540;11927;3534;10215;687;1959;1456;4292;2143;6251
171330;202207;3255;8353;2504;7077;598;1736;1138;3205;1736;4941
171360;202207;1709;4425;1299;3849;123;341;844;2672;967;3013
171370;202207;851;1965;646;1672;71;184;420;1064;491;1248
171380;202207;1699;4378;1406;3985;163;408;987;2970;1150;3378
171395;202207;1145;2795;774;2169;73;234;504;1361;577;1595
171420;202207;2273;5883;1718;4892;307;925;873;2411;1180;3336
171430;202207;1250;3369;1030;2976;76;251;682;1870;758;2121
171488;202207;2866;7412;2237;6411;382;1072;1189;3388;1571;4460
171500;202207;1035;2461;730;1967;81;227;459;1201;540;1428
171510;202207;943;2735;801;2488;73;251;537;1650;610;1901
171515;202207;551;1297;391;1050;32;109;251;612;283;721
171525;202207;821;2044;618;1718;47;157;408;1061;455;1218
171550;202207;382;1009;295;887;38;147;167;456;205;603
171570;202207;1245;3404;1035;3047;137;418;616;1839;753;2257
171575;202207;1938;4850;1266;3703;142;404;612;1776;754;2180
171610;202207;6866;18136;5085;15136;1195;3873;1191;3810;2386;7683
171620;202207;3250;7840;2756;7161;146;456;2327;5971;2473;6427
171630;202207;1245;2992;956;2598;134;373;617;1693;751;2066
171650;202207;2556;6761;1979;5831;489;1565;595;1804;1084;3369
171660;202207;2645;6238;1840;4959;188;511;1166;3108;1354;3619
171665;202207;1417;3731;1121;3258;232;700;524;1534;756;2234
171670;202207;2167;5423;1612;4512;232;702;738;2008;970;2710
171700;202207;1326;3453;965;2811;114;349;569;1616;683;1965
171720;202207;884;2130;676;1818;48;136;499;1320;547;1456
171750;202207;1582;4388;1106;3516;263;834;278;1058;541;1892
171780;202207;1502;3471;1068;2814;97;287;730;1870;827;2157
171790;202207;1586;4792;1264;4141;186;632;643;2075;829;2707
171800;202207;823;2067;629;1787;64;204;356;962;420;1166
171820;202207;13541;35587;10011;29778;2345;7428;2765;8614;5110;16042
171830;202207;1752;5135;1491;4692;245;770;840;2748;1085;3518
171840;202207;838;2065;629;1741;26;91;386;1022;412;1113
171845;202207;759;1715;578;1454;47;155;410;973;457;1128
171850;202207;1083;3145;907;2787;51;219;685;2035;736;2254
171855;202207;1158;3278;969;2940;80;260;602;1749;682;2009
171865;202207;566;1505;477;1374;59;187;281;771;340;958
171870;202207;920;2365;641;1885;97;300;317;915;414;1215
171875;202207;1586;4037;1295;3609;42;178;1008;2733;1050;2911
171880;202207;1550;3961;1333;3674;42;137;1063;2937;1105;3074
171884;202207;1222;3042;921;2544;211;548;428;1215;639;1763
171886;202207;1717;4381;1248;3694;313;1020;329;1047;642;2067
171888;202207;673;1839;463;1442;25;102;276;817;301;919
171889;202207;489;1378;328;1055;73;251;113;333;186;584
171890;202207;1377;3739;1017;3148;134;435;637;1940;771;2375
171900;202207;640;2022;498;1741;74;225;225;800;299;1025
172000;202207;651;1811;510;1561;109;315;209;649;318;964
172010;202207;1407;4011;1187;3659;108;327;737;2289;845;2616
172015;202207;416;1327;314;1130;57;192;136;492;193;684
172020;202207;3267;8338;2834;7792;205;588;2077;5867;2282;6455
172025;202207;810;2075;583;1722;46;141;405;1187;451;1328
172030;202207;1411;3903;1153;3480;91;299;841;2519;932;2818
172049;202207;1417;3295;930;2609;130;361;477;1391;607;1752
172065;202207;1676;3913;1324;3461;141;280;977;2790;1118;3070
172080;202207;2748;7410;2193;6451;121;401;1461;4217;1582;4618
172085;202207;515;1318;321;914;59;179;118;300;177;479
172090;202207;4698;10484;3679;9164;154;391;2937;7254;3091;7645
172093;202207;496;1415;353;1169;24;106;205;644;229;750
172097;202207;800;1945;533;1500;81;232;215;576;296;808
172100;202207;57933;134740;42819;111866;7801;22185;17925;46135;25726;68320
172110;202207;1876;6146;1600;5740;103;435;1241;4492;1344;4927
172120;202207;5802;15732;4560;13789;473;1586;2748;8226;3221;9812
172125;202207;463;1174;351;999;30;101;203;532;233;633
172130;202207;688;1626;519;1350;23;91;350;832;373;923
172208;202207;3025;6681;2378;5859;210;445;1738;4297;1948;4742
172210;202207;2999;6937;2313;6097;271;672;1467;4056;1738;4728
210005;202207;21916;58267;16464;49652;4108;12970;7083;21898;11191;34868
210010;202207;2277;6187;2074;5953;49;232;1871;5306;1920;5538
210015;202207;3608;10108;3086;9408;162;500;2549;7801;2711;8301
210020;202207;8329;17915;7094;16482;107;309;6552;15176;6659;15485
210030;202207;5082;15780;4604;15054;494;1585;3592;11983;4086;13568
210040;202207;2458;4857;2156;4500;56;140;1924;3926;1980;4066
210043;202207;6678;17632;5587;16158;352;1086;4447;12910;4799;13996
210047;202207;7713;21459;6093;19350;162;713;5255;16669;5417;17382
210050;202207;2701;7840;2137;6856;161;690;1591;4930;1752;5620
210055;202207;2300;6363;2058;6030;51;180;1820;5333;1871;5513
210060;202207;8389;28485;7415;26764;693;2615;5197;19195;5890;21810
210070;202207;7769;19559;7171;18797;78;232;6727;17576;6805;17808
210080;202207;4875;14535;4578;14201;49;263;4243;13143;4292;13406
210083;202207;6879;16585;5788;15398;122;358;5431;14460;5553;14818
210087;202207;3144;8299;2657;7646;161;504;2124;6087;2285;6591
210090;202207;10293;29449;9510;28170;544;1385;8077;24042;8621;25427
210095;202207;7255;22173;6585;21307;444;1420;5319;17866;5763;19286
210100;202207;7308;21148;6304;19404;722;2248;4310;13364;5032;15612
210110;202207;3271;9269;2990;8922;63;304;2675;7907;2738;8211
210120;202207;30648;70362;25910;64471;1896;3624;19842;50616;21738;54240
210125;202207;4985;12478;4315;11717;680;1397;3128;9079;3808;10476
210130;202207;4758;11317;3856;10211;101;251;3375;8947;3476;9198
210135;202207;1975;4635;1633;4159;45;130;1425;3585;1470;3715
210140;202207;23386;57017;18189;50358;2803;7540;11289;31863;14092;39403
210150;202207;5258;11380;4629;10544;92;294;4080;9076;4172;9370
210160;202207;23339;55470;20012;51369;1632;3780;15570;40688;17202;44468
210170;202207;18159;49830;16674;47917;868;2346;14450;41813;15318;44159
210173;202207;2567;9111;2407;8854;100;518;2097;7641;2197;8159
210177;202207;3654;9506;3134;8844;427;1044;2328;6842;2755;7886
210180;202207;1644;3966;1427;3703;33;88;1283;3321;1316;3409
210190;202207;6140;14676;5054;13205;93;316;4372;11259;4465;11575
210193;202207;1542;3987;1330;3665;53;150;1021;2807;1074;2957
210197;202207;2270;6571;2044;6268;131;383;1692;5295;1823;5678
210200;202207;8900;25996;7831;24369;475;1647;6219;19321;6694;20968
210203;202207;8061;21764;6753;20055;445;1336;5423;16399;5868;17735
210207;202207;4299;9779;3473;8839;131;291;2925;7477;3056;7768
210210;202207;8425;25078;7574;23900;158;827;6480;20270;6638;21097
210215;202207;2697;7988;2328;7456;138;634;1846;5823;1984;6457
210220;202207;7569;22476;7122;21839;152;907;6418;19193;6570;20100
210230;202207;6197;16640;5604;15763;153;466;5076;14255;5229;14721
210232;202207;13295;37559;10871;33975;1641;4998;7060;23249;8701;28247
210235;202207;3881;10766;3382;10064;172;610;2828;8383;3000;8993
210237;202207;4282;10291;3607;9525;26;151;3421;8936;3447;9087
210240;202207;2851;8170;2577;7748;70;265;2134;6297;2204;6562
210250;202207;6617;17773;5951;16937;92;393;5428;15353;5520;15746
210255;202207;2997;8428;2556;7669;279;923;1664;4842;1943;5765
210260;202207;5947;16663;5150;15499;370;1186;4139;12467;4509;13653
210270;202207;5639;13972;4990;13165;79;378;4522;11757;4601;12135
210275;202207;3807;9010;3230;8312;181;433;2604;6732;2785;7165
210280;202207;6779;16698;5538;14911;171;720;4486;11661;4657;12381
210290;202207;9156;20923;8203;19775;149;380;7675;18458;7824;18838
210300;202207;36819;94564;29819;84617;5090;13617;16554;51246;21644;64863
210310;202207;3434;8018;2970;7382;50;140;2703;6681;2753;6821
210312;202207;3115;7007;2767;6636;17;87;2604;6139;2621;6226
210315;202207;3906;9025;3454;8527;119;276;3143;7826;3262;8102
210317;202207;4990;14066;4519;13507;97;457;4128;12244;4225;12701
210320;202207;27465;65595;25472;63113;309;1482;23738;57809;24047;59291
210325;202207;4021;10603;3362;9729;363;1053;2595;7629;2958;8682
210330;202207;29037;72193;23268;65158;3822;8796;15140;46619;18962;55415
210340;202207;13042;31525;11668;29791;427;1163;9964;25499;10391;26662
210350;202207;10368;26851;9082;25279;135;486;8177;22659;8312;23145
210355;202207;4450;13897;3906;13045;120;534;3300;10999;3420;11533
210360;202207;13988;41314;12608;39141;513;2301;9591;28767;10104;31068
210370;202207;13740;26467;10407;22959;435;613;9403;21288;9838;21901
210375;202207;3723;9499;2741;8042;867;2695;773;2463;1640;5158
210380;202207;6217;14655;5349;13611;257;678;4575;11591;4832;12269
210390;202207;3455;9556;3204;9169;75;335;2901;8175;2976;8510
210400;202207;5149;13824;4521;13090;206;454;4021;11895;4227;12349
210405;202207;8298;19953;6710;17831;1223;2802;3928;11247;5151;14049
210407;202207;2317;6850;1926;6182;106;366;1498;4791;1604;5157
210408;202207;3009;10149;2775;9834;156;722;2210;7853;2366;8575
210409;202207;4294;13409;3846;12795;191;713;3140;10673;3331;11386
210410;202207;4030;10990;3379;9875;100;426;2772;7909;2872;8335
210420;202207;4216;12574;3724;11707;207;620;3054;9660;3261;10280
210430;202207;2457;6807;2128;6357;178;469;1700;5204;1878;5673
210440;202207;4881;12136;4224;11326;166;366;3758;10137;3924;10503
210450;202207;2585;7024;2215;6493;192;480;1719;5154;1911;5634
210455;202207;5311;12701;4086;11169;979;2723;2053;5688;3032;8411
210460;202207;4036;10909;3367;10036;96;372;2868;8481;2964;8853
210462;202207;1870;5242;1561;4771;65;192;1229;3787;1294;3979
210465;202207;3016;7980;2613;7425;124;488;2172;6015;2296;6503
210467;202207;6968;19262;6012;18037;382;1111;4956;15100;5338;16211
210470;202207;2116;5464;1567;4692;147;426;1136;3451;1283;3877
210480;202207;19126;52037;15812;48034;1810;3948;11426;38071;13236;42019
210490;202207;3820;8968;3052;7945;75;214;2593;6704;2668;6918
210500;202207;6994;24506;6428;23586;351;1644;5393;19615;5744;21259
210510;202207;7142;20352;6279;19429;174;515;5677;17843;5851;18358
210515;202207;4210;11385;3573;10626;183;586;2974;8988;3157;9574
210520;202207;2851;7751;2545;7346;112;390;2133;6075;2245;6465
210530;202207;60541;141569;46884;121996;8635;23774;17634;51650;26269;75424
210535;202207;4137;11778;3752;11230;128;463;3286;9816;3414;10279
210540;202207;16863;45223;14057;41226;1710;4544;9731;29922;11441;34466
210542;202207;7299;16029;5665;14193;513;1139;4451;11434;4964;12573
210545;202207;2484;7122;2284;6803;42;173;1986;5825;2028;5998
210547;202207;4087;13510;3594;12636;206;770;2819;10083;3025;10853
210550;202207;6545;18767;5008;16304;519;1851;3247;10830;3766;12681
210560;202207;4080;11720;3584;10934;102;390;3046;9164;3148;9554
210565;202207;1651;4724;1371;4325;85;357;1054;3329;1139;3686
210570;202207;12226;30947;10803;29196;282;811;9627;26133;9909;26944
210580;202207;3354;8089;2641;7219;211;504;1892;5461;2103;5965
210590;202207;4717;13010;4035;12157;81;405;3595;10776;3676;11181
210592;202207;3070;8038;2828;7666;27;130;2483;6584;2510;6714
210594;202207;2756;7170;2141;6238;155;427;1544;4664;1699;5091
210596;202207;3220;10034;2855;9404;318;1045;2108;7155;2426;8200
210598;202207;2197;5616;1954;5291;96;274;1691;4577;1787;4851
210600;202207;3303;8550;2687;7689;266;700;1813;5216;2079;5916
210610;202207;3393;8128;2899;7538;60;249;2532;6490;2592;6739
210620;202207;3379;7634;2756;6858;162;304;2318;5788;2480;6092
210630;202207;3527;10515;3121;9831;145;572;2523;7857;2668;8429
210632;202207;6357;15604;5647;14678;186;731;4948;12555;5134;13286
210635;202207;1868;6234;1750;6017;168;530;1337;4730;1505;5260
210637;202207;2910;8669;2440;8007;153;582;1863;6190;2016;6772
210640;202207;5284;16745;4901;16305;61;322;4533;15081;4594;15403
210650;202207;7846;20847;6999;19765;110;390;6244;17593;6354;17983
210660;202207;9068;24459;8095;22906;203;884;6994;19234;7197;20118
210663;202207;3450;8087;3058;7614;276;455;2304;6226;2580;6681
210667;202207;2207;6576;1958;6204;46;163;1689;5473;1735;5636
210670;202207;5770;16192;5180;15304;111;478;4626;13520;4737;13998
210675;202207;6076;14333;5186;13247;532;1114;4060;10754;4592;11868
210680;202207;5394;11573;4546;10591;102;178;4209;9825;4311;10003
210690;202207;9326;23873;7727;22097;283;903;6905;19710;7188;20613
210700;202207;3127;8007;2485;7085;164;427;1871;5420;2035;5847
210710;202207;5840;16029;5129;15097;98;454;4614;13438;4712;13892
210720;202207;3437;10068;2983;9513;81;394;2646;8360;2727;8754
210725;202207;1488;4438;1280;4126;55;188;910;3037;965;3225
210730;202207;1625;3424;1376;3090;64;125;1179;2661;1243;2786
210735;202207;5219;13737;4410;12717;247;604;3672;10949;3919;11553
210740;202207;5885;13961;4991;12946;112;263;4244;10958;4356;11221
210745;202207;4834;12191;4387;11642;63;213;3961;10447;4024;10660
210750;202207;27565;67685;23838;62977;3094;7207;16068;44591;19162;51798
210760;202207;6797;15536;5693;14367;142;249;5305;13599;5447;13848
210770;202207;7028;16117;6002;14960;61;245;5601;13814;5662;14059
210780;202207;8383;24155;7229;22273;494;1557;5672;17492;6166;19049
210790;202207;5072;14117;4486;13349;282;709;3728;11398;4010;12107
210800;202207;5395;13458;4592;12378;81;312;4123;10943;4204;11255
210805;202207;4590;15035;4235;14514;192;729;3625;12480;3817;13209
210810;202207;5477;14653;4933;13962;444;1056;3951;11584;4395;12640
210820;202207;8016;21350;6675;19255;880;2423;4078;12169;4958;14592
210825;202207;8846;22506;7980;21400;306;829;7104;19067;7410;19896
210830;202207;9583;23538;8657;22421;613;1195;7270;19436;7883;20631
210840;202207;4032;8964;3659;8497;39;150;3347;7630;3386;7780
210845;202207;7044;17428;6192;16486;43;143;5924;15819;5967;15962
210850;202207;7361;21049;6093;19198;407;1298;4798;15288;5205;16586
210860;202207;23846;54715;19683;49739;1058;2292;16083;42020;17141;44312
210870;202207;8481;19416;6712;17430;144;391;6038;15601;6182;15992
210880;202207;4643;12925;4142;12290;208;700;3278;9641;3486;10341
210890;202207;5279;12386;4813;11855;269;658;4137;10147;4406;10805
210900;202207;5412;14610;4215;12497;1538;4624;866;2948;2404;7572
210905;202207;2489;5579;2110;5108;46;81;1964;4783;2010;4864
210910;202207;8133;23461;6697;21168;760;2404;4495;14280;5255;16684
210920;202207;3534;10424;3091;9838;79;370;2778;8741;2857;9111
210923;202207;1977;4958;1700;4548;85;254;1363;3569;1448;3823
210927;202207;5245;16103;4520;15209;574;1874;3113;10945;3687;12819
210930;202207;3100;8728;2718;8039;109;415;2283;6565;2392;6980
210940;202207;4191;11185;3809;10723;374;1589;3126;8159;3500;9748
210945;202207;8661;21192;7701;20091;437;928;6368;17179;6805;18107
210950;202207;6086;15361;4702;13452;565;1255;3259;9953;3824;11208
210955;202207;1701;4882;1429;4464;310;911;794;2587;1104;3498
210960;202207;10408;28544;8929;26320;2384;6746;4389;14018;6773;20764
210970;202207;1888;4605;1555;4055;96;281;1285;3225;1381;3506
210975;202207;2010;5574;1810;5279;173;503;1354;3965;1527;4468
210980;202207;11431;23754;10057;22322;101;233;9525;21137;9626;21370
210990;202207;19677;49748;15252;44158;1449;3511;10913;33082;12362;36593
211000;202207;16526;43176;13603;39580;1870;4782;9666;29696;11536;34478
211003;202207;6754;17422;5630;16100;119;438;4928;14271;5047;14709
211010;202207;7472;22848;6709;21907;89;416;6082;20028;6171;20444
211020;202207;9628;24715;8371;23321;219;734;7304;20765;7523;21499
211023;202207;2337;6880;2146;6636;117;373;1781;5495;1898;5868
211027;202207;4130;10637;3917;10321;119;405;3596;9330;3715;9735
211030;202207;4304;11108;3796;10468;357;892;2819;7954;3176;8846
211040;202207;5053;16606;4631;15895;122;624;4123;14056;4245;14680
211050;202207;10546;24321;9463;22968;127;406;8650;20857;8777;21263
211060;202207;8091;21696;7309;20662;161;656;6516;18175;6677;18831
211065;202207;2779;6545;2319;5972;87;196;2015;5250;2102;5446
211070;202207;9318;25949;7917;23919;320;1105;6713;20216;7033;21321
211080;202207;1484;3730;1164;3245;35;180;894;2319;929;2499
211085;202207;2446;6192;2022;5649;182;354;1582;4684;1764;5038
211090;202207;3496;8950;3135;8537;30;133;2900;7841;2930;7974
211100;202207;8061;17772;7489;17108;36;123;7096;16160;7132;16283
211102;202207;3705;10989;3351;10474;282;918;2686;8410;2968;9328
211105;202207;2608;7574;2178;6835;120;392;1656;5118;1776;5510
211107;202207;5345;15590;4522;14390;175;601;3607;11936;3782;12537
211110;202207;7154;17258;5658;15092;256;749;4545;11862;4801;12611
211120;202207;53910;122179;43932;110546;7273;16469;27974;74033;35247;90502
211125;202207;2193;6176;1843;5647;45;201;1560;4743;1605;4944
211130;202207;211261;470126;181285;431578;26136;54468;111631;279520;137767;333988
211140;202207;5385;14830;4647;13878;183;595;3921;11767;4104;12362
211150;202207;10792;26390;9027;24198;401;983;7477;20327;7878;21310
211153;202207;3311;8226;2307;6976;392;1073;1431;4597;1823;5670
211157;202207;1391;3953;1172;3554;81;249;838;2530;919;2779
211160;202207;5824;13425;4703;11892;130;485;3846;9232;3976;9717
211163;202207;1708;5130;1537;4888;49;185;1343;4285;1392;4470
211167;202207;1888;5083;1744;4887;29;107;1619;4516;1648;4623
211170;202207;7759;16564;7155;15859;58;148;6813;14965;6871;15113
211172;202207;2886;7468;2433;6800;96;331;1949;5239;2045;5570
211174;202207;3152;8314;2838;7962;28;155;2684;7466;2712;7621
211176;202207;4776;12548;3713;11006;364;1072;2803;8345;3167;9417
211178;202207;5958;11772;5130;10891;25;106;4964;10435;4989;10541
211180;202207;4661;14092;4257;13528;164;671;3560;11221;3724;11892
211190;202207;3690;9383;3108;8557;33;175;2832;7689;2865;7864
211195;202207;1768;4228;1531;3882;52;140;1355;3401;1407;3541
211200;202207;2411;6568;1886;5740;182;581;1327;3996;1509;4577
211210;202207;6911;19649;6176;18641;423;1362;5030;15185;5453;16547
211220;202207;46661;105110;38628;95407;3624;8318;28986;72298;32610;80616
211223;202207;6004;14776;4880;13298;615;1654;3213;8835;3828;10489
211227;202207;1923;5665;1660;5294;77;311;1340;4288;1417;4599
211230;202207;9494;24105;8061;22079;352;742;6793;18861;7145;19603
211240;202207;8619;25367;8049;24633;220;820;7354;22415;7574;23235
211245;202207;8601;21715;7500;20556;140;332;7113;19567;7253;19899
211250;202207;16746;45113;15131;42744;1209;3489;11958;33630;13167;37119
211260;202207;9035;26603;7856;25171;190;815;7019;22605;7209;23420
211270;202207;11478;33268;9752;31037;395;1595;7969;25513;8364;27108
211280;202207;16697;37459;15024;35380;547;1169;13501;31849;14048;33018
211285;202207;2292;6503;2038;6176;138;470;1569;4776;1707;5246
211290;202207;8037;22462;7168;21284;297;970;5923;17538;6220;18508
211300;202207;8169;22502;7091;20739;449;1422;5447;15665;5896;17087
211400;202207;13382;34137;10913;30785;1349;3608;7266;21520;8615;25128
220005;202207;2219;5133;1998;4830;33;97;1700;3990;1733;4087
220010;202207;1649;4379;1330;3843;38;131;1035;2945;1073;3076
220020;202207;4965;11190;4296;10303;160;427;3713;8722;3873;9149
220025;202207;2596;5265;2219;4717;76;131;1821;3762;1897;3893
220027;202207;1558;3456;1333;3151;30;96;1167;2691;1197;2787
220030;202207;4112;9208;3820;8840;112;276;3335;7602;3447;7878
220040;202207;8899;24712;7696;22506;1446;3873;4397;13327;5843;17200
220045;202207;1806;4765;1495;4280;24;128;1287;3569;1311;3697
220050;202207;5833;13453;5014;12440;61;239;4672;11410;4733;11649
220060;202207;3233;5682;2787;5169;24;48;2669;4906;2693;4954
220070;202207;2730;6394;2270;5738;65;139;1919;4804;1984;4943
220080;202207;838;2201;722;2040;14;58;621;1725;635;1783
220090;202207;1983;4385;1596;3823;74;103;1266;3127;1340;3230
220095;202207;1057;2002;1001;1944;29;56;920;1777;949;1833
220100;202207;1635;3994;1304;3496;32;125;1067;2727;1099;2852
220105;202207;2362;6530;2050;6006;134;430;1539;4462;1673;4892
220110;202207;4074;9981;3548;9129;42;177;3166;8006;3208;8183
220115;202207;3185;8242;2926;7912;136;383;2565;6887;2701;7270
220117;202207;1588;3488;1244;3024;11;43;1034;2428;1045;2471
220120;202207;17781;37694;16358;35934;81;328;15520;33616;15601;33944
220130;202207;1322;3176;1100;2877;25;107;984;2494;1009;2601
220140;202207;2631;4862;2249;4429;56;121;2074;4045;2130;4166
220150;202207;7469;19450;6757;18269;155;569;5710;15057;5865;15626
220155;202207;1341;3571;1073;3092;24;80;769;2150;793;2230
220157;202207;1252;2704;1050;2410;28;68;864;1927;892;1995
220160;202207;3204;8089;2735;7264;52;186;2222;5725;2274;5911
220170;202207;1794;4388;1507;3977;26;100;1317;3422;1343;3522
220173;202207;2432;6238;1938;5384;52;189;1523;4120;1575;4309
220177;202207;2513;5921;2383;5781;6;23;2350;5684;2356;5707
220180;202207;1336;2830;1091;2443;5;27;903;1877;908;1904
220190;202207;9098;19191;7774;17483;504;1011;6129;13981;6633;14992
220191;202207;1836;4991;1662;4709;112;343;1200;3309;1312;3652
220192;202207;2329;5664;1679;4548;34;117;1373;3625;1407;3742
220194;202207;2082;5208;1813;4790;52;195;1505;3811;1557;4006
220196;202207;2446;5679;2219;5354;23;107;1949;4591;1972;4698
220198;202207;1535;3525;1302;3241;9;22;1209;3013;1218;3035
220200;202207;5734;15483;4983;14491;106;388;4244;12314;4350;12702
220202;202207;2461;6200;2088;5603;36;137;1798;4721;1834;4858
220205;202207;2925;7412;2591;6838;68;222;2193;5644;2261;5866
220207;202207;858;2388;718;2151;72;194;461;1413;533;1607
220208;202207;2001;5622;1625;4938;243;779;909;2736;1152;3515
220209;202207;1772;4719;1504;4245;27;98;1224;3407;1251;3505
220210;202207;2178;4536;1905;4139;18;62;1687;3534;1705;3596
220211;202207;1997;4184;1830;3968;23;72;1621;3456;1644;3528
220213;202207;2085;4996;1762;4455;32;112;1428;3436;1460;3548
220217;202207;2764;6782;2564;6553;144;202;2275;6033;2419;6235
220220;202207;14031;30524;11966;27585;598;1300;9508;21707;10106;23007
220225;202207;1142;2674;922;2399;2;11;865;2230;867;2241
220230;202207;6707;15035;5766;13755;123;284;5105;12127;5228;12411
220240;202207;3616;9376;2989;8325;102;401;2434;6583;2536;6984
220245;202207;2234;4254;1696;3626;12;47;1564;3303;1576;3350
220250;202207;3474;8623;3037;8084;23;101;2831;7463;2854;7564
220253;202207;1885;4652;1592;4199;37;126;1368;3518;1405;3644
220255;202207;2268;4784;1914;4295;44;155;1653;3550;1697;3705
220260;202207;5699;14642;4958;13367;259;670;3957;10621;4216;11291
220265;202207;1722;4642;1572;4450;85;308;1306;3603;1391;3911
220270;202207;6740;20356;6292;19554;178;924;5287;15807;5465;16731
220271;202207;1687;3965;1474;3673;32;108;1272;3134;1304;3242
220272;202207;1989;5283;1732;4819;54;193;1305;3458;1359;3651
220273;202207;1467;3800;1216;3358;57;195;930;2518;987;2713
220275;202207;2929;5782;2358;5027;29;55;2164;4542;2193;4597
220277;202207;2696;5810;2270;5224;82;163;1893;4280;1975;4443
220280;202207;2148;4179;1799;3748;34;61;1604;3277;1638;3338
220285;202207;1819;3860;1563;3557;11;45;1482;3322;1493;3367
220290;202207;7961;20035;6326;17814;492;1285;4533;13188;5025;14473
220300;202207;2270;5975;1771;5335;33;170;1454;4314;1487;4484
220310;202207;3674;8836;2892;7932;40;167;2522;6840;2562;7007
220320;202207;3518;9253;2717;7855;79;354;2128;5915;2207;6269
220323;202207;1889;4972;1437;4252;44;175;1168;3347;1212;3522
220325;202207;1370;3850;1150;3475;33;146;922;2725;955;2871
220327;202207;1847;4661;1614;4301;54;195;1347;3479;1401;3674
220330;202207;5941;11935;5102;10959;40;121;4743;10040;4783;10161
220335;202207;2097;5395;1899;5128;99;185;1638;4467;1737;4652
220340;202207;2082;5205;1572;4359;73;227;1010;2690;1083;2917
220342;202207;1399;3658;1249;3444;84;180;963;2696;1047;2876
220345;202207;3479;7263;2629;6106;26;87;2308;5262;2334;5349
220350;202207;3813;8973;3043;7848;216;509;2148;5512;2364;6021
220360;202207;1462;3436;1121;2908;20;59;899;2280;919;2339
220370;202207;10110;26070;9115;24547;331;943;7711;20539;8042;21482
220375;202207;1921;4732;1695;4460;8;12;1628;4306;1636;4318
220380;202207;1805;3707;1452;3222;16;40;1288;2816;1304;2856
220385;202207;1062;2196;866;1867;7;13;773;1634;780;1647
220390;202207;13500;30377;10715;26382;1865;4620;5573;13793;7438;18413
220400;202207;1730;3774;1308;3129;18;58;1014;2294;1032;2352
220410;202207;1379;3450;1118;3016;28;97;925;2438;953;2535
220415;202207;980;2314;788;1998;25;51;620;1541;645;1592
220420;202207;2165;5746;1727;4908;75;259;1263;3500;1338;3759
220430;202207;3304;7266;2949;6793;50;130;2664;6020;2714;6150
220435;202207;2308;5072;1996;4603;32;99;1713;3821;1745;3920
220440;202207;3608;8597;3062;7820;60;283;2731;6627;2791;6910
220450;202207;3100;7098;2566;6438;51;181;2276;5623;2327;5804
220455;202207;1510;4018;1436;3927;9;52;1319;3597;1328;3649
220460;202207;1292;2698;1194;2567;44;76;1040;2192;1084;2268
220465;202207;2682;7584;2346;7072;165;478;1815;5532;1980;6010
220470;202207;4341;10682;3837;9885;161;396;3040;7643;3201;8039
220480;202207;3078;7421;2445;6453;198;404;1674;4408;1872;4812
220490;202207;2836;6453;2415;5936;26;119;2123;5101;2149;5220
220500;202207;3774;8313;3153;7382;131;255;2437;5586;2568;5841
220510;202207;3111;7624;2506;6596;109;270;2000;5274;2109;5544
220515;202207;2042;4323;1873;4087;71;95;1606;3478;1677;3573
220520;202207;5900;13664;5276;12787;102;261;4441;10823;4543;11084
220525;202207;1623;3586;1365;3275;10;32;1259;3010;1269;3042
220527;202207;1801;4049;1514;3633;48;97;1340;3233;1388;3330
220530;202207;1916;3983;1613;3601;172;366;1221;2824;1393;3190
220535;202207;982;2383;909;2273;34;108;742;1787;776;1895
220540;202207;3707;10656;3405;10080;206;590;2768;8193;2974;8783
220545;202207;1705;4548;1548;4308;66;264;1308;3547;1374;3811
220550;202207;10053;28868;8867;26713;465;1599;6660;19568;7125;21167
220551;202207;1668;4113;1452;3758;21;87;1233;3098;1254;3185
220552;202207;1879;5024;1520;4402;23;124;1220;3388;1243;3512
220553;202207;2317;4791;1930;4292;27;61;1739;3829;1766;3890
220554;202207;1114;2513;856;2123;99;187;583;1447;682;1634
220555;202207;3897;7855;3436;7305;31;109;3073;6468;3104;6577
220556;202207;1443;3770;1265;3456;40;174;943;2428;983;2602
220557;202207;1924;5384;1587;4680;105;375;1141;3235;1246;3610
220558;202207;1652;3912;1305;3436;25;98;1102;2803;1127;2901
220559;202207;2122;4659;1789;4149;66;107;1467;3398;1533;3505
220560;202207;2117;4182;1748;3737;25;45;1621;3442;1646;3487
220570;202207;9258;24141;8317;22792;614;1500;6584;18076;7198;19576
220580;202207;7775;19207;7010;18056;121;345;6243;15985;6364;16330
220585;202207;2360;6747;1939;5984;60;185;1569;4837;1629;5022
220590;202207;1740;4014;1438;3589;107;232;1112;2763;1219;2995
220595;202207;3178;7596;2855;7176;97;274;2452;6077;2549;6351
220600;202207;2004;3593;1745;3299;29;44;1616;3031;1645;3075
220605;202207;1713;4683;1469;4259;20;107;1174;3274;1194;3381
220610;202207;3207;8217;2985;7902;21;105;2806;7355;2827;7460
220620;202207;9572;25195;8732;24076;148;714;7977;21632;8125;22346
220630;202207;411;1136;320;978;27;85;199;583;226;668
220635;202207;2070;5624;1834;5160;62;211;1471;4018;1533;4229
220640;202207;2727;6952;2311;6363;93;292;1855;5076;1948;5368
220650;202207;2733;6319;2347;5748;144;254;1823;4566;1967;4820
220660;202207;2913;8404;2427;7598;80;360;1987;6077;2067;6437
220665;202207;1459;3957;1238;3604;35;159;1037;2926;1072;3085
220667;202207;1873;5099;1687;4783;73;259;1383;3838;1456;4097
220669;202207;1893;5101;1800;4967;42;175;1612;4339;1654;4514
220670;202207;2590;5829;2055;5084;37;94;1784;4398;1821;4492
220672;202207;3882;8622;3179;7782;98;332;2815;6707;2913;7039
220675;202207;1494;3733;1328;3449;79;225;1006;2567;1085;2792
220680;202207;3555;7817;3391;7611;275;372;2917;6833;3192;7205
220690;202207;1811;4353;1565;3982;112;304;1175;2946;1287;3250
220695;202207;1076;2704;981;2543;22;60;829;2121;851;2181
220700;202207;13794;27917;11327;24726;514;1102;9102;19261;9616;20363
220710;202207;1019;2513;738;2028;23;80;566;1497;589;1577
220720;202207;2604;5361;2337;5024;23;75;2087;4381;2110;4456
220730;202207;1506;3817;1284;3480;16;72;1104;2908;1120;2980
220735;202207;1186;2432;911;2026;38;83;721;1556;759;1639
220740;202207;1573;3705;1253;3283;53;133;1033;2734;1086;2867
220750;202207;4874;10538;4292;9762;206;371;3829;8734;4035;9105
220755;202207;1731;3601;1446;3199;21;63;1226;2632;1247;2695
220760;202207;4044;8854;3559;8228;47;156;3349;7683;3396;7839
220770;202207;30347;79955;26042;73015;6707;19538;11332;32173;18039;51711
220775;202207;1548;3304;1387;3106;6;26;1350;2990;1356;3016
220777;202207;1806;4256;1408;3656;58;111;998;2697;1056;2808
220779;202207;1394;3441;1191;3126;36;115;999;2572;1035;2687
220780;202207;6644;14874;5956;13908;310;783;4756;10956;5066;11739
220785;202207;1662;3341;1461;3090;14;30;1381;2890;1395;2920
220790;202207;12019;30215;10745;28453;238;936;9211;23982;9449;24918
220793;202207;1135;2574;914;2212;13;32;779;1859;792;1891
220795;202207;1587;3722;1380;3428;26;84;1224;3012;1250;3096
220800;202207;24286;46832;20875;42470;1047;1924;16795;33433;17842;35357
220810;202207;3504;8862;2957;7966;82;194;2365;6444;2447;6638
220820;202207;6750;14568;5937;13431;265;484;4979;11164;5244;11648
220830;202207;8600;20225;7627;18867;365;948;6223;15095;6588;16043
220840;202207;14949;39775;12615;35494;2066;5536;7484;20858;9550;26394
220850;202207;3499;9811;3108;9320;62;290;2783;8330;2845;8620
220855;202207;967;1944;845;1791;16;54;772;1607;788;1661
220860;202207;1292;2734;1123;2498;21;72;1041;2270;1062;2342
220865;202207;2597;6571;1986;5508;49;207;1504;4008;1553;4215
220870;202207;3781;8748;3134;7928;32;144;2879;7185;2911;7329
220880;202207;7329;13916;6337;12722;142;310;5817;11592;5959;11902
220885;202207;1733;4385;1447;3957;77;232;1149;3114;1226;3346
220887;202207;1824;3524;1527;3141;37;59;1402;2871;1439;2930
220890;202207;1634;4438;1404;4109;61;205;1142;3329;1203;3534
220900;202207;2516;5100;2111;4569;26;52;1892;4007;1918;4059
220910;202207;1977;4509;1675;4069;226;356;1244;3203;1470;3559
220915;202207;1073;2679;843;2277;11;42;636;1613;647;1655
220920;202207;1778;4772;1530;4452;87;286;1278;3712;1365;3998
220930;202207;2284;5008;1929;4540;20;60;1751;4151;1771;4211
220935;202207;1214;3261;949;2703;22;90;632;1677;654;1767
220937;202207;1692;4089;1427;3667;45;132;1122;2828;1167;2960
220940;202207;2109;4702;1719;4062;31;104;1455;3293;1486;3397
220945;202207;568;1754;451;1544;22;120;303;1008;325;1128
220950;202207;1578;3407;1056;2614;15;41;852;2008;867;2049
220955;202207;1851;4249;1525;3715;21;51;1314;3149;1335;3200
220960;202207;860;2089;626;1703;39;118;394;999;433;1117
220965;202207;2056;4967;1787;4593;28;122;1548;3864;1576;3986
220970;202207;2505;5009;1868;4111;13;39;1647;3519;1660;3558
220975;202207;870;2052;746;1902;10;52;673;1653;683;1705
220980;202207;1388;3438;1235;3239;26;88;1062;2735;1088;2823
220985;202207;1667;3643;1445;3308;84;149;1133;2578;1217;2727
220987;202207;1712;4542;1509;4208;57;197;1250;3423;1307;3620
220990;202207;1890;4820;1645;4448;24;98;1385;3685;1409;3783
220995;202207;1545;3698;1271;3240;16;51;1056;2634;1072;2685
220997;202207;2744;7420;2493;7016;53;209;2206;6065;2259;6274
221000;202207;5338;12946;4674;12026;129;468;4016;10143;4145;10611
221005;202207;1781;4130;1613;3860;26;117;1380;3151;1406;3268
221010;202207;1486;2902;1169;2514;44;64;1013;2171;1057;2235
221020;202207;1734;4900;1555;4601;22;81;1213;3558;1235;3639
221030;202207;1929;4106;1641;3756;24;65;1448;3335;1472;3400
221035;202207;1832;4120;1561;3751;29;46;1377;3333;1406;3379
221037;202207;828;2012;699;1793;12;39;529;1266;541;1305
221038;202207;597;1538;464;1316;27;87;329;905;356;992
221039;202207;954;2451;783;2175;27;113;627;1685;654;1798
221040;202207;5041;13205;4342;12052;212;585;3495;9661;3707;10246
221050;202207;5214;10759;4659;10074;94;222;4219;9058;4313;9280
221060;202207;10998;27021;9047;23906;446;1040;7238;18974;7684;20014
221062;202207;1406;3876;1202;3560;67;195;977;2860;1044;3055
221063;202207;1362;3281;1181;3028;64;191;961;2393;1025;2584
221065;202207;3278;7247;2853;6557;14;51;2568;5793;2582;5844
221070;202207;3815;10857;3075;9344;425;1233;1853;5733;2278;6966
221080;202207;4076;9133;3334;8046;56;200;2793;6485;2849;6685
221090;202207;1617;3689;1329;3261;14;47;1155;2769;1169;2816
221093;202207;1909;4416;1732;4123;176;337;1241;2912;1417;3249
221095;202207;1034;2450;852;2191;25;78;701;1782;726;1860
221097;202207;965;2277;728;1880;16;49;561;1362;577;1411
221100;202207;153966;362943;129814;324934;9248;26591;93871;223642;103119;250233
221110;202207;12085;31372;10996;29998;221;777;9796;26423;10017;27200
221120;202207;5528;14519;4903;13601;168;525;4242;11705;4410;12230
221130;202207;6734;15106;5262;12530;762;1723;3367;7693;4129;9416
221135;202207;2328;4894;2025;4512;76;153;1737;3948;1813;4101
221140;202207;1751;3419;1466;3075;42;79;1313;2715;1355;2794
221150;202207;1296;2947;979;2432;24;113;772;1786;796;1899
221160;202207;853;1948;750;1817;46;69;578;1423;624;1492
221170;202207;1167;2920;1078;2767;7;23;973;2444;980;2467
230010;202207;3524;8464;2882;7399;42;146;2382;5907;2424;6053
230015;202207;4012;11059;3471;9983;192;609;2512;7077;2704;7686
230020;202207;17062;45345;15856;43552;651;1856;13650;37268;14301;39124
230030;202207;14672;33466;12266;30312;358;928;10412;25598;10770;26526
230040;202207;5039;11807;4172;10467;51;212;3576;8769;3627;8981
230050;202207;2988;8674;2294;7139;280;941;1138;3234;1418;4175
230060;202207;2832;6942;2214;5909;36;142;1785;4628;1821;4770
230070;202207;5099;11701;4067;9928;608;1255;2517;6317;3125;7572
230075;202207;11361;31196;10341;29520;516;1830;8501;23661;9017;25491
230080;202207;3637;6791;2798;5764;12;22;2604;5327;2616;5349
230090;202207;5385;11591;4511;10263;174;381;3742;8282;3916;8663
230100;202207;24651;54856;21483;50780;1807;4305;15392;35963;17199;40268
230110;202207;15333;42044;12828;37331;1911;5719;7091;20231;9002;25950
230120;202207;9529;22520;8263;20595;595;1531;6141;15106;6736;16637
230125;202207;3558;8558;2888;7500;79;263;2331;5828;2410;6091
230130;202207;6660;18328;5427;15807;379;1078;3740;10741;4119;11819
230140;202207;4059;10959;3390;9677;104;430;2658;7270;2762;7700
230150;202207;1874;5057;1537;4374;186;504;941;2681;1127;3185
230160;202207;8211;17665;7096;16067;190;432;6079;13480;6269;13912
230170;202207;7253;19124;5871;16408;428;1160;4091;11230;4519;12390
230180;202207;1863;4718;1562;4167;17;75;1270;3245;1287;3320
230185;202207;5234;13111;4381;11765;400;1049;3126;8473;3526;9522
230190;202207;16786;45875;13853;40506;1665;4957;8051;23091;9716;28048
230195;202207;6521;17081;5844;15973;339;932;4501;12213;4840;13145
230200;202207;5551;14314;4566;12554;275;776;3399;9093;3674;9869
230205;202207;4997;12701;4351;11810;275;762;3432;9164;3707;9926
230210;202207;12617;26333;10719;23872;495;1097;8606;18697;9101;19794
230220;202207;17503;39079;15301;36034;881;2001;12478;28969;13359;30970
230230;202207;8228;21512;7370;19912;381;1111;5784;15235;6165;16346
230240;202207;15996;37181;13666;33405;686;1532;10854;26179;11540;27711
230250;202207;10248;26208;9431;25015;324;968;7397;18928;7721;19896
230260;202207;17629;45930;15154;41835;2292;6057;8942;24712;11234;30769
230270;202207;8683;21160;6659;17586;914;2195;3788;10412;4702;12607
230280;202207;23408;55455;19224;48745;432;1785;15652;37517;16084;39302
230290;202207;5921;14332;4941;12585;183;511;3962;9769;4145;10280
230300;202207;5803;13647;5180;12796;76;224;4610;11316;4686;11540
230310;202207;5396;14122;4513;12559;188;621;3242;8753;3430;9374
230320;202207;8942;23698;7419;21063;258;1021;5778;15901;6036;16922
230330;202207;5510;13713;4283;11460;130;441;3253;8410;3383;8851
230340;202207;4468;12639;3842;11428;226;757;2790;8042;3016;8799
230350;202207;21800;52609;19033;48741;923;2832;13910;34712;14833;37544
230360;202207;3495;8316;2733;7035;154;373;2009;5101;2163;5474
230365;202207;3582;7828;2942;6914;88;256;2524;5854;2612;6110
230370;202207;81974;190399;71111;175584;4684;13392;54271;128791;58955;142183
230380;202207;7197;18309;5664;15537;134;519;4295;11283;4429;11802
230390;202207;3927;10334;3351;9442;76;315;2671;7318;2747;7633
230393;202207;3926;10195;3123;8636;86;443;2484;6503;2570;6946
230395;202207;6548;16604;5587;15010;532;1400;3714;9863;4246;11263
230400;202207;6470;15925;5663;14686;77;370;4599;11382;4676;11752
230410;202207;14737;41316;12084;36642;867;2846;8389;25365;9256;28211
230420;202207;34501;86027;28268;75841;2813;7913;17598;45525;20411;53438
230423;202207;5319;14526;4645;13286;300;922;3376;9454;3676;10376
230425;202207;6797;18821;6209;17729;609;1695;4400;12456;5009;14151
230426;202207;3122;7551;2269;5986;47;174;1727;4380;1774;4554
230427;202207;2063;5413;1455;4203;158;453;770;2066;928;2519
230428;202207;11386;28461;9720;26076;1459;3820;5681;14958;7140;18778
230430;202207;5642;14727;4449;12685;155;555;3374;9345;3529;9900
230435;202207;7434;17110;6048;14833;835;1958;3585;8682;4420;10640
230440;202207;540578;1174599;458766;1061792;30667;79254;337467;750544;368134;829798
230445;202207;4720;11984;3797;10416;261;714;2534;6688;2795;7402
230450;202207;4299;10975;3739;10171;206;724;2825;7347;3031;8071
230460;202207;2475;6137;2118;5574;65;240;1764;4543;1829;4783
230465;202207;4938;12277;4144;10828;135;441;3234;8057;3369;8498
230470;202207;12910;38594;11562;36202;785;2972;8451;25700;9236;28672
230480;202207;1721;4426;1436;3937;61;266;1110;2842;1171;3108
230490;202207;3209;8043;2658;7027;209;634;1781;4367;1990;5001
230495;202207;6969;17793;6106;16345;732;1969;3832;10060;4564;12029
230500;202207;10409;31016;9149;28805;333;1254;7366;23134;7699;24388
230510;202207;1973;5045;1548;4216;158;437;923;2422;1081;2859
230520;202207;5471;13613;4698;12331;383;937;3413;8801;3796;9738
230523;202207;18587;50893;14707;43146;3267;9322;4236;12732;7503;22054
230526;202207;4552;11272;3837;10138;318;681;2711;7374;3029;8055
230530;202207;6260;18246;5204;16292;895;2867;3157;9844;4052;12711
230533;202207;5497;11215;4321;9493;78;206;3638;7679;3716;7885
230535;202207;5774;15259;4841;13725;344;1089;3227;9066;3571;10155
230540;202207;17391;44849;14780;40954;315;1149;12150;33228;12465;34377
230550;202207;26049;61132;21222;53440;1708;4339;14688;35795;16396;40134
230560;202207;9035;19826;7252;17158;196;413;6132;14529;6328;14942
230565;202207;3588;8983;2974;7896;97;325;2362;6083;2459;6408
230570;202207;3856;9094;3252;8267;75;233;2700;6743;2775;6976
230580;202207;14247;31490;12262;28730;638;1209;10072;23590;10710;24799
230590;202207;10880;27897;9017;24713;582;1635;6697;17908;7279;19543
230600;202207;4367;10003;3404;8412;141;317;2349;5825;2490;6142
230610;202207;7719;19173;6786;17636;450;1158;5345;13786;5795;14944
230620;202207;2389;5942;1854;4952;101;322;1214;3036;1315;3358
230625;202207;10790;26894;9172;24187;1922;5237;4244;10783;6166;16020
230630;202207;13730;34555;12041;31568;1298;3132;8100;21241;9398;24373
230640;202207;31078;87248;27986;82316;1296;4752;22491;64748;23787;69500
230650;202207;6110;14905;5147;13337;138;550;4285;10671;4423;11221
230655;202207;10852;32622;10176;31530;717;2168;8245;25698;8962;27866
230660;202207;6831;18722;5487;16392;183;843;4372;12744;4555;13587
230670;202207;6919;15172;5007;12245;147;411;4002;9446;4149;9857
230680;202207;3166;7842;2627;6950;167;363;1839;4849;2006;5212
230690;202207;7986;21841;6740;19508;415;1366;4411;12533;4826;13899
230700;202207;12429;27757;9916;23378;459;1090;7578;17305;8037;18395
230710;202207;7721;22623;6751;20665;587;1818;4653;14013;5240;15831
230720;202207;2244;6050;1856;5361;141;376;1265;3569;1406;3945
230725;202207;5329;14073;4775;13146;362;1150;3265;8640;3627;9790
230730;202207;69280;168317;54345;147192;12048;32330;20327;58207;32375;90537
230740;202207;6932;17974;5808;16195;178;537;4598;12739;4776;13276
230750;202207;9593;23614;7865;20818;156;540;6322;16193;6478;16733
230760;202207;13294;31785;11448;29068;456;1446;8779;21491;9235;22937
230763;202207;5590;13876;4572;12174;92;398;3656;9351;3748;9749
230765;202207;49750;122329;41672;109941;4613;12986;25596;64744;30209;77730
230770;202207;33381;69104;28396;62874;1964;4404;21723;46774;23687;51178
230780;202207;7560;23908;6770;22118;869;2782;4095;13487;4964;16269
230790;202207;3582;9137;3191;8545;132;455;2476;6325;2608;6780
230800;202207;10156;28562;8817;26014;1155;3447;5167;14725;6322;18172
230810;202207;12326;34613;10920;32343;509;1679;8456;24564;8965;26243
230820;202207;4046;12028;3338;10573;317;1199;2082;6237;2399;7436
230830;202207;8885;21764;7495;19564;237;661;6132;15512;6369;16173
230835;202207;4715;10400;3648;8795;132;310;2941;6932;3073;7242
230837;202207;4044;10193;3613;9495;80;322;3075;7784;3155;8106
230840;202207;10973;29417;9421;26818;775;2176;6925;19564;7700;21740
230850;202207;11929;29891;10070;26570;522;1376;7567;19653;8089;21029
230860;202207;7262;14558;6091;12949;76;197;5519;11441;5595;11638
230870;202207;20402;42773;17546;38270;890;1708;14140;30370;15030;32078
230880;202207;2320;6457;2110;6119;67;298;1652;4617;1719;4915
230890;202207;5211;15054;4681;14119;241;813;3496;10302;3737;11115
230900;202207;3773;9637;3180;8521;130;450;2346;5976;2476;6426
230910;202207;3843;8999;2998;7762;66;266;2465;6276;2531;6542
230920;202207;5443;13876;4396;12168;120;445;3413;9107;3533;9552
230930;202207;7965;20427;6522;17929;301;904;4572;12246;4873;13150
230940;202207;9612;21669;8340;19820;160;405;7180;16810;7340;17215
230945;202207;7481;19560;6345;17512;301;977;4635;12315;4936;13292
230950;202207;7141;16294;6285;15151;122;312;5393;12917;5515;13229
230960;202207;15250;40359;13155;36589;2059;5833;6790;18297;8849;24130
230970;202207;17761;42497;15054;38482;1442;3830;10084;24992;11526;28822
230980;202207;3658;8662;3164;7855;312;720;2217;5526;2529;6246
230990;202207;1955;5039;1620;4403;74;260;1173;3007;1247;3267
231000;202207;3091;7484;2447;6265;78;234;1853;4500;1931;4734
231010;202207;4509;8940;3549;7437;24;99;3205;6478;3229;6577
231020;202207;10198;27276;8994;25135;1281;3290;5688;16168;6969;19458
231025;202207;9208;22138;8080;20427;531;1294;6306;15732;6837;17026
231030;202207;8367;23098;6386;19127;832;2438;3707;10994;4539;13432
231040;202207;3611;8818;3092;7937;71;238;2586;6382;2657;6620
231050;202207;13904;31753;11340;27477;511;1344;8903;20771;9414;22115
231060;202207;3257;8350;2888;7792;84;286;2301;6257;2385;6543
231070;202207;9286;24516;7975;22254;662;1922;5485;15006;6147;16928
231080;202207;4492;11654;3720;10389;204;660;2674;7350;2878;8010
231085;202207;8464;18314;6834;16412;203;517;5566;13129;5769;13646
231090;202207;5025;12211;3673;9672;117;444;2601;6488;2718;6932
231095;202207;2525;7072;2013;6015;191;553;1321;3920;1512;4473
231100;202207;3598;9465;2942;8304;138;456;2195;6044;2333;6500
231110;202207;4207;11362;3862;10742;304;948;2760;7382;3064;8330
231120;202207;2789;7224;2331;6472;104;317;1739;4738;1843;5055
231123;202207;2214;5324;1732;4477;107;259;1237;3139;1344;3398
231126;202207;6369;16005;5159;13788;289;751;3811;10018;4100;10769
231130;202207;27200;59650;22644;54053;1274;3702;17427;39868;18701;43570
231135;202207;4849;12518;3995;10935;184;543;2853;7654;3037;8197
231140;202207;19450;49778;15677;43650;703;2554;11548;30901;12251;33455
231150;202207;6849;17252;4889;13509;774;2159;1878;5179;2652;7338
231160;202207;7989;21143;7103;19558;774;1952;4530;12511;5304;14463
231170;202207;5409;14064;4470;12383;275;826;3211;8479;3486;9305
231180;202207;17394;44620;14150;38336;2356;6387;7163;18943;9519;25330
231190;202207;4696;12020;3679;10206;88;345;2849;7638;2937;7983
231195;202207;5776;15966;4739;13967;293;978;3457;10027;3750;11005
231200;202207;9758;24975;8452;22562;150;689;7134;18100;7284;18789
231210;202207;5573;14784;4682;13300;152;602;3711;10177;3863;10779
231220;202207;15473;34542;12237;28945;584;1311;9190;20836;9774;22147
231230;202207;11016;32235;9671;29817;713;2397;7204;21942;7917;24339
231240;202207;13717;36950;12043;34006;1626;4490;7537;21118;9163;25608
231250;202207;2380;5491;1560;3814;93;208;1019;2362;1112;2570
231260;202207;3795;9386;3227;8514;310;713;2237;5982;2547;6695
231270;202207;7463;17479;6043;15225;148;558;4667;11205;4815;11763
231280;202207;2041;5776;1787;5338;163;462;1223;3645;1386;4107
231290;202207;42599;117376;35649;104685;4827;14365;18837;53468;23664;67833
231300;202207;4790;12125;3738;10124;133;444;2634;6827;2767;7271
231310;202207;9226;20844;7320;17557;579;1485;5213;11946;5792;13431
231320;202207;8148;21228;6233;17811;143;443;4846;13725;4989;14168
231325;202207;2850;6674;2286;5810;171;309;1637;4169;1808;4478
231330;202207;12166;32004;10088;28175;1378;3639;6322;17749;7700;21388
231335;202207;6365;15562;5277;13887;140;476;4501;11680;4641;12156
231340;202207;21416;59548;19164;55818;1397;4127;14466;42277;15863;46404
231350;202207;18502;45614;16771;43190;281;905;15070;38346;15351;39251
231355;202207;5158;13700;4573;12664;200;641;3635;9821;3835;10462
231360;202207;9106;24969;7858;22931;373;1191;6204;17831;6577;19022
231370;202207;2398;6153;1909;5294;43;130;1462;3988;1505;4118
231375;202207;4602;13306;4102;12482;106;439;3409;10231;3515;10670
231380;202207;6873;16536;6115;15534;180;445;5077;12916;5257;13361
231390;202207;3882;10412;3457;9721;115;457;2602;7035;2717;7492
231395;202207;4925;12942;4120;11684;270;793;2889;8002;3159;8795
231400;202207;11356;29490;9475;26140;285;1203;7368;19555;7653;20758
231410;202207;17678;48033;16007;45490;828;2359;13059;36985;13887;39344
240010;202207;2974;7146;2330;6045;347;892;1205;3030;1552;3922
240020;202207;15649;38529;13090;34226;797;2430;9053;22723;9850;25153
240030;202207;4335;8346;3896;7738;91;266;3509;6700;3600;6966
240040;202207;909;2458;753;2176;21;82;511;1401;532;1483
240050;202207;3902;9633;3059;8131;60;178;2346;6049;2406;6227
240060;202207;1688;4064;1346;3461;47;128;1048;2631;1095;2759
240070;202207;2991;7545;2642;6844;198;560;1909;4701;2107;5261
240080;202207;3358;8349;2647;7147;114;354;1910;5042;2024;5396
240090;202207;2593;5772;2117;5006;25;64;1806;4180;1831;4244
240100;202207;12755;27519;10237;23368;256;741;8263;17882;8519;18623
240110;202207;5449;14053;4538;12425;167;597;3434;9010;3601;9607
240120;202207;3902;10149;3240;9287;254;866;2324;6505;2578;7371
240130;202207;4515;8239;3672;7170;51;97;3290;6352;3341;6449
240140;202207;2040;5760;1727;5202;196;669;1097;3216;1293;3885
240145;202207;7803;20287;6317;17792;687;2005;4025;11142;4712;13147
240150;202207;1170;2970;998;2645;50;162;767;1967;817;2129
240160;202207;1660;4529;1362;3989;38;156;986;2824;1024;2980
240165;202207;1101;2742;921;2415;29;97;764;1946;793;2043
240170;202207;3258;7746;2729;6861;295;735;1786;4426;2081;5161
240180;202207;3488;9587;2781;8162;614;1728;1270;3860;1884;5588
240185;202207;1520;4286;1369;4022;44;186;1085;3064;1129;3250
240190;202207;1275;3229;1071;2919;26;100;896;2418;922;2518
240200;202207;14492;32175;11753;27780;1360;3224;7179;16308;8539;19532
240210;202207;3987;8482;3276;7376;37;163;2848;6115;2885;6278
240220;202207;8420;23496;7488;22067;457;1597;5777;16826;6234;18423
240230;202207;6809;15686;5357;13377;281;590;3970;10032;4251;10622
240240;202207;2028;5522;1370;4096;168;532;487;1260;655;1792
240250;202207;3648;8327;3146;7619;55;210;2686;6278;2741;6488
240260;202207;17964;47366;15589;43517;4439;11929;6890;21089;11329;33018
240270;202207;2818;7469;2357;6730;115;346;1682;4888;1797;5234
240280;202207;1889;4478;1568;3965;69;175;1230;3066;1299;3241
240290;202207;1325;3534;1064;3016;33;141;741;1928;774;2069
240300;202207;2586;6167;1873;4935;98;250;1170;3001;1268;3251
240310;202207;9756;24207;7729;20716;989;2661;4029;10561;5018;13222
240320;202207;2223;5676;1535;4327;89;281;1069;2887;1158;3168
240325;202207;39814;95634;32587;83963;4122;11706;18871;46078;22993;57784
240330;202207;2089;5240;1610;4386;69;242;1129;2898;1198;3140
240340;202207;2415;4828;1962;4174;57;145;1642;3336;1699;3481
240350;202207;2919;6167;2593;5794;28;94;2402;5300;2430;5394
240360;202207;13180;32364;11741;30220;1803;4224;7548;19656;9351;23880
240370;202207;2547;5598;1961;4561;92;249;1453;3159;1545;3408
240375;202207;1093;2493;901;2187;34;114;714;1637;748;1751
240380;202207;2643;6814;2021;5545;198;526;1159;3121;1357;3647
240390;202207;1152;2594;787;1936;32;63;520;1192;552;1255
240400;202207;1692;3824;1273;3139;38;139;918;2112;956;2251
240410;202207;675;1883;547;1639;49;176;328;937;377;1113
240420;202207;5747;17467;5107;16226;453;1782;3485;10577;3938;12359
240430;202207;4091;9454;3408;8335;113;373;2659;6194;2772;6567
240440;202207;3213;6572;2742;5915;272;494;2041;4413;2313;4907
240450;202207;5107;12923;4014;10989;358;1166;2460;6264;2818;7430
240460;202207;3874;9311;3459;8673;289;647;2785;7031;3074;7678
240470;202207;3955;11269;3013;9358;598;1704;1435;4672;2033;6376
240480;202207;667;1679;412;1137;26;66;209;544;235;610
240485;202207;2486;6466;1998;5631;155;460;1322;3718;1477;4178
240490;202207;1881;4284;1443;3539;89;177;1034;2496;1123;2673
240500;202207;2418;6077;2081;5516;108;299;1670;4374;1778;4673
240510;202207;1874;4702;1603;4301;78;252;1270;3321;1348;3573
240520;202207;1842;3859;1401;3278;102;207;1087;2551;1189;2758
240530;202207;2675;6578;2354;6065;71;203;1997;4998;2068;5201
240540;202207;2681;6011;2387;5574;52;140;2123;4909;2175;5049
240550;202207;970;2204;862;2025;16;59;770;1751;786;1810
240560;202207;4429;9431;3806;8627;169;327;3142;7080;3311;7407
240570;202207;3135;7870;2110;5718;296;821;764;1895;1060;2716
240580;202207;9819;25708;8646;23707;534;1537;6988;18974;7522;20511
240590;202207;1030;2102;882;1882;10;21;727;1486;737;1507
240600;202207;2043;5088;1491;4034;55;161;1030;2623;1085;2784
240610;202207;5333;12439;4538;11086;199;511;3450;8103;3649;8614
240615;202207;1459;3435;1168;2962;104;262;833;2029;937;2291
240620;202207;2178;5449;1862;4927;82;266;1528;3955;1610;4221
240630;202207;2491;6041;2236;5638;302;501;1564;4165;1866;4666
240640;202207;1067;2591;837;2210;30;100;640;1624;670;1724
240650;202207;4679;12464;3943;11027;297;819;2753;7647;3050;8466
240660;202207;4030;8481;3621;7948;65;137;3343;7290;3408;7427
240670;202207;2914;7323;2307;6144;177;515;1550;3938;1727;4453
240680;202207;1882;4415;1493;3766;47;152;1185;2856;1232;3008
240690;202207;1331;2929;1037;2443;26;94;857;1902;883;1996
240700;202207;2718;7459;2171;6476;104;338;1613;4759;1717;5097
240710;202207;21599;47818;18423;42906;1625;3830;13556;30473;15181;34303
240720;202207;5997;13799;5080;12516;579;1409;3378;8290;3957;9699
240725;202207;1279;3371;978;2829;47;132;636;1773;683;1905
240730;202207;2657;6695;2080;5648;70;221;1592;4204;1662;4425
240740;202207;2180;5504;1744;4657;69;224;1243;3114;1312;3338
240750;202207;2565;7722;2152;6852;262;926;1274;3998;1536;4924
240760;202207;1969;4093;1422;3295;99;143;1088;2584;1187;2727
240770;202207;3722;9356;3123;8531;141;483;2555;6841;2696;7324
240780;202207;5887;14707;4920;13147;684;1783;3178;8442;3862;10225
240790;202207;1037;2627;845;2300;25;115;629;1617;654;1732
240800;202207;64418;136474;51463;117886;5049;12046;32965;71389;38014;83435
240810;202207;115518;265786;99593;241271;8657;22271;71526;167522;80183;189793
240820;202207;6881;18703;6027;17200;746;2159;3869;11033;4615;13192
240830;202207;9883;25901;8598;24019;325;1147;6931;19058;7256;20205
240840;202207;1248;2907;999;2520;44;99;699;1713;743;1812
240850;202207;1624;4129;1127;3105;93;250;634;1654;727;1904
240860;202207;1638;3809;1234;3127;40;131;973;2364;1013;2495
240870;202207;1218;2865;922;2379;151;378;484;1276;635;1654
240880;202207;1438;4290;1250;3926;111;420;902;2785;1013;3205
240890;202207;5806;13794;4568;11639;461;1330;2865;6667;3326;7997
240895;202207;3392;9327;3051;8782;371;1006;2219;6541;2590;7547
240910;202207;4023;9930;3329;8727;57;195;2718;6904;2775;7099
240920;202207;1197;2720;963;2379;104;183;601;1525;705;1708
240930;202207;4230;8752;3440;7775;234;357;2353;5779;2587;6136
240933;202207;1840;4278;1529;3838;36;140;1305;3175;1341;3315
240940;202207;8158;17524;6490;14903;618;1401;4302;9395;4920;10796
240950;202207;1263;3433;1082;3090;40;161;859;2340;899;2501
240960;202207;781;2127;699;1961;16;60;553;1488;569;1548
240970;202207;2263;5040;1828;4354;71;224;1518;3490;1589;3714
240980;202207;4421;10701;3963;9969;79;332;3450;8359;3529;8691
240990;202207;3265;7867;2877;7202;229;702;2128;4981;2357;5683
241000;202207;1142;2660;882;2205;15;46;694;1653;709;1699
241010;202207;3550;9672;3213;9015;142;508;2569;6951;2711;7459
241020;202207;2432;5960;1843;4826;99;310;1318;3258;1417;3568
241025;202207;1907;5103;1529;4452;46;176;1100;3099;1146;3275
241030;202207;2810;8196;2255;7076;268;759;1435;4530;1703;5289
241040;202207;2430;7061;2079;6476;91;419;1586;4879;1677;5298
241050;202207;1638;4191;1312;3610;39;135;973;2591;1012;2726
241060;202207;932;2361;797;2090;45;109;547;1380;592;1489
241070;202207;806;1969;668;1752;16;40;517;1303;533;1343
241080;202207;1299;3404;1005;2808;35;118;719;1939;754;2057
241090;202207;2348;6168;1876;5370;88;350;1402;3864;1490;4214
241100;202207;1348;3466;1013;2798;45;112;688;1847;733;1959
241105;202207;1179;3220;955;2822;191;597;418;1205;609;1802
241110;202207;1068;2794;793;2235;45;124;506;1361;551;1485
241120;202207;8498;22459;7151;20214;793;2236;4549;12939;5342;15175
241140;202207;3811;9400;2909;7660;114;359;2148;5443;2262;5802
241142;202207;869;2200;652;1815;42;124;389;1002;431;1126
241150;202207;6776;16065;5937;14795;249;599;4638;11393;4887;11992
241160;202207;1342;3451;1046;2921;167;516;576;1497;743;2013
241170;202207;1525;3627;1287;3218;31;107;1063;2546;1094;2653
241180;202207;1197;2799;884;2246;88;231;498;1199;586;1430
241190;202207;1364;3204;1131;2784;16;60;844;1969;860;2029
241200;202207;27180;61550;23875;56444;2607;6442;16165;36569;18772;43011
241210;202207;1776;4268;1302;3415;103;303;791;2008;894;2311
241220;202207;11257;29028;9883;26817;2081;5604;4980;13688;7061;19292
241230;202207;3356;8054;2911;7395;114;298;2397;6019;2511;6317
241240;202207;1384;3659;827;2478;95;296;275;781;370;1077
241250;202207;6899;17149;5551;14814;159;686;4309;10879;4468;11565
241255;202207;3030;8127;2630;7395;151;505;1961;5311;2112;5816
241260;202207;5728;13599;4567;11727;171;537;3527;8698;3698;9235
241270;202207;1844;5014;1525;4423;125;381;1055;3002;1180;3383
241280;202207;2910;6071;2534;5426;85;191;2166;4528;2251;4719
241290;202207;3730;8408;2728;6836;79;225;2157;5234;2236;5459
241300;202207;1743;4312;1409;3753;28;108;964;2460;992;2568
241310;202207;2641;5636;2281;5137;63;111;1971;4403;2034;4514
241320;202207;1089;3278;933;2981;95;346;581;1806;676;2152
241330;202207;2000;4672;1579;4116;19;74;1395;3603;1414;3677
241335;202207;4214;10555;3678;9625;129;407;3013;7663;3142;8070
241340;202207;1959;4822;1559;4064;185;586;893;2115;1078;2701
241350;202207;2495;6185;2162;5615;112;294;1664;4240;1776;4534
241355;202207;1596;3879;1286;3302;46;96;960;2426;1006;2522
241360;202207;2362;5587;1728;4372;56;156;1285;3092;1341;3248
241370;202207;1555;3843;1186;3128;63;193;866;2114;929;2307
241380;202207;815;1983;639;1687;70;176;363;939;433;1115
241390;202207;3051;8199;2668;7633;153;475;2060;5883;2213;6358
241400;202207;4211;10683;3680;9892;221;703;2841;7474;3062;8177
241410;202207;2822;7760;2280;6686;236;759;1447;4155;1683;4914
241415;202207;2119;5295;1793;4703;50;191;1444;3598;1494;3789
241420;202207;3328;8838;2974;8275;471;1419;1897;5221;2368;6640
241430;202207;807;1886;510;1331;18;48;336;818;354;866
241440;202207;9599;26204;8589;24516;310;996;6962;19540;7272;20536
241445;202207;1581;3334;1379;3072;45;83;1212;2705;1257;2788
241450;202207;3415;7400;2800;6466;237;497;2125;4874;2362;5371
241460;202207;4485;11123;3580;9349;254;697;2437;6091;2691;6788
241470;202207;1593;3942;1291;3489;43;139;1058;2817;1101;2956
241475;202207;1431;3581;1118;3024;24;92;834;2116;858;2208
241480;202207;3540;10038;2894;8714;790;2346;1038;3369;1828;5715
241490;202207;857;1760;614;1406;14;42;496;1092;510;1134
241500;202207;934;2288;846;2186;8;19;787;2036;795;2055
250010;202207;3078;8289;2549;7232;71;234;1898;5225;1969;5459
250020;202207;1869;4499;1392;3642;85;156;1025;2665;1110;2821
250030;202207;8081;20238;7064;18709;832;2250;4972;12983;5804;15233
250040;202207;5405;14045;4717;12885;635;1693;3092;8360;3727;10053
250050;202207;4275;10222;3800;9622;166;454;3172;8063;3338;8517
250053;202207;1485;3766;1349;3565;132;298;956;2529;1088;2827
250057;202207;838;2428;767;2325;8;35;701;2120;709;2155
250060;202207;6673;15712;5892;14659;340;854;4760;11701;5100;12555
250070;202207;4626;11744;3857;10468;49;209;3092;8103;3141;8312
250073;202207;937;2228;745;1918;8;26;605;1517;613;1543
250077;202207;3051;6681;2358;5616;34;117;1987;4569;2021;4686
250080;202207;6493;13504;5410;12189;63;222;4880;10796;4943;11018
250090;202207;4372;8742;3839;8065;64;167;3413;6963;3477;7130
250100;202207;3917;11133;3512;10430;135;508;2776;7990;2911;8498
250110;202207;5743;14441;5208;13710;315;969;4036;10431;4351;11400
250115;202207;865;1885;653;1573;10;37;520;1210;530;1247
250120;202207;2124;5707;1789;5168;28;134;1432;4025;1460;4159
250130;202207;6986;15675;5952;14297;59;270;5244;12241;5303;12511
250135;202207;1577;3738;1369;3392;51;136;1157;2821;1208;2957
250140;202207;2542;6850;2339;6603;116;406;1992;5628;2108;6034
250150;202207;5388;15511;4831;14620;175;677;3887;11463;4062;12140
250153;202207;1588;3877;1290;3440;55;147;1015;2668;1070;2815
250157;202207;2370;5834;2101;5412;44;158;1757;4402;1801;4560
250160;202207;4473;10064;3586;8879;79;199;3077;7560;3156;7759
250170;202207;2173;5131;1940;4803;37;131;1659;3999;1696;4130
250180;202207;26794;55929;22986;51200;844;2446;18947;40438;19791;42884
250190;202207;4956;11767;4163;10656;357;904;3015;7509;3372;8413
250200;202207;2993;5870;2569;5339;44;111;2308;4637;2352;4748
250205;202207;954;2793;807;2562;15;69;641;2018;656;2087
250210;202207;1679;4675;1490;4373;56;229;1173;3339;1229;3568
250215;202207;1858;4727;1566;4328;98;309;890;2473;988;2782
250220;202207;763;1961;606;1711;32;113;419;1136;451;1249
250230;202207;1901;3972;1347;3184;19;54;1063;2423;1082;2477
250240;202207;3263;7775;2891;7175;40;176;2558;6172;2598;6348
250250;202207;5492;13474;4823;12562;277;538;3819;10359;4096;10897
250260;202207;1836;4847;1539;4320;59;175;1194;3343;1253;3518
250270;202207;1398;3843;1273;3691;92;277;914;2769;1006;3046
250280;202207;4669;10286;4180;9656;251;459;3287;7692;3538;8151
250290;202207;2021;4509;1696;4041;18;52;1364;3146;1382;3198
250300;202207;6971;15533;6269;14706;177;624;5379;12141;5556;12765
250310;202207;1364;3546;1117;3145;45;128;825;2293;870;2421
250320;202207;15450;30559;13462;28334;182;530;12361;25435;12543;25965
250330;202207;3020;7116;2578;6524;78;258;2228;5452;2306;5710
250340;202207;1449;3142;1249;2877;14;39;1127;2563;1141;2602
250350;202207;4501;11855;3901;10821;314;660;2978;8518;3292;9178
250355;202207;2560;6365;2262;5998;19;84;2087;5504;2106;5588
250360;202207;2105;5038;1876;4737;57;179;1569;3843;1626;4022
250370;202207;17980;39010;15182;34943;291;851;13175;29394;13466;30245
250375;202207;1518;3289;1237;2963;7;20;1153;2778;1160;2798
250380;202207;2074;4522;1908;4323;39;136;1722;3762;1761;3898
250390;202207;2232;5085;1878;4547;141;347;1448;3473;1589;3820
250400;202207;83303;193177;63231;163104;17800;47693;19677;52389;37477;100082
250403;202207;2616;5638;2320;5312;52;282;1984;4230;2036;4512
250407;202207;1632;3482;1257;2931;151;268;775;1975;926;2243
250410;202207;807;1944;690;1755;10;33;577;1402;587;1435
250415;202207;2280;5620;1992;5196;41;148;1726;4414;1767;4562
250420;202207;1478;3479;1332;3283;15;37;1219;2981;1234;3018
250430;202207;8442;17588;7243;16026;384;720;5946;12855;6330;13575
250435;202207;1834;4791;1441;4132;21;99;1093;3014;1114;3113
250440;202207;5130;12774;4437;11880;90;228;3873;10280;3963;10508
250450;202207;2088;4962;1714;4459;89;170;1334;3567;1423;3737
250460;202207;8398;21115;7350;19646;510;1384;5717;15217;6227;16601
250470;202207;1906;4416;1563;3888;39;109;1262;3026;1301;3135
250480;202207;4425;11276;3703;10382;63;180;3183;8972;3246;9152
250485;202207;810;1725;610;1450;63;109;410;954;473;1063
250490;202207;6314;13034;5585;12211;103;338;5033;10714;5136;11052
250500;202207;2308;5907;2036;5455;60;179;1657;4366;1717;4545
250510;202207;6542;14385;5598;13126;143;239;4779;11276;4922;11515
250520;202207;2166;5348;1845;4933;84;260;1443;3757;1527;4017
250523;202207;2667;5696;2334;5259;210;466;1776;3920;1986;4386
250527;202207;1990;4473;1795;4254;16;50;1638;3834;1654;3884
250530;202207;753;1774;639;1610;20;52;526;1280;546;1332
250535;202207;1553;4163;1376;3853;30;130;1099;2973;1129;3103
250540;202207;3927;7411;3316;6743;392;440;2676;5776;3068;6216
250550;202207;872;2634;771;2448;50;166;531;1665;581;1831
250560;202207;1974;5047;1701;4660;42;163;1406;3742;1448;3905
250570;202207;3126;8384;2687;7622;132;430;2068;5760;2200;6190
250580;202207;1205;2909;1065;2723;50;202;893;2186;943;2388
250590;202207;1182;2537;1068;2376;33;77;949;2057;982;2134
250600;202207;8875;22182;7323;20067;271;818;5710;15413;5981;16231
250610;202207;3307;8665;2938;8128;102;351;2414;6611;2516;6962
250620;202207;1037;2307;883;2061;51;134;677;1527;728;1661
250625;202207;2697;7238;2391;6747;51;228;2051;5647;2102;5875
250630;202207;13638;32105;11422;28556;1101;2897;7902;19012;9003;21909
250640;202207;4326;10158;3868;9564;114;340;3310;8099;3424;8439
250650;202207;1251;2641;1012;2329;15;52;877;1970;892;2022
250660;202207;1812;4122;1435;3593;34;111;1182;2835;1216;2946
250670;202207;2712;7609;2441;7133;50;199;2116;6035;2166;6234
250680;202207;6932;14214;6233;13431;44;181;5830;12261;5874;12442
250690;202207;8442;16958;7108;15351;181;340;6099;13010;6280;13350
250700;202207;5281;13679;4601;12638;708;1898;2892;7962;3600;9860
250710;202207;4963;13314;4309;12402;292;934;3178;9080;3470;10014
250720;202207;3217;7963;2863;7476;59;226;2564;6586;2623;6812
250730;202207;5191;12034;4568;11216;147;509;3922;9304;4069;9813
250740;202207;2351;5310;1935;4756;121;285;1476;3625;1597;3910
250750;202207;135264;302221;115494;275149;8497;21936;85770;198370;94267;220306
250760;202207;3372;6693;3012;6166;47;163;2738;5414;2785;5577
250770;202207;4684;12835;4184;12173;613;1544;2791;8524;3404;10068
250780;202207;2083;5040;1751;4469;73;202;1395;3466;1468;3668
250790;202207;2989;7948;2596;7378;98;390;2040;5599;2138;5989
250800;202207;2799;6789;2422;6202;102;213;1946;4956;2048;5169
250810;202207;1639;3703;1364;3327;121;199;1059;2684;1180;2883
250820;202207;2352;5721;2152;5492;39;131;1952;4926;1991;5057
250830;202207;7193;19476;5930;17020;233;833;4225;11521;4458;12354
250840;202207;858;2554;745;2346;37;134;551;1740;588;1874
250850;202207;2040;5483;1803;5078;36;158;1492;4096;1528;4254
250855;202207;1267;3168;1114;2946;43;134;914;2359;957;2493
250860;202207;4059;10682;3370;9590;486;1364;1914;5392;2400;6756
250870;202207;1218;2986;1021;2679;48;131;808;2092;856;2223
250880;202207;1887;4440;1554;3947;117;286;1146;2881;1263;3167
250890;202207;13287;28615;11689;26616;311;1281;10083;21660;10394;22941
250900;202207;3793;8766;3332;8017;76;217;2884;6727;2960;6944
250905;202207;2800;7245;2567;6940;38;140;2322;6261;2360;6401
250910;202207;8216;16845;6977;15482;84;267;6279;13762;6363;14029
250915;202207;2523;5213;1822;4458;22;44;1613;3972;1635;4016
250920;202207;4397;9805;3933;9130;269;538;3244;7424;3513;7962
250930;202207;2737;6636;2441;6268;85;282;2011;5030;2096;5312
250933;202207;1462;3851;1275;3530;50;175;1002;2693;1052;2868
250937;202207;914;2229;764;1998;22;74;624;1619;646;1693
250939;202207;2344;5315;2056;4951;52;131;1699;4012;1751;4143
250940;202207;4591;10949;3997;10168;53;150;3556;8962;3609;9112
250950;202207;1954;4722;1564;4202;37;138;1251;3279;1288;3417
250960;202207;1293;3471;1138;3231;28;126;939;2570;967;2696
250970;202207;9915;23298;8653;21294;231;590;7196;17201;7427;17791
250980;202207;2796;6702;2520;6324;20;93;2202;5356;2222;5449
250990;202207;2460;6718;2088;6098;90;342;1592;4475;1682;4817
251000;202207;2317;6000;1865;5249;50;180;1508;4194;1558;4374
251010;202207;2941;7459;2612;6967;36;144;2281;6000;2317;6144
251020;202207;1818;4615;1630;4330;33;152;1421;3661;1454;3813
251030;202207;1175;2923;957;2539;60;157;642;1677;702;1834
251040;202207;2139;5387;1814;4865;27;120;1544;4069;1571;4189
251050;202207;1161;3066;966;2695;50;175;691;1841;741;2016
251060;202207;1267;2495;960;2111;32;66;720;1574;752;1640
251065;202207;539;1391;393;1112;9;33;284;754;293;787
251070;202207;860;1987;716;1782;15;47;607;1466;622;1513
251080;202207;24320;54251;19961;47967;3283;7705;11559;28168;14842;35873
251090;202207;3238;8602;2705;7686;66;198;2201;6151;2267;6349
251100;202207;920;2729;795;2479;24;85;604;1789;628;1874
251110;202207;2079;5011;1718;4365;123;270;1246;3116;1369;3386
251120;202207;8901;21937;7470;20200;498;1536;5586;14810;6084;16346
251130;202207;5474;9699;4725;8881;46;115;4426;8166;4472;8281
251140;202207;4708;12348;4155;11573;104;339;3349;9253;3453;9592
251150;202207;3155;8347;2869;7903;70;335;2457;6569;2527;6904
251160;202207;2728;6774;2367;6244;29;146;2119;5446;2148;5592
251170;202207;2071;4744;1820;4429;26;101;1640;3871;1666;3972
251180;202207;3254;7525;2698;6773;247;506;1878;4830;2125;5336
251190;202207;5668;12551;5102;11912;54;249;4609;10416;4663;10665
251200;202207;5232;13391;4591;12581;126;316;3940;10855;4066;11171
251203;202207;1141;3380;1034;3138;53;169;719;2144;772;2313
251207;202207;1297;3223;970;2685;22;98;673;1789;695;1887
251210;202207;9358;21197;7623;18841;533;1051;5475;13965;6008;15016
251220;202207;1516;3225;1137;2733;103;198;835;2074;938;2272
251230;202207;5384;13874;4630;12566;113;394;3705;9689;3818;10083
251240;202207;4267;11115;3576;9947;258;664;2471;6852;2729;7516
251250;202207;13563;32018;11908;29305;645;1739;9269;21900;9914;23639
251260;202207;616;1477;551;1377;17;74;447;1059;464;1133
251270;202207;5123;14078;4552;13296;278;732;3515;10635;3793;11367
251272;202207;1563;3828;1436;3671;54;201;1237;3057;1291;3258
251274;202207;988;2583;783;2221;67;189;491;1359;558;1548
251275;202207;1689;3865;1418;3438;75;179;1129;2650;1204;2829
251276;202207;1549;3883;1342;3603;38;156;1082;2789;1120;2945
251278;202207;739;1799;656;1671;37;111;525;1306;562;1417
251280;202207;3146;6773;2874;6401;58;182;2561;5511;2619;5693
251290;202207;9001;16544;8244;15674;252;522;7341;13592;7593;14114
251300;202207;1001;2678;884;2500;16;66;748;2099;764;2165
251310;202207;3205;8251;2739;7525;57;267;2282;6081;2339;6348
251315;202207;2124;6006;1903;5587;111;323;1476;4299;1587;4622
251320;202207;1910;4628;1441;3824;39;134;1096;2812;1135;2946
251330;202207;2473;5210;2000;4640;28;82;1768;4063;1796;4145
251335;202207;1247;3198;1122;3013;23;103;1010;2650;1033;2753
251340;202207;4461;9458;3544;8278;156;367;2786;6408;2942;6775
251350;202207;1222;3198;1106;3016;39;115;909;2437;948;2552
251360;202207;2157;5339;1694;4675;27;82;1359;3680;1386;3762
251365;202207;905;2187;664;1735;22;56;518;1332;540;1388
251370;202207;29656;71900;25368;66051;3543;8738;15927;41904;19470;50642
251380;202207;1704;3902;1470;3547;30;108;1283;3005;1313;3113
251385;202207;893;2155;692;1805;32;76;474;1200;506;1276
251390;202207;8557;21096;7587;19621;585;1587;5526;13979;6111;15566
251392;202207;1190;2971;1003;2682;39;104;784;2080;823;2184
251394;202207;773;2015;622;1755;61;176;419;1139;480;1315
251396;202207;806;2025;679;1803;29;83;467;1182;496;1265
251398;202207;1172;2819;827;2211;24;85;609;1548;633;1633
251400;202207;1645;3352;1310;2911;23;87;1096;2302;1119;2389
251410;202207;1865;3873;1487;3335;12;41;1276;2736;1288;2777
251420;202207;2339;5493;1920;5011;48;166;1531;3890;1579;4056
251430;202207;1744;4814;1567;4509;45;161;1347;3812;1392;3973
251440;202207;1232;3147;996;2730;57;138;746;2074;803;2212
251445;202207;1904;4701;1745;4490;30;118;1510;3766;1540;3884
251450;202207;5194;13738;4609;12855;69;279;3949;10866;4018;11145
251455;202207;1001;2754;903;2581;21;84;725;2016;746;2100
251460;202207;1114;2825;907;2501;57;181;691;1865;748;2046
251465;202207;538;1431;454;1279;12;51;343;922;355;973
251470;202207;1355;3499;1005;2803;126;380;523;1338;649;1718
251480;202207;1165;2808;903;2360;18;67;682;1683;700;1750
251490;202207;2293;5460;1858;4876;100;266;1401;3643;1501;3909
251500;202207;2379;5882;2159;5588;54;170;1840;4665;1894;4835
251510;202207;3050;8455;2530;7440;104;374;1774;4988;1878;5362
251520;202207;1204;2872;911;2373;100;193;559;1451;659;1644
251530;202207;17665;37423;14427;33460;156;721;12875;29028;13031;29749
251540;202207;3486;9075;3113;8432;65;263;2589;6782;2654;7045
251550;202207;4912;9776;4001;8690;131;229;3340;7246;3471;7475
251560;202207;639;1826;568;1725;41;160;412;1190;453;1350
251570;202207;1083;2831;894;2463;20;99;706;1866;726;1965
251580;202207;2412;5111;2143;4719;34;116;1854;3888;1888;4004
251590;202207;1915;4144;1624;3799;51;125;1400;3161;1451;3286
251593;202207;1100;3004;976;2790;88;289;667;1841;755;2130
251597;202207;2526;6134;2271;5797;15;69;2080;5222;2095;5291
251600;202207;7296;18246;6317;16764;258;704;5155;13489;5413;14193
251610;202207;3704;9529;3232;8712;251;656;2350;6253;2601;6909
251615;202207;1586;3442;1258;2966;19;65;1048;2368;1067;2433
251620;202207;23619;47084;18451;40858;174;417;16162;35626;16336;36043
251630;202207;5983;12319;4841;10744;260;555;3786;8085;4046;8640
251640;202207;2553;6252;2265;5834;21;98;2047;5163;2068;5261
251650;202207;5030;11319;4347;10446;156;356;3691;8762;3847;9118
251660;202207;4092;11055;3595;10209;63;280;3008;8331;3071;8611
251670;202207;5138;12190;4544;11403;68;244;4117;10155;4185;10399
251675;202207;992;2173;897;2055;60;132;745;1688;805;1820
251680;202207;3118;7208;2618;6562;98;181;2168;5465;2266;5646
251690;202207;3690;9546;3133;8614;110;333;2390;6499;2500;6832
251700;202207;2580;6575;2128;5950;40;163;1757;4741;1797;4904
251710;202207;919;2183;662;1699;46;125;401;952;447;1077
251720;202207;1519;3934;1211;3418;22;94;947;2567;969;2661
251740;202207;739;1903;586;1636;29;96;433;1158;462;1254
260005;202207;35219;69188;29384;61898;1680;3669;23406;47647;25086;51316
260010;202207;12005;28854;9885;25532;617;1720;6141;15476;6758;17196
260020;202207;8127;16605;6707;14646;79;333;5764;12175;5843;12508
260030;202207;8621;18820;7316;17010;90;330;6289;14180;6379;14510
260040;202207;8694;20099;7318;18234;500;1288;5420;13452;5920;14740
260050;202207;15923;37144;13485;34423;226;708;12507;31836;12733;32544
260060;202207;4952;10783;4230;9692;375;673;3171;7466;3546;8139
260070;202207;13540;28858;11721;26339;232;850;10033;21596;10265;22446
260080;202207;8006;15760;6961;14450;135;347;6000;12085;6135;12432
260090;202207;6167;13819;5460;12901;318;755;4389;10304;4707;11059
260100;202207;3553;8385;3004;7620;48;221;2601;6431;2649;6652
260105;202207;5716;14220;5115;13416;112;449;4334;11061;4446;11510
260110;202207;25541;65473;22622;61270;1025;3236;18554;49240;19579;52476
260120;202207;17655;41286;14981;37533;1651;3802;10286;25838;11937;29640
260130;202207;3908;8564;3368;7836;118;283;2677;6029;2795;6312
260140;202207;15517;30766;13466;28378;326;858;11872;24372;12198;25230
260150;202207;4435;8800;3873;8121;112;230;3480;7234;3592;7464
260160;202207;8277;17609;7102;16198;88;257;6574;14909;6662;15166
260170;202207;25716;53385;22093;48665;1075;2432;18132;39109;19207;41541
260180;202207;4030;9714;3428;8885;84;293;2936;7456;3020;7749
260190;202207;24449;41782;20987;37818;147;385;19302;33886;19449;34271
260200;202207;12983;28116;11200;25849;501;982;9710;22438;10211;23420
260210;202207;12875;33352;10786;30071;353;1174;8634;23825;8987;24999
260220;202207;14420;27796;13383;26549;483;756;11829;23293;12312;24049
260230;202207;14641;29145;12793;26828;339;687;10808;22434;11147;23121
260240;202207;3199;8693;2766;7891;80;330;2181;6042;2261;6372
260250;202207;2727;6196;2336;5621;98;244;1894;4435;1992;4679
260260;202207;15992;36533;14239;34047;933;2158;11050;26467;11983;28625
260270;202207;5604;11176;4959;10448;85;298;4408;9027;4493;9325
260280;202207;14716;38884;13313;36912;349;1477;11720;31639;12069;33116
260290;202207;48752;112514;41949;103161;3741;9465;30072;72580;33813;82045
260300;202207;11912;27692;10242;25363;278;883;8692;21139;8970;22022
260310;202207;7377;15539;6613;14604;429;718;5395;12071;5824;12789
260320;202207;8710;23266;7345;21065;165;616;6088;17268;6253;17884
260330;202207;2862;8080;2465;7283;69;247;1975;5662;2044;5909
260340;202207;2482;5870;2146;5389;26;109;1899;4620;1925;4729
260345;202207;32632;75109;27627;68229;2956;7903;17759;41775;20715;49678
260350;202207;7264;13979;6327;12943;34;112;5873;11788;5907;11900
260360;202207;2864;6797;2515;6168;108;300;1761;4191;1869;4491
260370;202207;6390;16280;5441;14716;181;632;4321;11249;4502;11881
260380;202207;5821;15420;4952;14028;201;593;3832;10733;4033;11326
260390;202207;5348;14848;4336;12868;208;616;2911;8459;3119;9075
260392;202207;4440;11634;4008;11091;63;374;3494;9503;3557;9877
260400;202207;24967;49193;21775;45100;384;1089;18407;36026;18791;37115
260410;202207;92409;204281;74092;179437;13492;33948;36526;88874;50018;122822
260415;202207;5363;12192;4638;11115;43;176;4022;9326;4065;9502
260420;202207;15568;27770;13403;25409;66;216;12748;23814;12814;24030
260430;202207;3109;9042;2617;8100;187;600;1739;5319;1926;5919
260440;202207;4984;10511;4431;9794;41;150;4020;8695;4061;8845
260450;202207;6484;14943;5771;14017;291;593;4880;11933;5171;12526
260460;202207;6416;16592;5477;15048;458;1400;3682;9742;4140;11142
260470;202207;5761;13047;4818;11982;84;233;4378;10993;4462;11226
260480;202207;4525;10665;3809;9684;313;834;2723;6908;3036;7742
260490;202207;6512;12949;5726;11893;32;121;5268;10709;5300;10830
260500;202207;7067;16098;6058;14689;436;997;4389;10608;4825;11605
260510;202207;12612;26431;10733;23870;114;398;9659;20948;9773;21346
260515;202207;5171;12448;4078;10515;127;401;2989;7222;3116;7623
260520;202207;18774;40223;16295;37105;928;2070;13207;29635;14135;31705
260530;202207;11355;28959;9676;26483;118;571;8516;22808;8634;23379
260540;202207;9230;17061;8259;15884;98;257;7662;14448;7760;14705
260545;202207;118;325;77;237;11;44;27;70;38;114
260550;202207;3666;9102;2958;7956;191;629;2015;5093;2206;5722
260560;202207;6811;15837;5677;14177;137;476;4845;11789;4982;12265
260570;202207;10088;22416;8909;20906;228;664;7817;17927;8045;18591
260580;202207;5795;11560;5241;10851;25;78;4879;9966;4904;10044
260590;202207;9225;16721;7955;15341;103;238;7260;13749;7363;13987
260600;202207;39700;90396;32995;80649;1110;3251;26406;62055;27516;65306
260610;202207;8799;20906;7717;19479;411;1091;5818;14492;6229;15583
260620;202207;23654;50886;20988;47371;1173;3300;16780;36048;17953;39348
260630;202207;2738;6766;2235;5989;58;172;1840;4819;1898;4991
260640;202207;29330;56303;25115;51532;831;1769;21573;43364;22404;45133
260650;202207;7302;16886;5828;15063;483;909;4753;12467;5236;13376
260660;202207;8700;19242;7617;17893;321;859;6736;15530;7057;16389
260670;202207;2646;6294;2150;5522;74;200;1632;4017;1706;4217
260680;202207;35623;76523;30182;69156;2044;4948;22272;49250;24316;54198
260690;202207;3976;9534;3286;8489;82;291;2593;6551;2675;6842
260700;202207;8412;18310;7838;17684;33;156;7629;17138;7662;17294
260710;202207;1587;3773;1339;3413;62;201;1062;2652;1124;2853
260720;202207;33161;69861;28505;64227;1879;4346;22387;49827;24266;54173
260730;202207;9307;23997;8049;22260;199;765;6959;18840;7158;19605
260740;202207;1514;3930;1239;3494;21;81;995;2813;1016;2894
260750;202207;9367;20924;7364;18514;171;376;6440;16616;6611;16992
260760;202207;7584;15363;6616;14248;117;335;5895;12488;6012;12823
260765;202207;10277;25491;9037;23832;606;1841;6606;16905;7212;18746
260770;202207;4500;10419;3680;9114;96;303;2983;7190;3079;7493
260775;202207;6744;15641;5921;14448;158;552;4857;11262;5015;11814
260780;202207;4409;11651;3910;10865;355;1215;2549;6600;2904;7815
260790;202207;157896;318216;133197;287450;16654;35405;91979;194743;108633;230148
260795;202207;4108;8310;3591;7670;123;292;3119;6535;3242;6827
260800;202207;7212;13780;6526;12883;216;401;5780;11152;5996;11553
260805;202207;4365;10675;3729;9646;157;515;2954;7336;3111;7851
260810;202207;8070;18987;7076;17237;304;799;5682;13262;5986;14061
260820;202207;5400;11026;4797;10348;79;250;4140;8817;4219;9067
260825;202207;3431;9222;3001;8502;108;345;2329;6481;2437;6826
260830;202207;5135;13253;4281;11829;467;1077;2884;8139;3351;9216
260840;202207;5508;11703;4953;10977;280;534;4241;9342;4521;9876
260845;202207;5205;12416;4599;11456;207;604;3600;8634;3807;9238
260850;202207;5883;14393;4931;12690;362;1004;3337;8111;3699;9115
260860;202207;3977;10322;3395;9315;121;383;2740;7302;2861;7685
260870;202207;5356;11140;4591;10214;151;319;4026;8950;4177;9269
260875;202207;9795;20167;8096;17793;663;1354;5822;12812;6485;14166
260880;202207;12051;29520;10523;27118;254;827;8937;22457;9191;23284
260890;202207;15807;35769;13665;32671;927;2292;9656;22649;10583;24941
260900;202207;6602;16637;5468;15057;451;1258;3648;9955;4099;11213
260910;202207;3954;9311;3452;8586;119;324;2760;6738;2879;7062
260915;202207;6265;14995;5589;14201;42;182;5248;13207;5290;13389
260920;202207;4029;8324;3441;7700;81;166;3055;6809;3136;6975
260930;202207;4777;12667;4089;11507;166;624;3244;8763;3410;9387
260940;202207;17708;37565;15409;34459;1070;2515;11871;25755;12941;28270
260950;202207;8708;20604;7052;17963;332;1090;4900;11567;5232;12657
260960;202207;98321;190030;81994;170034;7107;14882;59804;119560;66911;134442
260970;202207;6660;15630;5871;14568;404;766;4427;11157;4831;11923
260980;202207;5395;13910;4675;13009;63;173;4237;11843;4300;12016
260990;202207;20372;50835;17172;46503;742;2338;13626;36117;14368;38455
261000;202207;20114;41208;16984;37356;526;1358;14058;29946;14584;31304
261010;202207;2601;6107;2240;5627;110;264;1883;4727;1993;4991
261020;202207;7993;18368;6971;16722;322;816;5736;13322;6058;14138
261030;202207;4732;12459;4149;11485;123;464;3324;8852;3447;9316
261040;202207;6256;16204;5114;14210;165;624;4019;10729;4184;11353
261050;202207;9365;21361;8471;20100;232;524;7124;16662;7356;17186
261060;202207;17286;38417;15039;35778;357;986;12700;29581;13057;30567
261070;202207;82707;165863;69231;148544;6089;12630;50502;106123;56591;118753
261080;202207;8174;17323;7384;16370;129;246;6897;15227;7026;15473
261090;202207;23707;49061;21065;45671;506;1223;18582;39439;19088;40662
261100;202207;10112;24623;8792;22764;634;1590;6618;16979;7252;18569
261110;202207;84541;212940;71387;189992;8690;24850;44648;115107;53338;139957
261120;202207;4502;9750;3909;8951;120;257;3371;7583;3491;7840
261130;202207;8794;18837;7725;17440;129;326;6852;15178;6981;15504
261140;202207;4502;9177;3994;8517;266;544;3117;6546;3383;7090
261150;202207;6660;14700;5875;13606;205;431;5008;11480;5213;11911
261153;202207;2187;6046;1809;5344;70;215;1252;3677;1322;3892
261160;202207;282274;588281;233629;524275;54331;121276;109837;249617;164168;370893
261170;202207;8888;17758;7779;16334;256;493;6778;13877;7034;14370
261180;202207;10994;24778;9603;23027;489;1095;7346;17501;7835;18596
261190;202207;5701;14120;5093;13193;144;637;4254;10560;4398;11197
261200;202207;4086;8249;3566;7587;104;274;3059;6294;3163;6568
261210;202207;2218;4878;1891;4426;108;193;1568;3654;1676;3847
261220;202207;17344;42215;14786;37981;1395;3751;10127;24999;11522;28750
261230;202207;4562;11773;3777;10753;51;198;3177;9049;3228;9247
261240;202207;7047;14639;6242;13485;253;535;5317;11304;5570;11839
261245;202207;4419;11005;3614;9656;70;315;2949;7509;3019;7824
261247;202207;3616;9636;2984;8535;343;924;1878;5446;2221;6370
261250;202207;31920;62840;28250;58671;3894;7554;20651;43662;24545;51216
261255;202207;4701;12578;3813;10919;158;588;2911;8068;3069;8656
261260;202207;18141;37618;16113;35092;262;1004;14946;31639;15208;32643
261270;202207;6001;11891;5290;11058;168;359;4682;9568;4850;9927
261280;202207;2924;7400;2529;6783;105;333;2002;5190;2107;5523
261290;202207;3395;7830;2813;7178;86;280;2335;5950;2421;6230
261300;202207;16290;37896;13941;34285;352;1302;11454;26812;11806;28114
261310;202207;11732;25521;10147;23439;774;1838;7693;17317;8467;19155
261320;202207;7129;18005;6152;16481;70;296;5265;13797;5335;14093
261330;202207;7671;15423;6958;14528;235;511;6106;12553;6341;13064
261340;202207;6056;13534;5360;12676;133;395;4759;11025;4892;11420
261350;202207;9806;26805;8541;24685;207;652;6797;19426;7004;20078
261360;202207;10223;21192;8670;19055;349;819;7082;15036;7431;15855
261370;202207;28467;64794;24113;59117;2155;5293;16958;40986;19113;46279
261380;202207;5055;12830;4311;11620;437;1182;2978;7992;3415;9174
261390;202207;19785;51337;16581;46419;1160;3712;11511;31348;12671;35060
261400;202207;5652;15120;4933;13744;263;838;3791;10134;4054;10972
261410;202207;11524;25466;9528;22532;334;982;7929;18018;8263;19000
261420;202207;9191;23771;8264;22698;543;1907;6523;17452;7066;19359
261430;202207;4867;10674;4219;9735;52;226;3771;8385;3823;8611
261440;202207;1621;4497;1323;3935;54;241;951;2689;1005;2930
261450;202207;17168;41252;15114;38249;618;1504;11982;30313;12600;31817
261460;202207;9120;21986;7850;20073;221;681;6506;16316;6727;16997
261470;202207;4546;10457;3903;9569;48;204;3334;8031;3382;8235
261480;202207;6482;17099;5551;15586;274;946;4398;11971;4672;12917
261485;202207;6179;15621;5414;14511;390;1209;4061;10600;4451;11809
261500;202207;7859;17505;6838;16162;663;1270;4716;11629;5379;12899
261510;202207;2108;5742;1816;5273;73;268;1411;4050;1484;4318
261520;202207;2724;7458;2430;6894;106;326;1803;5004;1909;5330
261530;202207;14621;37544;11952;33060;704;2607;7470;18849;8174;21456
261540;202207;11188;27897;10224;26590;2321;5428;5286;15144;7607;20572
261550;202207;4374;10361;3825;9536;208;622;2897;6909;3105;7531
261560;202207;11088;25857;9758;23995;389;1079;8042;19399;8431;20478
261570;202207;4124;10235;3235;8785;214;652;2244;5897;2458;6549
261580;202207;8012;18868;6962;17465;79;361;6385;15782;6464;16143
261590;202207;3262;7310;2653;6455;87;272;2110;4948;2197;5220
261600;202207;7018;14358;6030;13014;219;487;4965;10339;5184;10826
261610;202207;2522;6803;2016;5882;196;583;1279;3748;1475;4331
261618;202207;3303;6660;2924;6142;86;262;2524;5060;2610;5322
261620;202207;5393;13225;4937;12570;698;1579;3430;9165;4128;10744
261630;202207;6926;18307;5889;16368;454;1412;3859;10188;4313;11600
261640;202207;46310;91030;39667;83144;2052;3497;31657;66910;33709;70407
261650;202207;5281;10877;4502;9939;270;531;3562;7829;3832;8360
270010;202207;4922;15122;4229;13966;165;831;3383;10848;3548;11679
270020;202207;4878;10406;4251;9647;117;447;3743;8072;3860;8519
270030;202207;37932;98059;31756;88446;2453;7182;23464;64455;25917;71637
270040;202207;12268;29234;10462;27103;692;1878;8415;21674;9107;23552
270050;202207;6058;13158;5125;12116;185;421;4605;10879;4790;11300
270060;202207;2576;6122;2193;5670;158;410;1729;4424;1887;4834
270070;202207;5889;13861;5142;12844;100;413;4512;10838;4612;11251
270080;202207;1675;4153;1398;3715;81;202;1067;2781;1148;2983
270090;202207;2035;5625;1847;5285;43;182;1592;4439;1635;4621
270100;202207;7882;15721;6900;14413;166;412;6130;12461;6296;12873
270110;202207;3810;8192;3085;7354;195;347;2463;6109;2658;6456
270120;202207;2883;7402;2507;6904;74;271;2078;5580;2152;5851
270130;202207;5758;13632;4940;12654;164;529;4212;10647;4376;11176
270135;202207;2269;5025;1920;4646;27;125;1771;4222;1798;4347
270140;202207;10424;23417;8335;20578;325;1029;6506;15233;6831;16262
270150;202207;3287;8354;3011;7982;14;69;2868;7549;2882;7618
270160;202207;6210;16135;5321;15059;151;537;4796;13468;4947;14005
270170;202207;3680;10055;3095;9232;195;859;2264;6408;2459;7267
270180;202207;2590;7317;2352;7016;41;219;2095;6119;2136;6338
270190;202207;2618;5620;2380;5347;17;77;2244;4957;2261;5034
270200;202207;2995;8134;2601;7571;290;748;1805;5355;2095;6103
270210;202207;6654;14137;5671;13021;66;239;5257;11885;5323;12124
270220;202207;1947;4487;1576;3965;122;351;1159;2776;1281;3127
270230;202207;11200;28113;9365;25392;845;2401;6890;18391;7735;20792
270235;202207;6820;19471;5948;18111;220;772;4929;14833;5149;15605
270240;202207;13927;33396;11646;30368;967;2613;8838;22857;9805;25470
270250;202207;3545;7648;3161;7126;149;331;2753;6122;2902;6453
270255;202207;5093;13438;4058;11663;132;502;3178;8863;3310;9365
270260;202207;5979;17081;5396;16118;92;484;4696;13749;4788;14233
270270;202207;1181;2817;975;2569;119;280;718;1901;837;2181
270280;202207;4463;9711;3576;8636;267;562;2655;6602;2922;7164
270290;202207;9062;26068;8169;24701;149;733;7291;21732;7440;22465
270300;202207;4771;11419;3709;10253;174;414;2961;8315;3135;8729
270310;202207;7960;20392;6807;18700;147;560;5867;15833;6014;16393
270320;202207;6189;17095;5281;15418;238;847;3988;11152;4226;11999
270330;202207;4962;14039;4375;13185;195;875;3648;10762;3843;11637
270340;202207;1921;4593;1625;4193;84;156;1372;3545;1456;3701
270350;202207;2144;4548;1740;4084;116;276;1314;3074;1430;3350
270360;202207;3608;7377;3257;6984;44;133;3121;6626;3165;6759
270370;202207;1570;4474;1422;4214;33;164;1219;3555;1252;3719
270375;202207;4110;8108;3533;7477;13;43;3399;7149;3412;7192
270380;202207;6568;15769;5591;14590;597;1403;4186;11158;4783;12561
270390;202207;1384;3167;1097;2832;13;68;930;2379;943;2447
270400;202207;7685;18014;6444;16232;217;566;5198;12816;5415;13382
270410;202207;5434;14250;4725;13195;131;468;4032;11132;4163;11600
270420;202207;7333;18457;6651;17484;211;814;5842;14900;6053;15714
270430;202207;166230;363690;130518;318854;19228;48294;74408;180961;93636;229255
270440;202207;5323;13296;4633;12427;136;435;4075;10847;4211;11282
270450;202207;9275;21509;8233;20260;342;796;7016;17420;7358;18216
270460;202207;4432;8944;3775;8153;204;343;3351;7299;3555;7642
270470;202207;13282;33406;11555;31011;580;1781;9307;24665;9887;26446
270480;202207;3493;8282;2932;7507;155;481;2426;6034;2581;6515
270490;202207;1058;2670;917;2500;35;122;767;2040;802;2162
270500;202207;5686;15534;5062;14513;230;821;4152;11647;4382;12468
270510;202207;7189;16322;6039;14900;331;999;4833;11443;5164;12442
270520;202207;4681;12032;3741;10570;710;2079;1787;5074;2497;7153
270530;202207;1491;4010;1269;3661;63;161;888;2593;951;2754
270540;202207;2594;6491;2177;5958;70;251;1870;5040;1940;5291
270550;202207;7677;18082;6066;16303;553;1413;4558;12453;5111;13866
270560;202207;3397;7984;2822;7224;153;470;2234;5541;2387;6011
270570;202207;6060;13587;5271;12496;421;1032;4279;9895;4700;10927
270580;202207;2729;6849;2471;6501;119;318;2134;5579;2253;5897
270590;202207;1689;4785;1552;4600;15;78;1472;4343;1487;4421
270600;202207;3220;8912;2916;8459;61;239;2589;7420;2650;7659
270610;202207;4222;10100;3696;9418;79;221;3331;8384;3410;8605
270620;202207;1427;3928;1306;3720;27;106;1130;3123;1157;3229
270630;202207;20901;46073;18049;42241;758;2114;15408;35182;16166;37296
270640;202207;6285;16282;5397;14916;164;625;4543;12285;4707;12910
270642;202207;2905;8482;2557;7952;185;672;1942;5925;2127;6597
270644;202207;4498;10131;3754;9193;233;556;3044;7396;3277;7952
270650;202207;4111;10139;3592;9468;231;771;2992;7712;3223;8483
270660;202207;2243;5226;1928;4803;69;197;1532;3685;1601;3882
270670;202207;21675;43063;18418;39161;484;1151;16127;33342;16611;34493
270680;202207;7472;14196;6773;13434;478;568;6031;12361;6509;12929
270690;202207;11602;25893;9692;23471;313;889;8028;19017;8341;19906
270700;202207;633;1730;553;1605;62;184;381;1084;443;1268
270710;202207;6505;17683;5707;16475;347;1122;4517;12862;4864;13984
270720;202207;4417;11082;3935;10309;91;321;3516;9017;3607;9338
270730;202207;9493;18996;8221;17658;1027;1275;6224;14786;7251;16061
270740;202207;2546;6419;2230;6058;83;259;1869;5023;1952;5282
270750;202207;6523;15456;5732;14467;103;396;5122;12717;5225;13113
270760;202207;3813;9704;3203;8877;56;250;2712;7391;2768;7641
270770;202207;25866;59510;21018;53474;3227;7844;13161;34068;16388;41912
270780;202207;2260;5221;2079;4988;48;161;1897;4468;1945;4629
270790;202207;1988;4784;1683;4380;143;361;1313;3395;1456;3756
270800;202207;13626;32089;12300;30267;517;1360;10422;25371;10939;26731
270810;202207;3903;9799;3096;8577;177;603;2314;6208;2491;6811
270820;202207;1847;5115;1571;4686;52;226;1276;3743;1328;3969
270830;202207;6074;13360;4960;12027;164;543;4128;9738;4292;10281
270840;202207;9572;26243;8349;24421;238;1055;7094;20112;7332;21167
270850;202207;10161;21725;8950;20337;499;1376;7792;17349;8291;18725
270860;202207;16768;34324;13424;30576;645;1522;11006;24634;11651;26156
270870;202207;2597;6816;2110;6015;213;569;1399;4022;1612;4591
270880;202207;8939;24937;7969;23472;209;892;6644;19064;6853;19956
270890;202207;3862;9630;3271;8800;370;966;2063;5539;2433;6505
270895;202207;4414;10710;3968;10155;70;330;3598;8950;3668;9280
270900;202207;1934;4578;1474;3859;21;72;1191;3035;1212;3107
270910;202207;4721;12466;4079;11523;141;412;3448;9615;3589;10027
270915;202207;10929;28355;8852;25109;735;2481;6164;16795;6899;19276
270920;202207;7054;17914;6240;16799;79;410;5506;14425;5585;14835
270930;202207;20769;43738;16273;38595;1944;3919;11507;28587;13451;32506
270940;202207;7144;17436;5983;16089;189;832;4877;12643;5066;13475
280010;202207;693;1854;538;1539;21;88;385;1002;406;1090
280020;202207;5991;13475;5058;12066;338;843;3885;8965;4223;9808
280030;202207;105338;218249;87024;193377;14100;31250;50480;110691;64580;141941
280040;202207;3570;8573;3116;7934;208;623;2347;5734;2555;6357
280050;202207;4837;12678;4053;11445;819;2320;2092;5888;2911;8208
280060;202207;8135;18515;6590;16298;982;2622;3903;9487;4885;12109
280067;202207;8448;18166;7210;16327;499;900;5344;11975;5843;12875
280070;202207;2012;5702;1848;5450;126;413;1505;4374;1631;4787
280100;202207;4933;11451;4166;10299;499;1109;2710;6902;3209;8011
280110;202207;1862;4034;1599;3666;21;69;1470;3288;1491;3357
280120;202207;9088;22885;8041;21266;948;2281;5805;15547;6753;17828
280130;202207;10401;22115;9051;20292;539;1264;7274;16099;7813;17363
280140;202207;7136;14405;6321;13306;602;1048;4839;10393;5441;11441
280150;202207;4680;10904;4048;10030;501;1093;2900;7219;3401;8312
280160;202207;1507;3756;1281;3402;139;399;887;2247;1026;2646
280170;202207;6472;14416;5809;13593;210;557;4941;11335;5151;11892
280190;202207;1755;3223;1572;2990;47;114;1415;2618;1462;2732
280200;202207;1460;3564;1201;3199;81;240;883;2274;964;2514
280210;202207;20448;44959;17782;41279;1879;4374;12085;27368;13964;31742
280220;202207;1962;4712;1664;4325;88;225;1334;3471;1422;3696
280230;202207;4914;11379;3995;10013;274;568;2761;6914;3035;7482
280240;202207;3789;9173;3347;8528;40;197;2920;7206;2960;7403
280250;202207;1120;2323;945;2076;56;146;738;1545;794;1691
280260;202207;2812;5736;2482;5332;42;106;2291;4882;2333;4988
280270;202207;2789;6893;2444;6397;140;421;2063;5286;2203;5707
280280;202207;4496;12383;3980;11633;520;1272;2782;8419;3302;9691
280290;202207;24374;54925;21059;50403;1818;4411;14155;33966;15973;38377
280300;202207;15390;30771;13454;28693;1550;2025;9997;23193;11547;25218
280310;202207;1571;3774;1309;3362;41;128;1021;2530;1062;2658
280320;202207;10384;24979;8966;22898;997;2495;6257;15643;7254;18138
280330;202207;5354;12172;4456;10917;325;734;3291;7959;3616;8693
280340;202207;6196;11896;5178;10769;246;370;4504;9466;4750;9836
280350;202207;34993;68634;30993;63455;958;2395;26461;52203;27419;54598
280360;202207;6504;16729;5682;15478;649;1882;3593;9661;4242;11543
280370;202207;2729;5763;2196;4896;123;217;1702;3732;1825;3949
280380;202207;1201;2870;1010;2618;84;169;712;1884;796;2053
280390;202207;4758;9827;4030;8752;217;420;3321;7093;3538;7513
280400;202207;4844;10491;4229;9709;490;972;3052;7085;3542;8057
280410;202207;3162;7691;2655;6920;238;643;1732;4313;1970;4956
280420;202207;5067;11919;4578;11314;89;252;4203;10312;4292;10564
280430;202207;2699;5634;2387;5234;65;174;2063;4366;2128;4540
280440;202207;5032;11904;4439;11037;167;530;3799;9143;3966;9673
280445;202207;2608;6296;2330;5847;47;160;1853;4449;1900;4609
280450;202207;11420;25799;9892;23733;2311;5492;4854;12004;7165;17496
280460;202207;8379;17552;7596;16519;392;827;6523;13964;6915;14791
280470;202207;1935;4962;1621;4386;112;321;1180;3090;1292;3411
280480;202207;56608;120786;49190;110748;4597;10869;35321;76880;39918;87749
280490;202207;4107;11052;3444;9922;138;562;2593;7117;2731;7679
280500;202207;1259;2589;1044;2323;24;72;874;1921;898;1993
280510;202207;3727;7101;3258;6491;75;182;2862;5492;2937;5674
280520;202207;2169;4622;1887;4240;141;261;1465;3253;1606;3514
280530;202207;2675;6287;2328;5821;134;330;1838;4559;1972;4889
280540;202207;9780;24263;8794;22883;363;1007;7559;19474;7922;20481
280550;202207;7865;16458;6563;14647;128;458;5593;11934;5721;12392
280560;202207;8776;21165;8204;20349;122;422;7405;18007;7527;18429
280570;202207;7743;16587;6326;14881;312;748;4889;11329;5201;12077
280580;202207;6880;15619;6044;14461;493;1029;4744;11272;5237;12301
280590;202207;3231;6932;2738;6357;145;414;2106;4643;2251;5057
280600;202207;4710;10665;4151;9871;176;418;3188;7436;3364;7854
280610;202207;3246;6713;2888;6262;119;290;2484;5207;2603;5497
280620;202207;7076;14906;6059;13627;529;870;4391;10310;4920;11180
280630;202207;4591;11101;4203;10595;243;601;3398;8589;3641;9190
280640;202207;2867;6563;2502;6153;154;305;2156;5390;2310;5695
280650;202207;1392;3399;1153;3049;111;304;816;2077;927;2381
280660;202207;4356;8556;3772;7890;156;264;3280;6841;3436;7105
280670;202207;23542;49876;20319;45752;2317;5055;14332;32128;16649;37183
280680;202207;3407;7314;2933;6645;318;563;1963;4644;2281;5207
280690;202207;1185;2529;998;2292;57;137;825;1840;882;1977
280700;202207;1379;2999;1171;2705;36;94;954;2142;990;2236
280710;202207;17843;35950;15135;32891;1152;1722;12665;28141;13817;29863
280720;202207;3043;6252;2492;5613;71;165;1979;4509;2050;4674
280730;202207;1199;2873;1021;2599;90;233;720;1757;810;1990
280740;202207;19909;38730;17254;34984;957;2125;13882;26971;14839;29096
280750;202207;3964;10272;3413;9330;226;663;2463;6594;2689;7257
280760;202207;8173;18460;6999;16866;722;1534;4833;11804;5555;13338
290010;202207;3664;6959;2423;5116;13;41;2084;4195;2097;4236
290020;202207;7394;15205;6773;14458;565;857;5644;12361;6209;13218
290030;202207;5469;11079;4476;9992;270;485;3681;8396;3951;8881
290035;202207;6264;11894;5124;10456;307;504;3946;8230;4253;8734
290040;202207;6263;11656;5360;10596;429;570;4361;8906;4790;9476
290050;202207;2358;7040;1990;6296;126;427;1354;4178;1480;4605
290060;202207;1730;3527;1259;2879;166;374;863;1921;1029;2295
290070;202207;48186;93717;41643;85703;2462;4928;32994;66368;35456;71296
290080;202207;7109;17681;6223;16410;641;1657;4541;11942;5182;13599
290090;202207;2568;4400;1851;3630;15;45;1710;3306;1725;3351
290100;202207;11722;27248;9489;24071;1618;3768;5059;13417;6677;17185
290110;202207;6482;15102;5648;13825;689;1572;3628;8871;4317;10443
290115;202207;4598;12491;3907;11304;313;906;3040;8767;3353;9673
290120;202207;7423;16835;6181;15123;171;554;5205;12436;5376;12990
290130;202207;5292;11615;4114;10070;193;455;3081;7642;3274;8097
290135;202207;5253;11090;4275;9512;190;445;3423;7275;3613;7720
290140;202207;5204;12207;4022;10671;169;473;3321;8835;3490;9308
290150;202207;3574;7207;3097;6662;146;359;2588;5411;2734;5770
290160;202207;4157;8303;3687;7669;186;343;3128;6431;3314;6774
290170;202207;4250;9045;3773;8535;124;266;3406;7700;3530;7966
290180;202207;3514;8618;2920;7694;77;281;2468;6353;2545;6634
290190;202207;5797;12782;5163;11972;147;392;4359;10028;4506;10420
290195;202207;3050;6449;2407;5649;84;228;2052;4751;2136;4979
290200;202207;4743;12147;3738;10452;181;493;2768;7700;2949;8193
290205;202207;4104;9496;3618;8791;153;447;2927;6869;3080;7316
290210;202207;16880;38721;14926;35830;1538;2905;11329;27848;12867;30753
290220;202207;3736;7503;3288;6963;97;231;2861;5914;2958;6145
290225;202207;3808;6934;2937;6041;56;156;2696;5434;2752;5590
290230;202207;3574;7309;3287;6980;117;180;2835;6103;2952;6283
290240;202207;4892;10139;3961;9027;80;259;3466;7765;3546;8024
290250;202207;4634;11886;3774;10645;132;349;3104;8882;3236;9231
290260;202207;6370;13916;5390;12514;293;726;4497;10182;4790;10908
290265;202207;3884;10604;3138;9247;254;794;2126;6168;2380;6962
290270;202207;12379;38527;11367;36829;713;2598;8922;28753;9635;31351
290280;202207;7077;19727;6068;17754;442;1455;4238;12083;4680;13538
290290;202207;11263;30589;9019;26586;890;2829;5917;17096;6807;19925
290300;202207;4933;12074;3579;9612;209;627;2531;6561;2740;7188
290310;202207;2550;4644;2075;4101;22;75;1922;3705;1944;3780
290320;202207;32488;75814;26269;66808;4601;11377;14961;38439;19562;49816
290323;202207;4452;10946;3784;9896;103;284;2972;7740;3075;8024
290327;202207;4913;12708;4156;11337;395;982;2839;7687;3234;8669
290330;202207;2927;5054;2363;4454;25;41;2192;4137;2217;4178
290340;202207;7333;15726;5688;13793;549;1216;4362;10670;4911;11886
290350;202207;5386;14042;4463;12471;274;803;3194;8832;3468;9635
290360;202207;6364;13733;5576;12721;108;268;4946;11137;5054;11405
290370;202207;5683;12776;4146;10760;151;428;3009;7717;3160;8145
290380;202207;6763;15395;5621;13885;143;313;4860;11995;5003;12308
290390;202207;17839;45861;14683;40836;1422;3988;10103;27956;11525;31944
290395;202207;3456;8756;2738;7564;72;289;2132;5742;2204;6031
290400;202207;4428;10979;3536;9549;176;531;2669;7016;2845;7547
290405;202207;5207;13864;4397;12503;389;1118;2982;8578;3371;9696
290410;202207;6384;15894;4851;13540;170;650;3664;9932;3834;10582
290420;202207;3657;8965;2985;7945;101;288;2361;6226;2462;6514
290430;202207;4197;9409;3494;8381;156;498;2766;6279;2922;6777
290440;202207;3353;7588;2386;6084;167;367;1675;4327;1842;4694
290450;202207;4640;9549;3696;8242;111;274;3171;6816;3282;7090
290460;202207;14599;38206;12169;33807;2413;6790;5243;14431;7656;21221
290470;202207;5645;11775;4244;9905;435;1025;2730;6286;3165;7311
290475;202207;7615;19908;6342;17799;95;453;5314;14605;5409;15058
290480;202207;2144;4844;1753;4286;64;222;1329;3040;1393;3262
290485;202207;5302;14020;4624;13070;171;637;3820;10634;3991;11271
290490;202207;11044;22741;9987;21349;396;892;8355;17652;8751;18544
290500;202207;4800;13311;3724;11143;632;1990;1546;4465;2178;6455
290510;202207;4267;9156;3583;8292;82;223;3207;7345;3289;7568
290515;202207;4028;10326;3484;9561;37;109;3156;8740;3193;8849
290520;202207;14225;36474;11062;30560;599;1902;7295;19008;7894;20910
290530;202207;5555;14839;4655;13412;104;435;3925;11153;4029;11588
290540;202207;4463;10249;4042;9788;119;346;3630;8742;3749;9088
290550;202207;4906;11503;4257;10748;38;107;3890;9893;3928;10000
290560;202207;7348;17438;5630;14977;430;1392;3844;9708;4274;11100
290570;202207;55539;126314;49210;118481;2545;6598;40341;95317;42886;101915
290580;202207;10096;24981;8731;23097;927;2078;6330;17405;7257;19483
290590;202207;7825;22531;6504;20237;173;641;5307;16607;5480;17248
290600;202207;21474;55685;18517;50997;958;2699;14645;39997;15603;42696
290610;202207;2846;8252;2219;7024;109;375;1539;4816;1648;5191
290620;202207;6881;18496;5922;16943;373;971;4780;13723;5153;14694
290630;202207;11429;23878;9291;21215;717;1563;7263;16613;7980;18176
290640;202207;3203;7302;2461;6268;240;471;1679;4531;1919;5002
290650;202207;18260;38159;16435;36144;1243;2867;13846;30145;15089;33012
290660;202207;4355;10345;3477;8958;151;437;2551;6508;2702;6945
290670;202207;9539;20432;8276;18620;273;730;7117;15702;7390;16432
290680;202207;12807;31758;10556;28514;257;1059;8856;23399;9113;24458
290682;202207;6282;13439;5446;12361;415;623;4139;10074;4554;10697
290685;202207;4111;8505;2981;6929;514;1001;1572;3959;2086;4960
290687;202207;8664;19975;7163;17642;920;2098;4643;11625;5563;13723
290689;202207;3237;8280;2423;6855;269;821;1574;4427;1843;5248
290690;202207;6535;15428;5341;13784;302;850;4015;10138;4317;10988
290700;202207;3648;7663;3259;7193;49;163;2986;6446;3035;6609
290710;202207;10354;24830;8762;22683;255;773;7566;19407;7821;20180
290720;202207;23270;55212;20872;51658;1202;3027;16719;40414;17921;43441
290730;202207;8191;17672;6927;16193;397;743;5235;12470;5632;13213
290740;202207;1254;2950;959;2487;11;29;854;2177;865;2206
290750;202207;15291;32087;13176;28904;436;1155;10772;22349;11208;23504
290755;202207;2294;6059;1840;5271;122;332;1249;3583;1371;3915
290760;202207;4247;11518;3476;10146;234;585;2411;7180;2645;7765
290770;202207;3208;8477;2937;8153;107;231;2509;7094;2616;7325
290780;202207;9047;20950;7705;19165;332;678;5933;14961;6265;15639
290790;202207;5936;14352;5111;13185;269;653;4203;10899;4472;11552
290800;202207;8216;14914;5910;12289;349;563;4456;9393;4805;9956
290810;202207;6562;14641;5297;12857;219;480;4062;9988;4281;10468
290820;202207;6314;14461;5544;13347;397;791;3908;9430;4305;10221
290830;202207;4943;11108;4336;10192;76;261;3592;8006;3668;8267
290840;202207;20829;50026;17643;45212;1935;4174;12041;31968;13976;36142
290850;202207;10096;19044;8846;17707;518;761;7400;14885;7918;15646
290860;202207;7321;18262;6346;17143;320;790;5331;14668;5651;15458
290870;202207;5494;13858;4161;11399;306;797;2807;7592;3113;8389
290880;202207;1630;3644;1301;3229;192;435;743;1989;935;2424
290890;202207;11086;20114;9807;18700;399;606;8789;16806;9188;17412
290900;202207;2699;6657;2062;5564;160;423;1281;3391;1441;3814
290910;202207;5976;12839;4551;10743;52;136;3942;9186;3994;9322
290920;202207;6357;13793;5570;12856;209;275;4878;11794;5087;12069
290930;202207;8439;21929;6713;18967;260;955;5113;13973;5373;14928
290940;202207;4005;10531;3307;9486;163;566;2616;7392;2779;7958
290950;202207;1633;3799;1324;3351;110;283;886;2247;996;2530
290960;202207;6981;15615;6200;14670;286;594;5205;12260;5491;12854
290970;202207;3589;10102;2909;8848;120;418;2235;6728;2355;7146
290980;202207;15881;34181;13696;31010;793;1954;9643;20717;10436;22671
290990;202207;11145;26898;9850;24925;315;1141;8347;20285;8662;21426
291000;202207;3804;8923;2900;7811;135;374;2354;6396;2489;6770
291005;202207;19153;42555;16859;39713;822;2034;14182;32775;15004;34809
291010;202207;3429;9883;2722;8367;154;527;1774;5278;1928;5805
291020;202207;1480;3381;1198;2909;28;84;877;1984;905;2068
291030;202207;2919;6422;2114;5131;170;372;1357;3184;1527;3556
291040;202207;6103;15266;4972;13684;233;736;3878;10657;4111;11393
291050;202207;12502;25793;11009;23812;1257;2598;8106;17307;9363;19905
291060;202207;9822;22453;8641;20941;768;1752;6647;16026;7415;17778
291070;202207;20405;46951;17183;42012;405;1290;14629;34835;15034;36125
291072;202207;32551;72429;24735;60189;3434;8720;14124;32853;17558;41573
291075;202207;6253;14184;5595;13173;105;285;4665;10563;4770;10848
291077;202207;1907;4662;1476;3930;74;146;1015;2714;1089;2860
291080;202207;149651;326793;120739;288302;26880;61748;54746;132815;81626;194563
291085;202207;6299;14795;5091;12956;186;529;4194;10493;4380;11022
291090;202207;2512;4262;1861;3547;51;99;1594;2966;1645;3065
291100;202207;3887;7427;2741;6086;119;250;2165;4752;2284;5002
291110;202207;6789;18938;5676;17070;299;1137;4366;12718;4665;13855
291120;202207;9600;20341;8214;18639;371;920;6591;14741;6962;15661
291125;202207;2701;4300;2054;3582;67;105;1774;3049;1841;3154
291130;202207;3635;9579;2711;7842;72;325;2090;5775;2162;6100
291140;202207;5598;13631;4077;10998;596;1427;2457;6569;3053;7996
291150;202207;3189;5825;2512;5086;7;18;2389;4797;2396;4815
291160;202207;5817;14713;4804;13268;501;1417;3100;8406;3601;9823
291165;202207;2383;6192;1724;4928;30;130;1201;3293;1231;3423
291170;202207;25365;58784;21170;52037;1420;3533;14095;33246;15515;36779
291180;202207;8828;16376;6858;13849;200;470;6014;11816;6214;12286
291185;202207;3993;8885;3545;8225;197;446;2807;6453;3004;6899
291190;202207;8637;19473;7115;17580;208;598;5765;14227;5973;14825
291200;202207;3144;8026;2308;6477;82;305;1531;4024;1613;4329
291210;202207;8699;16399;6444;13840;375;689;4913;10579;5288;11268
291220;202207;5510;13311;4916;12467;385;950;3542;8847;3927;9797
291230;202207;5635;10272;4411;8941;83;127;4059;8218;4142;8345
291240;202207;4694;11258;3961;10061;77;239;3392;8459;3469;8698
291250;202207;3714;10250;2873;8749;201;596;1799;5520;2000;6116
291260;202207;1697;3579;1382;3178;42;101;1146;2633;1188;2734
291270;202207;6490;14759;5070;12806;452;1031;3667;9400;4119;10431
291280;202207;3317;7277;2462;6037;159;366;1721;4038;1880;4404
291290;202207;6451;15759;4895;13377;452;1293;3263;8723;3715;10016
291300;202207;4511;10978;3583;9484;139;406;2739;7058;2878;7464
291310;202207;5840;14368;4980;12891;136;410;4251;10810;4387;11220
291320;202207;7733;18843;6045;16002;1240;3088;3176;8671;4416;11759
291330;202207;2169;5081;1787;4455;67;186;1381;3334;1448;3520
291340;202207;4930;11573;3958;10012;208;441;2737;6875;2945;7316
291345;202207;3368;8854;3006;8326;147;444;2470;6822;2617;7266
291350;202207;8458;17981;6617;15755;120;307;5726;13542;5846;13849
291360;202207;49651;98222;39834;86848;4525;9421;26886;59425;31411;68846
291370;202207;9524;23479;8378;21762;573;1712;6378;15945;6951;17657
291380;202207;5133;10798;4584;10077;160;401;3990;8610;4150;9011
291390;202207;15310;29612;11737;25707;497;1055;9932;21493;10429;22548
291400;202207;19052;40282;16058;36001;1516;3176;11403;25628;12919;28804
291410;202207;3412;8302;2669;7067;56;178;2002;5169;2058;5347
291420;202207;2178;4865;1691;4263;27;101;1491;3709;1518;3810
291430;202207;3007;7764;2566;7032;92;346;2029;5364;2121;5710
291440;202207;7494;19402;6425;17738;444;1208;4780;13388;5224;14596
291450;202207;12501;24458;10326;21987;168;270;9368;20077;9536;20347
291460;202207;19440;45010;16950;41435;952;2521;13047;31007;13999;33528
291465;202207;10311;23274;8148;20803;232;848;7006;17589;7238;18437
291470;202207;23026;43948;19601;40073;1125;2118;15380;31452;16505;33570
291480;202207;55585;109458;42763;92717;4193;9214;26859;55825;31052;65039
291490;202207;7894;16294;7010;15314;238;507;6388;13884;6626;14391
291500;202207;6287;12793;5281;11525;120;297;4844;10545;4964;10842
291510;202207;5324;11158;4002;9490;57;229;3485;8083;3542;8312
291520;202207;5284;10960;4035;9375;320;706;3129;7234;3449;7940
291530;202207;2733;5658;1995;4728;219;495;1363;3284;1582;3779
291535;202207;4248;10925;3612;9828;175;461;2886;7887;3061;8348
291540;202207;2500;5090;1739;4177;67;179;1467;3478;1534;3657
291550;202207;7460;14440;5806;12429;518;967;4172;8882;4690;9849
291560;202207;20840;46222;15455;39260;2740;6596;8215;21476;10955;28072
291570;202207;2766;5718;2121;4984;177;281;1740;4246;1917;4527
291580;202207;7489;17275;5893;15209;299;891;4467;11155;4766;12046
291590;202207;2899;5883;2562;5497;80;205;2299;4849;2379;5054
291600;202207;6536;13630;5042;11445;443;1067;3465;7613;3908;8680
291610;202207;7834;16040;6989;15122;420;672;5761;12902;6181;13574
291620;202207;3541;7180;2692;6259;207;412;2042;4862;2249;5274
291630;202207;4158;7852;3179;6661;412;648;2369;5108;2781;5756
291640;202207;20425;43874;15760;37433;1667;3944;9265;21205;10932;25149
291650;202207;11909;24640;10559;23067;959;1361;8539;19443;9498;20804
291660;202207;2250;5187;1636;4262;111;384;1097;2656;1208;3040
291670;202207;2290;5635;1879;5041;198;471;1293;3544;1491;4015
291680;202207;4794;10550;3895;9315;422;987;2541;6166;2963;7153
291685;202207;5442;12357;4338;10846;189;397;3378;8456;3567;8853
291690;202207;5146;9592;3591;7502;196;379;3004;6130;3200;6509
291700;202207;10910;26920;9591;24794;328;1091;8157;20470;8485;21561
291710;202207;6358;13269;4856;11255;320;782;3665;8217;3985;8999
291720;202207;5012;14025;4129;12341;868;2604;2145;6428;3013;9032
291730;202207;8626;17432;7413;15889;391;801;6251;13316;6642;14117
291733;202207;3319;7707;2791;7022;120;235;2065;5409;2185;5644
291735;202207;3110;7953;2418;6750;73;183;1759;4889;1832;5072
291740;202207;4482;10877;3159;8450;113;242;2193;5809;2306;6051
291750;202207;25056;53335;20699;47017;2793;5520;13460;31161;16253;36681
291760;202207;12958;33282;10172;29063;3073;10034;2900;7899;5973;17933
291770;202207;8733;21159;7306;18753;334;1102;5638;13717;5972;14819
291780;202207;5866;14211;5253;13402;114;379;4562;11415;4676;11794
291790;202207;3536;8034;3219;7652;340;608;2439;5986;2779;6594
291800;202207;40221;87846;31837;76254;4134;10092;19302;44642;23436;54734
291810;202207;12541;26648;10634;24363;463;907;8847;20459;9310;21366
291820;202207;4518;10737;3926;9979;127;347;3192;8055;3319;8402
291830;202207;5479;11129;4465;9808;261;416;3551;7851;3812;8267
291835;202207;7498;20691;6009;18013;595;1791;4009;12127;4604;13918
291840;202207;56981;141424;49618;130474;4898;13551;35967;93358;40865;106909
291845;202207;3906;7735;3252;6951;207;360;2715;5922;2922;6282
291850;202207;5058;12491;4227;11196;134;331;3567;9459;3701;9790
291855;202207;2736;4588;2189;3990;26;53;2061;3731;2087;3784
291860;202207;2461;6151;1668;4647;39;117;1120;3020;1159;3137
291870;202207;1446;3411;976;2600;34;115;700;1812;734;1927
291875;202207;3327;9398;2842;8415;65;280;2108;5990;2173;6270
291880;202207;6352;16147;5464;14775;347;824;4083;11190;4430;12014
291890;202207;1954;3671;1297;2907;204;440;789;1755;993;2195
291900;202207;1554;3355;1189;2818;31;86;944;2151;975;2237
291905;202207;2704;6438;2211;5687;108;327;1692;4174;1800;4501
291910;202207;4177;8236;3600;7559;87;188;3215;6746;3302;6934
291915;202207;8456;21981;6840;19299;249;709;5101;14584;5350;15293
291920;202207;36985;83659;32041;77285;1811;5357;25299;58658;27110;64015
291930;202207;3124;7117;2662;6500;274;630;1956;4818;2230;5448
291940;202207;4380;10267;2940;7957;261;637;1749;4685;2010;5322
291950;202207;10608;30055;8827;26798;455;1440;5974;17963;6429;19403
291955;202207;20855;46688;18718;44011;1185;3008;15509;36031;16694;39039
291960;202207;4423;9090;3744;8226;312;486;2966;6734;3278;7220
291970;202207;5683;12229;4797;11156;153;430;3878;8799;4031;9229
291980;202207;11693;29959;9444;26308;851;2186;6476;18198;7327;20384
291990;202207;2690;6198;2233;5643;27;89;2059;5167;2086;5256
291992;202207;5011;10619;4182;9607;321;629;3323;7626;3644;8255
291995;202207;2601;6143;2136;5442;76;264;1737;4251;1813;4515
292000;202207;3060;6526;2519;5882;64;199;2108;4827;2172;5026
292010;202207;6720;14010;5464;12231;90;351;4665;10080;4755;10431
292020;202207;5484;13797;4624;12387;164;584;3741;9650;3905;10234
292030;202207;2403;6399;2086;5856;134;408;1365;3708;1499;4116
292040;202207;5469;12048;4343;10450;190;444;3536;8469;3726;8913
292045;202207;5201;10911;4058;9296;28;90;3773;8625;3801;8715
292050;202207;7470;19003;6044;16618;288;928;4084;10932;4372;11860
292060;202207;14590;29030;13513;27731;426;778;12110;24448;12536;25226
292070;202207;7255;15993;6340;14922;406;869;5405;12738;5811;13607
292080;202207;4311;8514;3590;7611;41;131;3346;7004;3387;7135
292090;202207;5096;10177;3619;8370;193;503;2882;6600;3075;7103
292100;202207;14987;32497;12814;29818;1977;4440;7802;18566;9779;23006
292105;202207;3923;9202;3396;8496;49;187;2867;7093;2916;7280
292110;202207;7547;15676;5442;12764;729;1818;3495;7916;4224;9734
292120;202207;8371;19185;6893;16777;645;1383;4887;11814;5532;13197
292130;202207;3972;8658;3257;7761;191;499;2463;5777;2654;6276
292140;202207;6748;13374;5731;11972;206;395;5035;10366;5241;10761
292145;202207;3011;7415;2513;6607;123;251;1953;5181;2076;5432
292150;202207;18047;41947;15534;38024;435;1204;13087;31289;13522;32493
292160;202207;3431;7477;2618;6461;36;109;2022;5327;2058;5436
292170;202207;10299;24811;8610;22159;449;1363;6630;16511;7079;17874
292180;202207;3348;8510;2499;6976;200;566;1561;4232;1761;4798
292190;202207;3434;8164;2883;7377;286;751;1970;5082;2256;5833
292200;202207;10908;24486;8227;20778;1589;4038;4112;10643;5701;14681
292205;202207;4438;11061;3827;10169;107;322;3289;8727;3396;9049
292210;202207;7898;15709;6516;14006;82;301;6038;12740;6120;13041
292220;202207;2633;5492;2257;4942;117;227;1753;3726;1870;3953
292225;202207;3662;9740;3187;9054;58;263;2796;7796;2854;8059
292230;202207;10129;22020;8945;20538;263;741;7577;16988;7840;17729
292240;202207;5656;14899;4898;13524;286;779;3552;9743;3838;10522
292250;202207;6964;16192;6196;15114;281;781;4931;11721;5212;12502
292260;202207;3752;9141;3304;8581;68;230;2907;7487;2975;7717
292265;202207;4245;10113;3486;8957;67;282;2940;7324;3007;7606
292270;202207;5537;10652;4484;9421;195;310;3716;7810;3911;8120
292273;202207;3337;6487;2643;5646;151;241;1897;4295;2048;4536
292275;202207;2120;4832;1725;4319;57;155;1401;3459;1458;3614
292280;202207;3193;6634;2543;5887;127;217;2128;5062;2255;5279
292285;202207;3005;6455;2373;5629;93;175;1943;4641;2036;4816
292290;202207;8733;20346;6943;17876;195;524;5789;14756;5984;15280
292300;202207;12225;27883;9626;24422;1199;3068;6236;15959;7435;19027
292303;202207;3707;8993;3200;8230;91;200;2782;7132;2873;7332
292305;202207;2614;6497;2375;6175;58;198;2114;5420;2172;5618
292310;202207;8228;18017;7104;16648;98;366;6322;14436;6420;14802
292320;202207;6650;16680;5268;14305;182;605;4046;10692;4228;11297
292330;202207;3518;6400;2911;5733;203;301;2292;4693;2495;4994
292335;202207;5766;13653;5091;12676;227;523;4294;10737;4521;11260
292340;202207;6142;16120;5007;14004;292;758;3552;9889;3844;10647
292350;202207;3088;7411;2584;6753;138;381;2117;5486;2255;5867
292360;202207;5740;13987;4764;12412;238;669;3504;8935;3742;9604
292370;202207;12803;26291;10994;23940;96;353;10350;22168;10446;22521
292380;202207;7931;20227;7048;18716;427;1166;5465;14275;5892;15441
292390;202207;5789;9495;4448;7980;70;125;4117;7286;4187;7411
292400;202207;26197;67446;22543;61954;2098;5756;15752;43261;17850;49017
292405;202207;5402;11676;4503;10324;137;332;3605;8292;3742;8624
292410;202207;2795;5549;2391;5056;112;192;2084;4435;2196;4627
292420;202207;5591;11537;5031;10783;75;247;4603;9558;4678;9805
292430;202207;5683;15564;4306;13055;330;1098;2892;8621;3222;9719
292440;202207;10254;28553;9371;27297;129;619;8431;24307;8560;24926
292450;202207;4698;12140;3570;10037;99;332;2778;7657;2877;7989
292460;202207;6991;15306;5881;13641;161;438;5021;11306;5182;11744
292465;202207;3028;7006;2549;6409;156;304;1665;4545;1821;4849
292467;202207;2413;5886;2134;5521;306;642;1471;4063;1777;4705
292470;202207;3316;7963;2495;6691;146;355;1773;4766;1919;5121
292480;202207;7734;15293;6355;13661;165;340;5746;12270;5911;12610
292490;202207;3196;6352;2686;5683;91;168;2176;4603;2267;4771
292500;202207;8382;19538;6681;16864;382;929;4833;11930;5215;12859
292510;202207;16278;38227;12755;32887;824;2232;9168;23287;9992;25519
292520;202207;8648;19717;7613;18219;356;993;6227;14537;6583;15530
292525;202207;7745;15675;6378;14125;118;275;5765;12744;5883;13019
292530;202207;38074;90811;30476;78917;5828;15810;15964;40417;21792;56227
292540;202207;5304;8712;4239;7592;119;193;3895;6971;4014;7164
292550;202207;9601;23350;7424;20746;581;1490;5225;15391;5806;16881
292560;202207;5176;11910;4323;10740;164;491;3301;7934;3465;8425
292570;202207;4372;10249;3648;9017;58;211;3107;7392;3165;7603
292575;202207;7881;20775;7177;19837;763;2015;5349;14981;6112;16996
292580;202207;9118;19974;7507;17687;272;511;6407;14940;6679;15451
292590;202207;8317;20600;6934;18170;332;1037;5603;14275;5935;15312
292593;202207;3303;7639;2632;6518;81;202;2191;5346;2272;5548
292595;202207;6480;15405;5588;14320;203;557;4782;12207;4985;12764
292600;202207;13330;31933;11475;29262;586;1387;9181;23375;9767;24762
292610;202207;5354;11941;4520;10599;166;362;3637;8401;3803;8763
292620;202207;8141;18608;6729;16921;132;315;6160;15547;6292;15862
292630;202207;10846;23304;8728;20066;897;2147;5934;13239;6831;15386
292640;202207;9307;24666;7812;22242;460;1336;5422;15467;5882;16803
292650;202207;4895;11332;4325;10584;60;203;3972;9579;4032;9782
292660;202207;12624;32195;10701;29361;660;1710;8009;22202;8669;23912
292665;202207;2350;6490;1980;5993;87;242;1575;4890;1662;5132
292670;202207;3963;10251;3073;8616;230;732;1994;5389;2224;6121
292680;202207;4622;11025;3653;9398;126;322;2818;7006;2944;7328
292690;202207;2928;7132;2015;5668;219;550;1242;3598;1461;4148
292700;202207;12071;29097;10460;26672;684;1552;7741;19732;8425;21284
292710;202207;3433;8469;3195;8177;55;162;2991;7624;3046;7786
292720;202207;10410;21989;8783;20128;467;913;6790;16024;7257;16937
292730;202207;6165;12411;5586;11580;435;668;4490;9537;4925;10205
292740;202207;430496;915786;379612;846877;42112;95575;267950;583228;310062;678803
292750;202207;7950;17674;6982;16392;224;576;5946;13825;6170;14401
292760;202207;4662;11898;4021;10817;196;595;3095;8143;3291;8738
292770;202207;8474;19202;6976;17179;856;2096;4942;12288;5798;14384
292780;202207;2465;4367;1826;3624;50;115;1534;2875;1584;2990
292790;202207;4466;8595;3364;7407;212;427;2744;6082;2956;6509
292800;202207;13021;30067;11070;27145;541;1373;9006;21744;9547;23117
292805;202207;4375;9169;3467;8044;136;336;2856;6510;2992;6846
292810;202207;15137;31133;12372;27055;588;1459;10137;21110;10725;22569
292820;202207;7996;20914;5831;17274;427;1439;4023;11654;4450;13093
292830;202207;3329;7200;2824;6611;109;237;2369;5598;2478;5835
292840;202207;11638;25010;9978;22823;181;525;9004;20141;9185;20666
292850;202207;2998;7076;2525;6433;227;556;1768;4452;1995;5008
292860;202207;21059;40620;19022;38248;471;1051;16855;33135;17326;34186
292870;202207;25421;54405;22008;49770;1474;3220;16049;35170;17523;38390
292880;202207;13187;33324;11128;30153;408;1418;8364;21669;8772;23087
292890;202207;9479;21941;8369;20406;163;551;7409;17684;7572;18235
292895;202207;4034;7366;3113;6042;234;368;2417;4721;2651;5089
292900;202207;3381;7773;3044;7306;48;192;2595;5993;2643;6185
292905;202207;5282;11998;4202;10405;121;356;3330;7979;3451;8335
292910;202207;6103;14406;5409;13496;173;445;4352;10576;4525;11021
292920;202207;11402;28251;10548;27139;271;972;9222;23210;9493;24182
292925;202207;6031;16023;4959;14019;361;929;3496;9834;3857;10763
292930;202207;7844;20660;6795;18812;863;2441;4033;10979;4896;13420
292935;202207;3130;6269;2509;5589;25;72;2287;5091;2312;5163
292937;202207;3242;7595;2769;7004;210;491;2035;5221;2245;5712
292940;202207;3497;7949;2772;6877;386;795;1781;4627;2167;5422
292950;202207;10747;25623;9345;23639;479;1189;7188;17852;7667;19041
292960;202207;6241;13650;5222;12254;187;365;4173;9741;4360;10106
292970;202207;4580;11572;4039;10816;105;323;3352;9045;3457;9368
292975;202207;5081;10081;4504;9435;125;284;4110;8554;4235;8838
292980;202207;4497;8887;3732;7835;58;179;3323;6787;3381;6966
292990;202207;13431;33733;11212;30063;406;1265;8820;22872;9226;24137
293000;202207;3200;6963;2719;6232;135;298;2106;4794;2241;5092
293010;202207;21637;49923;17514;43863;2002;5187;11505;28391;13507;33578
293015;202207;9880;27720;7735;23720;643;1980;5271;16325;5914;18305
293020;202207;11708;29756;10562;28159;166;583;9548;25329;9714;25912
293030;202207;5985;14488;4626;12422;300;632;3091;8636;3391;9268
293040;202207;5097;11798;4147;10500;108;305;3538;8891;3646;9196
293050;202207;28768;59931;25251;54923;1722;3512;19138;40843;20860;44355
293060;202207;4382;10570;3527;9018;249;642;2540;6277;2789;6919
293070;202207;34791;71893;30947;67171;2065;4566;24599;52278;26664;56844
293075;202207;4271;11728;3696;10814;80;388;3164;9184;3244;9572
293076;202207;4089;8926;3674;8447;93;177;3245;7545;3338;7722
293077;202207;7474;18538;6015;16315;789;2000;3537;10176;4326;12176
293080;202207;5347;14384;4485;12900;89;372;3674;10339;3763;10711
293090;202207;3573;9858;2751;8466;223;637;1882;5804;2105;6441
293100;202207;6701;16337;5423;14151;267;635;4225;10976;4492;11611
293105;202207;4354;12766;3707;11499;242;785;2578;7950;2820;8735
293110;202207;2918;6328;2457;5691;85;211;2019;4571;2104;4782
293120;202207;6041;13170;5486;12397;463;679;4439;10401;4902;11080
293130;202207;4180;10457;3593;9708;113;413;3122;8273;3235;8686
293135;202207;36985;80822;27418;68119;4922;12801;11627;28980;16549;41781
293140;202207;3247;5781;2864;5333;78;123;2567;4689;2645;4812
293150;202207;5919;16246;4876;14375;378;1223;3351;9659;3729;10882
293160;202207;5138;10379;4540;9718;641;828;3358;8031;3999;8859
293170;202207;6290;10823;5392;9781;110;246;4760;8427;4870;8673
293180;202207;5216;13233;4306;11646;93;359;3490;9156;3583;9515
293190;202207;18624;41185;16375;38078;136;565;14900;33915;15036;34480
293200;202207;10824;22680;8859;19718;303;663;7415;16275;7718;16938
293210;202207;5985;14163;5041;12802;378;940;3831;9697;4209;10637
293220;202207;6861;14713;5161;12043;768;1738;3204;7267;3972;9005
293230;202207;5372;11153;4041;9469;278;586;3068;7218;3346;7804
293240;202207;5368;12350;4327;10761;226;380;3176;8290;3402;8670
293245;202207;4671;11254;4218;10607;143;429;3614;8889;3757;9318
293250;202207;6809;14873;5479;13101;323;812;4277;10075;4600;10887
293260;202207;5609;12988;4576;11439;191;367;3275;8233;3466;8600
293270;202207;8978;17211;7136;15252;614;765;5677;12957;6291;13722
293280;202207;5111;12133;4445;11200;302;657;3448;8765;3750;9422
293290;202207;19800;48881;17458;45341;1572;4156;12676;32504;14248;36660
293300;202207;7703;15947;6590;14344;497;1021;5007;10653;5504;11674
293305;202207;5163;10755;4371;9770;40;105;4027;8946;4067;9051
293310;202207;2530;5859;2135;5257;39;137;1740;4158;1779;4295
293315;202207;5426;10867;4502;9579;448;632;3518;7698;3966;8330
293317;202207;3363;6939;2994;6426;300;456;2223;4851;2523;5307
293320;202207;15488;31774;13786;29925;197;503;12670;27086;12867;27589
293325;202207;2143;4776;1697;4213;199;492;1135;2803;1334;3295
293330;202207;86563;207014;71586;182711;9050;25440;42178;100929;51228;126369
293340;202207;2473;6393;2008;5580;142;425;1371;3738;1513;4163
293345;202207;4401;10493;3530;9201;429;818;2336;6641;2765;7459
293350;202207;7027;18020;6018;16785;126;381;5314;14903;5440;15284
293360;202207;18731;40161;16201;36876;468;1140;14242;32380;14710;33520
310010;202207;1131;2405;760;1920;92;258;305;695;397;953
310020;202207;3352;8356;2544;6975;450;1299;998;2541;1448;3840
310030;202207;2258;5900;1750;5030;245;744;1113;3105;1358;3849
310040;202207;955;2319;744;1966;71;240;417;962;488;1202
310050;202207;1809;4802;1540;4386;101;382;1094;2985;1195;3367
310060;202207;3750;9407;3190;8678;127;392;2465;6781;2592;7173
310070;202207;396;880;294;736;12;36;223;546;235;582
310080;202207;865;2232;632;1822;87;268;318;861;405;1129
310090;202207;5955;13363;4891;11722;198;583;3909;9031;4107;9614
310100;202207;4282;10142;3606;9099;116;402;3047;7429;3163;7831
310110;202207;5538;13448;4313;11425;607;1856;2543;6343;3150;8199
310120;202207;751;1711;493;1324;82;277;248;562;330;839
310130;202207;470;1099;401;998;24;76;314;741;338;817
310140;202207;363;947;272;820;46;164;138;376;184;540
310150;202207;7199;16756;5473;13809;483;1479;3155;7260;3638;8739
310160;202207;11365;25923;8719;21856;1269;3577;4261;9973;5530;13550
310163;202207;1332;3688;1040;3117;220;738;323;846;543;1584
310170;202207;11330;25751;9189;22564;872;2096;6516;15854;7388;17950
310180;202207;2364;5268;1727;4286;177;519;1128;2646;1305;3165
310190;202207;3192;8542;2603;7549;627;1953;579;1571;1206;3524
310200;202207;2336;6209;1754;5186;288;994;815;2228;1103;3222
310205;202207;1323;3340;1057;2931;129;384;675;1884;804;2268
310210;202207;2789;7044;2260;6108;121;323;1591;4151;1712;4474
310220;202207;1351;3455;1023;2837;75;227;666;1755;741;1982
310230;202207;2616;6524;2120;5630;225;713;1373;3377;1598;4090
310240;202207;1189;3141;1009;2831;52;181;702;1860;754;2041
310250;202207;1340;3033;1108;2687;37;108;901;2100;938;2208
310260;202207;4125;10023;2795;7644;688;2216;1028;2264;1716;4480
310270;202207;3397;7009;2746;6158;94;250;2303;5122;2397;5372
310280;202207;3183;6541;2529;5676;143;384;1863;3926;2006;4310
310285;202207;2134;6179;1768;5528;163;574;1120;3452;1283;4026
310290;202207;1722;4178;1467;3761;159;509;963;2233;1122;2742
310300;202207;1930;4988;1551;4336;156;559;867;2173;1023;2732
310310;202207;378;842;255;645;42;111;139;332;181;443
310320;202207;570;1345;397;1070;17;64;230;580;247;644
310330;202207;572;1297;341;879;42;120;149;341;191;461
310340;202207;9586;22770;7535;19335;983;2410;3984;10095;4967;12505
310350;202207;15655;35772;11179;28723;1653;4700;5887;14166;7540;18866
310360;202207;681;1417;554;1261;25;67;360;781;385;848
310370;202207;1423;4178;1234;3856;231;797;411;1366;642;2163
310375;202207;1000;2288;700;1853;173;467;259;644;432;1111
310380;202207;431;951;239;656;23;64;126;321;149;385
310390;202207;657;1827;526;1574;89;297;230;624;319;921
310400;202207;14134;32450;10642;27252;739;2331;7118;17215;7857;19546
310410;202207;1218;3371;711;2285;76;282;296;835;372;1117
310420;202207;5691;13828;4230;11291;505;1530;2246;5456;2751;6986
310430;202207;2003;5097;1383;4010;227;676;585;1482;812;2158
310440;202207;749;1827;527;1437;58;184;272;676;330;860
310445;202207;1558;4098;1165;3344;98;259;796;2235;894;2494
310450;202207;5396;12037;4149;10141;235;750;3198;7456;3433;8206
310460;202207;2044;5178;1561;4328;202;627;576;1389;778;2016
310470;202207;4129;8647;3194;7412;415;850;2032;4873;2447;5723
310480;202207;1150;2784;881;2346;98;329;524;1264;622;1593
310490;202207;3332;8477;2648;7371;325;1054;1503;3870;1828;4924
310500;202207;1735;4237;1345;3622;204;591;805;2067;1009;2658
310510;202207;2662;6457;1909;5114;298;884;894;2242;1192;3126
310520;202207;1323;3205;940;2502;144;403;463;1204;607;1607
310530;202207;918;2222;664;1802;103;329;253;560;356;889
310540;202207;3513;9378;2847;8147;493;1554;1350;3536;1843;5090
310550;202207;1493;3390;1071;2703;67;228;689;1571;756;1799
310560;202207;19233;46926;13996;37618;1578;4858;7022;16637;8600;21495
310570;202207;1328;3036;1038;2645;50;167;844;2085;894;2252
310590;202207;5004;12039;4012;10254;231;699;2506;5858;2737;6557
310600;202207;1610;4329;1314;3726;165;511;703;1841;868;2352
310610;202207;561;1464;354;1101;100;337;83;234;183;571
310620;202207;253365;592675;193440;487758;19810;59566;113015;255280;132825;314846
310630;202207;5409;13794;4177;11450;493;1414;2458;6447;2951;7861
310640;202207;1686;4111;1379;3582;126;414;911;2140;1037;2554
310650;202207;2774;7028;2042;5697;143;488;1294;3372;1437;3860
310660;202207;1704;3987;1396;3567;30;77;1229;3095;1259;3172
310665;202207;1647;3725;1366;3358;29;104;1111;2709;1140;2813
310670;202207;74287;173939;62737;155299;5257;15048;44342;103139;49599;118187
310680;202207;914;1951;756;1733;25;93;633;1378;658;1471
310690;202207;2726;6113;2028;5074;149;445;1361;3160;1510;3605
310700;202207;585;1147;462;1001;6;18;376;779;382;797
310710;202207;7227;18885;5279;15960;1107;3882;990;2673;2097;6555
310720;202207;1287;2754;1020;2414;35;113;778;1762;813;1875
310730;202207;11992;28544;10238;25889;419;1343;7808;18833;8227;20176
310740;202207;7817;19903;5873;16202;734;2396;2734;6702;3468;9098
310750;202207;1535;3380;1180;2884;86;264;739;1626;825;1890
310760;202207;836;1944;604;1592;38;105;394;999;432;1104
310770;202207;1228;3138;856;2552;122;421;388;1010;510;1431
310780;202207;4981;10563;4088;9361;239;574;3070;6931;3309;7505
310790;202207;2115;6270;1825;5666;409;1448;423;1080;832;2528
310800;202207;2722;7659;1983;6211;469;1667;135;353;604;2020
310810;202207;1610;3613;1351;3206;52;167;1033;2301;1085;2468
310820;202207;1323;3212;828;2405;159;466;229;678;388;1144
310825;202207;3125;8028;2499;7064;59;295;2071;5606;2130;5901
310830;202207;2385;6117;1804;5084;324;1027;837;2162;1161;3189
310840;202207;2587;6554;1941;5476;392;1279;669;1620;1061;2899
310850;202207;1566;3996;1283;3579;43;194;969;2555;1012;2749
310855;202207;3704;8954;2902;7706;190;543;2098;5404;2288;5947
310860;202207;7985;21062;6500;18369;728;1885;3968;11298;4696;13183
310870;202207;1066;2414;846;2106;58;161;620;1491;678;1652
310880;202207;1061;2962;806;2412;95;303;468;1368;563;1671
310890;202207;2587;7027;1719;5309;338;1140;277;711;615;1851
310900;202207;4734;12474;3453;9863;582;1868;1525;3915;2107;5783
310910;202207;2516;5795;1787;4668;255;715;475;1120;730;1835
310920;202207;2235;5329;1699;4557;174;535;1103;2832;1277;3367
310925;202207;1275;2916;1014;2536;46;158;787;1860;833;2018
310930;202207;6394;15379;4518;12431;840;2329;2182;6221;3022;8550
310940;202207;8191;17031;6699;14967;230;638;5393;11573;5623;12211
310945;202207;1572;3708;1224;3142;149;442;735;1741;884;2183
310950;202207;2144;6033;1418;4433;244;872;413;1074;657;1946
310960;202207;822;2101;494;1437;77;243;131;347;208;590
310970;202207;1345;3792;957;3003;249;805;187;556;436;1361
310980;202207;389;844;216;555;20;54;113;273;133;327
310990;202207;1702;4184;1375;3649;156;476;839;2054;995;2530
311000;202207;4834;12240;3648;10341;612;1942;1989;5225;2601;7167
311010;202207;1155;2871;948;2523;211;587;509;1317;720;1904
311020;202207;1344;3221;890;2450;57;181;498;1297;555;1478
311030;202207;2127;4979;1537;4019;341;1031;661;1581;1002;2612
311040;202207;335;977;261;824;75;259;60;172;135;431
311050;202207;3585;8462;2729;7193;411;1250;1392;3417;1803;4667
311060;202207;4050;9593;3022;7805;376;1115;1350;3111;1726;4226
311070;202207;2840;6459;2044;5266;252;836;1093;2515;1345;3351
311080;202207;1332;2769;1064;2370;40;131;837;1747;877;1878
311090;202207;2694;7780;2197;6892;445;1485;735;2244;1180;3729
311100;202207;2838;7566;1810;5569;352;1213;511;1345;863;2558
311110;202207;4423;8768;2406;5832;522;1217;621;1505;1143;2722
311115;202207;1611;3229;1346;2894;41;87;1145;2407;1186;2494
311120;202207;8113;20065;6221;16739;903;2726;2549;5923;3452;8649
311130;202207;2150;5326;1641;4635;148;501;957;2593;1105;3094
311140;202207;1810;4185;1405;3640;145;420;941;2362;1086;2782
311150;202207;1680;5011;1335;4370;174;649;714;2224;888;2873
311160;202207;4724;12551;3486;10363;628;2140;1466;4014;2094;6154
311170;202207;1078;2583;885;2334;59;176;558;1542;617;1718
311180;202207;1692;3531;1124;2717;173;411;623;1460;796;1871
311190;202207;993;2653;735;2140;113;365;297;733;410;1098
311200;202207;2589;6505;1921;5256;330;1014;813;1911;1143;2925
311205;202207;1073;2854;880;2508;35;120;584;1552;619;1672
311210;202207;1214;3246;1074;3059;117;293;769;2262;886;2555
311220;202207;971;2348;833;2108;27;98;630;1468;657;1566
311230;202207;9181;25473;6951;21048;1232;3787;2709;8200;3941;11987
311240;202207;1264;3018;989;2638;166;503;512;1282;678;1785
311250;202207;1517;3924;1168;3325;215;658;441;1130;656;1788
311260;202207;3131;7228;2062;5436;257;776;1022;2351;1279;3127
311265;202207;1571;3557;1162;2917;45;142;876;2097;921;2239
311270;202207;3466;9445;2993;8706;169;693;2146;5961;2315;6654
311280;202207;1335;3387;761;2274;177;579;170;453;347;1032
311290;202207;2106;5955;1894;5540;109;353;1294;3719;1403;4072
311300;202207;5339;13355;4404;11826;199;668;3574;9337;3773;10005
311310;202207;654;1682;549;1500;35;100;364;946;399;1046
311320;202207;3669;10435;3192;9431;281;1037;1747;4628;2028;5665
311330;202207;7220;16084;5706;13814;519;1365;3417;8054;3936;9419
311340;202207;12604;32471;10002;28047;2195;6630;3397;8903;5592;15533
311350;202207;2757;6271;2002;4965;215;596;1065;2326;1280;2922
311360;202207;1281;2939;899;2415;237;695;352;952;589;1647
311370;202207;5548;12457;4092;10218;463;1323;2378;5501;2841;6824
311380;202207;448;1312;333;1079;54;178;169;543;223;721
311390;202207;1989;5668;1593;5149;685;2449;393;1115;1078;3564
311400;202207;1862;4734;1344;3786;228;692;403;909;631;1601
311410;202207;2203;6010;1772;5315;230;795;986;2805;1216;3600
311420;202207;1856;5037;1397;4194;290;954;470;1183;760;2137
311430;202207;5220;12881;3514;9665;486;1427;1507;3851;1993;5278
311440;202207;3496;9013;2712;7758;754;2444;689;1812;1443;4256
311450;202207;2395;6663;1657;5213;442;1558;376;944;818;2502
311455;202207;1218;2587;858;2073;106;258;499;1177;605;1435
311460;202207;652;1833;438;1389;83;306;102;255;185;561
311470;202207;582;1692;405;1312;98;352;60;194;158;546
311480;202207;1326;2956;1093;2620;86;205;844;2005;930;2210
311490;202207;302;858;231;724;37;141;100;277;137;418
311500;202207;552;1286;433;1109;36;109;277;671;313;780
311510;202207;3981;9357;2843;7497;303;905;1449;3446;1752;4351
311520;202207;738;1881;643;1702;56;178;403;1046;459;1224
311530;202207;10697;23245;7350;18170;1520;4314;2734;6148;4254;10462
311535;202207;993;2520;722;1990;116;352;327;839;443;1191
311540;202207;593;1676;518;1549;63;220;378;1098;441;1318
311545;202207;2271;6027;1964;5553;94;314;1538;4278;1632;4592
311547;202207;1958;4096;1718;3763;40;90;1440;3053;1480;3143
311550;202207;3481;8752;2847;7684;397;1200;1319;3230;1716;4430
311560;202207;357;714;217;499;30;79;89;171;119;250
311570;202207;1732;3811;1214;3099;50;140;897;2326;947;2466
311580;202207;2612;4723;1827;3787;158;316;1285;2570;1443;2886
311590;202207;699;1684;579;1517;68;209;372;928;440;1137
311600;202207;1811;4047;1484;3612;176;496;1052;2466;1228;2962
311610;202207;2671;7419;2185;6528;135;478;1431;4092;1566;4570
311615;202207;4072;9910;3273;8646;135;451;2645;6754;2780;7205
311620;202207;652;1655;492;1389;61;191;289;773;350;964
311630;202207;1504;3898;1220;3324;104;296;777;2046;881;2342
311640;202207;883;2198;696;1912;101;305;366;927;467;1232
311650;202207;2198;5059;1767;4414;201;549;1094;2600;1295;3149
311660;202207;3540;9498;2629;7737;393;1307;772;1739;1165;3046
311670;202207;1873;4395;1395;3575;153;451;713;1743;866;2194
311680;202207;2598;6514;2003;5516;144;384;1408;3905;1552;4289
311690;202207;712;1369;518;1130;34;76;373;824;407;900
311700;202207;2408;5350;1855;4567;22;89;1560;3706;1582;3795
311710;202207;1803;4890;1331;4094;325;1074;473;1419;798;2493
311720;202207;483;1352;389;1180;48;163;212;632;260;795
311730;202207;4999;11801;3507;9042;825;2251;1477;3508;2302;5759
311740;202207;1134;2759;927;2469;71;152;731;1982;802;2134
311750;202207;4637;12648;3763;11140;327;1196;2473;6842;2800;8038
311760;202207;792;2079;607;1742;97;348;241;548;338;896
311770;202207;2569;6769;2016;5819;397;1254;817;2160;1214;3414
311780;202207;1680;4431;1240;3643;214;709;465;1190;679;1899
311783;202207;2682;6422;2197;5658;55;223;1808;4441;1863;4664
311787;202207;945;2552;733;2089;114;354;307;739;421;1093
311790;202207;1754;4619;1191;3564;236;816;368;964;604;1780
311800;202207;5759;16095;4593;13658;996;3057;853;1991;1849;5048
311810;202207;1092;2959;875;2587;58;187;595;1717;653;1904
311820;202207;1085;2369;848;2027;59;169;593;1315;652;1484
311830;202207;10084;26838;7359;21243;2090;6270;1410;3890;3500;10160
311840;202207;4445;10161;3573;8954;261;692;2664;6616;2925;7308
311850;202207;403;978;318;832;12;48;226;557;238;605
311860;202207;82252;189728;65055;161301;6891;19576;41446;95420;48337;114996
311870;202207;2150;5385;1520;4319;259;891;655;1650;914;2541
311880;202207;7349;17494;6144;15834;398;969;4557;11861;4955;12830
311890;202207;2073;4431;1617;3807;50;181;1271;2800;1321;2981
311900;202207;804;1895;609;1635;103;252;337;929;440;1181
311910;202207;4883;11422;3789;9999;673;1830;1950;5088;2623;6918
311920;202207;2540;5936;2050;5242;102;259;1459;3686;1561;3945
311930;202207;5238;11031;3947;9331;765;2044;2042;4375;2807;6419
311940;202207;18471;44930;13486;35884;1756;5140;6241;15168;7997;20308
311950;202207;2724;6596;2043;5419;183;534;1220;3205;1403;3739
311960;202207;569;1319;445;1137;50;153;226;509;276;662
311970;202207;482;1462;360;1171;68;262;90;241;158;503
311980;202207;530;1330;292;868;32;105;111;296;143;401
311990;202207;611;1383;395;1050;60;201;169;371;229;572
311995;202207;1089;2936;574;1766;28;107;87;171;115;278
312000;202207;929;2030;706;1713;36;95;518;1231;554;1326
312010;202207;1252;3001;1001;2619;41;150;726;1795;767;1945
312015;202207;1520;4011;1337;3719;53;224;1081;2894;1134;3118
312020;202207;2031;5825;1435;4487;257;872;335;900;592;1772
312030;202207;2479;5131;2120;4725;58;175;1938;4250;1996;4425
312040;202207;963;2662;691;2127;109;331;308;900;417;1231
312050;202207;1360;3908;1104;3447;227;890;413;1143;640;2033
312060;202207;1131;2580;718;2021;158;463;304;830;462;1293
312070;202207;1072;2833;759;2199;36;135;477;1270;513;1405
312080;202207;3311;7610;2573;6529;140;406;1743;4105;1883;4511
312083;202207;1194;2633;931;2251;50;169;745;1707;795;1876
312087;202207;2972;6714;2419;5895;85;218;1968;4758;2053;4976
312090;202207;13094;31492;10326;27160;1129;3482;6098;14925;7227;18407
312100;202207;1913;4893;1485;4187;115;405;928;2415;1043;2820
312110;202207;1131;3296;925;2876;157;592;431;1204;588;1796
312120;202207;1178;3059;823;2424;198;697;281;681;479;1378
312125;202207;2219;5105;1889;4657;102;301;1520;3606;1622;3907
312130;202207;1319;2952;977;2406;78;236;522;1136;600;1372
312140;202207;832;2300;693;2015;136;432;309;822;445;1254
312150;202207;559;1407;476;1261;29;80;317;781;346;861
312160;202207;10966;26907;8541;22830;907;2831;4572;11244;5479;14075
312170;202207;1027;2471;785;2034;49;149;526;1311;575;1460
312180;202207;1602;3947;1312;3456;137;394;764;1904;901;2298
312190;202207;904;2289;704;1943;61;205;389;989;450;1194
312200;202207;5552;13704;4360;11833;554;1519;2578;6787;3132;8306
312210;202207;1628;3227;1239;2702;46;132;1004;2110;1050;2242
312220;202207;1911;5347;1630;4849;159;495;1071;3178;1230;3673
312230;202207;21235;50379;15344;40258;3040;9020;5265;11526;8305;20546
312235;202207;2430;5408;1945;4741;196;441;1377;3277;1573;3718
312240;202207;904;2684;694;2250;144;480;219;696;363;1176
312245;202207;3532;7268;2996;6517;30;84;2721;5780;2751;5864
312247;202207;1256;2651;882;2100;109;273;554;1253;663;1526
312250;202207;1060;2670;679;1947;97;288;232;625;329;913
312260;202207;1158;2775;932;2434;48;186;737;1809;785;1995
312270;202207;817;2114;625;1735;30;111;362;892;392;1003
312280;202207;499;1368;399;1192;85;281;139;371;224;652
312290;202207;1071;2861;892;2578;152;496;330;863;482;1359
312300;202207;1239;3525;888;2705;201;672;198;479;399;1151
312310;202207;1146;3159;907;2685;119;415;472;1305;591;1720
312320;202207;2440;5777;1787;4692;373;962;493;1252;866;2214
312330;202207;1059;2776;872;2427;106;317;520;1372;626;1689
312340;202207;277;667;199;547;29;113;113;261;142;374
312350;202207;297;575;211;479;14;36;142;288;156;324
312352;202207;1746;5049;1538;4658;277;897;735;2384;1012;3281
312360;202207;3817;10122;2888;8432;556;1798;1199;3181;1755;4979
312370;202207;2382;5584;1929;4894;210;632;1226;2908;1436;3540
312380;202207;2530;5214;2086;4658;12;38;1821;3944;1833;3982
312385;202207;1462;3624;1131;3052;356;970;300;845;656;1815
312390;202207;2221;5870;1656;4829;245;807;513;1273;758;2080
312400;202207;3550;9396;3018;8548;914;2762;926;2663;1840;5425
312410;202207;16276;39887;13432;35443;1629;4685;8650;21805;10279;26490
312420;202207;4672;11460;3826;10118;730;2150;1963;4920;2693;7070
312430;202207;10024;23173;8194;20090;240;789;6314;14715;6554;15504
312440;202207;1158;3445;972;3079;474;1551;191;596;665;2147
312450;202207;1538;4154;1179;3520;294;943;477;1397;771;2340
312460;202207;571;1291;420;1075;28;85;278;682;306;767
312470;202207;538;1277;332;914;49;144;102;238;151;382
312480;202207;1202;2820;870;2337;73;237;496;1243;569;1480
312490;202207;2962;6086;2355;5274;167;414;1548;3289;1715;3703
312500;202207;1215;2680;1021;2424;40;140;788;1820;828;1960
312510;202207;5366;13434;3761;10449;794;2175;1107;2852;1901;5027
312520;202207;404;948;320;822;53;173;194;461;247;634
312530;202207;757;1632;637;1488;31;73;464;1110;495;1183
312540;202207;1802;4591;1240;3541;141;400;704;1917;845;2317
312550;202207;951;2257;711;1823;38;113;464;1078;502;1191
312560;202207;2079;5128;1604;4380;98;304;1147;3077;1245;3381
312570;202207;3037;6572;2282;5632;407;964;1177;2956;1584;3920
312580;202207;717;1851;496;1399;47;169;247;630;294;799
312590;202207;1765;4724;1366;3948;141;483;805;2107;946;2590
312595;202207;2431;6428;2000;5764;274;725;1202;3660;1476;4385
312600;202207;1494;3411;974;2386;134;410;304;736;438;1146
312610;202207;8238;19831;5625;15127;835;2551;2116;4926;2951;7477
312620;202207;2861;6701;2176;5754;63;249;1758;4616;1821;4865
312630;202207;373;979;274;803;46;168;123;324;169;492
312640;202207;609;1588;450;1331;53;197;223;601;276;798
312650;202207;2408;5490;1702;4241;59;202;1269;2914;1328;3116
312660;202207;1539;3415;1181;2832;89;218;834;1880;923;2098
312670;202207;6757;14859;5666;13207;139;568;4588;9939;4727;10507
312675;202207;1407;3350;1152;2987;46;156;937;2360;983;2516
312680;202207;1785;4138;1590;3856;46;178;1411;3306;1457;3484
312690;202207;3346;6604;2516;5575;118;238;1970;4326;2088;4564
312695;202207;1191;2834;1011;2551;38;76;842;2088;880;2164
312700;202207;2371;5985;1725;4845;178;588;959;2517;1137;3105
312705;202207;1885;3710;1663;3408;11;40;1573;3187;1584;3227
312707;202207;1593;4190;1122;3341;53;225;754;2092;807;2317
312710;202207;8446;18446;5430;13879;1348;3350;1762;4660;3110;8010
312720;202207;1264;3077;973;2624;99;312;648;1637;747;1949
312730;202207;1813;4059;1304;3372;120;332;821;2043;941;2375
312733;202207;1521;3796;1143;3105;45;159;778;1955;823;2114
312735;202207;901;2164;707;1807;60;165;461;1085;521;1250
312737;202207;951;1947;684;1575;59;153;484;1067;543;1220
312738;202207;895;2105;647;1685;53;168;417;994;470;1162
312740;202207;504;1227;321;925;70;213;89;198;159;411
312750;202207;1712;4561;1254;3734;156;547;604;1648;760;2195
312760;202207;2079;5754;1506;4611;226;708;606;1764;832;2472
312770;202207;52224;119139;33988;88473;5743;16432;13601;33050;19344;49482
312780;202207;2969;7834;2510;7094;284;845;1602;4398;1886;5243
312790;202207;273;627;140;405;6;18;31;54;37;72
312800;202207;6399;16196;5055;13767;590;1924;2896;7282;3486;9206
312810;202207;1841;4695;1221;3660;327;1032;415;1149;742;2181
312820;202207;1998;4917;1615;4269;90;252;1178;3043;1268;3295
312825;202207;1751;3503;1485;3164;40;87;1284;2676;1324;2763
312830;202207;3184;8407;2060;6215;443;1452;614;1680;1057;3132
312840;202207;1686;4108;1316;3511;126;402;735;1814;861;2216
312850;202207;1210;2516;878;2054;23;91;611;1290;634;1381
312860;202207;1237;3003;848;2405;210;634;266;663;476;1297
312870;202207;6939;17660;4455;13020;731;2255;1295;3404;2026;5659
312880;202207;1688;3951;1318;3357;133;322;725;1819;858;2141
312890;202207;2675;6088;1982;4990;125;298;1178;2863;1303;3161
312900;202207;1516;3583;1239;3221;120;361;766;1994;886;2355
312910;202207;1708;3036;1003;2131;149;305;526;1079;675;1384
312920;202207;1092;2785;780;2287;135;454;278;704;413;1158
312930;202207;2784;6289;2068;5236;355;923;1031;2626;1386;3549
312940;202207;1176;2940;937;2607;84;293;535;1381;619;1674
312950;202207;3781;8522;2669;6816;409;1180;1402;3319;1811;4499
312960;202207;2042;4966;1691;4437;105;234;1234;3347;1339;3581
312965;202207;1935;4720;1584;4184;152;387;1051;2772;1203;3159
312970;202207;1774;4634;1440;4121;141;502;885;2361;1026;2863
312980;202207;29621;75747;24060;65929;4280;12617;11510;29395;15790;42012
312990;202207;604;1399;417;1095;68;215;214;503;282;718
313000;202207;542;1441;413;1220;29;121;258;703;287;824
313005;202207;2854;7578;2387;6815;122;371;1760;4852;1882;5223
313010;202207;6593;16495;5323;14482;762;2324;3259;8492;4021;10816
313020;202207;1230;3581;927;2936;163;580;198;539;361;1119
313030;202207;1375;2898;964;2335;62;197;697;1588;759;1785
313040;202207;990;2813;826;2500;34;147;536;1536;570;1683
313050;202207;2110;5423;1479;4470;242;848;436;1154;678;2002
313055;202207;2171;5350;1902;4970;470;1312;1155;2921;1625;4233
313060;202207;1203;2752;897;2233;204;591;211;478;415;1069
313065;202207;1898;5019;1671;4652;44;200;1385;3716;1429;3916
313070;202207;1043;2617;809;2231;83;245;434;1131;517;1376
313080;202207;439;1159;325;956;56;191;125;306;181;497
313090;202207;6255;14863;5214;13239;286;817;3706;9177;3992;9994
313100;202207;1533;3717;1213;3253;50;175;888;2288;938;2463
313110;202207;1732;4289;1241;3427;118;384;657;1623;775;2007
313115;202207;3381;8749;2713;7531;284;960;1588;3959;1872;4919
313120;202207;4331;9746;3174;8221;185;499;2191;5650;2376;6149
313130;202207;37742;90162;28810;74527;2832;8420;16967;40623;19799;49043
313140;202207;852;1721;588;1377;35;92;451;1036;486;1128
313150;202207;1599;4297;1195;3588;355;1206;220;554;575;1760
313160;202207;1550;3609;1197;3089;25;89;925;2279;950;2368
313170;202207;13210;35010;9921;28915;1648;5249;3870;10067;5518;15316
313180;202207;2850;6881;2135;5450;174;483;1454;3517;1628;4000
313190;202207;5214;13842;3845;11185;676;2121;1478;3868;2154;5989
313200;202207;1327;3203;1128;2861;25;90;939;2284;964;2374
313210;202207;4659;11688;3849;10413;419;1294;2438;6288;2857;7582
313220;202207;2138;5290;1449;3980;180;550;672;1610;852;2160
313230;202207;3237;8228;2619;7443;63;212;2128;6078;2191;6290
313240;202207;12699;29115;8891;23269;916;2928;5013;11987;5929;14915
313250;202207;7149;19655;5501;16192;989;2991;2568;7158;3557;10149
313260;202207;921;2163;660;1750;76;280;366;825;442;1105
313270;202207;7594;15901;6319;14236;483;1028;5026;11344;5509;12372
313280;202207;529;1355;354;1022;44;151;165;443;209;594
313290;202207;1186;3552;913;3060;211;803;340;1082;551;1885
313300;202207;2126;5392;1636;4561;352;1056;585;1448;937;2504
313310;202207;1620;4499;1304;3850;205;728;463;1094;668;1822
313320;202207;2306;5738;1646;4687;329;1008;614;1764;943;2772
313330;202207;4791;11485;3642;9791;241;740;2417;6349;2658;7089
313340;202207;1803;3751;1354;3142;89;254;982;2168;1071;2422
313350;202207;3446;8950;2348;6621;241;813;1046;2516;1287;3329
313360;202207;1896;4334;1306;3411;205;644;683;1604;888;2248
313370;202207;1871;4756;1469;3996;290;836;586;1441;876;2277
313375;202207;2183;5422;1418;4040;244;811;403;999;647;1810
313380;202207;8044;18876;5872;14978;846;2526;3069;6784;3915;9310
313390;202207;918;2657;783;2420;55;232;526;1535;581;1767
313400;202207;4358;9777;3365;8353;146;434;2575;6203;2721;6637
313410;202207;1607;3846;1187;3141;292;776;602;1535;894;2311
313420;202207;18199;38832;10224;25971;2438;6770;2174;5134;4612;11904
313430;202207;1354;3268;1126;2863;78;297;800;1819;878;2116
313440;202207;7880;15548;5663;12802;210;554;4356;9555;4566;10109
313450;202207;849;2139;615;1716;106;319;216;504;322;823
313460;202207;2637;6972;2103;6115;372;1209;1016;2840;1388;4049
313470;202207;3277;7628;2625;6680;131;390;2048;5095;2179;5485
313480;202207;1277;3433;802;2437;78;273;320;864;398;1137
313490;202207;3598;8666;2003;5771;368;1162;593;1575;961;2737
313500;202207;647;1610;460;1246;51;133;210;523;261;656
313505;202207;11753;28259;9962;25820;402;1177;7969;20423;8371;21600
313507;202207;1636;3838;1298;3327;46;164;1013;2489;1059;2653
313510;202207;17469;43460;13692;36373;1310;3847;7675;18752;8985;22599
313520;202207;18023;43855;14560;38249;659;2111;11296;28475;11955;30586
313530;202207;665;1881;500;1529;62;228;217;570;279;798
313535;202207;2678;6929;2149;5943;236;611;1318;3599;1554;4210
313540;202207;973;2631;778;2181;105;332;385;958;490;1290
313545;202207;1284;3920;1087;3547;130;479;588;1855;718;2334
313550;202207;2398;6419;2000;5526;224;664;1333;3574;1557;4238
313560;202207;3396;5765;2548;4770;37;69;2265;4187;2302;4256
313570;202207;1159;3085;947;2729;177;532;458;1254;635;1786
313580;202207;7059;15770;5579;13456;374;1042;3910;8981;4284;10023
313590;202207;1311;3250;1063;2902;210;575;565;1610;775;2185
313600;202207;5050;11378;4273;10245;83;318;3798;8822;3881;9140
313610;202207;1183;2762;970;2402;80;223;637;1463;717;1686
313620;202207;6584;16251;5322;14039;488;1546;3432;8587;3920;10133
313630;202207;10383;23564;7464;19254;723;2220;4606;11314;5329;13534
313640;202207;1507;2932;1008;2294;85;225;716;1588;801;1813
313650;202207;1889;5331;1485;4656;117;415;918;2912;1035;3327
313652;202207;997;2623;882;2428;57;198;663;1719;720;1917
313655;202207;1352;3043;1054;2676;81;213;771;1926;852;2139
313657;202207;1310;3206;1023;2747;36;142;756;1865;792;2007
313660;202207;1295;3164;1079;2817;68;243;800;1955;868;2198
313665;202207;6453;15574;5140;13310;394;1220;3509;8434;3903;9654
313670;202207;63287;146248;43191;113228;5419;15781;21808;53169;27227;68950
313680;202207;1246;2950;1018;2592;50;124;684;1644;734;1768
313690;202207;1124;3176;819;2573;160;553;232;665;392;1218
313695;202207;2083;5115;1546;4234;106;286;1043;2919;1149;3205
313700;202207;3282;9395;2823;8808;226;752;2256;7045;2482;7797
313710;202207;1695;3561;1216;2945;96;261;818;1935;914;2196
313720;202207;7226;18506;5278;14615;698;2139;2448;6043;3146;8182
313730;202207;1639;3254;1230;2729;81;160;814;1789;895;1949
313740;202207;1902;6465;1606;5744;364;1474;399;1251;763;2725
313750;202207;2596;6240;2077;5392;303;911;1213;2859;1516;3770
313753;202207;2479;5754;1661;4437;261;799;699;1749;960;2548
313760;202207;6889;17709;5467;15097;826;2569;2763;6897;3589;9466
313770;202207;4693;12243;3718;10735;190;532;2814;8236;3004;8768
313780;202207;4703;11479;3471;9569;436;1165;1176;3306;1612;4471
313790;202207;658;1770;566;1602;70;219;344;923;414;1142
313800;202207;1575;3314;1155;2738;96;269;674;1477;770;1746
313810;202207;2000;4477;1614;3944;55;192;1306;3073;1361;3265
313820;202207;20405;49445;13494;35325;2218;6003;3996;9596;6214;15599
313830;202207;467;1284;339;1016;60;208;144;393;204;601
313835;202207;1074;2789;852;2429;86;307;459;1178;545;1485
313840;202207;9343;22685;7388;19616;1642;4600;2111;5468;3753;10068
313850;202207;1156;2609;915;2278;150;420;482;1096;632;1516
313860;202207;3225;7854;2458;6521;316;966;1240;2943;1556;3909
313862;202207;1383;2872;706;1884;43;121;347;930;390;1051
313865;202207;3005;7205;2476;6378;81;247;1895;4683;1976;4930
313867;202207;1607;4546;1278;3916;235;738;678;2144;913;2882
313868;202207;1973;5450;1599;4782;57;229;1212;3456;1269;3685
313870;202207;1233;2959;826;2239;94;272;368;884;462;1156
313880;202207;2405;5822;1809;4824;192;619;1006;2390;1198;3009
313890;202207;2769;5106;2027;4176;51;131;1598;3150;1649;3281
313900;202207;6048;15860;4256;12281;1013;3178;1272;3126;2285;6304
313910;202207;867;2392;660;1982;125;400;161;470;286;870
313920;202207;3314;9121;2731;7973;463;1406;1440;4150;1903;5556
313925;202207;1948;4483;1544;3798;182;412;995;2406;1177;2818
313930;202207;5810;14889;4675;12983;324;970;3193;8683;3517;9653
313940;202207;11583;31391;8929;26989;1708;5561;2268;7374;3976;12935
313950;202207;6561;13027;5094;11228;251;625;3742;8083;3993;8708
313960;202207;6757;15176;4542;11546;695;2066;1866;4105;2561;6171
313970;202207;1807;4400;1535;3967;49;137;1047;2591;1096;2728
313980;202207;1594;3937;1114;3216;196;639;500;1353;696;1992
313990;202207;2403;6759;1851;5632;265;1035;1035;2738;1300;3773
314000;202207;12281;28470;9931;24582;664;2021;6529;15649;7193;17670
314010;202207;1596;3553;1253;3084;44;156;953;2231;997;2387
314015;202207;2560;6464;2029;5562;209;694;1221;3075;1430;3769
314020;202207;591;1503;396;1178;129;460;45;131;174;591
314030;202207;938;2482;726;2089;104;308;330;919;434;1227
314040;202207;719;1867;604;1667;78;270;336;875;414;1145
314050;202207;2252;5501;1683;4495;99;336;1054;2568;1153;2904
314053;202207;2399;6367;1937;5499;307;804;1134;3342;1441;4146
314055;202207;2675;6137;2256;5548;85;223;1840;4540;1925;4763
314060;202207;1492;3662;1119;3068;32;116;801;2129;833;2245
314070;202207;5772;14304;4644;12382;662;1839;2559;6515;3221;8354
314080;202207;2349;5742;1690;4672;147;471;800;1972;947;2443
314085;202207;2752;6797;2205;6001;221;617;1426;3828;1647;4445
314090;202207;5902;14061;5070;12876;418;1071;3368;8745;3786;9816
314100;202207;3459;7859;2674;6784;64;184;1983;5030;2047;5214
314110;202207;5780;15099;4722;13167;499;1553;2652;6729;3151;8282
314120;202207;806;1782;378;1030;74;232;131;316;205;548
314130;202207;784;1939;541;1496;27;99;355;925;382;1024
314140;202207;5400;13557;4301;11605;424;1275;2477;6356;2901;7631
314150;202207;1669;3939;1200;3144;92;261;794;2016;886;2277
314160;202207;2745;6448;1962;5126;211;572;920;2319;1131;2891
314170;202207;1082;2738;862;2307;40;147;595;1447;635;1594
314180;202207;6502;16153;5175;14102;489;1331;2988;8041;3477;9372
314190;202207;721;1671;544;1425;63;207;328;786;391;993
314200;202207;3404;8889;2806;7916;230;651;1872;5160;2102;5811
314210;202207;2333;5707;1817;4804;289;791;690;1721;979;2512
314220;202207;1896;4825;1508;4217;215;712;734;1866;949;2578
314225;202207;1220;3292;983;2853;95;290;646;1811;741;2101
314230;202207;1037;2496;832;2212;81;224;544;1431;625;1655
314240;202207;1246;3179;971;2778;205;610;428;1208;633;1818
314250;202207;498;1379;320;992;41;138;128;350;169;488
314260;202207;1293;3094;1028;2742;243;642;464;1188;707;1830
314270;202207;3819;9743;3138;8663;96;327;2379;6429;2475;6756
314280;202207;4151;9058;2889;7225;288;815;1739;4024;2027;4839
314290;202207;5293;12416;4443;10994;253;685;3241;7697;3494;8382
314300;202207;2345;6215;1504;4460;303;960;490;1286;793;2246
314310;202207;4430;11135;3074;8888;900;2897;438;1110;1338;4007
314315;202207;1143;3265;933;2835;59;228;645;1887;704;2115
314320;202207;3768;9456;2547;7223;401;1319;1066;2728;1467;4047
314330;202207;62803;166019;48500;141178;11308;33841;13704;39407;25012;73248
314340;202207;2985;7102;1980;5357;365;1168;693;1548;1058;2716
314345;202207;1760;4547;1458;4031;113;321;1041;2768;1154;3089
314350;202207;977;2529;666;1973;138;436;152;326;290;762
314360;202207;623;1722;425;1304;60;187;139;374;199;561
314370;202207;863;2086;698;1836;54;173;480;1193;534;1366
314380;202207;1348;3478;945;2806;206;697;294;831;500;1528
314390;202207;17703;41279;12491;32507;1715;5062;5382;12157;7097;17219
314400;202207;4634;13009;3573;10982;1050;3387;1251;3982;2301;7369
314410;202207;3434;9133;2399;7144;472;1612;576;1640;1048;3252
314420;202207;897;2078;664;1718;28;91;436;1063;464;1154
314430;202207;9311;20646;6696;16562;936;2432;3375;7884;4311;10316
314435;202207;2172;5427;1705;4695;267;764;931;2462;1198;3226
314437;202207;1041;2430;764;1993;69;192;475;1198;544;1390
314440;202207;685;1865;492;1492;135;466;121;296;256;762
314450;202207;1699;4156;1400;3671;192;546;764;1846;956;2392
314460;202207;3923;11017;2969;9131;712;2371;1025;2824;1737;5195
314465;202207;2673;6878;2177;5973;52;206;1701;4432;1753;4638
314467;202207;1109;2661;915;2345;80;232;636;1570;716;1802
314470;202207;2586;6914;2138;6071;342;1045;1068;2841;1410;3886
314480;202207;9478;24533;7282;20121;1032;3175;3278;8024;4310;11199
314490;202207;1230;2972;896;2341;65;191;599;1511;664;1702
314500;202207;2104;4742;1527;3994;387;1000;534;1398;921;2398
314505;202207;2577;5429;2108;4798;123;248;1604;3555;1727;3803
314510;202207;2403;5952;1749;4989;452;1465;702;1870;1154;3335
314520;202207;7260;20520;5826;17774;1260;4151;1403;3850;2663;8001
314530;202207;6346;17795;5669;16607;292;1113;4325;12160;4617;13273
314535;202207;3190;7213;2560;6315;134;390;2021;4919;2155;5309
314537;202207;1398;3600;1063;3069;74;207;725;2033;799;2240
314540;202207;495;1149;359;936;15;41;215;516;230;557
314545;202207;2270;4819;2025;4536;52;131;1742;3946;1794;4077
314550;202207;866;1955;583;1510;40;137;336;763;376;900
314560;202207;5582;15137;4218;12307;539;1907;1883;4718;2422;6625
314570;202207;355;942;251;758;25;85;125;375;150;460
314580;202207;550;1540;443;1327;96;287;161;469;257;756
314585;202207;797;2240;611;1857;56;185;288;812;344;997
314587;202207;2587;6420;2011;5510;573;1461;982;2732;1555;4193
314590;202207;5047;12608;3878;10568;460;1437;1961;4882;2421;6319
314600;202207;2152;5621;1390;4227;326;1079;182;483;508;1562
314610;202207;11031;25958;8496;22037;1009;3148;4193;10974;5202;14122
314620;202207;2797;5808;2266;5141;119;245;1858;4226;1977;4471
314625;202207;1804;4298;1532;3926;36;162;1308;3234;1344;3396
314630;202207;6014;13861;4837;12246;181;522;3922;9799;4103;10321
314640;202207;899;1898;692;1581;43;127;494;1040;537;1167
314650;202207;985;2175;659;1666;64;200;399;893;463;1093
314655;202207;1724;4426;1215;3555;158;453;637;1859;795;2312
314660;202207;411;835;301;660;13;31;226;467;239;498
314670;202207;1895;3920;1319;3137;27;77;934;2126;961;2203
314675;202207;1935;4585;1629;4101;88;231;1277;3142;1365;3373
314690;202207;2368;6048;1807;5213;456;1317;724;2060;1180;3377
314700;202207;13413;34470;9321;27120;1482;4705;4163;11364;5645;16069
314710;202207;9722;25536;7227;20445;1056;3324;2918;7162;3974;10486
314720;202207;2681;7544;1881;5869;349;1176;396;1074;745;2250
314730;202207;2859;7067;2024;5568;356;1092;731;1762;1087;2854
314740;202207;3685;9582;2912;8253;461;1407;1528;4077;1989;5484
314750;202207;342;845;267;694;34;104;161;370;195;474
314760;202207;2133;5929;1376;4275;216;804;421;1011;637;1815
314770;202207;1169;3227;692;2117;111;340;200;567;311;907
314780;202207;413;983;292;792;29;100;170;421;199;521
314790;202207;14008;34990;10146;28159;1602;4959;4424;11549;6026;16508
314795;202207;1744;4179;1484;3760;56;204;1168;2801;1224;3005
314800;202207;13226;32085;8864;24378;1461;4422;3126;7523;4587;11945
314810;202207;11834;29069;8946;24308;2198;6317;3411;8721;5609;15038
314820;202207;1504;3362;1176;2885;77;233;753;1753;830;1986
314830;202207;2007;5222;1650;4619;160;456;989;2633;1149;3089
314840;202207;1015;2869;792;2472;52;214;558;1647;610;1861
314850;202207;2927;5459;2399;4818;35;94;2195;4343;2230;4437
314860;202207;3827;9929;3187;8818;149;561;2334;6167;2483;6728
314870;202207;8000;16281;6164;14073;293;657;4738;10900;5031;11557
314875;202207;2144;5912;1891;5567;214;533;1421;4250;1635;4783
314880;202207;931;2159;715;1828;46;131;450;1101;496;1232
314890;202207;554;1580;417;1296;53;179;195;540;248;719
314900;202207;1012;2360;780;1980;90;266;410;988;500;1254
314910;202207;1951;5193;1453;4384;227;812;714;1984;941;2796
314915;202207;2485;6650;2027;5862;187;546;1295;3712;1482;4258
314920;202207;634;1486;444;1221;22;69;313;851;335;920
314930;202207;7014;18362;5448;15467;861;2753;2486;6330;3347;9083
314940;202207;482;1063;398;931;27;63;287;635;314;698
314950;202207;751;1758;524;1406;47;166;297;726;344;892
314960;202207;1075;2323;845;1969;57;145;615;1372;672;1517
314970;202207;1255;3508;972;2948;153;511;441;1220;594;1731
314980;202207;2186;5172;1722;4504;183;539;1160;2929;1343;3468
314990;202207;3148;8591;2292;6742;376;1154;630;1621;1006;2775
314995;202207;1933;4952;1514;4224;50;184;993;2586;1043;2770
315000;202207;1292;3047;925;2479;87;257;596;1540;683;1797
315010;202207;464;1172;372;1030;39;138;226;587;265;725
315015;202207;2827;7181;2461;6591;224;719;1731;4471;1955;5190
315020;202207;916;2476;650;1952;63;231;319;868;382;1099
315030;202207;753;1844;519;1441;168;458;120;298;288;756
315040;202207;1126;2758;943;2474;168;471;577;1409;745;1880
315050;202207;1368;3285;1020;2763;85;269;531;1362;616;1631
315053;202207;1426;3333;1063;2723;99;293;637;1530;736;1823
315057;202207;2105;5557;1668;4831;143;348;1081;3327;1224;3675
315060;202207;789;2198;581;1788;114;377;158;449;272;826
315070;202207;855;1865;669;1580;91;252;410;848;501;1100
315080;202207;3757;9305;2885;7772;129;422;2101;5348;2230;5770
315090;202207;951;2630;718;2213;96;328;331;934;427;1262
315100;202207;1646;4533;1100;3353;135;490;498;1328;633;1818
315110;202207;2545;5567;1874;4595;156;363;1094;2628;1250;2991
315120;202207;14822;32046;11023;26454;1141;2619;6639;15805;7780;18424
315130;202207;1961;5040;1666;4541;177;567;815;2024;992;2591
315140;202207;3570;9204;2855;7995;549;1692;1496;3896;2045;5588
315150;202207;5106;12090;3696;9850;549;1691;1784;4559;2333;6250
315160;202207;2236;5066;1554;4015;247;682;811;2010;1058;2692
315170;202207;1574;4745;1129;3703;220;751;332;1043;552;1794
315180;202207;20620;47965;12289;33192;1628;5028;4625;10809;6253;15837
315190;202207;2636;5409;1995;4571;195;437;1474;3394;1669;3831
315200;202207;5227;13392;3926;11253;1060;3292;1325;3491;2385;6783
315210;202207;10305;25116;7293;19222;710;2096;3695;8566;4405;10662
315213;202207;1218;3038;1058;2816;23;89;871;2251;894;2340
315217;202207;3143;8312;2379;7044;105;449;1669;4676;1774;5125
315220;202207;9928;25133;7837;21664;627;1611;4372;12168;4999;13779
315230;202207;3461;7162;2828;6330;196;369;1852;4301;2048;4670
315240;202207;2895;7670;2395;6819;514;1536;1157;3236;1671;4772
315250;202207;17064;42999;12767;35196;1905;5766;5869;14832;7774;20598
315260;202207;1112;2830;649;1908;132;387;77;190;209;577
315270;202207;1113;2970;834;2449;127;429;350;872;477;1301
315280;202207;3555;8474;2358;6399;622;1760;536;1430;1158;3190
315290;202207;1384;3218;865;2418;196;598;337;892;533;1490
315300;202207;787;1795;581;1489;30;91;422;1057;452;1148
315310;202207;1489;3521;1142;2948;92;286;777;1825;869;2111
315320;202207;742;2056;528;1630;67;247;207;603;274;850
315330;202207;866;2623;522;1768;64;243;214;626;278;869
315340;202207;3366;7751;2335;6194;501;1326;969;2515;1470;3841
315350;202207;2114;4986;1769;4471;160;463;1279;3100;1439;3563
315360;202207;1998;5431;1573;4607;212;655;741;2014;953;2669
315370;202207;638;1669;516;1445;86;238;246;654;332;892
315380;202207;296;770;203;581;42;116;27;51;69;167
315390;202207;1417;3732;1147;3264;113;402;667;1687;780;2089
315400;202207;4807;11912;3838;10252;444;1328;2328;5826;2772;7154
315410;202207;2780;5936;2027;4841;377;1020;514;1172;891;2192
315415;202207;1711;4389;1389;3877;370;1213;357;898;727;2111
315420;202207;1734;4587;1225;3667;266;865;337;871;603;1736
315430;202207;4175;9623;2924;7791;483;1440;1436;3669;1919;5109
315440;202207;1213;2899;948;2490;83;258;590;1421;673;1679
315445;202207;2524;5179;1876;4298;86;242;1529;3401;1615;3643
315450;202207;2584;6511;2105;5747;210;579;1386;3677;1596;4256
315460;202207;51554;128512;43445;114813;4416;14077;28168;68764;32584;82841
315470;202207;781;2056;553;1534;46;142;287;723;333;865
315480;202207;1558;4077;1156;3264;175;528;521;1324;696;1852
315490;202207;3355;7870;2350;6281;333;946;959;2371;1292;3317
315500;202207;602;1539;386;1107;29;93;215;546;244;639
315510;202207;1623;3671;1334;3271;11;51;1164;2757;1175;2808
315520;202207;1253;2973;1051;2669;40;117;868;2133;908;2250
315530;202207;862;2025;719;1789;67;207;532;1230;599;1437
315540;202207;1915;4749;1294;3595;118;396;571;1449;689;1845
315550;202207;2092;5339;1448;4168;263;897;465;1323;728;2220
315560;202207;7574;20411;6510;18577;377;1055;4749;13398;5126;14453
315570;202207;2885;6867;2077;5451;262;841;1094;2496;1356;3337
315580;202207;3753;8104;2953;6889;429;1061;1266;2751;1695;3812
315590;202207;1342;2767;1096;2413;42;159;858;1697;900;1856
315600;202207;2834;8056;1997;6457;416;1244;893;3082;1309;4326
315610;202207;1127;2658;852;2198;114;383;432;939;546;1322
315620;202207;605;1514;455;1286;50;154;236;664;286;818
315630;202207;1273;3181;970;2641;138;426;502;1227;640;1653
315640;202207;452;1039;351;916;31;101;227;549;258;650
315645;202207;1138;2785;796;2252;141;424;220;603;361;1027
315650;202207;2038;4309;1652;3780;69;155;1312;2939;1381;3094
315660;202207;2405;5825;1814;4777;175;463;1103;2817;1278;3280
315670;202207;18193;45317;14223;38329;2303;6720;7347;18384;9650;25104
315680;202207;3626;9504;2718;7875;349;1120;1434;3932;1783;5052
315690;202207;4409;10234;2657;7253;518;1375;795;2247;1313;3622
315700;202207;10086;25158;7724;20692;756;2297;4329;10609;5085;12906
315710;202207;2100;4762;1499;3888;68;215;1025;2541;1093;2756
315720;202207;5039;12901;4140;11352;191;770;2953;7638;3144;8408
315725;202207;2636;6218;2084;5368;200;493;1384;3695;1584;4188
315727;202207;670;1599;492;1297;58;182;256;621;314;803
315730;202207;703;1980;598;1784;128;413;225;591;353;1004
315733;202207;1667;3911;1287;3321;191;561;601;1386;792;1947
315737;202207;1362;3471;1002;2787;32;113;703;1865;735;1978
315740;202207;955;2509;770;2142;73;252;516;1328;589;1580
315750;202207;1514;3567;1166;3055;80;214;770;2012;850;2226
315760;202207;1404;2947;1168;2638;29;102;999;2163;1028;2265
315765;202207;2335;5292;1921;4768;29;96;1733;4264;1762;4360
315770;202207;1366;3560;1099;3193;384;1191;258;726;642;1917
315780;202207;36427;92002;30539;81774;1960;6477;20723;51985;22683;58462
315790;202207;4080;11680;3470;10551;337;1022;2069;6581;2406;7603
315800;202207;1521;4655;1154;3835;156;607;466;1341;622;1948
315810;202207;1580;3523;1318;3108;59;165;1056;2376;1115;2541
315820;202207;3422;7723;2786;6890;253;613;2037;4978;2290;5591
315830;202207;1436;4017;980;3021;107;362;278;695;385;1057
315840;202207;1014;2279;727;1804;45;134;405;894;450;1028
315850;202207;1378;3691;1092;3223;156;493;587;1649;743;2142
315860;202207;626;1617;463;1344;85;261;157;370;242;631
315870;202207;526;1363;419;1191;24;82;297;802;321;884
315880;202207;1317;3068;958;2472;118;359;408;893;526;1252
315890;202207;2096;5418;1715;4902;463;1397;755;2180;1218;3577
315895;202207;7404;18825;5543;15332;590;1897;2797;6991;3387;8888
315900;202207;933;2330;781;2105;89;293;490;1233;579;1526
315910;202207;666;1624;572;1490;54;157;441;1127;495;1284
315920;202207;1609;3884;944;2669;162;562;336;803;498;1365
315930;202207;1318;2725;911;2168;87;216;509;1137;596;1353
315935;202207;1222;3359;974;2894;189;570;416;1222;605;1792
315940;202207;709;1761;558;1550;86;260;297;761;383;1021
315950;202207;1385;3541;1168;3208;96;308;927;2480;1023;2788
315960;202207;6562;17286;4594;13448;1056;3454;1068;2307;2124;5761
315970;202207;656;1662;528;1492;65;199;357;1018;422;1217
315980;202207;5031;10227;2933;6939;491;1253;1436;3017;1927;4270
315990;202207;4019;9772;3155;8310;336;941;1767;4420;2103;5361
316000;202207;873;1898;696;1648;59;167;452;1005;511;1172
316010;202207;852;2254;632;1861;65;209;282;696;347;905
316020;202207;1065;2815;855;2428;92;312;521;1375;613;1687
316030;202207;3181;8011;2422;6692;366;1023;1462;4042;1828;5065
316040;202207;3065;8371;2194;6736;395;1399;584;1494;979;2893
316045;202207;2552;5522;2343;5268;135;196;2061;4732;2196;4928
316050;202207;452;1179;355;1023;35;102;209;547;244;649
316060;202207;830;1845;613;1562;28;89;448;1094;476;1183
316070;202207;6683;16942;5433;14642;798;2195;2822;7189;3620;9384
316080;202207;898;2624;708;2239;165;563;135;366;300;929
316090;202207;536;1372;447;1208;41;145;284;679;325;824
316095;202207;1476;4277;1144;3479;261;863;462;1285;723;2148
316100;202207;2781;7473;2053;5994;319;1062;878;2277;1197;3339
316105;202207;828;2040;658;1768;43;119;433;1180;476;1299
316110;202207;16577;41522;13765;37018;895;2890;9982;25713;10877;28603
316120;202207;1440;3661;922;2580;152;478;348;765;500;1243
316130;202207;1500;3152;1003;2369;66;194;636;1396;702;1590
316140;202207;1329;3366;839;2436;145;424;292;830;437;1254
316150;202207;2529;5333;2008;4570;137;401;1156;2419;1293;2820
316160;202207;1151;2857;921;2459;39;140;675;1745;714;1885
316165;202207;1043;2294;824;1980;81;207;551;1257;632;1464
316170;202207;1515;3293;1172;2810;69;224;855;1893;924;2117
316180;202207;1794;4750;1285;3791;243;779;335;873;578;1652
316190;202207;3084;8289;1803;5326;244;749;738;1881;982;2630
316200;202207;4213;10886;3332;9429;633;1948;1434;3836;2067;5784
316210;202207;6221;17196;4455;13142;1444;4634;513;1298;1957;5932
316220;202207;802;2273;555;1793;108;361;109;349;217;710
316225;202207;1880;3926;1428;3248;48;181;1123;2319;1171;2500
316230;202207;562;1394;432;1179;91;269;210;555;301;824
316240;202207;6522;17199;5679;15725;432;1292;4172;11269;4604;12561
316245;202207;3713;10558;3347;9982;166;761;2637;7460;2803;8221
316250;202207;12874;29145;9741;24103;1843;4834;3934;9543;5777;14377
316255;202207;3455;8961;2984;8217;142;389;2215;6130;2357;6519
316257;202207;1690;3626;1254;2945;86;215;869;1932;955;2147
316260;202207;2977;6170;2355;5233;241;520;1514;3260;1755;3780
316265;202207;1277;3237;1001;2775;27;82;742;1979;769;2061
316270;202207;4330;12251;3676;10895;436;1374;2066;5751;2502;7125
316280;202207;3487;8822;2928;7831;354;1046;1696;4328;2050;5374
316290;202207;4529;11372;3552;9574;423;1272;1522;3770;1945;5042
316292;202207;6873;16778;5548;14713;633;1854;3668;9265;4301;11119
316294;202207;1037;2919;794;2514;139;521;243;678;382;1199
316295;202207;3991;10405;3281;9239;231;780;2160;5747;2391;6527
316300;202207;1216;3079;950;2676;56;168;678;1864;734;2032
316310;202207;917;2344;638;1859;140;473;199;525;339;998
316320;202207;777;2055;598;1773;118;388;144;373;262;761
316330;202207;1207;2920;921;2448;61;173;682;1771;743;1944
316340;202207;1158;2910;885;2440;68;260;574;1460;642;1720
316350;202207;1571;3969;1320;3555;169;457;894;2340;1063;2797
316360;202207;754;1834;638;1651;60;150;492;1293;552;1443
316370;202207;6830;16102;5284;13536;621;1930;2875;6386;3496;8316
316380;202207;2005;4390;1597;3819;87;188;1151;2708;1238;2896
316390;202207;851;2198;632;1829;255;829;123;304;378;1133
316400;202207;1367;3630;906;2753;105;352;347;926;452;1278
316410;202207;1389;3350;1158;3003;39;135;966;2414;1005;2549
316420;202207;2258;5636;1915;5161;34;154;1568;4055;1602;4209
316430;202207;1023;2557;705;2015;107;344;291;760;398;1104
316440;202207;993;2864;808;2541;140;511;237;661;377;1172
316443;202207;659;1719;469;1360;105;352;136;367;241;719
316447;202207;2486;5806;2127;5274;27;93;1886;4565;1913;4658
316450;202207;2430;6623;1846;5469;206;676;1127;3216;1333;3892
316460;202207;1491;3662;1220;3224;117;341;801;1986;918;2327
316470;202207;8481;22557;6384;18466;869;2928;2951;7536;3820;10464
316480;202207;238;587;203;543;38;104;119;303;157;407
316490;202207;387;1022;281;823;53;185;96;233;149;418
316500;202207;1487;4292;1025;3214;205;676;270;751;475;1427
316510;202207;923;2786;750;2456;123;408;377;1222;500;1630
316520;202207;1604;3685;1231;3036;180;507;563;1198;743;1705
316530;202207;1243;3035;915;2466;105;366;450;1082;555;1448
316540;202207;1192;2783;965;2461;140;419;484;1097;624;1516
316550;202207;1640;4237;1378;3782;51;180;1116;2997;1167;3177
316553;202207;5438;14729;4005;11523;511;1672;1825;4525;2336;6197
316555;202207;3095;8444;2694;7924;79;301;2287;6623;2366;6924
316556;202207;616;1372;466;1123;30;92;284;566;314;658
316557;202207;1346;3774;1165;3504;395;1302;434;1237;829;2539
316560;202207;448;1245;324;1020;45;164;135;387;180;551
316570;202207;1636;4291;1369;3839;324;836;466;1411;790;2247
316580;202207;439;869;292;642;29;72;169;344;198;416
316590;202207;1510;3574;1050;2727;160;378;574;1418;734;1796
316600;202207;1112;3036;965;2764;146;458;578;1579;724;2037
316610;202207;720;2009;582;1791;57;218;350;1027;407;1245
316620;202207;2615;6022;2286;5541;141;324;1829;4380;1970;4704
316630;202207;1789;4949;1498;4416;388;1097;592;1985;980;3082
316640;202207;189;485;153;428;31;104;62;139;93;243
316650;202207;1286;3423;1046;3058;72;236;713;2002;785;2238
316660;202207;212;498;100;272;13;39;30;63;43;102
316670;202207;1929;4576;1453;3854;381;1050;487;1185;868;2235
316680;202207;2684;6503;2028;5308;158;476;1389;3500;1547;3976
316690;202207;1594;4300;1187;3548;204;688;371;973;575;1661
316695;202207;1116;3074;907;2703;18;70;610;1761;628;1831
316700;202207;553;1020;471;933;13;29;415;793;428;822
316710;202207;3873;11281;3080;9730;426;1538;1659;4918;2085;6456
316720;202207;24752;63097;19093;52751;2887;8642;9364;24035;12251;32677
316730;202207;614;1380;490;1182;55;146;277;590;332;736
316740;202207;962;2503;842;2321;115;343;576;1574;691;1917
316750;202207;460;1218;342;1023;64;199;144;397;208;596
316760;202207;4483;12864;3830;11664;1292;4343;1471;4345;2763;8688
316770;202207;1853;3822;1396;3228;39;96;1121;2620;1160;2716
316780;202207;680;1845;554;1630;208;675;121;281;329;956
316790;202207;859;2156;634;1729;84;251;206;525;290;776
316800;202207;7671;19827;6136;17206;749;2293;3157;8459;3906;10752
316805;202207;1308;2486;1062;2210;33;89;919;1874;952;1963
316810;202207;827;2080;616;1708;76;234;412;1113;488;1347
316820;202207;411;884;244;612;17;62;147;331;164;393
316830;202207;1002;2410;784;2065;79;208;495;1286;574;1494
316840;202207;3402;7850;2735;6820;148;464;2121;5033;2269;5497
316850;202207;2538;5842;1933;4854;178;535;1206;2765;1384;3300
316860;202207;25771;59784;19580;50597;2517;7591;10432;25261;12949;32852
316870;202207;9982;24789;7572;20410;894;2751;4013;9775;4907;12526
316880;202207;1234;2978;1038;2711;115;365;666;1591;781;1956
316890;202207;1348;2940;844;2278;106;351;530;1343;636;1694
316900;202207;2905;7161;2303;6093;394;1089;992;2385;1386;3474
316905;202207;573;1611;469;1417;133;394;180;580;313;974
316910;202207;1171;2847;812;2250;222;663;219;564;441;1227
316920;202207;2204;4804;1638;3983;190;548;1069;2381;1259;2929
316930;202207;10560;27639;8300;23809;1632;5226;3511;8978;5143;14204
316935;202207;5043;12520;3762;10200;610;1832;1740;4280;2350;6112
316940;202207;7423;20277;5797;17116;859;2804;2644;7111;3503;9915
316950;202207;2288;4810;1768;4126;40;108;1510;3455;1550;3563
316960;202207;6088;12578;4447;10434;349;901;3173;7198;3522;8099
316970;202207;4716;11958;3985;10736;548;1558;1910;4755;2458;6313
316980;202207;900;2407;674;2055;219;755;194;548;413;1303
316990;202207;15018;37553;11361;30558;2516;7231;2610;6192;5126;13423
317000;202207;2981;7703;2609;7209;210;486;1958;5530;2168;6016
317005;202207;3002;7788;2353;6529;331;987;1316;3473;1647;4460
317010;202207;31620;70911;21637;55931;3510;9767;10787;27161;14297;36928
317020;202207;81967;186625;51815;135355;9288;26347;19207;45276;28495;71623
317030;202207;787;1948;630;1729;17;61;475;1275;492;1336
317040;202207;13313;31700;9284;25020;2165;6239;2981;8179;5146;14418
317043;202207;1081;2188;796;1812;40;101;622;1374;662;1475
317047;202207;1338;2939;936;2310;54;163;669;1567;723;1730
317050;202207;1400;4120;1017;3261;150;557;393;1046;543;1603
317052;202207;2887;7033;2302;6138;199;570;1592;4121;1791;4691
317057;202207;2429;4924;1846;4088;41;123;1434;2993;1475;3116
317060;202207;577;1483;350;1022;50;156;140;354;190;510
317065;202207;1263;3500;1036;3064;75;271;658;1798;733;2069
317070;202207;9033;24010;7014;20226;1077;3499;3075;8133;4152;11632
317075;202207;1197;2862;910;2387;100;293;523;1257;623;1550
317080;202207;7706;16816;5880;13961;1140;2886;2842;6471;3982;9357
317090;202207;5510;14449;4832;13391;276;739;3635;10013;3911;10752
317100;202207;3002;6823;2016;5251;399;1069;861;2138;1260;3207
317103;202207;2737;6183;2322;5612;96;361;1892;4324;1988;4685
317107;202207;1768;4160;1328;3353;48;162;881;1908;929;2070
317110;202207;789;1771;439;1220;76;248;171;455;247;703
317115;202207;1257;3395;1032;2982;124;367;626;1794;750;2161
317120;202207;21478;52262;17811;46527;1152;3806;12220;29722;13372;33528
317130;202207;13392;29615;9310;23013;1270;3412;3715;8989;4985;12401
317140;202207;1092;2441;850;2066;65;154;594;1434;659;1588
317150;202207;1169;2551;904;2219;35;117;752;1779;787;1896
317160;202207;4028;9104;2647;6916;260;625;1368;3764;1628;4389
317170;202207;2329;5405;1785;4452;96;302;1193;2670;1289;2972
317180;202207;2188;6383;1617;5066;315;1039;442;1258;757;2297
317190;202207;1289;3305;969;2787;172;532;482;1321;654;1853
317200;202207;7360;18371;5505;14817;1141;3247;1491;3566;2632;6813
317210;202207;1402;3121;1089;2702;41;142;788;1948;829;2090
317220;202207;372;1003;319;910;57;171;186;504;243;675
320010;202207;5458;15132;4202;12601;519;1727;2337;6713;2856;8440
320013;202207;2445;6226;1742;4917;285;839;819;2338;1104;3177
320016;202207;3332;8047;2573;6882;211;573;1745;4612;1956;5185
320020;202207;5345;12805;4083;10674;600;1813;2035;5115;2635;6928
320030;202207;2047;5361;1357;4001;192;615;570;1554;762;2169
320035;202207;2268;5640;1873;5007;332;1012;1067;2732;1399;3744
320040;202207;5152;13588;4295;12093;565;1709;2381;6348;2946;8057
320050;202207;2172;4615;1873;4190;211;595;1212;2489;1423;3084
320060;202207;16689;42839;12547;34819;1994;6020;5851;14810;7845;20830
320070;202207;2266;5510;1710;4498;216;718;947;2164;1163;2882
320080;202207;6562;15839;4658;12202;809;2263;1967;4734;2776;6997
320090;202207;9933;25101;6702;18736;1382;4163;2551;6437;3933;10600
320100;202207;3866;9486;3136;8250;419;1207;1834;4651;2253;5858
320110;202207;2712;5777;1993;4681;203;594;1251;2644;1454;3238
320115;202207;2567;7464;2212;6910;707;2278;926;3016;1633;5294
320120;202207;30722;73002;22229;58340;2823;8197;11401;27489;14224;35686
320130;202207;65428;163224;54137;143826;6353;18514;33357;84280;39710;102794
320140;202207;4624;11847;3302;9318;407;1362;1660;4331;2067;5693
320150;202207;17158;41838;12439;33364;2930;8789;2161;4833;5091;13622
320160;202207;7539;19435;5635;16027;690;2182;2807;7650;3497;9832
320170;202207;2137;5681;1530;4521;400;1183;559;1702;959;2885
320180;202207;870;2559;693;2211;233;820;188;549;421;1369
320190;202207;3526;10459;2673;8621;588;2137;630;1788;1218;3925
320200;202207;1551;4033;1067;3160;222;714;316;932;538;1646
320210;202207;5462;12943;4206;10842;628;1788;2328;5554;2956;7342
320220;202207;4152;9921;3178;8370;581;1618;1545;3791;2126;5409
320225;202207;1719;4940;1185;3751;359;1236;283;869;642;2105
320230;202207;6500;16359;4922;13749;1093;3232;1574;4422;2667;7654
320240;202207;20641;49166;15533;41237;3795;10869;4936;12572;8731;23441
320245;202207;3835;10619;2812;8446;810;2597;467;1292;1277;3889
320250;202207;3296;8168;2221;5863;400;1157;943;2157;1343;3314
320255;202207;2461;6873;2138;6317;430;1345;1253;3704;1683;5049
320260;202207;1706;4549;1090;3269;243;762;273;681;516;1443
320265;202207;2733;8056;2129;6821;853;2959;331;1010;1184;3969
320270;202207;2621;7010;2025;5853;509;1654;664;1855;1173;3509
320280;202207;9591;23242;7846;20432;1146;3400;4766;11633;5912;15033
320290;202207;1563;4419;1013;3171;255;887;273;790;528;1677
320300;202207;5123;14000;4129;12106;1081;3504;1484;4121;2565;7625
320305;202207;6332;16397;4816;13602;861;2716;2307;6126;3168;8842
320310;202207;2578;6590;1825;5058;321;965;806;2012;1127;2977
320313;202207;2958;6885;2027;5236;373;1072;713;1573;1086;2645
320316;202207;1882;4972;1445;4254;229;672;791;2326;1020;2998
320320;202207;26692;65900;19356;53639;4340;12575;7199;19585;11539;32160
320330;202207;3438;8633;2693;7360;416;1176;1530;4165;1946;5341
320332;202207;10063;24892;8058;21386;1546;4443;4067;10299;5613;14742
320334;202207;2203;5857;1527;4513;286;1005;403;915;689;1920
320335;202207;1992;5489;1386;4112;262;909;450;1201;712;2110
320340;202207;6511;14301;5454;12816;419;1136;3717;8505;4136;9641
320350;202207;6338;14326;4479;11161;438;1267;2532;5759;2970;7026
320360;202207;1636;3965;1203;3175;140;388;598;1481;738;1869
320370;202207;3286;9244;2536;7696;702;2364;921;2593;1623;4957
320380;202207;3453;8064;2870;7122;255;783;1939;4462;2194;5245
320390;202207;9365;23122;6883;18373;1369;3915;2897;7173;4266;11088
320400;202207;3871;10302;2878;8243;740;2303;1114;2968;1854;5271
320405;202207;6353;15179;4818;12612;662;1832;2641;6580;3303;8412
320410;202207;5758;13941;4393;11794;741;1997;2187;5914;2928;7911
320420;202207;4602;10738;3555;9122;773;2132;1328;3197;2101;5329
320425;202207;2567;5699;1969;4738;151;390;1311;2997;1462;3387
320430;202207;3765;8998;2998;7709;411;1116;1826;4500;2237;5616
320435;202207;2766;8042;2176;6838;609;2049;829;2652;1438;4701
320440;202207;1841;4742;1379;3876;239;728;598;1523;837;2251
320450;202207;2414;6156;1931;5298;301;1022;1084;2663;1385;3685
320455;202207;5181;14927;3563;11268;841;2964;900;2470;1741;5434
320460;202207;2510;7029;1839;5673;496;1697;524;1464;1020;3161
320465;202207;1796;4728;1309;3803;263;812;606;1742;869;2554
320470;202207;4813;12033;3598;9656;689;2091;1299;3050;1988;5141
320480;202207;2736;6228;2227;5398;284;682;1446;3387;1730;4069
320490;202207;29896;70436;22648;58382;3933;10312;10486;26539;14419;36851
320495;202207;1631;4195;1187;3341;282;926;243;553;525;1479
320500;202207;75545;184043;61204;160198;7042;20774;38031;93257;45073;114031
320501;202207;5833;15776;4430;13285;1266;4232;1283;3713;2549;7945
320503;202207;2934;7932;1970;5974;546;1790;532;1507;1078;3297
320506;202207;3198;9040;2411;7379;699;2311;368;1035;1067;3346
320510;202207;14326;35170;11634;30725;1274;3714;7127;17921;8401;21635
320515;202207;2122;5540;1604;4477;434;1323;527;1380;961;2703
320517;202207;2570;7108;2062;6079;580;1831;759;2171;1339;4002
320520;202207;51689;123762;39914;104414;5788;16825;19400;47670;25188;64495
320530;202207;42274;101699;33751;87384;2588;8187;22157;52957;24745;61144
330010;202207;31944;74357;26827;66388;2121;6048;19931;47182;22052;53230
330015;202207;1886;4129;1501;3566;188;554;977;2133;1165;2687
330020;202207;24916;56952;21088;51591;2174;5908;15569;37011;17743;42919
330022;202207;2341;5908;1823;5083;327;943;843;2317;1170;3260
330023;202207;8091;17701;6397;15189;856;2227;4166;9448;5022;11675
330025;202207;8926;19024;5959;14282;1058;2757;2395;5270;3453;8027
330030;202207;13653;32358;10664;27700;713;2404;7449;17953;8162;20357
330040;202207;20755;48924;17173;43242;834;2728;12996;30787;13830;33515
330045;202207;124776;252155;106348;229536;4915;11726;90953;191755;95868;203481
330050;202207;3730;8947;2953;7738;465;1431;1730;4114;2195;5545
330060;202207;7100;16661;5587;14117;1004;2964;2467;5619;3471;8583
330070;202207;34917;77648;29172;69771;3431;8909;19849;46259;23280;55168
330080;202207;12579;27287;10712;24747;1195;2941;7471;17010;8666;19951
330090;202207;4158;7985;3059;6525;207;413;2196;4700;2403;5113
330093;202207;3498;7582;2698;6542;131;377;2191;5154;2322;5531
330095;202207;1771;4476;1386;3780;145;444;815;2067;960;2511
330100;202207;91924;213789;80024;197127;3270;10154;64972;155470;68242;165624
330110;202207;2821;6926;2300;6115;267;807;1501;3734;1768;4541
330115;202207;3478;7657;2519;6186;439;1151;1381;3147;1820;4298
330120;202207;4446;8688;3454;7482;159;436;2763;5691;2922;6127
330130;202207;6220;15062;5145;13507;665;1801;3380;8669;4045;10470
330140;202207;5194;11252;4309;10086;223;711;3510;7838;3733;8549
330150;202207;3157;7472;2536;6505;406;1145;1495;3600;1901;4745
330160;202207;1866;4546;1447;3863;295;853;784;1915;1079;2768
330170;202207;176370;370001;148952;334356;16709;38063;110430;244267;127139;282330
330180;202207;2614;5509;2109;4834;101;308;1653;3603;1754;3911
330185;202207;14069;30084;11948;27318;429;1295;10238;22605;10667;23900
330187;202207;6690;14829;5291;12639;680;1757;3431;7735;4111;9492
330190;202207;55802;114416;48476;104723;2054;5360;40890;85566;42944;90926
330200;202207;22591;50395;18747;45685;2553;6104;13336;32407;15889;38511
330205;202207;2759;6244;2106;5219;142;415;1452;3357;1594;3772
330210;202207;4036;9111;3036;7517;357;952;1754;4002;2111;4954
330220;202207;17439;38955;13077;31981;1999;5506;6493;14312;8492;19818
330225;202207;5137;11802;4018;10184;220;676;2970;7255;3190;7931
330227;202207;24142;50881;20874;47010;528;1520;18683;41060;19211;42580
330230;202207;2373;5022;1592;4003;142;378;790;1952;932;2330
330240;202207;32566;75219;27694;68057;2125;6012;20888;49348;23013;55360
330245;202207;2093;4817;1317;3487;260;723;569;1365;829;2088
330250;202207;55010;122442;46591;110612;5393;13826;32998;76410;38391;90236
330260;202207;6543;14159;5070;12254;254;771;4063;9436;4317;10207
330270;202207;41187;89902;26256;65736;3447;9499;12715;29651;16162;39150
330280;202207;3332;7494;2636;6400;165;521;1860;4135;2025;4656
330285;202207;36435;75060;29963;66108;1294;3632;24633;51883;25927;55515
330290;202207;5716;11796;4694;10495;276;836;3770;7921;4046;8757
330300;202207;7372;15528;5537;13003;388;1029;4093;9146;4481;10175
330310;202207;3472;7526;2623;6205;146;377;1934;4362;2080;4739
330320;202207;22519;47518;17750;41640;1870;3871;13280;31051;15150;34922
330330;202207;60811;121937;49283;106883;3374;8151;38299;80124;41673;88275
330340;202207;23452;51273;17611;42602;2284;6528;10061;22172;12345;28700
330350;202207;206101;413159;174715;375898;7184;16793;152098;321467;159282;338260
330360;202207;9581;20487;8256;18896;298;698;7149;16136;7447;16834
330370;202207;6797;17135;5456;14954;945;2901;2941;7617;3886;10518
330380;202207;8220;19063;6554;16230;591;1824;4554;10518;5145;12342
330385;202207;5302;13224;4370;11896;707;2191;2459;6310;3166;8501
330390;202207;41592;97260;32176;81626;3194;9829;21374;49957;24568;59786
330395;202207;4295;9388;3547;8459;137;448;2840;6489;2977;6937
330400;202207;4547;10692;3829;9572;169;587;2969;6886;3138;7473
330410;202207;4264;9855;3183;8114;441;1396;1985;4579;2426;5975
330411;202207;3519;8830;2805;7594;174;596;1957;4971;2131;5567
330412;202207;2122;5241;1742;4646;125;414;1223;3040;1348;3454
330414;202207;31643;71337;26305;64240;1561;4402;20636;49025;22197;53427
330415;202207;5940;14630;4431;12066;416;1261;2634;6812;3050;8073
330420;202207;16123;37097;12072;30717;1196;3599;7235;16896;8431;20495
330430;202207;14128;28079;12169;25552;252;828;10592;21337;10844;22165
330440;202207;3661;8622;2855;7306;298;957;1943;4581;2241;5538
330450;202207;1843;4636;1485;4053;120;376;942;2400;1062;2776
330452;202207;23878;54816;19538;48475;1849;5383;13960;32990;15809;38373
330455;202207;838912;1739165;691026;1537185;67923;163246;507973;1092295;575896;1255541
330460;202207;1509;3736;1168;3248;198;578;633;1720;831;2298
330470;202207;7281;16069;5412;13318;1169;3163;2283;5306;3452;8469
330475;202207;12303;28017;10084;25221;1231;3649;6958;16695;8189;20344
330480;202207;7271;17105;6180;15550;474;1309;4446;10688;4920;11997
330490;202207;143547;300706;118236;267655;9897;24030;89686;198124;99583;222154
330500;202207;10530;23052;8933;20952;541;1437;7005;15977;7546;17414
330510;202207;57962;128123;45478;111199;4760;12695;32524;76940;37284;89635
330513;202207;1631;3793;1324;3380;187;513;796;2004;983;2517
330515;202207;3538;8375;2943;7573;345;1075;1934;4672;2279;5747
330520;202207;17130;39559;14465;35654;1205;3540;10451;24507;11656;28047
330530;202207;2081;4656;1517;3840;275;757;748;1834;1023;2591
330540;202207;3745;9001;2908;7627;652;1827;1302;3275;1954;5102
330550;202207;15920;34062;12672;29861;2012;5238;7902;17868;9914;23106
330555;202207;25941;47682;21989;43105;760;1675;18914;36821;19674;38496
330560;202207;5065;11861;4108;10374;546;1471;2718;6538;3264;8009
330570;202207;3750;8936;3275;8266;458;1306;2295;5630;2753;6936
330575;202207;7848;17539;6840;15906;307;869;5696;12597;6003;13466
330580;202207;27208;63790;22546;55866;3262;8536;13300;30769;16562;39305
330590;202207;1915;4480;1603;4088;217;516;1084;2819;1301;3335
330600;202207;16246;37950;13461;33657;817;2521;9609;22671;10426;25192
330610;202207;12582;29367;10370;25995;946;2703;7149;17079;8095;19782
330615;202207;2734;6515;2236;5862;366;862;1481;3989;1847;4851
330620;202207;5368;13618;4318;11899;819;2498;2148;5563;2967;8061
330630;202207;36915;81950;28862;69620;1282;4053;21842;49706;23124;53759
350010;202207;2713;6806;1686;4719;326;984;449;980;775;1964
350020;202207;845;2081;517;1468;69;213;181;459;250;672
350030;202207;4313;11150;3360;9565;667;2165;1753;4612;2420;6777
350040;202207;912;2472;554;1736;78;299;181;433;259;732
350050;202207;1741;4035;1202;3151;198;616;463;960;661;1576
350055;202207;1124;2685;905;2354;118;332;553;1326;671;1658
350060;202207;316;744;168;445;24;78;69;172;93;250
350070;202207;4136;10245;2817;7931;425;1358;1212;2999;1637;4357
350075;202207;759;2040;585;1724;202;603;116;347;318;950
350080;202207;785;1965;556;1581;53;174;266;677;319;851
350090;202207;734;1567;461;1140;71;206;263;580;334;786
350100;202207;3003;7260;2169;5902;127;460;1447;3611;1574;4071
350110;202207;584;1368;439;1120;16;51;303;735;319;786
350115;202207;1435;3942;1175;3430;185;604;609;1615;794;2219
350120;202207;755;1699;443;1172;36;119;247;587;283;706
350130;202207;3975;9806;3146;8331;456;1327;1706;4062;2162;5389
350140;202207;866;2255;627;1834;43;163;359;950;402;1113
350150;202207;572;1631;472;1453;90;305;160;419;250;724
350160;202207;14503;35199;10271;27440;1310;3885;6102;15173;7412;19058
350170;202207;3094;8048;2603;7037;349;1060;1477;3625;1826;4685
350180;202207;1194;2743;718;1912;102;289;358;875;460;1164
350190;202207;4036;10881;2905;8367;400;1381;1480;3620;1880;5001
350200;202207;573;1453;448;1224;25;84;304;764;329;848
350210;202207;7495;16291;5312;12926;418;1239;3631;8252;4049;9491
350220;202207;3594;9359;2581;7435;471;1435;1061;2742;1532;4177
350230;202207;1248;2973;1012;2647;164;496;581;1431;745;1927
350240;202207;736;1974;473;1377;87;251;129;323;216;574
350250;202207;4163;10628;3152;9009;784;2356;1093;2984;1877;5340
350260;202207;1022;2216;654;1612;65;179;394;886;459;1065
350270;202207;5351;13271;4291;11393;541;1643;2524;6143;3065;7786
350275;202207;3288;8074;2705;7221;241;812;1941;4849;2182;5661
350280;202207;22290;48789;14481;36443;2115;5683;7137;16659;9252;22342
350290;202207;4033;10471;2926;8294;470;1491;1384;3567;1854;5058
350300;202207;808;1966;624;1640;74;218;377;905;451;1123
350310;202207;1117;2937;863;2464;106;351;409;1060;515;1411
350315;202207;718;1669;512;1348;28;101;305;695;333;796
350320;202207;19708;47965;15092;40010;2537;7515;7274;17520;9811;25035
350330;202207;16882;39052;12605;31361;1057;3050;8558;19771;9615;22821
350335;202207;431;1152;334;970;38;121;149;410;187;531
350340;202207;1549;3777;952;2680;121;387;438;1105;559;1492
350350;202207;870;2045;681;1840;97;279;423;1130;520;1409
350360;202207;1297;3556;1029;3035;174;547;462;1302;636;1849
350370;202207;805;1883;579;1476;177;427;213;507;390;934
350380;202207;5715;14901;4180;11727;968;2833;1479;3858;2447;6691
350390;202207;13530;32900;10735;28401;1397;4032;6424;15868;7821;19900
350395;202207;507;1243;259;775;31;95;87;237;118;332
350400;202207;10160;23769;7275;19105;1809;5032;2241;5690;4050;10722
350410;202207;12960;34043;9773;28092;1786;5672;4275;11286;6061;16958
350420;202207;1269;3137;904;2421;152;415;312;707;464;1122
350430;202207;791;1900;608;1618;73;228;354;847;427;1075
350440;202207;2513;5757;2053;5093;117;353;1424;3309;1541;3662
350450;202207;8261;21476;6544;18565;1268;4047;3108;8065;4376;12112
350460;202207;2531;6215;1574;4405;227;660;703;1772;930;2432
350470;202207;292;678;234;590;10;28;173;414;183;442
350480;202207;1147;2713;763;2064;169;508;207;488;376;996
350490;202207;2326;5603;1686;4605;301;931;719;1712;1020;2643
350500;202207;764;1907;557;1561;70;211;228;594;298;805
350510;202207;1426;3389;1083;2804;90;267;694;1668;784;1935
350520;202207;2786;7777;2222;6758;321;1100;1053;2867;1374;3967
350530;202207;3637;8684;2786;7110;232;695;1716;3990;1948;4685
350535;202207;1804;4494;1515;4083;220;662;955;2469;1175;3131
350540;202207;2387;4981;1811;4178;170;437;1297;2801;1467;3238
350550;202207;10245;24021;7196;19041;657;2136;4383;10530;5040;12666
350560;202207;5001;12455;4135;11083;240;812;3049;7729;3289;8541
350570;202207;35021;89946;28877;78911;4316;13017;15914;40889;20230;53906
350580;202207;2551;6389;1647;4664;442;1410;487;1078;929;2488
350590;202207;5865;14971;4395;11879;522;1591;2683;6681;3205;8272
350600;202207;40251;90259;26060;66413;3680;10703;12779;29600;16459;40303
350610;202207;8669;22069;6326;17623;783;2521;3488;8911;4271;11432
350620;202207;491;1191;308;902;32;105;174;468;206;573
350630;202207;1936;4377;1444;3581;94;295;1029;2326;1123;2621
350635;202207;12398;27981;9491;23575;1028;2881;6354;14982;7382;17863
350640;202207;1081;2804;601;1775;105;324;183;445;288;769
350650;202207;10528;26578;7579;20997;1249;3830;3328;8382;4577;12212
350660;202207;5820;13911;4578;11961;516;1366;2899;7345;3415;8711
350670;202207;2061;5280;1649;4659;232;674;993;2798;1225;3472
350680;202207;1312;3350;898;2590;142;419;390;1051;532;1470
350690;202207;1670;4092;1212;3308;191;575;652;1700;843;2275
350700;202207;5956;14010;4612;12016;819;2458;2551;6128;3370;8586
350710;202207;3604;8980;3056;8084;552;1688;1673;4051;2225;5739
350715;202207;895;2401;759;2181;147;500;377;935;524;1435
350720;202207;189;455;137;378;18;48;56;136;74;184
350730;202207;726;1971;575;1670;43;150;347;905;390;1055
350740;202207;2070;5092;1435;3868;240;706;542;1271;782;1977
350745;202207;737;1780;430;1199;34;113;213;539;247;652
350750;202207;12894;31873;10322;27601;1679;5288;5337;12834;7016;18122
350760;202207;20155;46067;15297;38101;2219;6541;8675;19101;10894;25642
350770;202207;1239;2884;772;2107;67;198;450;1167;517;1365
350775;202207;815;1791;569;1433;69;169;311;745;380;914
350780;202207;2835;6485;2087;5474;548;1296;864;2535;1412;3831
350790;202207;2557;6508;1656;4850;341;1015;487;1215;828;2230
350800;202207;4359;11377;3714;10315;233;787;2648;6989;2881;7776
350810;202207;3472;7860;2624;6619;509;1288;1260;3061;1769;4349
350820;202207;1123;2520;687;1746;71;218;375;858;446;1076
350830;202207;1015;2601;591;1716;99;308;190;441;289;749
350840;202207;4169;11557;3236;9867;593;1990;1497;4182;2090;6172
350850;202207;9799;25072;7775;21582;1218;3728;4372;11284;5590;15012
350860;202207;4359;10628;3790;9878;135;502;2992;7586;3127;8088
350870;202207;3248;8304;2396;6962;335;1031;1254;3510;1589;4541
350880;202207;1760;4588;1434;3974;374;1069;490;1234;864;2303
350890;202207;572;1457;376;1057;48;148;136;324;184;472
350900;202207;11018;27337;7960;21313;1190;3608;4258;10174;5448;13782
350910;202207;1111;2469;945;2236;76;203;747;1709;823;1912
350920;202207;15046;34678;12788;31192;437;1409;10588;24694;11025;26103
350925;202207;4891;12400;3581;10175;583;1860;1881;4858;2464;6718
350930;202207;1723;4299;1207;3313;88;266;690;1826;778;2092
350940;202207;2979;7143;2361;6173;220;675;1623;3963;1843;4638
350945;202207;1095;2843;835;2361;139;395;392;1022;531;1417
350950;202207;114362;274465;89418;229492;10237;28956;56945;137640;67182;166596
350960;202207;7998;20377;6226;17085;864;2654;3487;8957;4351;11611
350970;202207;4457;11670;3297;9550;892;2848;1039;2466;1931;5314
350980;202207;865;2134;721;1892;140;396;386;945;526;1341
350990;202207;2400;5986;1831;5084;423;1305;750;1946;1173;3251
350995;202207;1018;2909;919;2718;80;295;620;1722;700;2017
351000;202207;3620;9083;2404;6739;542;1581;799;2116;1341;3697
351010;202207;453;1094;298;821;42;134;143;377;185;511
351015;202207;1147;3203;951;2816;178;580;411;1055;589;1635
351020;202207;10143;25533;7768;21541;1519;4437;3903;10199;5422;14636
351030;202207;3595;9800;2889;8434;425;1422;1612;4415;2037;5837
351040;202207;6415;14434;5401;12946;191;590;4496;10340;4687;10930
351050;202207;21006;48425;16034;41074;2540;7019;8855;21635;11395;28654
351060;202207;59153;139384;45758;117223;3831;11220;31836;77775;35667;88995
351070;202207;1740;4071;1019;2899;272;811;207;523;479;1334
351080;202207;3326;7560;2491;6552;261;812;1703;4183;1964;4995
351090;202207;383;999;288;832;56;175;104;287;160;462
351100;202207;3369;8522;2248;6326;455;1420;769;2034;1224;3454
351110;202207;7550;18522;5289;14489;764;2393;2712;6880;3476;9273
351120;202207;854;2119;597;1670;105;305;225;573;330;878
351130;202207;1378;3568;657;1964;111;375;184;469;295;844
351140;202207;2714;7067;2071;5916;428;1371;941;2359;1369;3730
351150;202207;3511;9363;2481;7275;334;1126;1024;2616;1358;3742
351160;202207;1385;4049;1034;3274;211;715;251;673;462;1388
351170;202207;1816;4572;1580;4154;130;393;1123;2771;1253;3164
351190;202207;1171;3086;820;2397;188;550;273;750;461;1300
351200;202207;1952;4460;1493;3817;118;347;1060;2527;1178;2874
351210;202207;1754;4070;1157;3026;67;242;703;1641;770;1883
351220;202207;4333;10776;3746;9867;331;904;2648;6716;2979;7620
351230;202207;2566;6284;2006;5339;341;1023;1009;2367;1350;3390
351240;202207;2815;6945;1803;4932;450;1240;527;1276;977;2516
351250;202207;1237;3179;739;2160;80;267;292;805;372;1072
351260;202207;1034;2439;736;1919;146;387;290;695;436;1082
351270;202207;629;1620;435;1237;48;154;208;491;256;645
351280;202207;4634;11585;3572;9687;720;2030;1497;3783;2217;5813
351290;202207;1764;3950;1164;2947;125;352;775;1863;900;2215
351300;202207;24910;62768;18191;50576;3097;9407;8988;23275;12085;32682
351310;202207;4321;9908;3315;8334;156;535;2481;5864;2637;6399
351320;202207;1025;2870;750;2326;144;489;227;607;371;1096
351330;202207;563;1341;437;1090;26;92;311;691;337;783
351340;202207;8883;21604;7443;19172;1298;3801;4427;10396;5725;14197
351350;202207;15065;35234;12518;31174;827;2410;9698;23016;10525;25426
351360;202207;4788;11552;3937;10329;726;2174;2075;4909;2801;7083
351370;202207;2428;6424;1665;4902;399;1291;484;1204;883;2495
351380;202207;55157;125832;40069;100872;4176;11627;25390;60415;29566;72042
351385;202207;464;1142;201;581;28;81;76;197;104;278
351390;202207;1643;3722;1107;2970;78;241;825;2129;903;2370
351400;202207;1292;3311;1060;2868;135;353;639;1655;774;2008
351410;202207;3104;8100;2316;6647;387;1161;1044;2835;1431;3996
351420;202207;592;1343;356;948;38;98;227;552;265;650
351430;202207;1180;2880;960;2532;52;159;730;1851;782;2010
351440;202207;4114;10257;2795;7683;550;1593;843;1956;1393;3549
351450;202207;2034;5137;1429;4080;283;959;373;805;656;1764
351460;202207;1155;2845;947;2525;113;335;619;1576;732;1911
351470;202207;1450;3455;1153;2978;71;228;789;1907;860;2135
351480;202207;2880;7715;2285;6781;373;1302;1138;3046;1511;4348
351490;202207;2576;6646;2224;6050;74;295;1791;4670;1865;4965
351492;202207;416;1029;355;909;7;20;278;692;285;712
351495;202207;259;637;208;547;21;51;123;306;144;357
351500;202207;50745;114137;39428;96365;4945;12994;25919;59908;30864;72902
351510;202207;15862;35979;11866;29483;1244;3519;7846;18432;9090;21951
351512;202207;560;1426;409;1111;81;220;148;363;229;583
351515;202207;3920;8576;2518;6287;483;1261;657;1718;1140;2979
351518;202207;2866;6940;1896;5248;269;866;874;2044;1143;2910
351519;202207;718;1885;452;1378;92;304;88;217;180;521
351520;202207;1462;3480;695;1995;70;246;350;890;420;1136
351530;202207;407;1025;249;713;40;117;111;272;151;389
351535;202207;1999;4700;1434;3740;228;631;684;1684;912;2315
351540;202207;3184;7380;2195;5704;222;686;1151;2607;1373;3293
351550;202207;8816;20765;6189;16182;617;1835;3558;8493;4175;10328
351560;202207;596;1620;480;1399;111;358;157;418;268;776
351565;202207;296;790;236;684;45;156;76;182;121;338
351570;202207;26977;66538;21221;55774;1861;5491;14159;35178;16020;40669
351580;202207;270;667;159;477;16;44;72;218;88;262
351590;202207;552;1223;288;765;26;69;162;397;188;466
351600;202207;1556;4002;1190;3308;194;556;588;1491;782;2047
351610;202207;825;1849;539;1371;43;117;305;713;348;830
351620;202207;28572;71563;21333;59786;3103;10146;10555;26928;13658;37074
351630;202207;34194;82480;27878;72340;2446;7468;19810;48582;22256;56050
351640;202207;22835;54458;18381;47001;1147;3642;13496;32481;14643;36123
351650;202207;441;1170;223;670;38;126;58;149;96;275
351660;202207;782;2112;531;1588;93;295;127;313;220;608
351670;202207;7323;18664;4889;13527;1039;2795;2023;5123;3062;7918
351680;202207;510;1329;345;988;65;190;105;240;170;430
351685;202207;535;1401;423;1229;89;260;177;456;266;716
351690;202207;1393;3410;825;2340;92;305;384;982;476;1287
351700;202207;1595;3738;1178;3048;207;606;643;1498;850;2104
351710;202207;935;2306;717;1919;57;187;424;1008;481;1195
351720;202207;1790;4340;1253;3432;205;574;576;1462;781;2036
351730;202207;1187;2837;986;2523;69;218;634;1476;703;1694
351740;202207;3936;9360;3205;8058;456;1261;1825;4200;2281;5461
351750;202207;1955;4822;1203;3494;165;515;576;1566;741;2081
351760;202207;3921;10177;2990;8436;539;1738;1464;3687;2003;5425
351770;202207;2380;6111;1953;5351;407;1105;1106;2892;1513;3997
351780;202207;1376;3327;839;2360;113;358;353;914;466;1272
351790;202207;1781;3981;1383;3435;193;488;870;2088;1063;2576
351800;202207;572;1261;293;762;39;107;118;265;157;372
351810;202207;1314;3252;1094;2929;210;583;597;1485;807;2068
351820;202207;3494;8985;2594;7300;590;1794;873;2201;1463;3995
351830;202207;5699;13816;4389;11660;369;1152;2871;7113;3240;8265
351840;202207;10938;27897;8510;23644;952;2983;5134;13123;6086;16106
351850;202207;1756;4623;1158;3441;186;623;414;988;600;1611
351860;202207;3173;8509;2447;7238;327;1102;1446;4150;1773;5252
351870;202207;30872;73619;23801;62270;5022;13557;11092;28658;16114;42215
351880;202207;187818;436710;146678;369493;22218;64365;89129;207634;111347;271999
351885;202207;1126;2774;901;2421;50;188;640;1622;690;1810
351890;202207;985;2452;640;1878;127;427;161;396;288;823
351900;202207;1457;3634;1113;3129;89;241;728;2001;817;2242
351905;202207;634;1695;474;1391;52;183;234;586;286;769
351907;202207;26728;65759;21115;56136;2128;6487;13989;35062;16117;41549
351910;202207;1969;4757;1432;3704;125;368;841;1914;966;2282
351920;202207;1013;2568;783;2143;111;335;328;801;439;1136
351925;202207;1137;2843;908;2461;95;320;539;1338;634;1658
351930;202207;4300;10723;3876;9997;332;988;3101;7756;3433;8744
351940;202207;1279;3138;927;2525;138;436;439;1166;577;1602
351950;202207;1950;4007;1495;3383;64;184;1109;2376;1173;2560
351960;202207;6189;14788;4671;12229;1120;3004;1950;4757;3070;7761
351970;202207;10997;28198;9017;25012;1137;3840;5826;15001;6963;18841
351980;202207;1248;2847;834;2186;100;315;479;1134;579;1449
351990;202207;1704;3796;1253;3155;58;197;672;1482;730;1679
352000;202207;3236;8399;2777;7509;254;810;1914;4817;2168;5627
352010;202207;2808;6906;2274;6073;642;1754;668;1800;1310;3554
352020;202207;1841;4642;1462;3999;246;761;794;1983;1040;2744
352030;202207;7264;17361;5833;15123;692;2134;3784;9194;4476;11328
352040;202207;5023;12026;3624;9467;574;1662;1411;3255;1985;4917
352042;202207;4050;9030;2798;7146;353;1044;1675;4125;2028;5169
352044;202207;2522;6369;1559;4580;246;829;387;913;633;1742
352050;202207;16251;41138;11127;31266;2767;8395;2799;6575;5566;14970
352060;202207;897;2267;681;1892;111;337;313;795;424;1132
352070;202207;1087;2126;732;1665;44;120;445;917;489;1037
352080;202207;538;1340;344;977;42;112;114;293;156;405
352090;202207;1844;5076;1536;4507;172;584;779;2057;951;2641
352100;202207;4420;11629;3499;9887;597;1937;1665;4391;2262;6328
352110;202207;813;2190;609;1809;116;353;244;653;360;1006
352115;202207;678;1739;566;1578;128;396;290;743;418;1139
352120;202207;1033;2727;821;2312;83;235;509;1316;592;1551
352130;202207;2317;6182;1511;4273;210;618;677;1748;887;2366
352140;202207;1467;3788;1068;2994;201;563;458;1258;659;1821
352150;202207;1038;2557;771;2110;82;251;508;1318;590;1569
352160;202207;1115;2618;808;2120;83;249;417;1034;500;1283
352170;202207;3549;8945;2805;7528;383;1163;1567;3840;1950;5003
352180;202207;3045;7775;2354;6596;473;1419;962;2496;1435;3915
352190;202207;1741;4185;1386;3648;223;617;790;2031;1013;2648
352200;202207;374;1093;272;898;43;143;102;326;145;469
352210;202207;25696;55225;20360;48127;1029;2933;16306;37266;17335;40199
352215;202207;755;1857;603;1604;106;301;321;817;427;1118
352220;202207;30991;69590;23347;57047;3237;8950;14067;31185;17304;40135
352230;202207;18761;49673;14848;42684;3497;11042;5925;15284;9422;26326
352240;202207;12816;30786;10001;26244;1783;5177;5204;12438;6987;17615
352250;202207;27929;73230;23065;65285;2603;8132;15671;42901;18274;51033
352260;202207;6060;14365;4282;10983;575;1738;2561;5819;3136;7557
352265;202207;1048;2826;921;2645;147;451;540;1492;687;1943
352270;202207;2187;5981;1712;4997;317;1045;700;1824;1017;2869
352280;202207;2801;6565;2137;5606;250;766;1235;2967;1485;3733
352290;202207;1708;4507;1373;3870;168;510;753;1897;921;2407
352300;202207;1105;2717;742;2012;80;243;401;1004;481;1247
352310;202207;48239;120739;37013;102452;6275;18250;20840;56329;27115;74579
352320;202207;8263;19498;6499;16411;800;2368;3963;8824;4763;11192
352330;202207;2973;7019;2336;6139;272;932;1554;3726;1826;4658
352340;202207;8353;20825;6414;17357;981;2949;3416;8402;4397;11351
352350;202207;2873;7424;2287;6223;130;436;1618;4170;1748;4606
352360;202207;1685;4172;1343;3561;101;326;964;2400;1065;2726
352370;202207;1239;3271;1059;2986;29;98;831;2283;860;2381
352380;202207;1049;2610;796;2183;170;471;314;794;484;1265
352390;202207;17947;42018;12557;32699;1888;5516;7167;17195;9055;22711
352400;202207;4256;11344;3381;9689;859;2684;1355;3554;2214;6238
352410;202207;4243;10102;3321;8625;295;852;2127;5237;2422;6089
352420;202207;974;2356;658;1841;147;435;210;557;357;992
352430;202207;10364;23411;7801;19182;1036;2856;4468;10236;5504;13092
352440;202207;22866;58656;17553;48763;3850;11297;6914;18248;10764;29545
352450;202207;926;2148;511;1448;69;202;210;524;279;726
352460;202207;3589;9157;2567;7395;476;1470;1139;3019;1615;4489
352470;202207;3783;9327;2948;7985;243;777;1917;4806;2160;5583
352480;202207;5081;11439;3461;8685;443;1334;1786;3955;2229;5289
352490;202207;971;2585;773;2244;140;446;355;962;495;1408
352500;202207;13216;32356;9239;25216;3443;10900;1929;3309;5372;14209
352510;202207;4917;12506;3833;10634;501;1553;2325;6081;2826;7634
352520;202207;3421;8467;2653;7202;388;1229;1550;3768;1938;4997
352530;202207;13847;33488;9794;26140;1841;5538;3717;8328;5558;13866
352540;202207;651;1791;491;1477;79;235;206;565;285;800
352550;202207;1127;2904;776;2292;135;465;299;771;434;1236
352560;202207;751;1893;616;1658;50;176;423;1043;473;1219
352570;202207;2642;7044;1772;5353;398;1336;248;483;646;1819
352580;202207;792;1935;671;1727;111;287;356;885;467;1172
352585;202207;414;1088;300;890;31;120;161;428;192;548
352590;202207;16062;40191;11787;32426;2230;6851;6390;16114;8620;22965
352600;202207;2389;5976;1929;5186;146;472;1305;3236;1451;3708
352610;202207;3272;8291;2472;6991;406;1372;1214;3178;1620;4550
352620;202207;6900;16073;5301;13846;1185;3166;2606;6660;3791;9826
352630;202207;1014;2361;759;2013;118;344;374;946;492;1290
352640;202207;3748;9003;2775;7306;277;785;1661;4086;1938;4871
352650;202207;682;1832;473;1403;68;214;186;510;254;724
352660;202207;1259;3456;1063;3074;106;381;694;1846;800;2227
352670;202207;12589;31252;9084;24660;1577;4788;4370;10561;5947;15349
352680;202207;3821;10539;2786;8273;485;1682;1346;3386;1831;5068
352690;202207;31720;75601;25174;65096;1132;3693;18570;45643;19702;49336
352700;202207;868;2086;654;1766;116;327;304;801;420;1128
352710;202207;6544;15865;4798;12816;1118;3320;2127;5156;3245;8476
352720;202207;11270;27384;9122;23625;1651;4654;4729;11348;6380;16002
352725;202207;631;1419;367;973;24;72;210;511;234;583
352730;202207;5956;16977;5329;15562;672;2173;2564;6378;3236;8551
352740;202207;2813;6416;2138;5428;224;647;1260;2994;1484;3641
352750;202207;488;1174;317;879;39;126;155;373;194;499
352760;202207;2020;5233;1601;4467;179;484;877;2335;1056;2819
352770;202207;1072;2705;766;2151;111;330;375;970;486;1300
352780;202207;764;2047;557;1619;119;325;162;461;281;786
352790;202207;474;1199;367;1002;43;118;162;387;205;505
352800;202207;1644;4644;1159;3578;267;852;226;530;493;1382
352810;202207;1466;3338;977;2500;148;374;540;1329;688;1703
352820;202207;523;1404;388;1171;86;269;101;264;187;533
352830;202207;654;1562;323;908;26;82;110;253;136;335
352840;202207;4819;12676;3934;11130;947;2912;1780;4814;2727;7726
352850;202207;14388;32437;10629;26641;2082;5893;5420;12171;7502;18064
352860;202207;1343;3490;1012;2918;164;522;406;1078;570;1600
352870;202207;1004;2437;706;1848;68;205;450;1114;518;1319
352880;202207;2002;4592;1419;3579;219;587;596;1367;815;1954
352885;202207;396;1009;309;865;43;137;187;495;230;632
352890;202207;809;1831;570;1365;40;115;372;783;412;898
352900;202207;22419;55262;15319;41741;2393;6809;6681;16851;9074;23660
352910;202207;441;1117;244;719;19;53;97;247;116;300
352920;202207;3268;7847;2505;6589;119;383;1815;4525;1934;4908
352930;202207;7258;18308;5539;15019;894;2782;2745;6666;3639;9448
352940;202207;30612;76370;23971;63367;3594;10501;14039;34560;17633;45061
352950;202207;662;1688;427;1265;90;281;109;276;199;557
352960;202207;860;2151;516;1450;66;198;171;365;237;563
352965;202207;298;792;208;627;48;153;55;148;103;301
352970;202207;3961;8302;3150;7075;136;359;2552;5498;2688;5857
352980;202207;1596;3809;1253;3343;273;770;703;1812;976;2582
352990;202207;5244;12896;3985;10863;647;1975;2229;5758;2876;7733
353000;202207;552;1432;324;932;50;170;108;259;158;429
353010;202207;3137;7370;2193;5674;402;1174;1019;2377;1421;3551
353020;202207;3954;9754;2460;6811;368;1128;952;2391;1320;3519
353030;202207;5614;13502;3878;10569;930;2670;1128;2894;2058;5564
353040;202207;819;1757;603;1441;80;213;367;804;447;1017
353050;202207;6142;16434;4402;12991;723;2345;2268;6291;2991;8636
353060;202207;59262;140633;49103;124949;2937;9204;37668;91424;40605;100628
353070;202207;12716;33538;9449;26720;1449;4622;4614;11639;6063;16261
353080;202207;5791;14664;4025;11345;785;2484;1633;3938;2418;6422
353090;202207;725;2012;598;1777;44;144;393;1115;437;1259
353100;202207;345;859;157;461;30;95;49;113;79;208
353110;202207;9322;22567;7517;20070;1779;4665;3699;10344;5478;15009
353120;202207;521;1253;396;1047;49;168;213;483;262;651
353130;202207;3383;7586;2284;5742;539;1484;957;2078;1496;3562
353140;202207;3430;7832;2612;6541;178;540;1853;4371;2031;4911
353150;202207;1790;4272;1313;3516;257;747;607;1520;864;2267
353160;202207;768;1892;560;1561;72;223;262;653;334;876
353170;202207;673;1647;521;1435;99;273;259;704;358;977
353180;202207;11422;27054;9129;23247;1950;5351;4823;11633;6773;16984
353190;202207;4078;10303;3216;8632;387;1179;1923;4771;2310;5950
353200;202207;2061;5286;1299;3809;181;618;476;1222;657;1840
353205;202207;531;1488;443;1295;48;154;244;676;292;830
353210;202207;1088;2260;731;1695;26;75;552;1207;578;1282
353215;202207;465;1154;365;991;45;145;173;406;218;551
353220;202207;862;2271;603;1754;118;328;163;432;281;760
353230;202207;924;2429;715;2098;174;595;227;598;401;1193
353240;202207;2857;7159;2411;6476;303;940;1504;3817;1807;4757
353250;202207;1555;3363;1042;2561;139;364;584;1392;723;1756
353260;202207;1353;3016;784;2099;115;343;370;885;485;1228
353270;202207;885;2112;742;1878;78;244;495;1156;573;1400
353280;202207;824;2086;610;1740;133;392;204;569;337;961
353282;202207;2083;5510;1745;4929;149;515;1116;2927;1265;3442
353284;202207;439;1007;252;656;26;85;115;254;141;339
353286;202207;204;490;125;359;26;72;35;82;61;154
353290;202207;1653;4173;1026;2931;185;527;311;795;496;1322
353300;202207;2560;6462;1892;5216;317;987;879;2086;1196;3073
353310;202207;463;1075;345;877;25;82;220;505;245;587
353320;202207;812;1954;690;1782;22;75;537;1336;559;1411
353325;202207;870;2353;629;1846;107;309;274;746;381;1055
353330;202207;732;1757;494;1331;74;219;255;614;329;833
353340;202207;3863;9938;2992;8301;498;1588;1590;3989;2088;5577
353350;202207;4774;11244;3556;9063;817;2115;1235;2831;2052;4946
353360;202207;779;2096;632;1819;64;230;377;1010;441;1240
353370;202207;672;1797;550;1602;38;116;374;1061;412;1177
353380;202207;359;971;286;842;35;121;147;385;182;506
353390;202207;7555;17851;5699;14865;462;1362;3577;8789;4039;10151
353400;202207;633;1592;484;1329;82;260;207;442;289;702
353410;202207;621;1537;468;1261;81;227;260;662;341;889
353420;202207;578;1432;388;1060;76;206;71;153;147;359
353430;202207;2763;7092;2189;6073;393;1144;1090;2831;1483;3975
353440;202207;85292;215162;64588;175498;8608;26038;38494;97150;47102;123188
353450;202207;457;1099;319;874;41;141;165;386;206;527
353460;202207;3967;10096;2987;8354;589;1805;732;1755;1321;3560
353470;202207;10584;26282;7845;21265;1236;3766;3722;9054;4958;12820
353475;202207;1979;4676;1368;3559;141;428;780;1818;921;2246
353480;202207;1885;4594;1538;4060;91;303;1125;2818;1216;3121
353490;202207;1225;3068;886;2461;129;381;407;1028;536;1409
353500;202207;1323;3015;972;2471;198;538;543;1297;741;1835
353510;202207;1114;3036;818;2384;173;549;291;722;464;1271
353520;202207;1260;3092;826;2334;88;276;390;966;478;1242
353530;202207;2955;7259;2376;6250;277;854;1374;3301;1651;4155
353540;202207;2453;6231;1989;5536;290;884;1184;3145;1474;4029
353550;202207;7204;17022;5859;14917;769;2139;3698;8816;4467;10955
353560;202207;2702;6775;2099;5903;566;1693;740;1903;1306;3596
353570;202207;786;1986;517;1487;80;262;219;568;299;830
353580;202207;2708;6687;2114;5588;384;1017;1121;2817;1505;3834
353590;202207;868;2049;635;1673;78;203;379;963;457;1166
353600;202207;1883;4536;1437;3763;169;483;784;1950;953;2433
353610;202207;887;2431;664;1985;108;349;308;849;416;1198
353620;202207;3455;8416;2512;6876;522;1472;884;2178;1406;3650
353625;202207;707;1656;422;1152;55;174;223;568;278;742
353630;202207;1815;5050;1550;4566;231;750;839;2269;1070;3019
353640;202207;1545;3780;1226;3277;171;471;743;1904;914;2375
353650;202207;8819;22565;6868;19098;825;2558;3945;10177;4770;12735
353657;202207;426;1074;324;920;28;96;160;415;188;511
353660;202207;1599;3174;1154;2584;157;365;749;1612;906;1977
353670;202207;5110;13172;4022;11161;708;2288;2022;5013;2730;7301
353680;202207;850;2075;629;1766;82;261;383;998;465;1259
353690;202207;523;1357;237;712;30;94;58;149;88;243
353700;202207;2501;6056;2048;5343;157;461;1455;3631;1612;4092
353710;202207;6183;13524;3793;9336;476;1223;2014;4293;2490;5516
353715;202207;509;1297;296;863;17;68;127;326;144;394
353720;202207;2385;5897;1860;5104;315;937;978;2587;1293;3524
353730;202207;5480;13526;4304;11516;500;1609;2662;6503;3162;8112
353740;202207;2410;5999;1742;4850;349;1078;694;1747;1043;2825
353750;202207;1096;3120;825;2626;188;626;254;767;442;1393
353760;202207;16837;35302;13136;30519;2351;5795;7723;17367;10074;23162
353770;202207;710;1930;429;1338;64;232;76;189;140;421
353780;202207;7573;18574;6255;16298;945;2817;3848;9329;4793;12146
353790;202207;3398;9559;2563;7869;597;2061;631;1594;1228;3655
353800;202207;22336;54675;18009;47987;2603;7049;10590;27359;13193;34408
353810;202207;1503;3829;1028;2855;155;475;446;1158;601;1633
353820;202207;2078;5283;1432;4058;330;1008;403;1007;733;2015
353830;202207;744;1745;560;1464;81;247;283;669;364;916
353850;202207;1879;4825;1458;4068;277;777;630;1665;907;2442
353860;202207;3176;8055;2450;6898;551;1795;1190;2946;1741;4741
353870;202207;36174;89735;26817;72480;3419;10251;14154;34543;17573;44794
353880;202207;3650;9445;2915;8108;214;733;1850;4799;2064;5532
353890;202207;3626;7247;2627;5812;158;443;1879;3738;2037;4181
353900;202207;856;2273;645;1881;87;291;272;706;359;997
353910;202207;3403;8467;2888;7698;221;694;2110;5446;2331;6140
353920;202207;2425;6190;1777;5045;463;1440;430;928;893;2368
353930;202207;5946;14811;4243;11638;772;2339;1915;4613;2687;6952
353940;202207;1489;4065;1079;3260;156;523;427;1132;583;1655
353950;202207;4052;10122;3158;8543;758;2220;1303;3189;2061;5409
353960;202207;925;2288;653;1806;164;425;184;489;348;914
353970;202207;754;1684;575;1422;46;144;426;991;472;1135
353980;202207;19410;45763;15215;38915;793;2463;11353;27467;12146;29930
353990;202207;1100;2530;721;1889;115;326;361;886;476;1212
354000;202207;3023;6994;1802;4728;406;1100;469;1097;875;2197
354010;202207;366;919;261;752;44;138;148;411;192;549
354020;202207;4574;11418;3705;9758;663;1928;1901;4486;2564;6414
354025;202207;849;2216;573;1687;79;262;181;466;260;728
354030;202207;583;1224;324;818;64;157;141;333;205;490
354040;202207;922;2003;610;1538;32;99;452;1059;484;1158
354050;202207;1171;3168;827;2566;159;574;342;999;501;1573
354060;202207;4473;11782;3284;9304;543;1760;1608;3992;2151;5752
354070;202207;4745;11526;3249;8678;504;1515;1588;3717;2092;5232
354075;202207;3428;8910;2780;7810;358;1138;1741;4583;2099;5721
354080;202207;1697;4465;1206;3545;202;632;471;1228;673;1860
354085;202207;513;960;409;831;0;0;327;612;327;612
354090;202207;1975;5192;1683;4607;99;297;1301;3414;1400;3711
354100;202207;25940;65343;18812;53462;3743;11419;8980;24214;12723;35633
354105;202207;1609;3862;1177;3126;145;469;600;1436;745;1905
354110;202207;518;1386;391;1154;72;236;160;439;232;675
354120;202207;1593;4146;1117;3155;230;709;379;929;609;1638
354130;202207;6790;16863;4655;12833;1279;3630;774;1742;2053;5372
354140;202207;23331;55171;16682;43297;2382;6907;8349;19472;10731;26379
354150;202207;3286;7486;2578;6422;643;1625;939;2304;1582;3929
354160;202207;3302;8921;2630;7671;610;1959;1056;2798;1666;4757
354165;202207;815;2257;641;1923;92;332;354;968;446;1300
354170;202207;2287;5933;1874;5196;155;491;1089;2791;1244;3282
354180;202207;495;1330;389;1122;42;125;215;573;257;698
354190;202207;1826;4894;1321;3850;90;303;706;1920;796;2223
354200;202207;1072;2461;813;2051;65;195;537;1240;602;1435
354210;202207;1163;2866;957;2551;55;190;684;1689;739;1879
354220;202207;3598;9106;2740;7504;416;1245;1448;3715;1864;4960
354230;202207;937;2153;760;1943;29;103;592;1445;621;1548
354240;202207;2078;5495;1431;4192;256;806;502;1276;758;2082
354250;202207;723;1708;477;1300;100;269;162;403;262;672
354260;202207;10195;24378;7961;20666;1142;3310;4432;10681;5574;13991
354270;202207;1181;3253;972;2871;149;469;458;1221;607;1690
354280;202207;992;2232;826;1981;46;135;614;1338;660;1473
354290;202207;1105;3294;921;2922;142;478;497;1533;639;2011
354300;202207;4175;11406;3544;10283;875;2530;1645;4652;2520;7182
354310;202207;875;2428;741;2193;159;502;357;1002;516;1504
354320;202207;1115;2583;740;1978;93;280;358;828;451;1108
354323;202207;558;1257;356;900;38;98;175;387;213;485
354325;202207;1673;4798;1130;3563;208;684;234;649;442;1333
354330;202207;11765;27776;8416;21347;866;2544;5406;12547;6272;15091
354340;202207;43874;103632;31859;83551;3885;11615;19283;47595;23168;59210
354350;202207;1392;3348;1113;2902;156;476;668;1595;824;2071
354360;202207;735;1720;463;1292;110;316;139;351;249;667
354370;202207;1162;3072;948;2731;141;433;586;1618;727;2051
354380;202207;746;1915;563;1639;89;332;200;473;289;805
354390;202207;17394;39754;12065;30714;1799;5047;6488;15168;8287;20215
354400;202207;1918;5734;1504;4814;275;918;548;1698;823;2616
354410;202207;8011;19410;6274;16284;928;2715;3566;8491;4494;11206
354420;202207;1765;4300;1282;3439;157;483;719;1732;876;2215
354425;202207;3350;7713;2474;6248;493;1277;1223;2965;1716;4242
354430;202207;1855;4554;1480;4006;103;325;975;2484;1078;2809
354440;202207;700;1720;461;1258;54;161;230;563;284;724
354450;202207;564;1455;325;985;50;169;102;252;152;421
354460;202207;965;2353;656;1820;136;419;262;667;398;1086
354470;202207;494;1230;347;965;15;57;175;418;190;475
354480;202207;1608;3482;1059;2622;86;249;692;1586;778;1835
354490;202207;960;2656;722;2152;134;403;342;925;476;1328
354500;202207;2606;6801;2089;5980;596;1788;665;1828;1261;3616
354510;202207;887;2330;714;2003;52;182;452;1141;504;1323
354515;202207;495;1346;345;1038;55;176;122;341;177;517
354520;202207;9032;23067;6586;18078;844;2723;3775;9413;4619;12136
354530;202207;5782;15000;4606;12838;1132;3101;1744;4802;2876;7903
354540;202207;1572;3892;1176;3213;227;663;505;1292;732;1955
354550;202207;682;1760;550;1527;70;233;297;741;367;974
354560;202207;2612;6002;1448;3884;156;438;817;1995;973;2433
354570;202207;1353;3297;575;1593;122;331;82;214;204;545
354580;202207;10133;25741;6967;19774;1006;3181;3655;9686;4661;12867
354600;202207;2406;5903;1896;5023;281;753;1129;2831;1410;3584
354610;202207;533;1341;298;862;30;88;143;397;173;485
354620;202207;565;1469;352;1060;32;128;168;442;200;570
354625;202207;358;941;224;690;33;118;63;159;96;277
354630;202207;2863;7738;2372;6834;676;2008;677;1806;1353;3814
354640;202207;4354;11391;3380;9555;409;1374;1717;4322;2126;5696
354650;202207;1001;2520;810;2213;107;288;476;1257;583;1545
354660;202207;4135;9284;2374;6492;282;903;1062;2610;1344;3513
354670;202207;1294;3436;921;2670;180;570;345;892;525;1462
354680;202207;6810;16288;5302;13918;936;2628;3016;7739;3952;10367
354690;202207;616;1783;455;1452;82;274;171;502;253;776
354700;202207;1028;2600;742;2049;83;269;401;994;484;1263
354710;202207;565;1455;383;1099;43;125;178;449;221;574
354720;202207;354;812;174;475;63;156;44;131;107;287
354730;202207;12672;33850;9967;28848;1306;4170;5975;16375;7281;20545
354740;202207;371;971;168;506;28;92;27;62;55;154
354750;202207;3128;7747;2169;5961;326;989;910;2159;1236;3148
354760;202207;2541;6445;1844;5212;391;1220;683;1726;1074;2946
354765;202207;414;1064;185;551;20;74;62;152;82;226
354770;202207;2948;6924;2184;5591;452;1144;946;2296;1398;3440
354780;202207;69758;164261;54529;135737;3954;11840;38351;88291;42305;100131
354790;202207;1184;3095;930;2688;72;245;604;1662;676;1907
354800;202207;3112;7646;2379;6476;500;1442;1074;2684;1574;4126
354805;202207;1607;3496;1160;2866;108;271;757;1715;865;1986
354810;202207;717;2016;446;1455;67;255;141;407;208;662
354820;202207;1124;3043;805;2460;160;559;270;662;430;1221
354830;202207;613;1429;362;980;81;237;127;300;208;537
354840;202207;1022;2497;650;1746;53;157;368;888;421;1045
354850;202207;26024;62204;19000;50385;1797;5671;12488;30756;14285;36427
354860;202207;1983;5157;1303;3830;212;675;487;1297;699;1972
354870;202207;76555;180821;60151;151797;4829;14246;41050;96276;45879;110522
354880;202207;7089;16778;3696;9882;428;1329;1566;3333;1994;4662
354890;202207;20272;47964;15999;40764;2086;6053;9325;22514;11411;28567
354900;202207;449;1086;300;834;61;193;115;262;176;455
354910;202207;7071;17789;4563;13368;993;3125;1236;3181;2229;6306
354920;202207;581;1504;298;937;44;145;67;172;111;317
354925;202207;330;892;197;607;19;57;51;144;70;201
354930;202207;421;992;288;758;37;100;141;345;178;445
354940;202207;2900;8069;2204;6625;644;2072;755;1970;1399;4042
354950;202207;1837;4305;1499;3875;99;333;1102;2682;1201;3015
354960;202207;1009;2531;727;2089;93;329;313;797;406;1126
354970;202207;5089;13222;4038;11508;356;1271;2751;7442;3107;8713
354980;202207;41328;93717;29083;73092;2780;8444;18883;43666;21663;52110
354990;202207;89832;209792;66359;168901;4373;13698;45764;107582;50137;121280
354995;202207;3818;7592;2972;6536;133;370;2432;5116;2565;5486
355000;202207;1862;4337;1422;3701;215;656;755;1788;970;2444
355010;202207;4861;12445;3225;9061;1041;2852;711;1959;1752;4811
355020;202207;4155;10918;3124;9176;634;2060;1374;3693;2008;5753
355030;202207;1642528;3845631;1231262;3085093;161482;449572;690919;1586020;852401;2035592
355040;202207;3758;8540;2929;7481;216;591;2257;5700;2473;6291
355050;202207;1302;2744;960;2279;229;562;444;959;673;1521
355060;202207;7679;19362;5765;15951;883;2824;3171;7957;4054;10781
355070;202207;12173;29031;10120;25863;1086;3302;6737;16041;7823;19343
355080;202207;1114;3039;714;2320;158;564;126;345;284;909
355090;202207;1543;4003;1245;3517;208;653;665;1719;873;2372
355100;202207;29068;70707;23225;62182;3101;8922;15013;38982;18114;47904
355110;202207;1102;2867;811;2444;197;669;90;236;287;905
355120;202207;867;2145;619;1788;74;240;292;798;366;1038
355130;202207;959;2073;537;1326;26;76;364;817;390;893
355140;202207;2525;4998;2142;4475;91;230;1878;3811;1969;4041
355150;202207;5536;13527;4499;11794;484;1386;2936;7307;3420;8693
355160;202207;2735;7038;1980;5749;439;1382;565;1487;1004;2869
355170;202207;14150;33279;11267;28633;1815;5024;6363;15393;8178;20417
355180;202207;3382;8198;2502;6856;443;1429;1299;3196;1742;4625
355190;202207;2221;5557;1751;4817;613;1711;658;1947;1271;3658
355200;202207;999;2880;854;2653;228;783;338;1010;566;1793
355210;202207;3690;9429;2813;7622;543;1565;1309;3337;1852;4902
355220;202207;60229;148625;49020;127941;7317;21256;27276;65087;34593;86343
355230;202207;1417;3442;795;2231;137;402;267;643;404;1045
355240;202207;29357;74035;21198;58643;2209;6929;12765;32897;14974;39826
355250;202207;46441;116177;35630;96197;7461;21221;17082;43210;24543;64431
355255;202207;744;1801;405;1189;41;114;128;362;169;476
355260;202207;1852;4101;1371;3361;101;336;956;2152;1057;2488
355270;202207;1372;3813;1090;3271;231;723;488;1343;719;2066
355280;202207;38130;90751;28246;73263;3301;9544;16264;39057;19565;48601
355290;202207;1116;2803;865;2400;153;427;414;1088;567;1515
355300;202207;1631;4436;1347;3931;241;748;596;1566;837;2314
355310;202207;1054;2769;787;2305;103;330;433;1227;536;1557
355320;202207;639;1628;485;1342;107;354;206;455;313;809
355330;202207;3530;8427;2769;7146;114;386;2100;5113;2214;5499
355340;202207;4850;10347;3736;8904;643;1549;2069;5022;2712;6571
355350;202207;1643;4332;1263;3631;242;789;561;1469;803;2258
355360;202207;1475;3513;1145;3008;134;367;671;1633;805;2000
355365;202207;418;1019;221;683;38;119;56;157;94;276
355370;202207;6327;15340;4929;13137;1034;2455;2312;6538;3346;8993
355380;202207;3415;8574;2652;7218;507;1502;1025;2405;1532;3907
355385;202207;1702;4115;1408;3708;99;345;930;2202;1029;2547
355390;202207;953;2513;696;1989;114;348;313;797;427;1145
355395;202207;2223;5952;1619;4760;265;864;671;1715;936;2579
355400;202207;11142;29979;9019;25949;1922;6304;3873;9939;5795;16243
355410;202207;28638;74555;18958;55146;3682;11761;6627;18016;10309;29777
355420;202207;734;2211;610;1982;142;508;203;613;345;1121
355430;202207;4387;10525;3383;8783;585;1623;1711;4290;2296;5913
355440;202207;870;2252;565;1641;91;261;127;318;218;579
355450;202207;4119;10064;2863;7698;410;1244;1390;3277;1800;4521
355460;202207;593;1391;388;1040;41;125;175;428;216;553
355465;202207;549;1323;446;1163;59;161;284;719;343;880
355470;202207;1380;3351;808;2219;199;608;277;680;476;1288
355475;202207;407;879;338;794;10;28;270;612;280;640
355480;202207;4935;12782;3940;11262;501;1662;2556;7060;3057;8722
355490;202207;1053;2721;605;1819;57;201;291;798;348;999
355495;202207;1033;2708;770;2270;101;367;328;840;429;1207
355500;202207;8171;19858;5333;14587;732;2242;2330;5631;3062;7873
355510;202207;1621;3846;1097;2977;196;562;455;1107;651;1669
355520;202207;420;962;220;629;45;123;63;180;108;303
355530;202207;365;813;150;411;7;21;76;189;83;210
355535;202207;648;1681;522;1478;109;330;254;657;363;987
355540;202207;14374;32892;12002;29663;1193;3362;8799;20849;9992;24211
355550;202207;744;2081;632;1876;69;241;352;936;421;1177
355560;202207;1317;3286;772;2241;168;524;33;104;201;628
355570;202207;346;895;198;585;37;115;59;155;96;270
355580;202207;1411;3239;872;2341;154;467;284;685;438;1152
355590;202207;188;476;143;402;14;39;81;218;95;257
355600;202207;1787;4252;1167;3181;202;607;369;963;571;1570
355610;202207;2251;5281;1506;4032;178;504;823;2011;1001;2515
355620;202207;6021;15110;4583;12409;490;1613;2654;6487;3144;8100
355630;202207;3026;7663;2208;6197;281;848;1284;3342;1565;4190
355635;202207;1091;2995;798;2420;120;389;291;799;411;1188
355640;202207;4035;10527;2742;8013;630;1836;651;1876;1281;3712
355645;202207;4687;12394;3430;10197;485;1596;1898;5369;2383;6965
355650;202207;8289;20996;6620;18036;1395;4008;3134;7803;4529;11811
355660;202207;1645;4091;1128;3209;200;525;324;850;524;1375
355670;202207;4837;12263;3480;9368;439;1445;1814;4149;2253;5594
355680;202207;3336;8787;1684;5067;436;1433;145;426;581;1859
355690;202207;869;2442;592;1924;168;580;12;24;180;604
355695;202207;294;782;175;526;14;47;35;76;49;123
355700;202207;9368;24726;7905;21721;972;3051;4845;12420;5817;15471
355710;202207;11500;26012;8000;19753;1083;3143;4282;9104;5365;12247
355715;202207;542;1420;301;883;68;198;59;161;127;359
355720;202207;1693;4443;1336;3841;181;576;752;1982;933;2558
355730;202207;1208;3072;969;2668;110;355;547;1383;657;1738
410010;202207;1408;3760;1084;3105;233;707;241;637;474;1344
410020;202207;1249;3439;946;2810;265;754;262;723;527;1477
410030;202207;1888;4788;1588;4333;201;558;881;2398;1082;2956
410040;202207;16420;42544;12233;34933;2551;7878;4195;10928;6746;18806
410045;202207;899;2331;646;1824;124;382;219;543;343;925
410050;202207;2580;6281;1815;4978;271;823;715;1799;986;2622
410060;202207;2392;6423;1921;5559;468;1453;558;1505;1026;2958
410070;202207;2295;5555;1692;4513;334;972;611;1426;945;2398
410080;202207;1557;3973;1113;3207;249;749;240;630;489;1379
410090;202207;1312;2981;1081;2656;119;268;581;1517;700;1785
410100;202207;2407;6488;1677;4881;316;985;177;478;493;1463
410105;202207;602;1442;368;1006;28;83;173;432;201;515
410110;202207;3818;8974;2757;7148;358;1056;1408;3317;1766;4373
410115;202207;653;1623;473;1308;60;186;191;470;251;656
410120;202207;3548;8746;3106;8098;478;1236;1996;5125;2474;6361
410130;202207;1516;3784;1332;3458;186;547;777;1903;963;2450
410140;202207;20148;47044;13493;35482;2530;7166;4153;9849;6683;17015
410150;202207;19161;43783;10417;27263;1773;4984;3060;6952;4833;11936
410160;202207;3476;9223;2831;8127;613;1957;1068;2886;1681;4843
410165;202207;724;1865;570;1551;77;246;312;786;389;1032
410170;202207;3399;8414;2184;5907;430;1272;276;635;706;1907
410180;202207;19478;51345;15205;43039;2399;7475;7628;19438;10027;26913
410185;202207;520;1428;395;1133;69;216;135;318;204;534
410190;202207;2581;6184;1873;4940;403;1086;500;1167;903;2253
410200;202207;6760;14680;3798;9765;743;2031;622;1456;1365;3487
410210;202207;3657;8848;2333;6538;375;1190;786;1882;1161;3072
410220;202207;618;1550;415;1180;76;233;132;334;208;567
410230;202207;2167;5545;1666;4576;239;765;733;1722;972;2487
410240;202207;6019;15087;4189;11674;842;2699;677;1631;1519;4330
410250;202207;2681;6254;1966;5115;172;527;933;2297;1105;2824
410260;202207;2262;5314;1408;3767;201;558;715;1794;916;2352
410270;202207;570;1453;409;1158;54;178;164;402;218;580
410275;202207;701;1864;488;1413;77;261;203;519;280;780
410280;202207;2750;6898;1888;5308;236;765;835;2070;1071;2835
410290;202207;3802;10124;2643;7793;740;2153;705;2053;1445;4206
410300;202207;806;1908;634;1644;64;198;331;758;395;956
410302;202207;375;909;229;649;22;76;107;279;129;355
410304;202207;1671;3745;1455;3368;126;314;1100;2409;1226;2723
410305;202207;1963;4457;1368;3596;112;328;911;2288;1023;2616
410310;202207;3323;8349;2737;7331;247;850;1749;4386;1996;5236
410315;202207;864;1877;535;1366;176;450;148;376;324;826
410320;202207;1125;3029;750;2291;98;318;123;338;221;656
410322;202207;753;1933;392;1128;53;161;156;381;209;542
410330;202207;1738;4057;1212;3106;192;503;413;974;605;1477
410335;202207;983;2478;736;2038;121;372;295;725;416;1097
410337;202207;932;2238;652;1714;96;277;234;526;330;803
410340;202207;547;1468;370;1056;27;92;163;369;190;461
410345;202207;3043;7664;1822;5123;386;1152;638;1578;1024;2730
410347;202207;882;2188;652;1788;72;195;200;553;272;748
410350;202207;1877;4393;1348;3558;146;452;721;1705;867;2157
410360;202207;4618;11205;3499;9290;623;1713;1299;3302;1922;5015
410370;202207;16336;42037;10726;29329;1252;3841;4537;10468;5789;14309
410380;202207;2024;4752;1471;3810;237;695;537;1208;774;1903
410390;202207;3293;7597;2230;5845;448;1390;906;2011;1354;3401
410395;202207;1050;2838;833;2423;145;430;329;973;474;1403
410400;202207;8781;21107;6663;17291;803;2341;3884;9241;4687;11582
410405;202207;1025;2265;722;1816;106;293;362;824;468;1117
410410;202207;1742;4209;1568;3951;130;377;1089;2696;1219;3073
410420;202207;13837;35084;10542;28882;1643;4908;4798;11737;6441;16645
410425;202207;4153;10806;2861;8230;501;1525;1096;2821;1597;4346
410430;202207;15365;36787;10948;28986;1666;4897;4251;10124;5917;15021
410440;202207;2686;7331;2302;6642;362;1131;1238;3457;1600;4588
410442;202207;2848;7947;2297;6797;622;1925;661;1834;1283;3759
410445;202207;2597;7014;1854;5627;403;1335;280;924;683;2259
410450;202207;1754;4101;1318;3441;235;655;486;1140;721;1795
410460;202207;2730;6427;1976;5128;279;802;942;2197;1221;2999
410465;202207;3365;9123;2597;7723;473;1428;921;2475;1394;3903
410470;202207;2710;7021;1911;5633;556;1797;203;635;759;2432
410480;202207;46338;107165;26671;73526;3984;12318;7578;17579;11562;29897
410490;202207;13628;35320;9971;28084;1616;4860;4465;11415;6081;16275
410500;202207;2126;5251;1408;3923;258;762;322;725;580;1487
410510;202207;2092;4985;1450;3889;327;831;438;1188;765;2019
410520;202207;3451;10155;3015;9332;924;3009;1081;3367;2005;6376
410530;202207;1805;4280;869;2401;111;337;228;503;339;840
410540;202207;3245;8301;2241;6330;346;1122;965;2479;1311;3601
410550;202207;8965;22888;6126;17054;1027;3144;1795;4153;2822;7297
410560;202207;1841;4520;1340;3550;289;813;416;925;705;1738
410570;202207;3107;7842;2231;6365;737;2394;255;717;992;3111
410580;202207;32139;78692;24409;65022;3636;10856;12560;30686;16196;41542
410590;202207;1900;5054;1348;3799;196;588;434;999;630;1587
410600;202207;2080;5171;1630;4325;329;894;560;1457;889;2351
410610;202207;811;1987;612;1639;61;193;296;701;357;894
410620;202207;3145;8197;2214;6226;547;1594;533;1372;1080;2966
410630;202207;2967;7263;1976;5367;376;1207;494;1026;870;2233
410640;202207;5799;13042;4041;10025;898;2466;636;1583;1534;4049
410645;202207;1360;3465;1122;3174;185;562;741;2073;926;2635
410650;202207;2868;7421;1998;5700;354;1112;814;2075;1168;3187
410655;202207;1004;2329;716;1843;55;148;358;847;413;995
410657;202207;693;1826;433;1287;70;222;157;397;227;619
410660;202207;4239;10105;2612;6804;416;1163;958;2158;1374;3321
410670;202207;1175;2838;716;1958;113;316;259;626;372;942
410680;202207;2765;7860;1830;5614;434;1375;343;1022;777;2397
410685;202207;592;1454;434;1187;94;281;177;454;271;735
410690;202207;163172;378565;113937;291050;17053;49256;50390;112522;67443;161778
410700;202207;2835;6883;2342;6131;517;1391;977;2383;1494;3774
410710;202207;1041;2525;666;1830;132;398;281;685;413;1083
410712;202207;768;2001;639;1772;85;260;357;944;442;1204
410715;202207;1018;2783;641;1964;70;235;266;748;336;983
410720;202207;4230;10039;3506;8835;534;1613;1320;3093;1854;4706
410725;202207;1339;3131;811;2200;185;554;166;365;351;919
410730;202207;927;2283;659;1803;107;335;153;411;260;746
410740;202207;992;2639;748;2193;64;231;369;1058;433;1289
410750;202207;2228;5150;1781;4377;295;768;914;2090;1209;2858
410752;202207;448;1043;243;663;50;122;100;252;150;374
410753;202207;382;1067;269;832;40;143;79;218;119;361
410754;202207;1257;3043;1052;2748;74;186;750;2005;824;2191
410755;202207;646;1581;472;1271;67;173;211;515;278;688
410760;202207;4196;10436;2959;8204;679;2198;810;2078;1489;4276
410765;202207;19558;50657;15530;43216;3143;9664;4973;11861;8116;21525
410770;202207;1197;2731;836;2139;84;186;426;1098;510;1284
410773;202207;1495;3680;1292;3365;119;361;865;2147;984;2508
410775;202207;1869;4068;1625;3729;50;130;1214;2644;1264;2774
410780;202207;728;1718;485;1270;93;258;150;357;243;615
410785;202207;877;2098;640;1714;84;274;262;654;346;928
410790;202207;1178;3246;975;2868;209;653;148;343;357;996
410800;202207;3962;8244;3168;7134;75;229;2128;4546;2203;4775
410810;202207;510;1307;373;1044;42;148;164;396;206;544
410820;202207;1146;3079;630;1789;123;380;138;299;261;679
410830;202207;50580;114221;36132;90609;6099;17374;16488;37759;22587;55133
410832;202207;1247;3138;1014;2737;97;320;632;1556;729;1876
410840;202207;10483;25156;6258;17297;1290;3930;1817;4189;3107;8119
410845;202207;1324;3059;1019;2611;145;405;502;1201;647;1606
410850;202207;2469;6583;2149;6033;376;1197;1027;2709;1403;3906
410855;202207;830;1982;522;1394;61;179;257;598;318;777
410860;202207;5491;12362;4348;10550;240;738;2938;6590;3178;7328
410865;202207;1675;4511;1423;4057;139;441;815;2375;954;2816
410870;202207;1391;3536;1113;3059;135;405;641;1697;776;2102
410880;202207;5446;13785;3821;10947;714;2149;730;2046;1444;4195
410890;202207;1262;3281;999;2803;175;519;422;1092;597;1611
410895;202207;1156;3423;952;2999;296;1029;260;725;556;1754
410900;202207;981;2502;676;1956;100;321;163;354;263;675
410910;202207;507;1120;321;782;14;37;185;402;199;439
410920;202207;1008;2307;763;1936;112;311;384;922;496;1233
410930;202207;2015;4923;1398;3882;348;1106;253;646;601;1752
410940;202207;28312;72355;20831;59291;3848;12097;8132;21625;11980;33722
410950;202207;2275;6064;2045;5718;129;372;1626;4475;1755;4847
410960;202207;9690;22249;6843;17687;1664;4882;2882;6932;4546;11814
410965;202207;1341;3222;898;2445;100;318;510;1288;610;1606
410970;202207;4830;12340;3421;9651;864;2844;563;1262;1427;4106
410975;202207;1666;3810;1241;3150;180;530;564;1351;744;1881
410980;202207;8694;20627;5758;15574;612;1853;2717;6577;3329;8430
410990;202207;1686;3795;1153;2990;190;540;539;1351;729;1891
411000;202207;785;2056;548;1628;101;329;179;469;280;798
411005;202207;538;1273;330;866;41;112;120;269;161;381
411007;202207;2898;7351;2149;6025;412;1286;814;2108;1226;3394
411010;202207;5082;14202;3973;12078;1051;3338;604;1618;1655;4956
411020;202207;2716;7189;2240;6402;580;1740;737;2012;1317;3752
411030;202207;832;2009;574;1496;73;211;251;557;324;768
411040;202207;1175;2857;627;1718;101;290;171;378;272;668
411050;202207;2287;6767;1847;5869;402;1407;352;918;754;2325
411060;202207;2543;6469;1662;4691;350;1021;430;1113;780;2134
411065;202207;452;1096;275;749;24;78;117;291;141;369
411070;202207;8842;21036;7028;18163;806;2385;3898;9475;4704;11860
411080;202207;2286;5723;1839;4958;437;1328;515;1312;952;2640
411090;202207;917;2378;592;1742;86;275;138;351;224;626
411095;202207;2922;6639;1680;4476;240;670;314;718;554;1388
411100;202207;1420;3515;968;2709;106;349;361;932;467;1281
411110;202207;744;1870;346;1028;38;102;25;49;63;151
411120;202207;1755;4347;1430;3836;280;899;611;1436;891;2335
411125;202207;6224;17041;5516;15798;1260;3645;2491;7273;3751;10918
411130;202207;819;2060;579;1625;147;394;149;449;296;843
411140;202207;2551;7405;2090;6459;521;1686;647;2007;1168;3693
411150;202207;4737;11411;3197;8456;673;1907;349;724;1022;2631
411155;202207;1213;2895;805;2166;118;346;373;868;491;1214
411160;202207;444;956;297;728;34;93;86;209;120;302
411170;202207;933;2529;711;2074;152;498;305;819;457;1317
411180;202207;6874;16873;5491;14585;748;2241;2920;7010;3668;9251
411190;202207;2341;5776;1777;4800;244;737;782;1839;1026;2576
411200;202207;5760;14604;4324;12089;909;2980;1386;3228;2295;6208
411210;202207;4035;8660;2889;6843;409;1096;1338;2928;1747;4024
411220;202207;1075;2605;729;1980;136;381;245;613;381;994
411230;202207;1005;2556;749;2077;161;477;242;623;403;1100
411240;202207;1831;4143;1278;3235;224;611;519;1207;743;1818
411250;202207;2648;6644;1924;5365;383;1194;621;1557;1004;2751
411260;202207;361;893;240;654;30;105;96;219;126;324
411270;202207;2305;5824;1682;4626;263;770;783;1929;1046;2699
411275;202207;1821;3896;1279;3059;136;405;713;1535;849;1940
411280;202207;1628;4164;1164;3300;294;884;266;680;560;1564
411290;202207;948;2367;616;1731;59;196;339;901;398;1097
411295;202207;1428;3437;1039;2746;134;387;469;1130;603;1517
411300;202207;1170;2827;770;2066;81;248;322;712;403;960
411310;202207;1053;2261;817;1955;121;304;412;927;533;1231
411320;202207;6436;15557;4801;12771;691;2038;2257;5272;2948;7310
411325;202207;1679;4429;1367;3852;276;782;651;1880;927;2662
411330;202207;3774;9633;2766;7851;605;1913;846;2305;1451;4218
411340;202207;951;2519;572;1695;90;284;162;413;252;697
411342;202207;1236;2878;673;1775;117;341;237;533;354;874
411345;202207;1406;3307;1028;2681;72;219;686;1741;758;1960
411350;202207;3387;8664;2241;6455;580;1762;425;1081;1005;2843
411360;202207;895;1992;670;1651;66;207;381;824;447;1031
411370;202207;69352;164046;51154;133958;3992;12466;30508;73135;34500;85601
411373;202207;1679;3967;1325;3439;148;404;661;1729;809;2133
411375;202207;1304;3101;912;2388;102;283;377;901;479;1184
411380;202207;1329;2934;903;2158;50;128;587;1278;637;1406
411390;202207;1772;4590;1386;3794;217;657;549;1264;766;1921
411400;202207;2744;6357;2072;5192;190;549;1154;2689;1344;3238
411410;202207;3284;8755;2437;7040;525;1624;612;1596;1137;3220
411420;202207;4922;11592;2675;7475;367;1112;517;1053;884;2165
411430;202207;4520;11254;3422;9301;676;2072;1233;2852;1909;4924
411435;202207;513;1325;300;903;51;153;77;201;128;354
411440;202207;2980;7772;2358;6642;474;1467;761;1949;1235;3416
411450;202207;2949;7347;2229;6194;281;790;1281;3535;1562;4325
411460;202207;5174;12895;3287;9332;500;1591;757;1771;1257;3362
411470;202207;969;2318;729;1907;116;353;337;782;453;1135
411480;202207;6295;15688;4579;12602;812;2618;1595;3809;2407;6427
411490;202207;1918;4624;1457;3912;167;532;646;1528;813;2060
411500;202207;1569;4020;1075;2995;179;541;220;480;399;1021
411510;202207;2699;6268;2135;5399;324;976;664;1659;988;2635
411520;202207;40787;96358;24961;66032;2963;9155;10654;24471;13617;33626
411530;202207;1081;2657;606;1765;97;322;126;328;223;650
411535;202207;590;1630;401;1220;51;165;125;334;176;499
411540;202207;3067;7113;2152;5512;90;280;1306;3214;1396;3494
411545;202207;1035;2835;859;2518;70;232;556;1598;626;1830
411550;202207;814;1919;625;1588;104;274;191;435;295;709
411560;202207;2274;6067;1259;3884;189;621;97;227;286;848
411570;202207;8572;19043;5996;15230;1387;3790;1712;4062;3099;7852
411573;202207;896;2289;732;2002;131;406;344;854;475;1260
411575;202207;2349;5969;1740;4812;316;945;550;1375;866;2320
411580;202207;5603;12732;3416;9277;531;1637;633;1416;1164;3053
411585;202207;683;1946;340;1074;65;203;62;176;127;379
411590;202207;507;1314;376;1058;41;138;197;498;238;636
411600;202207;389;919;245;688;41;116;93;235;134;351
411605;202207;1828;4040;1183;3061;160;474;570;1472;730;1946
411610;202207;3296;6984;2376;5432;56;192;1771;3707;1827;3899
411620;202207;3357;8266;2808;7437;470;1286;1439;3759;1909;5045
411630;202207;965;2333;622;1740;91;316;245;581;336;897
411640;202207;543;1351;374;997;48;129;145;320;193;449
411650;202207;225;612;139;427;28;93;32;77;60;170
411660;202207;1033;2488;724;1911;78;226;290;672;368;898
411670;202207;1763;3975;1182;2946;102;272;683;1539;785;1811
411680;202207;1646;4204;1227;3407;241;726;449;1169;690;1895
411690;202207;4581;11050;3386;9007;693;1835;1039;2825;1732;4660
411695;202207;723;2046;502;1498;43;138;224;620;267;758
411700;202207;1923;4776;1300;3611;298;872;264;679;562;1551
411705;202207;2706;7295;2300;6622;359;1059;1426;4216;1785;5275
411710;202207;2359;5761;1624;4410;361;1007;482;1176;843;2183
411720;202207;1228;2813;867;2192;127;326;332;771;459;1097
411721;202207;1127;2697;830;2162;135;363;271;660;406;1023
411722;202207;1072;2823;616;1787;108;334;202;459;310;793
411725;202207;1465;3916;950;2891;220;719;232;648;452;1367
411727;202207;1687;4457;1103;3240;236;726;134;325;370;1051
411729;202207;688;1665;393;1090;59;194;114;253;173;447
411730;202207;6367;15701;4942;13027;848;2463;2413;5992;3261;8455
411740;202207;577;1451;315;897;78;204;62;142;140;346
411745;202207;871;2379;619;1832;87;289;147;323;234;612
411750;202207;7045;17513;5262;14201;654;1974;2708;6784;3362;8758
411760;202207;8435;20861;6469;17712;1930;5426;1490;4337;3420;9763
411770;202207;3742;10188;2782;8166;607;1902;650;1690;1257;3592
411780;202207;3071;8081;2638;7359;668;1940;976;2786;1644;4726
411790;202207;3473;7971;2119;5651;322;973;707;1597;1029;2570
411800;202207;1340;3671;962;2759;192;595;221;532;413;1127
411810;202207;1768;4370;1328;3554;224;627;521;1249;745;1876
411820;202207;16529;42345;13796;37834;3068;8741;7035;18542;10103;27283
411830;202207;583;1399;437;1141;139;327;65;183;204;510
411840;202207;14517;36663;10205;28120;1615;4842;3460;8326;5075;13168
411845;202207;726;1978;447;1361;72;252;119;314;191;566
411850;202207;9142;21962;6344;17232;1560;4433;1359;3329;2919;7762
411860;202207;846;2248;638;1842;98;318;152;401;250;719
411870;202207;677;1864;488;1452;127;432;98;250;225;682
411880;202207;2821;6441;2040;5221;231;690;963;2258;1194;2948
411885;202207;1255;3175;892;2493;127;420;236;523;363;943
411890;202207;1684;4302;1221;3512;222;707;143;378;365;1085
411900;202207;960;2495;602;1755;138;425;127;347;265;772
411910;202207;1245;3508;896;2827;168;639;285;804;453;1443
411915;202207;18207;43057;12804;33489;1863;5403;5637;13175;7500;18578
411920;202207;1379;3701;1135;3260;234;745;446;1180;680;1925
411925;202207;559;1400;391;1099;67;202;179;457;246;659
411930;202207;5896;16451;4972;14857;2220;6994;600;1983;2820;8977
411940;202207;3888;10523;3063;8884;711;2164;1121;2892;1832;5056
411950;202207;17514;44294;14610;39664;1543;4887;9370;24048;10913;28935
411960;202207;7034;17566;5582;14864;1014;2943;2313;5616;3327;8559
411965;202207;565;1485;402;1157;52;163;185;476;237;639
411970;202207;1336;2831;1044;2448;200;414;481;1302;681;1716
411980;202207;1840;4125;1349;3379;273;673;618;1463;891;2136
411990;202207;46288;114594;31012;87885;5418;16868;12770;33693;18188;50561
411995;202207;5350;12308;4181;10533;1089;3058;1354;3194;2443;6252
412000;202207;2151;4728;1522;3683;42;138;1101;2466;1143;2604
412010;202207;711;2036;502;1586;61;217;127;327;188;544
412015;202207;597;1587;476;1359;65;186;254;724;319;910
412020;202207;527;1434;326;1014;50;176;113;324;163;500
412030;202207;707;1892;523;1560;76;242;208;571;284;813
412033;202207;1069;2711;753;2110;73;212;287;680;360;892
412035;202207;817;2131;528;1603;83;257;259;754;342;1011
412040;202207;803;2067;479;1413;60;161;86;227;146;388
412050;202207;1748;4164;1193;3186;272;807;261;677;533;1484
412060;202207;8507;22996;6956;19971;1778;5777;1997;5372;3775;11149
412065;202207;731;1904;536;1527;107;332;152;394;259;726
412070;202207;1492;3622;1150;2991;142;428;511;1138;653;1566
412080;202207;2892;7223;2104;5749;278;852;933;2157;1211;3009
412085;202207;377;871;147;412;10;34;40;79;50;113
412090;202207;7426;17753;5469;14373;1176;3349;2301;5913;3477;9262
412100;202207;2114;5293;1566;4334;471;1436;424;1185;895;2621
412110;202207;1081;2721;686;1942;86;259;224;546;310;805
412120;202207;2669;6971;2061;5908;446;1447;651;1598;1097;3045
412125;202207;829;2193;523;1573;97;290;112;315;209;605
412130;202207;921;2206;617;1641;116;310;156;389;272;699
412135;202207;682;1754;340;996;45;165;125;304;170;469
412140;202207;2222;5143;1585;4065;256;729;425;1035;681;1764
412150;202207;3221;7829;2670;6867;447;1323;1406;3239;1853;4562
412160;202207;1021;3087;556;1839;48;182;43;92;91;274
412170;202207;5277;13361;4436;12046;808;2401;2093;5145;2901;7546
412175;202207;1520;4130;1255;3667;274;821;490;1379;764;2200
412180;202207;1969;5168;1462;4267;197;658;636;1681;833;2339
412190;202207;3814;9136;2747;7260;332;992;1132;2817;1464;3809
412200;202207;2212;5984;1444;4301;359;1172;292;768;651;1940
412210;202207;757;1737;468;1266;67;205;192;466;259;671
412215;202207;3841;9761;2767;7682;606;1729;1187;3318;1793;5047
412217;202207;1146;2792;946;2445;23;77;698;1674;721;1751
412220;202207;6913;18842;5546;16361;1260;3747;1769;5090;3029;8837
412230;202207;3110;8582;2450;7387;383;1351;515;1311;898;2662
412240;202207;9052;22563;5958;16684;1024;3104;1848;4508;2872;7612
412250;202207;2266;5586;1651;4463;396;1141;352;838;748;1979
412260;202207;1557;3844;1184;3136;217;599;408;993;625;1592
412265;202207;1152;2837;923;2472;118;363;554;1348;672;1711
412270;202207;1174;3128;772;2287;111;362;301;804;412;1166
412280;202207;470;1214;360;1024;85;254;91;228;176;482
412290;202207;1220;2911;878;2325;159;464;332;809;491;1273
412300;202207;1989;4919;1443;3983;252;740;412;1042;664;1782
412310;202207;793;2203;599;1826;98;358;167;444;265;802
412320;202207;868;2150;553;1532;62;219;168;430;230;649
412330;202207;1802;4520;1234;3512;247;764;427;1210;674;1974
412340;202207;1354;3535;990;2811;150;495;148;367;298;862
412350;202207;3595;9103;2401;6801;457;1359;598;1476;1055;2835
412360;202207;322;812;240;657;6;24;163;423;169;447
412370;202207;1118;2936;796;2305;176;524;210;564;386;1088
412380;202207;1744;4628;1245;3669;303;978;94;285;397;1263
412382;202207;564;1323;371;997;46;160;190;411;236;571
412385;202207;2673;6658;2155;5738;593;1549;844;2318;1437;3867
412390;202207;2871;6603;2248;5623;385;1020;768;1890;1153;2910
412395;202207;866;2279;616;1737;84;228;291;777;375;1005
412400;202207;1093;2717;751;2078;139;421;224;538;363;959
412402;202207;2755;6490;1915;5145;421;1119;500;1344;921;2463
412405;202207;3547;8981;2330;6793;653;1913;289;813;942;2726
412410;202207;7361;18236;5463;15227;939;3041;1793;4602;2732;7643
412420;202207;621;1479;402;1057;38;107;181;426;219;533
412430;202207;632;1546;348;962;40;113;145;365;185;478
412440;202207;3399;8432;2357;6628;549;1561;709;1912;1258;3473
412450;202207;594;1668;394;1186;62;187;40;77;102;264
412460;202207;1293;3080;1014;2630;168;475;481;1182;649;1657
412470;202207;1833;5333;1501;4628;349;1195;416;1191;765;2386
412480;202207;1444;3516;985;2634;160;473;386;886;546;1359
412490;202207;1562;3591;1193;2972;81;216;704;1606;785;1822
412500;202207;2369;5602;1789;4593;311;861;641;1448;952;2309
412510;202207;2266;6476;1651;5023;453;1486;312;741;765;2227
412520;202207;1551;3760;929;2545;198;536;163;397;361;933
412530;202207;775;1992;558;1578;75;210;103;271;178;481
412535;202207;906;2307;603;1731;126;387;91;186;217;573
412540;202207;1263;3099;903;2480;162;546;246;654;408;1200
412545;202207;786;1961;558;1520;101;295;183;467;284;762
412550;202207;42246;106114;31010;84809;4512;13593;14484;35286;18996;48879
412555;202207;335;826;223;592;26;91;73;140;99;231
412560;202207;5984;16003;4491;12804;980;3071;1134;2949;2114;6020
412570;202207;5211;12422;3157;8667;565;1765;580;1353;1145;3118
412575;202207;1243;2902;997;2513;175;450;524;1211;699;1661
412580;202207;1801;4356;1291;3454;110;329;730;1793;840;2122
412590;202207;490;1253;266;781;49;165;34;74;83;239
412600;202207;1948;4779;1512;3963;120;393;906;2141;1026;2534
412610;202207;965;2483;696;1927;96;292;323;763;419;1055
412620;202207;1457;3576;1118;3054;221;647;443;1113;664;1760
412625;202207;10398;26490;6765;19508;1273;3897;617;1595;1890;5492
412627;202207;1301;3480;904;2705;198;645;233;670;431;1315
412630;202207;3193;8960;2235;6944;386;1291;564;1526;950;2817
412635;202207;503;1290;315;916;39;129;105;239;144;368
412640;202207;1159;2937;666;1911;92;255;146;352;238;607
412650;202207;1926;5006;1514;4180;247;767;598;1446;845;2213
412660;202207;3092;7501;2215;5870;258;758;842;1968;1100;2726
412665;202207;460;1098;350;912;56;167;156;375;212;542
412667;202207;1986;5012;1444;3963;212;643;633;1662;845;2305
412670;202207;1007;2266;693;1781;147;389;215;491;362;880
412680;202207;2395;6076;1651;4722;195;649;530;1245;725;1894
412690;202207;1337;3289;926;2517;177;526;321;781;498;1307
412700;202207;2180;5412;1823;4859;291;852;936;2372;1227;3224
412710;202207;6644;18316;4934;14830;892;2952;1375;3497;2267;6449
412720;202207;1419;3886;1140;3318;172;557;348;801;520;1358
412730;202207;3070;7567;2225;5993;380;1128;880;2120;1260;3248
412740;202207;2316;6161;1604;4802;321;1068;257;735;578;1803
412750;202207;4587;11428;3747;10195;377;1156;2291;5859;2668;7015
412760;202207;3499;8882;2923;7944;548;1706;1629;4117;2177;5823
412770;202207;13265;33269;7483;22117;959;3004;1699;4120;2658;7124
412780;202207;1423;3539;1069;2923;257;769;383;931;640;1700
412785;202207;2552;5637;1794;4421;256;628;1137;2733;1393;3361
412788;202207;1628;4343;1324;3823;339;976;520;1431;859;2407
412790;202207;1578;3984;970;2826;148;486;335;797;483;1283
412795;202207;1408;3505;794;2309;138;438;164;432;302;870
412796;202207;2633;7103;2206;6362;491;1544;727;1901;1218;3445
412800;202207;4605;10428;3315;8147;359;1077;1742;3672;2101;4749
412810;202207;14667;35929;9920;26719;1150;3631;4292;10083;5442;13714
412820;202207;7281;18997;5190;14948;1198;3644;1587;4423;2785;8067
412830;202207;379;1044;290;863;37;104;71;203;108;307
412840;202207;2163;4982;1521;3799;139;408;869;1920;1008;2328
412850;202207;3152;7798;2353;6521;272;865;1178;2979;1450;3844
412853;202207;1830;4315;1520;3794;200;583;850;1816;1050;2399
412855;202207;1558;3860;861;2429;121;393;197;438;318;831
412860;202207;852;2048;563;1573;97;302;229;548;326;850
412862;202207;752;1813;506;1409;98;268;192;509;290;777
412863;202207;1447;4020;1285;3723;285;926;584;1529;869;2455
412865;202207;781;2016;566;1601;142;404;149;416;291;820
412870;202207;1052;2555;769;2110;210;645;239;643;449;1288
412880;202207;1036;2692;746;2153;144;458;250;642;394;1100
420005;202207;491;1381;290;906;29;92;141;431;170;523
420010;202207;3676;8520;2437;6449;165;478;1803;4728;1968;5206
420020;202207;527;1557;353;1122;62;236;121;298;183;534
420030;202207;128;430;88;325;26;106;20;74;46;180
420040;202207;668;1940;401;1346;90;357;35;101;125;458
420050;202207;811;1803;549;1342;116;322;307;652;423;974
420055;202207;193;563;109;356;22;83;39;114;61;197
420060;202207;185;517;132;395;23;63;54;155;77;218
420070;202207;977;2710;753;2264;167;529;361;1033;528;1562
420075;202207;90;236;52;158;8;24;15;29;23;53
420080;202207;490;1333;355;1004;69;218;135;333;204;551
420090;202207;483;1437;311;1048;71;256;72;205;143;461
420100;202207;1689;3936;1386;3460;81;218;1060;2608;1141;2826
420110;202207;309;927;266;837;39;142;140;427;179;569
420120;202207;713;1851;495;1387;71;227;246;607;317;834
420125;202207;422;1198;295;921;63;214;100;286;163;500
420127;202207;363;950;156;481;28;107;64;178;92;285
420130;202207;5036;13308;3867;11348;707;2344;1632;4234;2339;6578
420140;202207;5005;12757;3811;10728;1091;3320;970;2555;2061;5875
420150;202207;772;1906;561;1564;51;163;327;886;378;1049
420160;202207;237;574;100;298;16;62;30;74;46;136
420165;202207;188;531;117;370;30;102;36;92;66;194
420170;202207;328;977;244;774;41;145;91;243;132;388
420180;202207;185;572;109;383;17;79;29;83;46;162
420190;202207;244;702;142;445;29;90;46;127;75;217
420195;202207;2113;5252;1621;4475;404;1316;636;1575;1040;2891
420200;202207;7660;17740;5061;13024;674;2009;2438;5268;3112;7277
420205;202207;2393;6072;1642;4583;242;766;891;2364;1133;3130
420207;202207;2446;6010;1595;4434;266;843;673;1686;939;2529
420208;202207;389;1062;233;744;79;256;52;133;131;389
420209;202207;194;580;126;388;15;57;63;169;78;226
420210;202207;4603;11349;3330;9190;488;1571;1778;4539;2266;6110
420213;202207;937;2664;768;2325;155;517;298;867;453;1384
420215;202207;273;775;193;596;46;150;58;176;104;326
420220;202207;374;1063;249;807;39;148;97;273;136;421
420230;202207;6689;17040;5238;14427;632;1994;2977;7584;3609;9578
420240;202207;17686;47439;11624;33622;1381;4702;5574;13763;6955;18465
420243;202207;491;1239;409;1092;58;169;274;707;332;876
420245;202207;2010;4926;1541;4129;137;444;989;2464;1126;2908
420250;202207;625;1534;547;1418;42;139;409;1000;451;1139
420253;202207;541;1253;385;1033;28;80;238;630;266;710
420257;202207;182;468;121;362;19;58;62;188;81;246
420260;202207;1398;3328;1057;2880;87;287;797;2126;884;2413
420270;202207;668;1679;346;955;36;108;151;378;187;486
420280;202207;1667;4588;1351;3951;178;620;642;1725;820;2345
420285;202207;140;368;98;287;21;83;30;51;51;134
420287;202207;526;1148;374;945;71;191;171;417;242;608
420290;202207;6291;17024;4925;14158;668;2226;2859;7504;3527;9730
420300;202207;8820;23831;5221;15589;956;3144;1687;4352;2643;7496
420310;202207;1037;2223;598;1480;45;141;363;796;408;937
420315;202207;908;2332;635;1885;76;260;361;1018;437;1278
420320;202207;6898;17659;5146;14857;1456;4571;1647;4409;3103;8980
420325;202207;398;1092;282;871;41;137;112;317;153;454
420330;202207;1115;3112;735;2331;131;480;239;664;370;1144
420340;202207;1309;3307;1016;2791;210;625;395;952;605;1577
420350;202207;1480;3480;1104;2849;119;339;728;1822;847;2161
420360;202207;3448;9052;1907;5806;368;1202;181;515;549;1717
420370;202207;1573;3871;1268;3356;111;375;866;2121;977;2496
420380;202207;5348;13352;3698;10380;685;2147;1620;4159;2305;6306
420390;202207;1236;2991;886;2316;166;484;329;613;495;1097
420395;202207;1442;3898;1029;3095;162;553;196;423;358;976
420400;202207;1293;3368;904;2616;117;371;463;1270;580;1641
420410;202207;680;1680;524;1370;41;116;367;943;408;1059
420415;202207;406;1118;297;870;60;201;128;361;188;562
420417;202207;731;2085;572;1745;127;388;279;874;406;1262
420419;202207;179;612;129;475;51;200;13;53;64;253
420420;202207;15584;39371;10920;30762;2710;8596;3807;9657;6517;18253
420425;202207;737;1948;507;1455;43;153;268;714;311;867
420430;202207;3789;9773;2367;6763;407;1335;967;2421;1374;3756
420435;202207;344;869;200;604;34;115;98;280;132;395
420440;202207;910;2324;600;1673;144;405;225;584;369;989
420445;202207;281;658;178;478;27;85;68;148;95;233
420450;202207;948;2695;689;2116;113;427;261;682;374;1109
420455;202207;2447;5528;1831;4615;404;1030;815;2032;1219;3062
420460;202207;11399;28855;8802;24165;1178;3728;4868;12440;6046;16168
420470;202207;739;1858;404;1145;65;210;118;279;183;489
420475;202207;80;208;36;110;6;25;7;12;13;37
420480;202207;6525;15486;4242;11661;693;2035;1837;4877;2530;6912
420490;202207;445;1196;314;915;54;185;141;372;195;557
420500;202207;1579;4099;1063;3189;179;617;495;1390;674;2007
420510;202207;183;502;104;336;19;65;30;84;49;149
420515;202207;129;346;86;255;13;50;32;90;45;140
420517;202207;817;2107;688;1876;75;221;400;1073;475;1294
420519;202207;358;877;255;705;27;82;128;352;155;434
420520;202207;324;852;183;585;28;84;13;34;41;118
420530;202207;936;2670;634;2000;107;396;229;600;336;996
420535;202207;239;670;101;321;15;55;30;74;45;129
420540;202207;47397;110404;33053;86658;4451;13346;13507;30717;17958;44063
420543;202207;273;783;211;636;32;113;93;245;125;358
420545;202207;1572;4594;1184;3736;271;906;392;1127;663;2033
420550;202207;4637;11514;3087;8862;490;1556;1345;3710;1835;5266
420555;202207;401;1084;274;828;34;120;151;420;185;540
420560;202207;472;1101;332;902;51;130;191;523;242;653
420570;202207;3338;8250;2520;6762;406;1218;1318;3302;1724;4520
420580;202207;2040;5323;1437;4319;316;1023;443;1230;759;2253
420590;202207;3331;8714;2110;6107;354;1198;622;1420;976;2618
420600;202207;1300;3487;1038;3015;100;385;645;1759;745;2144
420610;202207;569;1534;380;1160;76;238;175;516;251;754
420620;202207;948;2292;654;1798;131;382;262;697;393;1079
420630;202207;1154;3390;848;2658;137;465;426;1242;563;1707
420640;202207;565;1507;304;977;89;298;58;173;147;471
420650;202207;4400;11096;2913;8100;430;1322;1307;3057;1737;4379
420660;202207;495;1216;318;848;65;191;68;145;133;336
420665;202207;816;2057;549;1610;87;288;251;650;338;938
420670;202207;1436;3918;888;2748;117;413;214;511;331;924
420675;202207;229;594;147;445;16;61;85;239;101;300
420680;202207;332;730;183;525;27;102;97;248;124;350
420690;202207;1057;2939;690;2081;95;309;233;586;328;895
420700;202207;3526;8948;2735;7553;207;653;1816;4805;2023;5458
420710;202207;1290;3470;1039;2951;128;462;617;1537;745;1999
420720;202207;1514;3944;1128;3251;174;548;654;1754;828;2302
420730;202207;3965;9891;3039;8381;513;1578;1613;4136;2126;5714
420740;202207;536;1537;308;1040;74;262;34;102;108;364
420750;202207;2437;6790;1624;4956;277;1020;603;1612;880;2632
420757;202207;118;292;54;168;6;20;26;83;32;103
420760;202207;420;1167;234;693;37;115;82;209;119;324
420765;202207;593;1619;320;971;43;154;180;517;223;671
420768;202207;1570;4087;1359;3742;142;385;1013;2763;1155;3148
420770;202207;430;1150;198;679;20;79;47;146;67;225
420775;202207;347;928;214;656;38;133;81;203;119;336
420780;202207;1118;3050;666;2024;108;331;108;299;216;630
420785;202207;254;626;185;493;21;68;83;165;104;233
420790;202207;1293;3582;989;2959;180;627;563;1556;743;2183
420800;202207;839;1957;515;1364;119;325;256;653;375;978
420810;202207;1743;4974;1454;4419;339;1226;695;1814;1034;3040
420820;202207;15899;38561;11721;31906;1779;5383;5960;15008;7739;20391
420830;202207;5637;14103;4268;11721;709;2152;1927;4915;2636;7067
420840;202207;593;1774;313;1105;75;265;30;90;105;355
420845;202207;3352;8304;2284;6427;437;1473;973;2526;1410;3999
420850;202207;1309;3976;863;2843;159;564;222;655;381;1219
420860;202207;465;1194;279;853;69;215;78;214;147;429
420870;202207;945;2550;673;1986;143;458;238;643;381;1101
420880;202207;1321;3765;1047;3235;209;725;449;1265;658;1990
420890;202207;9302;24474;5896;17507;863;2820;2067;5303;2930;8123
420895;202207;213;587;140;409;24;70;58;162;82;232
420900;202207;1807;4325;1129;3149;151;557;524;1217;675;1774
420910;202207;39772;101377;26783;77166;3930;13051;11832;29644;15762;42695
420915;202207;566;1931;442;1614;66;268;240;881;306;1149
420917;202207;551;1372;258;670;35;78;136;349;171;427
420920;202207;105;269;46;143;4;16;12;33;16;49
420930;202207;20402;50001;15011;40735;2251;6844;7768;19442;10019;26286
420940;202207;3848;9126;2440;6774;523;1627;609;1340;1132;2967
420945;202207;222;646;133;400;21;74;58;151;79;225
420950;202207;432;1183;278;832;44;146;81;210;125;356
420960;202207;1267;3013;922;2459;145;441;441;1043;586;1484
420970;202207;2797;7240;1933;5668;421;1292;644;1848;1065;3140
420980;202207;303;1006;256;900;93;340;68;239;161;579
420985;202207;408;1101;243;774;50;177;67;178;117;355
420990;202207;410;1207;248;817;38;131;55;158;93;289
421000;202207;663;1919;475;1523;97;335;110;278;207;613
421003;202207;522;1254;184;527;14;40;14;35;28;75
421005;202207;113;316;74;231;17;51;30;96;47;147
421010;202207;4097;10591;2989;8567;541;1805;1056;2523;1597;4328
421020;202207;449;1356;361;1188;55;213;188;581;243;794
421030;202207;1163;3133;887;2572;201;640;368;970;569;1610
421040;202207;778;1805;477;1331;53;152;279;745;332;897
421050;202207;1340;3460;915;2543;138;419;369;892;507;1311
421055;202207;192;502;114;331;18;57;60;156;78;213
421060;202207;839;2287;602;1796;98;356;288;751;386;1107
421070;202207;774;2195;490;1505;77;266;211;557;288;823
421080;202207;605;1707;475;1450;79;290;210;583;289;873
421085;202207;407;1124;184;604;23;69;35;92;58;161
421090;202207;327;839;185;508;18;61;69;162;87;223
421100;202207;991;2146;456;1271;81;248;137;318;218;566
421105;202207;1882;4784;1350;3807;205;630;649;1693;854;2323
421110;202207;1481;3579;1221;3207;123;385;768;1984;891;2369
421120;202207;1260;3667;883;2838;130;455;262;737;392;1192
421125;202207;402;980;291;765;85;244;125;303;210;547
421130;202207;6570;17870;5400;15580;979;3113;2900;7851;3879;10964
421140;202207;394;1027;263;767;47;149;107;274;154;423
421145;202207;488;1275;327;951;91;291;92;218;183;509
421150;202207;858;2315;588;1760;118;402;252;659;370;1061
421160;202207;670;1787;514;1480;74;269;314;821;388;1090
421165;202207;257;731;161;489;26;81;59;149;85;230
421170;202207;1331;3415;1125;3086;109;297;808;2220;917;2517
421175;202207;1178;2948;706;2128;118;418;324;900;442;1318
421180;202207;458;1154;256;753;30;106;122;308;152;414
421185;202207;374;922;261;701;32;95;141;349;173;444
421187;202207;309;922;190;623;38;121;69;216;107;337
421189;202207;481;1310;366;1078;53;182;156;414;209;596
421190;202207;15400;39598;11178;31721;1868;6050;4897;12329;6765;18379
421200;202207;887;2334;694;1971;96;337;395;1043;491;1380
421205;202207;255;655;189;535;38;109;81;220;119;329
421210;202207;1319;3189;748;2202;158;463;242;687;400;1150
421220;202207;1679;4708;1319;3967;350;1136;465;1260;815;2396
421223;202207;428;1080;291;843;53;169;176;484;229;653
421225;202207;1108;2985;953;2748;114;389;633;1790;747;2179
421227;202207;830;2247;543;1646;96;316;232;704;328;1020
421230;202207;677;1715;448;1292;93;302;164;450;257;752
421240;202207;311;893;144;490;23;102;27;64;50;166
421250;202207;2611;6389;1904;5258;294;808;1069;2850;1363;3658
421260;202207;267;816;71;230;18;58;7;22;25;80
421265;202207;978;2275;835;2090;58;141;698;1730;756;1871
421270;202207;428;1136;216;691;43;145;86;253;129;398
421280;202207;2684;6807;2027;5713;292;958;1096;2888;1388;3846
421290;202207;1240;3330;618;1820;97;303;146;365;243;668
421300;202207;352;916;179;567;31;109;31;95;62;204
421310;202207;249;689;170;526;48;149;80;245;128;394
421315;202207;324;815;217;607;51;131;71;202;122;333
421320;202207;718;2196;410;1332;41;136;61;104;102;240
421330;202207;712;2012;477;1482;101;334;141;398;242;732
421335;202207;440;1270;360;1130;53;194;177;524;230;718
421340;202207;1699;4445;1190;3528;172;575;561;1557;733;2132
421350;202207;1916;4667;1287;3633;235;733;509;1363;744;2096
421360;202207;2610;6657;1597;4652;386;1301;554;1283;940;2584
421370;202207;879;2682;577;1907;96;358;187;496;283;854
421380;202207;1006;2439;879;2252;90;271;578;1414;668;1685
421390;202207;178;467;73;243;19;62;22;64;41;126
421400;202207;689;1796;450;1326;72;244;213;545;285;789
421410;202207;221;581;111;362;28;83;29;102;57;185
421415;202207;234;622;165;453;21;69;70;163;91;232
421420;202207;722;1905;528;1484;54;177;286;742;340;919
421430;202207;109;331;73;239;8;25;14;32;22;57
421440;202207;761;1949;462;1378;88;250;189;546;277;796
421450;202207;550;1583;338;1106;50;162;50;163;100;325
421460;202207;413;1245;229;828;13;44;18;52;31;96
421470;202207;382;1027;261;789;40;126;91;279;131;405
421480;202207;3418;8844;2374;6745;342;1159;1063;2725;1405;3884
421490;202207;131;428;77;284;13;59;12;36;25;95
421500;202207;2603;7244;1816;5616;404;1444;518;1335;922;2779
421505;202207;371;942;310;851;27;91;205;542;232;633
421507;202207;507;1339;305;908;55;178;134;363;189;541
421510;202207;467;1224;320;902;43;154;159;367;202;521
421520;202207;549;1414;337;921;50;134;142;336;192;470
421530;202207;360;1053;209;708;32;147;40;97;72;244
421535;202207;485;1215;290;822;39;113;145;391;184;504
421540;202207;389;885;219;619;29;90;74;199;103;289
421545;202207;737;2090;568;1798;104;380;292;862;396;1242
421550;202207;2655;6771;2035;5680;326;997;1105;2937;1431;3934
421555;202207;214;615;75;256;8;27;14;25;22;52
421560;202207;103;328;62;217;9;36;20;55;29;91
421565;202207;1111;2749;788;2238;184;575;300;784;484;1359
421567;202207;594;1731;434;1306;114;380;119;352;233;732
421568;202207;377;1072;221;684;35;128;83;230;118;358
421569;202207;184;521;83;259;10;37;47;137;57;174
421570;202207;1732;4573;1264;3626;229;738;527;1313;756;2051
421575;202207;371;1006;274;759;32;112;155;384;187;496
421580;202207;5395;14080;3511;10215;477;1623;1435;3570;1912;5193
421590;202207;213;602;164;497;39;133;62;179;101;312
421600;202207;686;1748;463;1277;85;273;170;395;255;668
421605;202207;778;1990;572;1663;105;295;244;728;349;1023
421610;202207;1170;2996;800;2298;152;462;244;688;396;1150
421620;202207;4753;11964;3157;9138;606;1968;1243;3254;1849;5222
421625;202207;160;440;83;254;11;36;25;66;36;102
421630;202207;3242;8217;2181;6257;373;1211;832;2050;1205;3261
421635;202207;457;1210;291;870;25;103;164;421;189;524
421640;202207;772;1959;545;1608;116;356;260;724;376;1080
421650;202207;2982;7737;2062;6061;434;1502;715;1844;1149;3346
421660;202207;13494;35730;9851;28643;1386;4651;4791;12581;6177;17232
421670;202207;962;2630;682;1950;129;424;312;793;441;1217
421680;202207;1927;3973;1612;3500;79;271;1360;2722;1439;2993
421690;202207;1713;4696;1177;3585;244;804;346;975;590;1779
421700;202207;705;1998;488;1506;102;341;148;385;250;726
421710;202207;245;741;134;423;18;58;57;161;75;219
421715;202207;158;388;117;302;19;56;73;182;92;238
421720;202207;2479;6483;1490;4387;321;1057;478;1190;799;2247
421725;202207;326;781;176;507;31;96;69;166;100;262
421730;202207;579;1641;368;1057;54;162;189;485;243;647
421740;202207;952;2562;644;1935;106;352;242;611;348;963
421750;202207;1051;2425;542;1504;110;329;201;509;311;838
421755;202207;209;572;117;355;20;73;45;116;65;189
421760;202207;1223;3059;808;2303;159;514;301;742;460;1256
421770;202207;2888;7291;2074;5895;426;1228;862;2384;1288;3612
421775;202207;247;625;150;431;21;66;63;158;84;224
421780;202207;1033;2851;684;2117;118;418;311;863;429;1281
421790;202207;1039;2716;583;1809;117;381;196;549;313;930
421795;202207;214;607;151;460;27;86;48;132;75;218
421800;202207;3811;9634;2882;7965;432;1312;1634;4237;2066;5549
421810;202207;688;1791;472;1406;54;174;255;728;309;902
421820;202207;1236;3462;824;2493;150;520;304;766;454;1286
421825;202207;1765;4230;1530;3883;102;303;1170;2870;1272;3173
421830;202207;2199;6082;1673;5018;353;1160;417;1136;770;2296
421835;202207;283;683;194;538;30;103;102;273;132;376
421840;202207;280;869;216;727;40;160;60;184;100;344
421850;202207;444;1251;252;857;41;154;59;157;100;311
421860;202207;341;918;201;633;32;114;66;172;98;286
421870;202207;5642;13523;4265;11006;472;1532;2562;5850;3034;7382
421875;202207;353;1004;155;468;21;67;40;99;61;166
421880;202207;783;2157;522;1590;104;311;143;413;247;724
421885;202207;310;820;200;577;31;94;94;244;125;338
421890;202207;1073;2961;814;2456;121;454;485;1363;606;1817
421895;202207;492;1212;425;1108;47;107;286;774;333;881
421900;202207;1250;3221;930;2521;110;369;453;1051;563;1420
421910;202207;387;1135;221;722;33;133;56;150;89;283
421915;202207;469;1277;283;840;67;204;59;148;126;352
421917;202207;712;1561;408;1151;110;330;104;299;214;629
421920;202207;459;1345;323;1061;109;361;110;369;219;730
421930;202207;3533;8659;2031;5840;398;1251;754;1865;1152;3116
421935;202207;467;1365;378;1181;70;231;228;694;298;925
421940;202207;425;1180;204;609;28;91;65;160;93;251
421950;202207;3641;8961;2153;6134;422;1317;612;1504;1034;2821
421960;202207;186;439;103;290;11;34;37;81;48;115
421970;202207;2326;5762;1512;4131;272;886;680;1610;952;2496
421985;202207;373;1017;252;770;32;100;117;340;149;440
422000;202207;2301;5521;1878;4890;128;425;1346;3415;1474;3840
430003;202207;663;1698;455;1336;83;256;220;631;303;887
430005;202207;343;868;242;699;16;53;156;424;172;477
430010;202207;2094;4593;1589;3838;326;744;867;2125;1193;2869
430020;202207;657;1451;481;1202;57;166;295;681;352;847
430030;202207;1217;2684;705;1760;124;316;351;807;475;1123
430040;202207;11707;26226;7485;19253;1930;5211;1974;4778;3904;9989
430045;202207;621;1418;456;1135;28;84;345;826;373;910
430047;202207;280;597;111;283;24;64;36;84;60;148
430050;202207;948;2261;576;1553;105;296;256;648;361;944
430055;202207;319;750;159;430;17;54;78;182;95;236
430057;202207;102;228;47;136;14;47;12;31;26;78
430060;202207;22700;56378;18059;49253;2963;8787;9821;25835;12784;34622
430063;202207;862;2271;716;1997;133;372;410;1129;543;1501
430064;202207;1320;3326;972;2669;152;446;538;1412;690;1858
430066;202207;126;272;95;221;8;23;75;164;83;187
430070;202207;777;1968;167;517;35;108;23;57;58;165
430080;202207;1068;2540;630;1690;95;303;328;766;423;1069
430085;202207;1042;2145;645;1533;87;229;320;718;407;947
430087;202207;1002;2286;830;2063;81;227;564;1367;645;1594
430090;202207;532;1334;200;638;32;112;43;116;75;228
430100;202207;1170;2712;702;1850;132;376;228;517;360;893
430105;202207;1564;3843;1076;3012;162;521;512;1356;674;1877
430107;202207;188;532;93;281;12;31;31;77;43;108
430110;202207;2567;6032;1924;5084;306;870;965;2446;1271;3316
430120;202207;1473;3964;998;2842;179;495;459;1257;638;1752
430130;202207;4084;8698;3022;7251;1010;2378;669;1895;1679;4273
430140;202207;1200;2943;854;2328;125;375;456;1178;581;1553
430150;202207;640;1610;358;1050;73;233;107;291;180;524
430155;202207;271;662;124;361;21;63;21;51;42;114
430160;202207;24489;52287;19501;45506;1778;4571;13102;29422;14880;33993
430163;202207;3857;8238;2756;6626;84;295;2145;4948;2229;5243
430165;202207;342;826;121;369;14;37;22;57;36;94
430170;202207;1083;2721;388;1234;74;274;71;165;145;439
430175;202207;885;2221;762;1989;148;377;405;1047;553;1424
430180;202207;747;1773;559;1453;98;254;276;709;374;963
430185;202207;747;1859;389;1105;101;277;73;193;174;470
430187;202207;938;1866;685;1560;83;181;467;1046;550;1227
430190;202207;1644;3904;1300;3389;231;626;648;1613;879;2239
430192;202207;136;358;58;167;11;30;17;41;28;71
430195;202207;491;1367;80;260;8;24;16;43;24;67
430200;202207;1281;3461;1003;2960;306;933;272;840;578;1773
430205;202207;579;1241;530;1153;11;41;493;1042;504;1083
430210;202207;7552;18918;4935;13406;746;2225;1443;3004;2189;5229
430215;202207;390;916;241;630;38;103;100;257;138;360
430220;202207;709;1709;228;714;26;88;73;192;99;280
430222;202207;270;707;183;542;25;81;67;195;92;276
430223;202207;301;745;224;620;21;64;134;356;155;420
430225;202207;24;53;18;44;1;1;12;26;13;27
430230;202207;2316;5791;1925;5237;110;346;1524;4068;1634;4414
430235;202207;472;1254;300;896;46;151;87;210;133;361
430237;202207;619;1327;471;1094;23;65;369;826;392;891
430240;202207;1559;3489;870;2294;108;340;427;982;535;1322
430245;202207;828;2113;655;1799;113;311;393;1096;506;1407
430250;202207;1160;2646;841;2146;298;795;177;400;475;1195
430258;202207;150;378;112;305;9;23;57;153;66;176
430260;202207;817;1975;563;1533;62;186;323;857;385;1043
430265;202207;247;686;166;536;25;86;65;208;90;294
430270;202207;3670;8067;2943;6999;317;907;2108;4714;2425;5621
430280;202207;5939;12897;4277;10180;728;1775;2139;4827;2867;6602
430290;202207;2555;5426;2085;4880;100;286;1672;3790;1772;4076
430300;202207;12167;28110;9306;23447;1257;3464;5396;12871;6653;16335
430310;202207;15270;35892;10966;28242;1326;3756;6058;14407;7384;18163
430320;202207;1151;2727;665;1794;61;174;395;1022;456;1196
430330;202207;764;1782;446;1165;71;188;171;402;242;590
430340;202207;729;1614;497;1255;69;172;318;770;387;942
430350;202207;9892;22580;7661;18920;852;2271;4849;11289;5701;13560
430355;202207;382;1005;149;459;24;75;18;45;42;120
430360;202207;1002;2280;637;1662;135;398;215;500;350;898
430367;202207;401;852;244;599;40;122;132;287;172;409
430370;202207;561;1462;230;686;44;132;57;128;101;260
430380;202207;749;1780;381;1128;78;237;93;255;171;492
430390;202207;4030;9322;2630;6875;576;1632;378;743;954;2375
430400;202207;1185;2374;846;1916;132;329;408;866;540;1195
430410;202207;627;1400;457;1139;41;115;325;777;366;892
430420;202207;3321;7996;2597;6597;357;1048;1587;3678;1944;4726
430430;202207;625;1514;281;819;51;169;50;125;101;294
430435;202207;1974;4610;1462;3759;232;640;740;1842;972;2482
430440;202207;4741;11969;3811;10496;377;1155;2400;6463;2777;7618
430450;202207;8539;19141;6988;16576;1129;3027;3961;8688;5090;11715
430460;202207;43970;103218;32701;85121;4332;12563;18427;45328;22759;57891
430461;202207;245;629;91;264;17;59;37;85;54;144
430462;202207;348;875;181;551;31;92;50;137;81;229
430463;202207;7834;19375;5861;15887;1123;3371;2721;6979;3844;10350
430465;202207;628;1455;441;1118;63;178;274;659;337;837
430466;202207;5373;12539;4338;11004;742;1969;2426;5790;3168;7759
430467;202207;567;1326;411;1094;48;150;240;585;288;735
430468;202207;1586;3631;1277;3202;102;320;958;2317;1060;2637
430469;202207;686;1868;113;355;11;34;26;50;37;84
430470;202207;6655;16255;4456;12454;1152;3606;1232;3115;2384;6721
430471;202207;741;1915;617;1702;100;291;371;964;471;1255
430480;202207;712;1917;460;1375;71;232;135;330;206;562
430485;202207;186;465;85;239;15;33;21;57;36;90
430490;202207;465;1140;259;739;25;80;122;295;147;375
430495;202207;438;1143;297;885;40;131;143;396;183;527
430500;202207;1151;2806;812;2263;240;738;261;645;501;1383
430510;202207;32570;80072;23725;63795;3959;11855;10935;26579;14894;38434
430511;202207;394;1058;153;484;17;46;20;50;37;96
430512;202207;1183;2488;933;2121;203;473;395;891;598;1364
430513;202207;909;2072;453;1162;68;200;245;551;313;751
430515;202207;441;1151;316;904;36;108;163;449;199;557
430517;202207;1499;4006;1154;3269;173;484;674;1893;847;2377
430520;202207;1564;3753;857;2292;133;378;238;556;371;934
430530;202207;1091;2630;462;1333;74;227;132;343;206;570
430535;202207;4146;10027;3031;8098;404;1098;1602;4072;2006;5170
430537;202207;492;1366;425;1236;35;87;323;940;358;1027
430540;202207;700;1617;423;1164;60;167;241;645;301;812
430543;202207;1187;2037;723;1499;143;262;244;564;387;826
430544;202207;823;2213;559;1651;141;439;199;555;340;994
430545;202207;2884;6797;2189;5807;324;874;1301;3409;1625;4283
430550;202207;405;1086;303;877;69;214;99;261;168;475
430558;202207;176;387;70;181;5;12;30;73;35;85
430560;202207;322;736;173;493;30;92;61;151;91;243
430570;202207;972;2259;687;1772;122;407;331;707;453;1114
430580;202207;937;2235;681;1848;155;413;294;856;449;1269
430583;202207;206;506;47;132;2;7;11;20;13;27
430585;202207;244;577;132;357;24;77;46;101;70;178
430587;202207;229;594;173;503;17;57;78;224;95;281
430590;202207;1565;3569;1239;3067;124;348;877;2101;1001;2449
430593;202207;29;80;22;56;4;10;10;22;14;32
430595;202207;478;1211;129;408;17;52;29;69;46;121
430597;202207;513;1224;265;739;22;64;81;173;103;237
430600;202207;2199;5536;950;2689;135;387;245;619;380;1006
430605;202207;1561;3792;1145;3077;147;425;560;1453;707;1878
430607;202207;769;1653;513;1222;31;78;347;784;378;862
430610;202207;7089;15642;4940;12508;1274;3595;1443;3445;2717;7040
430613;202207;298;673;83;233;12;36;21;45;33;81
430620;202207;847;1938;645;1592;125;355;343;733;468;1088
430630;202207;489;1283;154;449;31;90;41;99;72;189
430632;202207;494;1256;220;617;42;108;81;220;123;328
430635;202207;678;1444;503;1149;39;82;368;837;407;919
430637;202207;504;1177;389;1008;37;118;263;651;300;769
430640;202207;1272;3297;876;2507;126;388;357;898;483;1286
430642;202207;394;1045;275;780;42;136;119;312;161;448
430645;202207;183;413;89;219;12;30;32;63;44;93
430650;202207;2185;5444;1639;4579;482;1250;643;2010;1125;3260
430655;202207;351;827;210;554;31;95;109;246;140;341
430660;202207;5938;14096;4596;12024;769;2155;2432;6103;3201;8258
430670;202207;707;1616;522;1308;89;224;238;580;327;804
430673;202207;584;1283;265;719;42;120;103;252;145;372
430675;202207;278;796;72;243;13;43;11;34;24;77
430676;202207;6473;14964;5228;13108;642;1750;3343;8082;3985;9832
430680;202207;1310;3195;831;2277;268;730;249;582;517;1312
430690;202207;3574;8732;2861;7515;838;2262;1150;2937;1988;5199
430692;202207;231;681;184;601;8;31;143;473;151;504
430693;202207;1063;2668;651;1879;127;411;190;499;317;910
430695;202207;436;1019;265;684;36;101;131;309;167;410
430697;202207;523;1238;406;1073;69;189;236;638;305;827
430700;202207;9330;21648;6022;15798;1216;3498;1693;3840;2909;7338
430705;202207;427;954;209;569;21;62;94;224;115;286
430710;202207;2096;3969;1420;3094;107;292;1025;2094;1132;2386
430720;202207;930;2144;488;1365;62;194;255;648;317;842
430730;202207;1115;2879;775;2227;112;318;359;974;471;1292
430740;202207;787;2021;400;1210;73;231;114;333;187;564
430745;202207;501;1166;347;878;49;163;183;369;232;532
430750;202207;1781;4162;1201;3167;315;859;490;1212;805;2071
430755;202207;503;1207;347;907;32;96;190;448;222;544
430760;202207;2676;6207;2075;5309;420;1163;1019;2440;1439;3603
430770;202207;8358;19350;6621;16749;715;2065;4424;10674;5139;12739
430780;202207;2334;5519;1546;4230;243;724;770;1994;1013;2718
430781;202207;694;1689;452;1160;146;399;155;334;301;733
430783;202207;393;863;255;658;39;125;137;332;176;457
430786;202207;34;106;20;74;3;13;2;7;5;20
430790;202207;5484;12755;4029;10334;374;1188;2490;5866;2864;7054
430800;202207;981;2020;746;1706;54;131;542;1186;596;1317
430805;202207;414;984;280;728;13;47;203;497;216;544
430807;202207;672;1599;419;1123;57;188;203;464;260;652
430810;202207;866;1994;412;1132;59;188;162;370;221;558
430820;202207;1438;3854;869;2664;136;431;284;779;420;1210
430825;202207;299;701;118;294;18;38;40;97;58;135
430830;202207;2090;5218;1712;4540;152;373;1199;3098;1351;3471
430840;202207;1224;2752;845;2164;113;280;554;1403;667;1683
430843;202207;195;461;91;243;7;19;34;83;41;102
430845;202207;580;1248;391;940;38;108;250;541;288;649
430850;202207;2742;6830;1915;5336;507;1454;558;1574;1065;3028
430860;202207;1202;2812;607;1669;82;280;283;653;365;933
430865;202207;660;1579;416;1145;105;317;109;236;214;553
430870;202207;621;1608;276;850;54;170;60;162;114;332
430880;202207;1704;3633;1199;2855;141;392;782;1735;923;2127
430885;202207;184;472;104;310;10;29;67;195;77;224
430890;202207;1242;2932;805;2195;132;425;107;267;239;692
430900;202207;3708;7281;2630;5802;133;417;1937;3947;2070;4364
430905;202207;1063;2537;727;1928;128;358;286;691;414;1049
430910;202207;2550;6547;1953;5365;299;947;937;2252;1236;3199
430912;202207;572;1553;399;1199;41;114;242;733;283;847
430915;202207;585;1650;401;1249;123;404;110;339;233;743
430920;202207;29743;70263;23645;60513;2675;7767;15400;37597;18075;45364
430925;202207;94;202;45;119;4;13;24;60;28;73
430930;202207;13281;29127;9433;23438;1261;3315;5302;12676;6563;15991
430940;202207;1334;3285;885;2433;184;544;338;810;522;1354
430950;202207;1000;2032;652;1477;46;144;468;960;514;1104
430955;202207;462;1171;124;350;20;56;38;91;58;147
430957;202207;198;611;179;572;35;106;103;337;138;443
430960;202207;1619;3685;939;2497;202;576;348;835;550;1411
430965;202207;1725;3851;1371;3333;63;148;1041;2549;1104;2697
430970;202207;432;996;243;653;36;101;125;309;161;410
430975;202207;566;1563;434;1272;76;242;182;490;258;732
430980;202207;470;1027;275;707;26;78;144;328;170;406
430990;202207;691;1812;486;1378;71;231;228;612;299;843
430995;202207;638;1499;459;1215;61;169;256;637;317;806
431000;202207;1575;3621;698;1965;129;370;62;148;191;518
431010;202207;2905;7301;2103;5953;403;1246;723;1784;1126;3030
431020;202207;9334;19522;5701;14108;962;2782;2565;5463;3527;8245
431030;202207;378;998;191;611;40;138;30;94;70;232
431033;202207;4687;10527;3157;8125;658;1722;1212;3039;1870;4761
431036;202207;351;748;76;217;3;10;25;55;28;65
431040;202207;1024;2424;668;1835;66;236;367;913;433;1149
431041;202207;507;1115;357;881;59;142;183;418;242;560
431043;202207;435;1053;263;727;31;110;147;359;178;469
431046;202207;114;282;44;126;6;16;7;16;13;32
431050;202207;1503;3403;1079;2743;184;460;578;1467;762;1927
431053;202207;788;1941;428;1257;72;232;141;336;213;568
431055;202207;694;1571;544;1333;45;119;390;948;435;1067
431057;202207;240;683;143;459;31;108;55;160;86;268
431060;202207;6604;15389;4536;12032;1011;2893;1635;4025;2646;6918
431065;202207;463;1099;345;904;48;136;178;448;226;584
431070;202207;467;1205;285;822;67;215;67;175;134;390
431075;202207;274;739;155;475;34;118;54;156;88;274
431080;202207;649;1711;456;1318;71;227;166;438;237;665
431085;202207;899;2217;529;1418;58;169;265;683;323;852
431087;202207;472;1225;375;1030;47;130;221;589;268;719
431090;202207;470;1063;185;551;29;89;45;132;74;221
431100;202207;4471;9104;3142;7419;313;823;2015;4573;2328;5396
431110;202207;1657;3610;1157;2748;170;453;593;1265;763;1718
431112;202207;748;1808;627;1603;73;224;426;1022;499;1246
431113;202207;534;1301;432;1110;84;227;247;596;331;823
431115;202207;1111;2923;859;2468;78;290;594;1602;672;1892
431120;202207;3115;7510;2150;5724;484;1420;784;1891;1268;3311
431123;202207;399;1021;268;758;47;126;140;388;187;514
431125;202207;1315;3231;958;2586;287;765;454;1252;741;2017
431127;202207;221;590;72;223;8;29;11;31;19;60
431130;202207;3706;8662;2839;7346;408;1182;1543;3796;1951;4978
431140;202207;6571;15165;4125;10701;503;1432;1814;3985;2317;5417
431142;202207;720;1643;534;1358;85;227;338;840;423;1067
431150;202207;1166;2911;843;2349;131;408;427;1139;558;1547
431160;202207;780;1983;521;1458;115;339;157;405;272;744
431162;202207;659;1569;421;1148;41;138;232;567;273;705
431164;202207;196;454;54;163;4;14;12;30;16;44
431170;202207;520;1328;382;1060;101;276;111;284;212;560
431171;202207;962;2001;806;1810;162;337;543;1214;705;1551
431173;202207;527;1287;380;1079;114;373;123;306;237;679
431175;202207;1510;3350;929;2361;135;346;392;940;527;1286
431177;202207;1026;2512;793;2154;155;455;438;1155;593;1610
431179;202207;359;772;111;319;22;64;34;98;56;162
431180;202207;2673;6528;1655;4556;360;1012;410;974;770;1986
431190;202207;685;1666;295;838;36;108;70;157;106;265
431198;202207;461;1286;377;1130;88;276;161;508;249;784
431200;202207;386;945;114;307;26;71;16;40;42;111
431205;202207;258;659;142;413;43;125;43;122;86;247
431210;202207;719;1597;572;1377;123;297;277;698;400;995
431213;202207;314;778;235;633;16;40;130;336;146;376
431215;202207;695;1623;359;1015;36;119;179;470;215;589
431217;202207;193;476;133;361;28;91;59;139;87;230
431220;202207;658;1579;406;1115;53;156;216;533;269;689
431225;202207;1748;3775;1356;3175;118;295;950;2166;1068;2461
431230;202207;822;2162;619;1711;142;419;290;724;432;1143
431235;202207;195;528;27;91;1;1;6;20;7;21
431237;202207;404;1196;316;1011;55;197;150;461;205;658
431238;202207;39;114;32;100;7;21;15;42;22;63
431240;202207;5790;13229;4633;11410;501;1486;2983;6819;3484;8305
431242;202207;328;757;280;667;29;81;207;474;236;555
431244;202207;439;1041;228;604;29;91;92;209;121;300
431245;202207;1509;3350;1003;2499;80;210;541;1246;621;1456
431247;202207;313;736;196;512;29;89;96;218;125;307
431250;202207;2069;4817;1583;4184;356;879;808;2253;1164;3132
431260;202207;333;862;203;607;24;85;77;212;101;297
431261;202207;312;910;258;814;27;116;146;420;173;536
431262;202207;325;895;169;546;23;81;93;290;116;371
431265;202207;1802;4113;726;2025;117;360;214;503;331;863
431267;202207;281;681;188;494;16;52;126;301;142;353
431270;202207;3233;6841;1743;4343;384;1024;596;1412;980;2436
431275;202207;167;439;107;303;23;69;50;126;73;195
431280;202207;262;705;105;340;17;54;12;26;29;80
431290;202207;408;1175;263;829;49;169;51;148;100;317
431295;202207;82;198;30;85;7;24;7;15;14;39
431300;202207;338;876;84;259;8;28;30;83;38;111
431301;202207;294;808;81;251;11;37;11;25;22;62
431303;202207;746;1779;451;1205;31;97;199;451;230;548
431306;202207;2581;5912;1630;4324;190;564;709;1659;899;2223
431308;202207;38;107;34;98;11;33;16;45;27;78
431310;202207;611;1533;439;1177;65;173;217;534;282;707
431320;202207;804;2116;480;1441;79;245;162;429;241;674
431330;202207;2034;4665;1107;3031;146;458;500;1216;646;1674
431333;202207;238;606;132;378;20;62;45;111;65;173
431335;202207;38;114;23;82;8;31;2;4;10;35
431337;202207;3895;8819;3153;7727;236;768;2402;5557;2638;6325
431339;202207;498;1214;365;988;91;233;152;418;243;651
431340;202207;21498;50054;15332;39882;2124;6234;8057;19378;10181;25612
431342;202207;460;1015;339;822;40;100;240;570;280;670
431344;202207;425;1039;241;680;34;98;125;337;159;435
431346;202207;239;581;84;262;16;50;13;33;29;83
431349;202207;1036;2307;693;1634;108;275;403;880;511;1155
431350;202207;5450;12718;4228;10791;495;1447;2575;6156;3070;7603
431360;202207;644;1466;332;887;86;254;94;218;180;472
431365;202207;2579;5413;2037;4699;104;286;1661;3718;1765;4004
431370;202207;5664;12661;4203;10428;797;2114;2207;5332;3004;7446
431380;202207;1034;2612;831;2284;150;424;473;1283;623;1707
431390;202207;3125;7313;2018;5406;207;684;1098;2538;1305;3222
431395;202207;1859;4002;1418;3368;162;395;946;2174;1108;2569
431400;202207;344;936;196;603;39;119;38;96;77;215
431402;202207;1033;2133;773;1748;102;237;528;1146;630;1383
431403;202207;217;598;170;510;38;132;73;189;111;321
431405;202207;6091;14938;4851;12941;801;2460;2437;5948;3238;8408
431406;202207;649;1693;439;1247;111;283;161;501;272;784
431407;202207;601;1520;433;1183;63;170;265;704;328;874
431410;202207;21417;49897;15208;39669;1941;5929;8818;21018;10759;26947
431413;202207;277;758;63;205;9;26;18;54;27;80
431415;202207;816;1901;538;1431;101;308;256;598;357;906
431417;202207;635;1328;416;985;66;185;227;503;293;688
431420;202207;1934;4029;1483;3437;120;327;985;2157;1105;2484
431430;202207;657;1590;325;941;45;147;112;280;157;427
431440;202207;39184;85271;28652;69675;4695;12421;13988;31133;18683;43554
431442;202207;161;447;80;269;13;43;12;38;25;81
431445;202207;410;1131;125;405;12;30;19;50;31;80
431446;202207;324;887;248;735;28;88;135;387;163;475
431447;202207;866;2146;502;1430;86;243;149;427;235;670
431449;202207;905;2177;607;1617;99;261;284;703;383;964
431450;202207;2767;5135;2162;4307;68;147;1788;3415;1856;3562
431454;202207;48;150;39;128;8;27;22;67;30;94
431455;202207;648;1466;335;847;31;79;172;386;203;465
431460;202207;3431;7671;2322;5768;519;1335;853;2046;1372;3381
431470;202207;1608;4151;1172;3286;222;676;462;1207;684;1883
431475;202207;285;759;57;189;3;11;8;17;11;28
431477;202207;517;1258;293;814;71;176;102;267;173;443
431478;202207;246;659;56;175;11;30;6;13;17;43
431480;202207;3951;9418;3116;8103;735;1952;1425;3659;2160;5611
431490;202207;133958;295884;103216;249964;6065;18315;77272;177366;83337;195681
431500;202207;547;1325;414;1090;57;161;225;565;282;726
431505;202207;295;667;197;521;18;51;135;353;153;404
431507;202207;357;831;139;407;43;132;21;49;64;181
431510;202207;1972;4724;1350;3555;350;941;400;1064;750;2005
431513;202207;247;532;133;338;37;116;39;67;76;183
431514;202207;140;329;110;281;3;8;75;172;78;180
431515;202207;578;1310;442;1080;98;251;245;566;343;817
431517;202207;70;201;57;175;6;24;27;77;33;101
431520;202207;427;1024;183;524;24;84;80;181;104;265
431530;202207;5992;12616;3671;9144;680;1736;1638;3896;2318;5632
431531;202207;233;532;148;382;20;55;56;130;76;185
431532;202207;663;1452;406;996;76;211;192;445;268;656
431535;202207;314;787;141;413;26;78;26;69;52;147
431540;202207;2012;5822;1839;5595;82;279;1439;4429;1521;4708
431545;202207;386;946;80;218;10;23;24;66;34;89
431550;202207;2558;6083;1817;4729;250;735;1004;2414;1254;3149
431555;202207;789;1693;472;1157;49;134;270;651;319;785
431560;202207;29429;66707;20269;52620;4000;10019;7927;21040;11927;31059
431570;202207;5744;11930;4891;10751;265;759;4072;8485;4337;9244
431575;202207;417;943;352;845;76;150;199;474;275;624
431580;202207;692;1723;450;1260;55;177;242;632;297;809
431590;202207;825;2141;595;1662;121;331;231;628;352;959
431595;202207;424;1079;273;775;53;156;101;257;154;413
431600;202207;1958;4439;1387;3559;246;690;649;1552;895;2242
431610;202207;1662;3829;1101;2857;168;426;503;1357;671;1783
431620;202207;534;1295;282;743;61;182;138;300;199;482
431630;202207;1483;3515;694;1950;138;421;227;565;365;986
431640;202207;7851;16645;6644;15132;696;1766;4675;10343;5371;12109
431642;202207;750;1620;461;1119;100;204;192;453;292;657
431643;202207;412;975;198;546;22;59;65;169;87;228
431645;202207;2571;4847;2036;4168;42;117;1780;3539;1822;3656
431647;202207;352;807;119;330;15;44;35;85;50;129
431650;202207;143;384;102;320;13;52;43;114;56;166
431660;202207;1037;2610;491;1492;87;308;122;320;209;628
431670;202207;1393;3180;828;2178;138;363;382;914;520;1277
431673;202207;255;648;106;327;14;47;30;75;44;122
431675;202207;416;1052;121;402;16;56;19;56;35;112
431680;202207;10583;24627;7985;20070;1566;4314;3951;9147;5517;13461
431690;202207;29902;68702;21488;54359;3160;9097;11685;27732;14845;36829
431695;202207;255;593;148;399;22;84;83;189;105;273
431697;202207;527;1168;411;998;68;157;236;574;304;731
431700;202207;1662;3836;1331;3276;213;464;727;1808;940;2272
431710;202207;16471;35642;11922;29401;1570;4145;7250;17333;8820;21478
431720;202207;7955;18311;4878;12893;1159;3167;1237;2897;2396;6064
431725;202207;42;101;31;82;8;27;16;36;24;63
431730;202207;5032;11162;3356;8661;629;1740;1608;3921;2237;5661
431740;202207;6106;13758;4140;10616;971;2781;1288;2950;2259;5731
431750;202207;9418;22757;7070;19115;1672;4737;2645;6943;4317;11680
431755;202207;354;945;93;298;10;37;23;62;33;99
431760;202207;6130;13136;4271;10226;457;1277;2658;5901;3115;7178
431770;202207;2336;4957;1793;4242;272;594;1178;2815;1450;3409
431775;202207;237;584;129;375;28;92;29;68;57;160
431780;202207;2486;5676;1632;4183;265;728;657;1603;922;2331
431790;202207;844;2132;560;1570;101;286;211;591;312;877
431795;202207;314;765;150;436;26;80;45;119;71;199
431800;202207;9721;21878;6175;16397;1649;5145;726;1780;2375;6925
431805;202207;317;805;72;258;3;7;3;5;6;12
431810;202207;3787;8207;2408;5808;364;939;1284;2864;1648;3803
431820;202207;2468;6133;1903;5252;483;1468;823;2203;1306;3671
431830;202207;10185;21399;7487;17771;2199;5890;1407;3495;3606;9385
431840;202207;3204;7480;2582;6537;347;943;1658;4113;2005;5056
431842;202207;547;1332;190;567;31;109;64;162;95;271
431843;202207;356;922;249;699;51;157;111;287;162;444
431844;202207;211;571;74;241;13;45;17;51;30;96
431845;202207;558;1383;379;1037;33;93;228;608;261;701
431846;202207;335;778;293;719;13;37;258;624;271;661
431848;202207;178;451;97;276;10;33;30;69;40;102
431849;202207;412;991;84;239;11;32;15;29;26;61
431850;202207;4974;12460;3835;10367;922;2689;1331;3340;2253;6029
431860;202207;744;1666;416;1067;49;138;256;629;305;767
431861;202207;120;322;79;234;19;63;26;65;45;128
431862;202207;553;1676;455;1493;94;353;215;661;309;1014
431870;202207;26355;61530;21176;53717;2093;6153;13745;33052;15838;39205
431880;202207;4579;11008;3335;8884;419;1299;1803;4496;2222;5795
431890;202207;5738;13480;3663;9641;1040;2765;944;2454;1984;5219
431900;202207;1177;2846;769;2119;122;369;368;909;490;1278
431910;202207;885;2001;357;929;52;139;119;243;171;382
431912;202207;592;1435;475;1243;65;178;309;797;374;975
431915;202207;1319;2837;1046;2428;72;176;801;1797;873;1973
431920;202207;1496;3053;1237;2731;34;82;1088;2361;1122;2443
431930;202207;826;2003;564;1543;190;504;194;545;384;1049
431935;202207;98;251;71;205;12;38;19;47;31;85
431936;202207;352;926;206;572;40;113;105;281;145;394
431937;202207;184;466;123;351;27;67;46;125;73;192
431940;202207;3451;7639;2195;5466;165;473;1355;3157;1520;3630
431950;202207;2463;5871;1941;5062;476;1251;865;2213;1341;3464
431960;202207;3500;7993;2679;6593;759;1930;821;1932;1580;3862
431970;202207;451;1091;208;573;50;136;49;130;99;266
431971;202207;85;207;39;115;5;15;9;26;14;41
431973;202207;671;1907;452;1460;45;163;323;1031;368;1194
431975;202207;125;251;36;95;6;20;9;18;15;38
431980;202207;1313;2985;1050;2594;125;398;694;1549;819;1947
431990;202207;7074;16140;5248;13588;443;1399;3260;8048;3703;9447
432000;202207;16333;35791;12223;29652;1631;4400;7582;17347;9213;21747
432010;202207;3134;6946;2096;5289;457;1184;767;1772;1224;2956
432020;202207;1899;4789;1186;3316;317;940;292;774;609;1714
432023;202207;608;1376;295;784;38;99;134;302;172;401
432026;202207;1188;2982;906;2447;257;698;346;969;603;1667
432030;202207;508;1132;295;764;18;45;176;412;194;457
432032;202207;381;924;248;658;23;73;132;314;155;387
432035;202207;791;2099;662;1882;169;442;326;978;495;1420
432040;202207;1238;2827;496;1444;51;168;210;535;261;703
432045;202207;195;507;121;358;18;54;54;149;72;203
432050;202207;638;1468;464;1177;61;187;245;599;306;786
432055;202207;791;1900;546;1457;167;427;159;421;326;848
432057;202207;180;461;151;393;6;16;98;231;104;247
432060;202207;482;1144;142;442;16;54;38;112;54;166
432065;202207;256;659;194;536;45;130;87;229;132;359
432067;202207;925;2397;778;2089;71;228;559;1430;630;1658
432070;202207;1922;4538;1378;3582;198;589;714;1678;912;2267
432080;202207;5839;12556;4351;10350;620;1765;2263;4943;2883;6708
432085;202207;454;1159;346;996;62;200;182;497;244;697
432090;202207;3105;7367;1854;5054;359;972;800;2037;1159;3009
432100;202207;1066;2570;530;1569;92;286;114;276;206;562
432110;202207;2461;5959;1798;4836;445;1284;366;873;811;2157
432120;202207;4160;10367;3337;9032;522;1568;1741;4410;2263;5978
432130;202207;3177;7329;2638;6549;450;1145;1495;3697;1945;4842
432132;202207;268;706;148;444;22;75;66;167;88;242
432135;202207;1159;2529;791;1924;82;202;547;1324;629;1526
432140;202207;2126;5531;1674;4700;189;621;1114;2985;1303;3606
432143;202207;1753;4336;1325;3666;92;295;836;2247;928;2542
432145;202207;2016;5125;1325;3771;201;619;442;1033;643;1652
432146;202207;129;342;99;307;37;134;29;82;66;216
432147;202207;633;1664;340;1024;119;366;61;180;180;546
432149;202207;564;1292;270;717;30;79;114;274;144;353
432150;202207;4424;10308;3337;8548;617;1760;1639;3862;2256;5622
432160;202207;7233;16987;5420;14285;1342;3699;2118;5496;3460;9195
432162;202207;238;517;40;112;7;18;11;22;18;40
432163;202207;179;425;34;94;3;9;5;6;8;15
432166;202207;742;1935;602;1676;103;333;230;560;333;893
432170;202207;1766;4515;1226;3550;216;674;509;1335;725;2009
432180;202207;3447;7741;1904;4992;286;847;861;1933;1147;2780
432183;202207;437;1184;318;932;70;247;133;352;203;599
432185;202207;979;2397;582;1641;109;323;253;675;362;998
432190;202207;2442;5539;1733;4462;146;468;1138;2708;1284;3176
432195;202207;1114;2728;725;2009;136;371;271;737;407;1108
432200;202207;4190;9566;3156;8019;239;660;2209;5430;2448;6090
432210;202207;484;1153;331;873;41;122;196;448;237;570
432215;202207;744;1897;658;1766;70;175;447;1195;517;1370
432218;202207;261;612;117;317;13;42;44;90;57;132
432220;202207;4168;9206;3020;7372;515;1285;1662;3878;2177;5163
432225;202207;157;405;105;305;14;39;49;138;63;177
432230;202207;899;2051;467;1267;57;182;204;486;261;668
432232;202207;558;1319;355;991;60;186;158;394;218;580
432234;202207;341;816;172;479;36;86;43;105;79;191
432235;202207;51;139;24;69;5;16;9;22;14;38
432237;202207;340;838;294;763;10;30;245;619;255;649
432240;202207;19891;44201;14683;37438;1290;3141;10072;25589;11362;28730
432250;202207;7264;18841;5425;15297;1044;3163;2684;7235;3728;10398
432252;202207;535;1219;344;861;42;109;191;437;233;546
432253;202207;1016;2784;693;2017;189;576;118;308;307;884
432254;202207;723;1656;224;644;28;81;39;84;67;165
432255;202207;116;288;66;184;7;22;35;85;42;107
432260;202207;6388;15204;4808;12350;982;2716;2220;5255;3202;7971
432270;202207;2544;6276;2055;5420;596;1637;725;1838;1321;3475
432280;202207;1519;3659;816;2331;130;413;275;645;405;1058
432285;202207;153;451;31;88;4;10;8;22;12;32
432290;202207;399;1025;248;704;66;199;71;160;137;359
432300;202207;34084;78750;26035;66401;2536;7677;17364;41816;19900;49493
432310;202207;1156;2616;883;2146;94;213;687;1647;781;1860
432320;202207;224;502;100;277;14;41;35;82;49;123
432330;202207;198;462;67;217;11;36;12;39;23;75
432335;202207;182;529;65;238;7;21;12;36;19;57
432340;202207;369;902;167;528;28;91;51;158;79;249
432345;202207;911;1787;775;1626;13;37;678;1384;691;1421
432350;202207;382;900;193;544;34;110;58;132;92;242
432360;202207;244;709;49;161;4;12;13;34;17;46
432370;202207;401;882;233;599;23;70;137;336;160;406
432375;202207;610;1403;421;1042;109;287;153;376;262;663
432377;202207;176;522;41;139;1;3;11;24;12;27
432380;202207;2239;5819;1591;4652;241;757;820;2316;1061;3073
500020;202207;3788;8735;2672;7020;249;793;1755;4446;2004;5239
500025;202207;1346;3162;868;2285;111;296;469;1177;580;1473
500060;202207;9494;24975;6637;19184;840;2643;3819;10909;4659;13552
500070;202207;5814;13556;4173;10885;754;2118;1987;5096;2741;7214
500080;202207;1841;4278;1134;3018;188;561;448;1037;636;1598
500085;202207;2363;5584;1664;4358;432;1225;688;1672;1120;2897
500090;202207;2412;5958;1644;4698;276;863;525;1605;801;2468
500100;202207;4514;10747;3437;9071;528;1580;1644;4055;2172;5635
500110;202207;11953;27531;8272;21930;1605;4482;3881;10300;5486;14782
500124;202207;2583;6767;2073;5978;314;898;1250;3661;1564;4559
500150;202207;1769;3706;1238;3003;221;612;676;1494;897;2106
500190;202207;5954;14592;3898;10767;793;2277;1349;3420;2142;5697
500200;202207;3192;6934;2174;5290;191;495;1400;3225;1591;3720
500210;202207;5905;12787;4227;10633;1127;2859;2109;5249;3236;8108
500215;202207;1691;4321;1256;3556;123;372;726;2017;849;2389
500220;202207;3708;9358;2713;7700;435;1338;1375;3640;1810;4978
500230;202207;2397;5245;1856;4520;236;605;1207;2866;1443;3471
500240;202207;4872;13415;3572;10778;529;1722;1537;4657;2066;6379
500260;202207;3798;7700;2475;5913;249;686;1494;3334;1743;4020
500270;202207;171086;383579;110877;286555;15320;44610;49988;116827;65308;161437
500280;202207;1619;3827;1081;3018;165;470;585;1622;750;2092
500290;202207;4320;9980;2658;7185;404;1241;1018;2432;1422;3673
500295;202207;4666;10689;3094;8024;530;1549;1322;3001;1852;4550
500310;202207;1200;2274;814;1803;127;237;458;1022;585;1259
500315;202207;5031;11992;4051;10649;276;792;3149;8192;3425;8984
500320;202207;24045;59796;16656;47873;4046;11680;6469;19555;10515;31235
500325;202207;6852;14312;4850;11617;549;1410;2970;6899;3519;8309
500330;202207;8036;17206;5345;13361;507;1299;2954;7414;3461;8713
500345;202207;2522;5882;1703;4578;282;798;663;1706;945;2504
500348;202207;2739;6541;2066;5429;189;550;1373;3572;1562;4122
500350;202207;1419;3709;830;2487;98;314;303;831;401;1145
500370;202207;32095;78679;23406;64755;2909;9252;12171;32411;15080;41663
500375;202207;3032;7541;1983;5445;261;779;799;1932;1060;2711
500380;202207;4145;9823;2905;7795;806;2205;520;1437;1326;3642
500390;202207;747;1518;462;1164;62;171;266;667;328;838
500400;202207;1845;4506;1221;3310;207;638;463;1117;670;1755
500410;202207;2827;6316;1966;5086;227;545;1086;2951;1313;3496
500430;202207;3288;7644;2256;6115;338;906;938;2753;1276;3659
500440;202207;1881;4299;1052;2889;170;458;398;1129;568;1587
500450;202207;2155;5080;1369;3749;267;736;364;939;631;1675
500460;202207;4411;11029;2726;7815;486;1572;741;1929;1227;3501
500470;202207;3105;7980;2021;5825;484;1524;547;1356;1031;2880
500480;202207;2316;6807;1912;6183;174;589;1397;4579;1571;5168
500490;202207;1346;2999;810;2179;154;493;215;572;369;1065
500500;202207;4809;12065;3185;9556;931;3095;387;1252;1318;4347
500510;202207;835;2005;552;1500;34;113;373;940;407;1053
500515;202207;1927;4700;1479;4006;204;603;846;2224;1050;2827
500520;202207;4033;10739;3106;9218;676;1971;1543;4757;2219;6728
500525;202207;1145;3133;912;2785;131;422;553;1649;684;2071
500540;202207;6116;15130;3744;10964;1087;3566;620;1545;1707;5111
500560;202207;6221;15622;4973;14077;219;683;4111;11716;4330;12399
500568;202207;5342;11075;3325;8095;651;1667;1392;3070;2043;4737
500570;202207;9816;21630;6769;16768;937;2701;3618;8123;4555;10824
500580;202207;3699;9011;2688;7293;650;1822;1194;3183;1844;5005
500600;202207;4346;10275;3197;8476;749;2096;1000;2598;1749;4694
500620;202207;9452;23469;6599;18198;1003;2990;3236;8331;4239;11321
500625;202207;623;1615;428;1237;64;204;167;454;231;658
500627;202207;929;2373;575;1753;93;302;187;534;280;836
500630;202207;8932;19076;5220;13217;1050;2885;1690;4035;2740;6920
500635;202207;3178;9627;2405;8576;257;812;1647;6373;1904;7185
500640;202207;2118;4316;1415;3400;69;193;960;2185;1029;2378
500660;202207;23968;55972;16580;45471;4975;13942;5500;15329;10475;29271
500690;202207;3164;7611;2186;6081;430;1410;1095;2846;1525;4256
500710;202207;3786;9466;2780;7766;666;2051;889;2350;1555;4401
500720;202207;6073;14709;4056;11392;826;2514;1388;3685;2214;6199
500730;202207;1261;2943;701;1958;136;384;213;594;349;978
500740;202207;5553;12569;3600;9569;638;1807;1623;4131;2261;5938
500750;202207;1270;2989;890;2381;129;375;388;926;517;1301
500755;202207;1269;3149;811;2304;141;442;246;616;387;1058
500769;202207;6119;14417;3454;9554;748;2189;548;1337;1296;3526
500770;202207;1672;4257;1152;3398;220;683;388;1097;608;1780
500780;202207;1482;3476;965;2606;177;550;266;610;443;1160
500790;202207;8524;21617;6266;17611;1235;3751;2419;6699;3654;10450
500793;202207;2448;5829;1773;4702;347;983;748;1812;1095;2795
500795;202207;3391;7490;2685;6571;144;366;2182;5401;2326;5767
500797;202207;935;2275;627;1718;191;555;189;489;380;1044
500800;202207;4142;9005;2606;6735;720;2068;514;1394;1234;3462
500830;202207;23066;54278;15738;41337;3410;9409;5711;14138;9121;23547
500840;202207;1711;3918;1063;2703;121;321;505;1185;626;1506
510010;202207;2121;4420;1504;3642;202;462;982;2374;1184;2836
510020;202207;4878;11716;2699;7553;486;1450;790;1934;1276;3384
510025;202207;8494;19477;5528;14883;663;1957;2925;7460;3588;9417
510030;202207;3677;7605;2465;5811;253;625;1335;3035;1588;3660
510035;202207;1333;3362;868;2614;238;719;325;1073;563;1792
510040;202207;2829;5912;2118;5030;258;539;1340;3303;1598;3842
510050;202207;2638;5041;1820;4015;219;578;1253;2647;1472;3225
510060;202207;1740;4227;1166;3202;259;762;272;621;531;1383
510080;202207;1767;4335;1201;3432;201;637;546;1475;747;2112
510100;202207;802;1755;585;1428;69;190;342;775;411;965
510120;202207;330;566;187;401;9;23;152;311;161;334
510125;202207;2403;5768;1874;4978;237;748;975;2363;1212;3111
510130;202207;1889;4445;1339;3589;312;864;603;1557;915;2421
510140;202207;3543;8776;2421;7356;864;2870;822;2576;1686;5446
510160;202207;2227;4866;1727;4234;58;160;1526;3720;1584;3880
510170;202207;5826;14189;4425;11981;859;2506;2061;5414;2920;7920
510180;202207;17588;36858;11922;29054;2005;5289;5858;14523;7863;19812
510185;202207;2044;5094;1333;4066;535;1654;314;1217;849;2871
510190;202207;2778;7302;1752;5613;435;1513;374;1276;809;2789
510250;202207;20566;48121;15388;40516;2249;6492;8918;23302;11167;29794
510260;202207;2091;8561;1759;7996;264;1180;1056;5432;1320;6612
510263;202207;4129;11095;2725;8331;517;1777;613;1609;1130;3386
510267;202207;6538;17914;3864;11969;698;2354;713;1868;1411;4222
510268;202207;1543;3824;1086;3058;293;869;292;679;585;1548
510269;202207;1181;3026;771;2289;148;484;325;903;473;1387
510270;202207;3508;9419;2468;7634;374;1292;1070;3240;1444;4532
510279;202207;2111;5247;1237;3665;172;576;390;1009;562;1585
510285;202207;1261;3159;832;2413;203;655;270;689;473;1344
510300;202207;4575;10574;3462;9145;289;770;2484;6655;2773;7425
510305;202207;1672;4385;1090;3317;224;682;305;979;529;1661
510310;202207;1180;2762;823;2200;196;511;312;867;508;1378
510320;202207;4605;10652;3216;8425;706;2018;1046;2475;1752;4493
510325;202207;5071;14181;3502;11127;821;2757;917;2872;1738;5629
510330;202207;3046;8552;2040;6825;448;1583;789;2846;1237;4429
510335;202207;5793;15728;4424;13502;764;2549;2280;6915;3044;9464
510336;202207;560;1490;406;1262;62;179;215;740;277;919
510337;202207;1706;4678;1130;3690;413;1441;305;992;718;2433
510340;202207;112710;240815;77268;191329;15845;43756;32380;74828;48225;118584
510343;202207;1422;3267;941;2483;116;358;517;1264;633;1622
510345;202207;1497;3904;1131;3216;182;519;588;1560;770;2079
510350;202207;3669;8698;2473;6821;722;2063;692;1847;1414;3910
510360;202207;2338;4418;1448;3397;59;109;1050;2590;1109;2699
510370;202207;2039;5449;1545;4676;213;685;955;2921;1168;3606
510380;202207;666;1535;395;1083;49;156;172;451;221;607
510385;202207;1413;4489;1050;3838;100;436;699;2630;799;3066
510390;202207;1630;3773;1125;3191;299;826;559;1660;858;2486
510395;202207;818;1692;546;1311;33;70;382;929;415;999
510410;202207;5878;14918;4305;12315;743;2153;2468;7209;3211;9362
510420;202207;2970;5644;2060;4466;80;181;1572;3370;1652;3551
510450;202207;626;1453;368;1017;80;221;115;297;195;518
510452;202207;1017;2709;754;2223;115;370;429;1227;544;1597
510454;202207;1273;3219;961;2713;133;339;581;1756;714;2095
510455;202207;1097;2801;720;2103;141;457;273;718;414;1175
510460;202207;2308;5501;1677;4568;363;1082;793;1935;1156;3017
510480;202207;5753;13288;3846;9891;681;1878;1684;3956;2365;5834
510490;202207;2037;4816;1534;4185;238;666;1000;2722;1238;3388
510500;202207;1751;4081;1059;3009;244;731;291;798;535;1529
510510;202207;4619;12123;3278;9902;934;3050;1029;3115;1963;6165
510515;202207;6181;14903;4198;11521;837;2568;1515;3675;2352;6243
510517;202207;1771;4327;1200;3492;449;1386;257;688;706;2074
510520;202207;2704;5266;1479;3698;140;369;679;1771;819;2140
510523;202207;1422;3170;1011;2559;113;319;668;1627;781;1946
510525;202207;9294;24192;6945;19759;1124;3459;3147;8377;4271;11836
510530;202207;607;1500;449;1283;48;138;290;844;338;982
510550;202207;2998;8107;2271;6924;416;1372;1231;3639;1647;5011
510558;202207;2684;6846;1989;5807;257;666;1045;3279;1302;3945
510560;202207;2068;5609;1298;4096;307;1021;280;916;587;1937
510562;202207;6941;15789;5140;12830;797;2036;2617;6413;3414;8449
510590;202207;3675;8502;2666;7237;272;750;1845;5106;2117;5856
510600;202207;1354;2773;949;2205;109;274;563;1225;672;1499
510610;202207;3199;7217;2200;5902;333;1019;1246;3244;1579;4263
510615;202207;3348;7778;2347;6258;313;890;1459;3860;1772;4750
510617;202207;1218;3402;966;3034;102;361;707;2268;809;2629
510618;202207;1452;3595;1041;2967;205;655;523;1427;728;2082
510619;202207;871;2149;486;1425;81;244;95;217;176;461
510620;202207;1575;3440;789;2190;282;877;64;139;346;1016
510621;202207;1810;4597;1084;3259;246;781;289;749;535;1530
510622;202207;6280;16460;4129;12080;1273;3986;663;1699;1936;5685
510623;202207;3251;7555;2349;6175;525;1484;899;2320;1424;3804
510624;202207;1880;4744;998;3125;116;400;223;623;339;1023
510625;202207;3974;9186;2426;6516;432;1275;865;2239;1297;3514
510626;202207;1665;3961;1108;3092;274;845;315;882;589;1727
510627;202207;732;1796;402;1176;107;325;110;339;217;664
510628;202207;1743;3678;1131;2914;342;986;447;1082;789;2068
510629;202207;1988;5202;1354;4072;286;925;384;1134;670;2059
510630;202207;3930;10332;2497;7768;584;1918;616;2026;1200;3944
510631;202207;707;1543;532;1295;21;40;416;1026;437;1066
510637;202207;4240;9436;3021;7745;684;1922;1111;2815;1795;4737
510642;202207;6985;17857;5427;15626;907;2980;3311;9299;4218;12279
510645;202207;1191;2236;736;1672;176;373;327;779;503;1152
510650;202207;8283;19265;6518;17357;932;1572;4627;13789;5559;15361
510665;202207;2033;4256;1292;3124;285;614;507;1342;792;1956
510670;202207;500;1032;296;759;34;89;157;401;191;490
510675;202207;7573;19742;5120;15236;1292;4244;918;2497;2210;6741
510677;202207;2672;6456;1893;5319;312;972;1085;2960;1397;3932
510680;202207;817;1986;472;1377;91;300;124;305;215;605
510682;202207;1953;5222;1445;4434;463;1591;496;1432;959;3023
510685;202207;601;1609;433;1288;38;120;261;772;299;892
510700;202207;5013;11186;3474;9069;333;984;2449;6248;2782;7232
510704;202207;12960;29338;8782;22490;2119;5719;2541;6026;4660;11745
510706;202207;2723;7524;1883;6147;351;1169;792;2812;1143;3981
510710;202207;3495;8146;2210;5804;555;1416;660;1646;1215;3062
510715;202207;745;1470;493;1154;35;99;313;695;348;794
510718;202207;2647;5860;1618;4479;340;922;753;2360;1093;3282
510719;202207;544;1106;318;786;37;113;171;380;208;493
510720;202207;1069;2335;702;1818;171;466;277;677;448;1143
510724;202207;1027;2732;701;2110;103;363;332;911;435;1274
510726;202207;1091;1979;627;1425;72;170;336;755;408;925
510729;202207;688;1535;319;869;39;120;91;254;130;374
510730;202207;3484;7981;2388;6337;329;998;1293;3212;1622;4210
510735;202207;1425;3708;1144;3328;89;261;922;2681;1011;2942
510740;202207;1138;2628;770;1991;76;240;481;1143;557;1383
510757;202207;550;1711;427;1520;144;580;144;483;288;1063
510760;202207;52653;110739;32817;81751;6523;18126;12094;27113;18617;45239
510770;202207;4840;10151;3397;8351;251;546;2359;5999;2610;6545
510774;202207;460;1141;327;940;56;157;186;546;242;703
510775;202207;774;1895;477;1421;110;346;135;370;245;716
510776;202207;810;1959;560;1490;104;315;255;659;359;974
510777;202207;1762;4406;1279;3790;201;719;832;2365;1033;3084
510779;202207;908;2321;666;1926;71;183;427;1287;498;1470
510780;202207;4837;11302;3552;9481;696;1783;1805;5212;2501;6995
510785;202207;2431;6097;1423;4289;339;1062;363;1142;702;2204
510787;202207;3831;10214;2561;7791;911;2885;249;706;1160;3591
510788;202207;638;1421;427;1113;65;155;202;597;267;752
510790;202207;22659;55845;14584;41811;3458;10772;1968;5063;5426;15835
510792;202207;11823;31350;7564;23252;1686;5638;1552;4257;3238;9895
510794;202207;1470;3839;1058;3185;337;1162;232;574;569;1736
510795;202207;11798;28708;8294;22779;1829;5564;2841;7141;4670;12705
510800;202207;1755;4499;1227;3630;351;1130;170;399;521;1529
510805;202207;1781;4706;1175;3599;235;798;478;1340;713;2138
510810;202207;807;1549;527;1191;164;315;247;601;411;916
510820;202207;915;1678;532;1213;28;58;346;775;374;833
510830;202207;1074;2372;816;2050;68;171;600;1555;668;1726
510835;202207;710;1567;465;1224;55;174;283;699;338;873
510840;202207;70881;141544;50571;117096;8163;18085;29639;70395;37802;88480
510850;202207;2177;5212;1392;4004;575;1876;95;146;670;2022
510860;202207;3037;7549;1977;5883;646;2063;389;1184;1035;3247
510880;202207;879;2360;640;1940;167;512;175;531;342;1043
510885;202207;719;1690;468;1305;87;239;120;322;207;561
510890;202207;955;2513;698;2052;188;586;253;724;441;1310
510895;202207;1661;4002;1118;3092;154;506;558;1378;712;1884
520005;202207;4026;9721;3190;8651;930;2158;1394;4482;2324;6640
520010;202207;3245;8202;2391;6612;504;1536;954;2311;1458;3847
520013;202207;4090;9726;2670;7205;646;1757;804;2281;1450;4038
520015;202207;600;1441;439;1203;102;281;170;499;272;780
520017;202207;1423;3372;999;2709;185;567;447;1091;632;1658
520020;202207;586;1139;451;984;29;74;365;771;394;845
520025;202207;44045;111396;37510;102265;5147;14742;24550;66333;29697;81075
520030;202207;7628;17158;6274;15355;423;1079;4804;11560;5227;12639
520050;202207;469;1100;286;769;40;106;156;414;196;520
520055;202207;2073;4849;1292;3302;205;520;581;1391;786;1911
520060;202207;2149;5254;1470;4087;297;939;378;1040;675;1979
520080;202207;2176;5249;1668;4571;315;783;835;2428;1150;3211
520082;202207;1019;2428;722;1931;123;349;321;907;444;1256
520085;202207;1200;2797;959;2455;196;502;480;1216;676;1718
520090;202207;1036;1903;750;1598;61;91;610;1329;671;1420
520110;202207;49113;123517;34179;98685;9722;30798;3802;9910;13524;40708
520120;202207;287;642;150;401;21;68;58;137;79;205
520130;202207;4573;10345;3507;8709;670;1698;1520;3686;2190;5384
520140;202207;57065;142591;39920;113825;13256;40012;5702;16679;18958;56691
520145;202207;701;1531;454;1175;97;264;185;430;282;694
520150;202207;748;1723;547;1465;70;183;281;734;351;917
520160;202207;1027;2343;700;1770;133;300;264;702;397;1002
520170;202207;5445;10759;3611;8633;276;727;2616;6164;2892;6891
520180;202207;3149;7571;2539;6718;321;1001;1613;4077;1934;5078
520215;202207;2070;4681;1499;3852;247;679;823;2053;1070;2732
520235;202207;893;1856;596;1449;97;248;327;785;424;1033
520250;202207;1966;4683;1439;3863;498;1417;321;992;819;2409
520260;202207;884;1988;547;1452;104;277;206;531;310;808
520280;202207;997;2132;780;1806;162;362;408;957;570;1319
520310;202207;1191;2431;770;1814;192;507;309;732;501;1239
520320;202207;2289;5577;1761;4770;211;568;1001;2758;1212;3326
520330;202207;5677;13844;4330;11610;652;2028;2352;5880;3004;7908
520340;202207;2717;5649;1643;4150;178;382;895;2350;1073;2732
520350;202207;3580;8252;2510;6632;734;1982;877;2349;1611;4331
520355;202207;2214;5706;1595;4553;457;1401;278;681;735;2082
520357;202207;988;2173;708;1778;35;84;563;1403;598;1487
520360;202207;916;2196;710;1876;123;345;320;797;443;1142
520380;202207;1629;3873;985;2727;160;485;355;871;515;1356
520390;202207;1346;2973;857;2325;237;685;224;636;461;1321
520393;202207;766;1719;509;1316;69;184;205;502;274;686
520396;202207;1030;2415;864;2171;50;126;617;1487;667;1613
520400;202207;1875;4200;1452;3648;99;278;1074;2673;1173;2951
520410;202207;2600;5366;1763;4165;263;714;982;2153;1245;2867
520420;202207;420;908;326;769;18;50;247;554;265;604
520425;202207;1769;4184;1001;2733;278;812;180;432;458;1244
520430;202207;2813;6191;1715;4454;407;1136;288;663;695;1799
520440;202207;3477;8024;1972;5352;420;1266;461;1174;881;2440
520450;202207;16045;36357;11064;28747;3159;8413;3084;8165;6243;16578
520455;202207;916;2292;648;1878;198;577;169;516;367;1093
520460;202207;1234;2726;957;2375;158;346;651;1687;809;2033
520465;202207;1052;2382;868;2135;58;178;676;1617;734;1795
520470;202207;2661;6115;2051;5334;519;1345;996;2750;1515;4095
520480;202207;1076;2791;766;2262;177;548;289;808;466;1356
520485;202207;1732;4866;1359;4280;227;769;672;2009;899;2778
520490;202207;5041;12411;3870;10619;681;2006;2199;5907;2880;7913
520495;202207;1906;3759;1446;3151;108;227;1077;2362;1185;2589
520500;202207;1969;4580;1467;3727;198;584;828;1952;1026;2536
520505;202207;1077;2097;831;1802;53;118;652;1366;705;1484
520510;202207;10436;24275;7655;20148;1362;4097;3548;8814;4910;12911
520520;202207;1392;3284;1069;2808;243;690;457;1183;700;1873
520530;202207;2940;7366;2145;5977;397;1070;1057;3103;1454;4173
520540;202207;3605;8939;2378;6611;447;1300;691;1747;1138;3047
520545;202207;1569;3603;1231;3100;273;678;602;1500;875;2178
520547;202207;1512;3655;1171;3076;244;649;612;1591;856;2240
520549;202207;18482;44839;15363;40449;1844;5385;10424;26520;12268;31905
520551;202207;5654;13745;4754;12473;434;1384;3467;8755;3901;10139
520552;202207;1114;2668;866;2307;171;455;447;1242;618;1697
520570;202207;626;1345;401;996;78;166;171;428;249;594
520580;202207;2584;5423;1934;4669;309;737;1158;2793;1467;3530
520590;202207;1598;3729;1089;2917;284;778;361;940;645;1718
520620;202207;10648;26027;8527;22974;1720;4913;4459;11804;6179;16717
520630;202207;1050;2426;734;1921;82;242;354;871;436;1113
520640;202207;2820;6407;2109;5211;482;1176;774;1986;1256;3162
520650;202207;1237;2530;885;2056;178;378;456;1103;634;1481
520660;202207;616;1467;339;981;59;194;95;272;154;466
520670;202207;1117;2772;925;2486;101;246;610;1647;711;1893
520680;202207;947;2134;752;1849;119;260;457;1136;576;1396
520690;202207;380;895;250;687;84;209;66;195;150;404
520710;202207;514;1162;347;884;18;50;233;559;251;609
520725;202207;1668;3782;1116;2861;169;493;585;1444;754;1937
520735;202207;1070;2386;723;1844;203;469;236;628;439;1097
520740;202207;2947;6219;2173;5234;468;1059;1049;2632;1517;3691
520750;202207;852;1831;601;1470;86;219;329;768;415;987
520753;202207;1535;3775;1145;3096;210;655;524;1293;734;1948
520760;202207;1674;3339;1419;3039;31;67;1294;2781;1325;2848
520780;202207;1772;4011;1283;3303;170;417;668;1686;838;2103
520790;202207;3838;8633;2630;6713;439;1023;1360;3663;1799;4686
520800;202207;21098;49865;16577;43374;2584;6706;9845;26122;12429;32828
520810;202207;1471;2922;1099;2503;236;525;579;1449;815;1974
520815;202207;680;2000;507;1626;92;317;151;482;243;799
520830;202207;2118;4293;1515;3575;96;238;1179;2735;1275;2973
520840;202207;3314;8211;2657;7332;817;2462;952;2685;1769;5147
520850;202207;962;2027;731;1712;157;429;351;791;508;1220
520860;202207;10521;26003;7810;21484;1746;4969;3151;8415;4897;13384
520870;202207;164124;358926;117248;288955;21611;55909;53193;124467;74804;180376
520880;202207;10635;28286;8464;24428;1748;5223;3540;9906;5288;15129
520890;202207;5447;11642;3799;9159;574;1590;1967;4480;2541;6070
520910;202207;5510;13025;3608;9879;737;2181;992;2501;1729;4682
520915;202207;903;2267;588;1635;112;345;221;563;333;908
520920;202207;5320;11071;3819;9253;712;1511;2024;5198;2736;6709
520929;202207;779;1770;596;1505;98;202;274;736;372;938
520940;202207;1152;2872;893;2490;71;234;673;1830;744;2064
520945;202207;564;1199;405;986;26;71;257;601;283;672
520960;202207;1304;2798;1003;2376;326;730;366;965;692;1695
520970;202207;3808;9397;2861;7901;905;2601;579;1735;1484;4336
520980;202207;919;1999;671;1683;108;276;320;757;428;1033
520990;202207;3644;8374;2961;7527;441;1036;2018;5228;2459;6264
520993;202207;1423;3341;950;2500;149;433;450;1125;599;1558
520995;202207;2957;6901;2225;5845;414;1031;783;2161;1197;3192
521000;202207;11132;27242;7373;20410;1193;3483;2204;5681;3397;9164
521010;202207;4487;10852;3299;8825;445;1278;1784;4569;2229;5847
521015;202207;927;2166;646;1672;51;146;409;999;460;1145
521020;202207;5034;11842;3009;8163;723;2083;624;1694;1347;3777
521030;202207;877;1585;680;1316;23;53;585;1093;608;1146
521040;202207;9835;22826;7280;18927;1733;4519;2542;6994;4275;11513
521056;202207;1196;2949;854;2380;254;682;227;682;481;1364
521060;202207;1215;2990;855;2324;169;500;313;823;482;1323
521080;202207;1255;2567;664;1674;105;277;302;705;407;982
521090;202207;3691;9458;2476;7026;603;1831;287;801;890;2632
521100;202207;2292;4806;1715;4030;217;535;1119;2625;1336;3160
521120;202207;5837;13045;4387;11205;774;1696;1803;5413;2577;7109
521130;202207;1165;2576;562;1491;51;121;287;783;338;904
521140;202207;1772;4217;1280;3339;178;461;675;1690;853;2151
521150;202207;15719;33069;10199;25225;2232;6063;4412;10637;6644;16700
521160;202207;908;1784;599;1330;65;128;383;817;448;945
521170;202207;1261;2769;914;2258;119;322;476;1096;595;1418
521180;202207;9871;24387;7809;20960;1440;4172;3788;9778;5228;13950
521190;202207;13484;31644;8503;23651;2049;6042;2413;6488;4462;12530
521200;202207;853;1950;580;1518;70;194;305;760;375;954
521205;202207;730;1642;557;1375;22;60;439;1038;461;1098
521210;202207;900;2289;520;1484;93;284;141;313;234;597
521220;202207;4482;9997;3076;7906;668;1846;1288;3263;1956;5109
521225;202207;490;958;359;812;37;81;269;614;306;695
521230;202207;1659;3882;1393;3541;590;1530;460;1211;1050;2741
521250;202207;43481;101458;35162;90030;8565;23152;18513;46136;27078;69288
521260;202207;614;1343;459;1113;72;200;268;608;340;808
521270;202207;2432;5342;2083;4919;201;417;1529;3711;1730;4128
521280;202207;2154;5410;1623;4564;340;1020;712;2007;1052;3027
521290;202207;665;1409;459;1152;47;122;291;702;338;824
521295;202207;1419;2940;1091;2533;149;290;735;1730;884;2020
521300;202207;2176;5032;1660;4280;336;823;902;2377;1238;3200
521305;202207;791;1755;542;1407;54;169;339;842;393;1011
521308;202207;5733;14051;3997;10951;354;1071;2500;6527;2854;7598
521310;202207;12274;29110;8411;22387;1533;4439;3675;9176;5208;13615
521340;202207;469;998;320;791;31;69;195;474;226;543
521350;202207;2278;5513;1728;4689;138;412;1224;3215;1362;3627
521370;202207;1449;3559;919;2689;293;924;153;474;446;1398
521375;202207;1714;4180;1160;3235;232;660;322;974;554;1634
521377;202207;1654;3300;1202;2744;135;252;888;2150;1023;2402
521380;202207;7298;18498;4664;13686;698;2107;960;2995;1658;5102
521385;202207;826;1847;620;1574;89;194;333;917;422;1111
521390;202207;795;1885;554;1507;139;413;100;275;239;688
521400;202207;3450;7596;2743;6701;279;693;1891;4566;2170;5259
521405;202207;1632;4021;1105;3044;130;359;607;1606;737;1965
521410;202207;1068;2446;843;2109;199;458;448;1154;647;1612
521440;202207;1699;3877;1302;3314;401;977;543;1439;944;2416
521450;202207;4793;13216;3538;10817;945;2922;848;2671;1793;5593
521460;202207;7175;17312;5196;13870;1395;3837;1851;4787;3246;8624
521470;202207;915;2204;632;1688;81;214;304;752;385;966
521480;202207;569;1249;386;948;80;180;162;362;242;542
521483;202207;2758;6271;1957;5087;416;1083;861;2257;1277;3340
521486;202207;2090;4745;1578;4014;151;285;1031;2650;1182;2935
521487;202207;490;1101;340;904;58;154;205;557;263;711
521490;202207;1024;2522;759;2094;33;115;540;1402;573;1517
521500;202207;2442;5856;1858;5044;184;687;1180;2978;1364;3665
521520;202207;930;2048;724;1763;117;245;395;990;512;1235
521523;202207;16705;45778;13759;41236;3956;12297;4984;14702;8940;26999
521525;202207;1283;2857;980;2432;82;249;665;1567;747;1816
521530;202207;2660;6591;1645;4577;328;930;438;1136;766;2066
521540;202207;954;2331;681;1887;141;443;287;758;428;1201
521550;202207;1934;4660;1077;3001;199;592;274;765;473;1357
521560;202207;6457;15254;4692;12888;1250;3285;2048;6002;3298;9287
521565;202207;804;1869;570;1490;94;251;266;693;360;944
521570;202207;4432;11354;3066;8832;605;1984;267;768;872;2752
521580;202207;593;1340;378;982;54;148;169;393;223;541
521590;202207;963;2012;688;1625;91;223;395;889;486;1112
521600;202207;509;1259;316;900;60;161;151;415;211;576
521630;202207;1980;4101;1248;3073;356;880;360;858;716;1738
521640;202207;2312;5156;1469;3904;326;935;462;1168;788;2103
521645;202207;615;1510;369;1059;156;434;26;61;182;495
521680;202207;1614;4195;1248;3595;358;1043;404;1163;762;2206
521690;202207;641;1498;530;1349;84;230;313;772;397;1002
521710;202207;4123;9494;2676;7107;479;1429;804;1839;1283;3268
521720;202207;2869;6086;1853;4594;237;637;1052;2560;1289;3197
521730;202207;4614;11840;3515;10030;940;3096;909;2193;1849;5289
521740;202207;5061;12258;3888;10552;1236;3525;1033;2742;2269;6267
521760;202207;19997;48801;15941;43027;3341;9560;7887;21550;11228;31110
521770;202207;3833;8552;2599;6658;623;1677;669;1702;1292;3379
521800;202207;8205;20160;5873;16343;1636;4564;1987;6046;3623;10610
521805;202207;1269;2465;865;1977;193;414;452;1097;645;1511
521810;202207;833;1862;604;1545;104;262;341;901;445;1163
521830;202207;6834;17185;5499;15145;348;1201;4044;10761;4392;11962
521839;202207;1047;2239;788;1843;70;197;559;1199;629;1396
521850;202207;8088;17582;5036;12973;1464;3656;711;1795;2175;5451
521860;202207;1891;4884;1276;3746;213;694;394;1030;607;1724
521870;202207;803;2102;576;1675;125;397;176;416;301;813
521878;202207;1014;2461;676;1837;63;207;359;874;422;1081
521880;202207;25466;59178;18006;47756;3969;11079;7668;19585;11637;30664
521890;202207;4023;9624;2777;7497;723;1980;771;1913;1494;3893
521900;202207;1591;3587;815;2252;176;411;31;88;207;499
521910;202207;1674;3440;1188;2854;260;629;540;1288;800;1917
521920;202207;642;1592;493;1353;62;209;298;768;360;977
521925;202207;903;2216;668;1858;138;432;306;819;444;1251
521930;202207;6462;14728;4314;11506;1140;2534;1763;5203;2903;7737
521935;202207;1211;2763;836;2132;71;197;486;1167;557;1364
521940;202207;1545;3174;1012;2441;171;463;521;1187;692;1650
521945;202207;770;1842;540;1446;81;221;287;758;368;979
521950;202207;874;1975;609;1557;104;270;284;722;388;992
521960;202207;809;1992;553;1529;55;188;317;793;372;981
521970;202207;3329;7103;2494;6083;260;535;1783;4540;2043;5075
521971;202207;904;2087;631;1671;162;420;169;429;331;849
521973;202207;1782;4336;1424;3815;125;305;1030;2775;1155;3080
521975;202207;15603;37684;12620;33510;2201;6121;7349;19283;9550;25404
521980;202207;2794;6063;2111;5165;155;384;1592;3913;1747;4297
521990;202207;1475;3607;1226;3234;230;663;707;1861;937;2524
522000;202207;3220;7875;2520;6980;576;1646;1292;3744;1868;5390
522005;202207;415;925;284;732;42;116;129;333;171;449
522010;202207;5232;12227;3780;9885;774;2161;1490;3681;2264;5842
522015;202207;1239;3033;918;2539;250;704;376;1031;626;1735
522020;202207;6417;14250;4272;11006;840;2168;1903;4975;2743;7143
522026;202207;900;2240;573;1687;93;331;172;420;265;751
522028;202207;596;1397;412;1088;85;260;187;440;272;700
522040;202207;4321;8756;3053;7073;338;822;2073;4612;2411;5434
522045;202207;23266;59511;17556;50046;3834;11633;5291;14332;9125;25965
522050;202207;1406;3367;992;2660;183;549;430;1008;613;1557
522060;202207;3491;8682;2517;7128;412;1139;1272;3640;1684;4779
522068;202207;2190;4906;1748;4386;94;208;1431;3599;1525;3807
522070;202207;928;1911;754;1662;21;38;658;1421;679;1459
522100;202207;979;2348;664;1806;90;256;332;861;422;1117
522108;202207;1300;2767;1015;2374;66;154;787;1812;853;1966
522119;202207;2180;4805;1734;4244;318;716;969;2494;1287;3210
522130;202207;574;1315;433;1131;39;87;330;883;369;970
522140;202207;27780;67125;19735;53099;4290;12255;6573;16372;10863;28627
522145;202207;934;2119;659;1720;139;386;334;867;473;1253
522150;202207;1281;2916;856;2258;207;551;226;594;433;1145
522155;202207;1190;2876;925;2488;145;341;561;1550;706;1891
522157;202207;844;1716;690;1537;33;68;552;1232;585;1300
522160;202207;7223;17385;4628;12872;1229;3651;524;1553;1753;5204
522170;202207;3195;7735;2467;6665;288;780;1558;4208;1846;4988
522180;202207;743;1671;486;1207;86;225;149;376;235;601
522185;202207;27428;62604;20169;52945;7535;21245;4530;12795;12065;34040
522190;202207;929;2004;647;1563;136;335;291;667;427;1002
522200;202207;2299;5968;1692;4892;443;1266;506;1473;949;2739
522205;202207;1941;4453;1417;3690;358;953;545;1411;903;2364
522220;202207;1403;3171;1033;2662;122;282;660;1760;782;2042
522230;202207;1584;3587;1238;3087;232;617;689;1701;921;2318
530010;202207;248034;622319;207189;562926;26605;79155;131044;344037;157649;423192
110001;202206;4560;12082;3052;9311;696;2340;1096;3303;1792;5643
110002;202206;15861;38727;11591;31758;2947;8602;3496;9585;6443;18187
110003;202206;824;2284;592;1828;146;479;190;526;336;1005
110004;202206;15269;37201;10489;29032;2133;6271;3754;10068;5887;16339
110005;202206;2907;7195;2062;5848;404;1130;670;2024;1074;3154
110006;202206;1812;4899;1104;3423;205;682;231;660;436;1342
110007;202206;1483;3664;972;2810;294;847;288;958;582;1805
110008;202206;4041;9755;3001;8319;452;1077;1837;5641;2289;6718
110009;202206;5206;13693;3365;10404;710;2408;1310;3901;2020;6309
110010;202206;9296;26834;7087;22922;1424;4294;3656;13138;5080;17432
110011;202206;8554;21408;5885;16791;1736;5169;1272;3599;3008;8768
110012;202206;18818;44866;12150;33870;3079;8875;2191;6047;5270;14922
110013;202206;6629;17811;4649;14029;1798;5702;760;2414;2558;8116
110014;202206;4474;11078;3049;8441;433;1322;1557;4149;1990;5471
110015;202206;6789;16452;4340;12000;823;2562;1426;3456;2249;6018
110018;202206;4712;11366;2912;8342;589;1815;796;2196;1385;4011
110020;202206;96857;213124;72602;180980;15819;38595;35368;92520;51187;131115
110025;202206;5893;13576;4032;10441;639;1773;2081;5216;2720;6989
110026;202206;637;1623;466;1358;106;334;168;514;274;848
110028;202206;8398;20263;5293;14887;1291;4045;760;2119;2051;6164
110029;202206;1787;4207;1078;2999;199;554;450;1264;649;1818
110030;202206;15499;35068;9727;26542;2497;7360;1494;4810;3991;12170
110032;202206;4100;10807;2530;7637;743;2206;561;1794;1304;4000
110033;202206;4747;13720;3628;11648;1182;3904;1139;3948;2321;7852
110034;202206;3653;8233;2477;6636;831;2436;720;2183;1551;4619
110037;202206;1853;5205;1326;4246;300;973;549;1801;849;2774
110040;202206;3462;9022;2525;7369;610;1941;820;2288;1430;4229
110045;202206;5495;14946;3982;12267;1027;3352;1440;4569;2467;7921
110050;202206;2001;5174;1350;4042;405;1384;224;592;629;1976
110060;202206;1042;2940;689;2129;175;563;175;531;350;1094
110070;202206;1804;5296;1295;4186;367;1305;328;950;695;2255
110080;202206;7417;16574;5621;14366;1072;2663;3097;8403;4169;11066
110090;202206;666;1753;464;1392;114;387;125;364;239;751
110092;202206;1510;4096;1048;3233;205;624;521;1679;726;2303
110094;202206;3327;9215;2482;7635;993;3207;362;1205;1355;4412
110100;202206;2009;5493;1581;4720;507;1572;588;1805;1095;3377
110110;202206;2046;5215;1455;4283;453;1420;325;1035;778;2455
110120;202206;1474;3951;1084;3220;259;812;355;1049;614;1861
110130;202206;3176;7516;1926;5301;291;782;211;530;502;1312
110140;202206;2632;7189;1903;5786;339;1125;815;2386;1154;3511
110143;202206;1618;4141;1172;3349;322;1002;354;972;676;1974
110145;202206;1108;2740;660;1910;155;440;267;810;422;1250
110146;202206;594;1471;407;1163;94;241;173;544;267;785
110147;202206;884;2169;583;1612;80;245;284;693;364;938
110148;202206;1112;2895;566;1728;136;468;78;211;214;679
110149;202206;3910;9645;2658;7721;880;2633;675;2122;1555;4755
110150;202206;3083;7451;2026;5834;626;1991;465;1461;1091;3452
110155;202206;948;2607;657;1927;135;448;266;700;401;1148
110160;202206;1632;4629;1204;3726;372;1169;303;970;675;2139
110170;202206;2384;5798;1539;4276;217;662;882;2304;1099;2966
110175;202206;2419;6483;1643;4855;299;925;663;1911;962;2836
110180;202206;1641;4161;1153;3237;141;408;610;1674;751;2082
120001;202206;4004;10593;3249;9476;452;1490;2158;6229;2610;7719
120005;202206;2222;7830;2011;7522;200;763;1564;5994;1764;6757
120010;202206;6654;17090;5716;15769;467;1241;4464;12473;4931;13714
120013;202206;2829;8518;2434;8008;590;1829;1291;4673;1881;6502
120017;202206;3244;8683;2751;7985;373;1051;1826;5596;2199;6647
120020;202206;17284;59179;15880;56656;1016;4260;12827;45770;13843;50030
120025;202206;4178;9920;3412;9036;405;1045;2462;6752;2867;7797
120030;202206;7218;26634;6663;25696;398;1977;5186;20241;5584;22218
120032;202206;1972;8082;1866;7883;92;578;1606;6656;1698;7234
120033;202206;4922;15946;4596;15378;95;541;4074;13440;4169;13981
120034;202206;3302;10415;2855;9693;115;608;2422;8032;2537;8640
120035;202206;4651;15531;4324;14986;238;1039;3691;12656;3929;13695
120038;202206;3476;9709;2992;8964;421;1357;1964;5878;2385;7235
120039;202206;2315;9107;2163;8824;121;683;1751;7097;1872;7780
120040;202206;62698;165801;53941;152850;6639;20092;35994;101601;42633;121693
120042;202206;4123;13033;3827;12528;144;683;3278;10541;3422;11224
120043;202206;1685;6257;1481;5964;46;317;1280;5071;1326;5388
120045;202206;6996;16464;5947;15250;373;1023;4900;12580;5273;13603
120050;202206;11471;35705;10547;34409;511;1928;8894;29119;9405;31047
120060;202206;11331;39236;10368;37843;486;2381;8977;32566;9463;34947
120070;202206;3961;11210;3414;10473;464;1270;2304;7499;2768;8769
120080;202206;5911;15012;5312;14178;691;1650;3948;10841;4639;12491
130002;202206;3852;13374;3440;12818;291;808;2900;11314;3191;12122
130006;202206;2958;9680;2456;8877;443;1434;1429;5838;1872;7272
130008;202206;3096;9815;2690;9237;147;527;2183;7687;2330;8214
130010;202206;4440;12041;3745;11243;135;351;3321;10093;3456;10444
130014;202206;4262;11266;3311;9824;526;1588;2058;6292;2584;7880
130020;202206;3252;11779;2874;11224;130;730;2360;9155;2490;9885
130030;202206;16180;37922;14984;36578;203;550;14113;34388;14316;34938
130040;202206;4728;12889;3921;11850;428;1135;2997;9397;3425;10532
130050;202206;8472;28510;7136;26797;294;1119;6345;24252;6639;25371
130060;202206;8411;31367;7156;29747;381;2186;5983;24628;6364;26814
130063;202206;7345;22553;6505;21618;193;880;5918;19644;6111;20524
130068;202206;4448;13536;3740;12599;185;898;3017;10072;3202;10970
130070;202206;8804;22628;7214;20904;474;1081;5878;17630;6352;18711
130080;202206;8750;27613;7607;26339;428;1331;6579;23315;7007;24646
130083;202206;3192;9632;2811;9159;298;900;2166;7348;2464;8248
130090;202206;4414;11790;3916;11213;68;176;3572;10352;3640;10528
130100;202206;8752;25032;7365;23580;166;346;6830;22352;6996;22698
130110;202206;9731;25262;7913;23023;1277;3304;5375;16884;6652;20188
130115;202206;5738;16936;4932;16020;151;450;4326;14265;4477;14715
130120;202206;15967;51412;14023;48884;1090;4196;11569;40624;12659;44820
130130;202206;6912;18737;5353;16763;544;1627;3931;12907;4475;14534
130140;202206;8201;26409;7169;25242;321;1408;6132;21759;6453;23167
130150;202206;4468;14299;4197;13997;79;414;3878;12922;3957;13336
130160;202206;7122;20244;6127;19028;349;923;5330;16893;5679;17816
130165;202206;3786;13014;3562;12762;151;563;3187;11544;3338;12107
130170;202206;14084;36507;11431;33539;513;1734;9896;29205;10409;30939
130180;202206;4906;14913;4665;14651;41;239;4503;14093;4544;14332
130185;202206;22696;50124;18622;45759;1443;1950;15834;41077;17277;43027
130190;202206;22195;67147;17934;61082;1512;5201;13704;47658;15216;52859
130195;202206;2795;9435;2327;8847;101;441;1962;7523;2063;7964
130200;202206;3391;8297;2799;7548;150;487;2359;6291;2509;6778
130210;202206;1586;5609;1424;5413;106;561;1179;4393;1285;4954
130220;202206;2779;8315;2305;7739;72;248;2069;7072;2141;7320
130230;202206;5655;20816;4915;19827;196;1082;4334;17516;4530;18598
130240;202206;16212;39295;13478;35884;159;803;12552;32994;12711;33797
130250;202206;29990;82871;25602;77840;1478;4066;21187;66527;22665;70593
130255;202206;5668;16330;4850;14936;188;678;4024;12320;4212;12998
130260;202206;339531;833800;281117;756078;63463;168316;160690;445130;224153;613446
130270;202206;11253;36018;9293;33086;1615;5284;5980;22452;7595;27736
130280;202206;4091;14846;3736;14445;112;476;3458;13501;3570;13977
130290;202206;16817;47644;14854;45271;715;2209;13203;40545;13918;42754
130300;202206;5637;17258;5029;16452;172;786;4328;14092;4500;14878
130310;202206;9012;23506;7947;22232;441;1201;6780;19244;7221;20445
130320;202206;3940;12191;3295;11335;396;1278;2436;8691;2832;9969
130330;202206;5377;15530;4334;14305;213;848;3638;12253;3851;13101
130340;202206;28613;77402;24639;72978;1135;3385;21329;64379;22464;67764
130350;202206;4446;14898;3968;14280;139;705;3473;12447;3612;13152
130353;202206;9172;22588;7428;20413;1013;2579;5258;15006;6271;17585
130356;202206;6175;18027;5198;16569;844;2555;3292;11036;4136;13591
130360;202206;3476;10511;2831;9723;67;296;2578;8857;2645;9153
130370;202206;5932;23623;5009;22302;566;3038;3454;15498;4020;18536
130380;202206;8521;34661;7948;33806;619;3100;6496;27689;7115;30789
130390;202206;7428;27798;6620;26565;473;2099;5645;22823;6118;24922
130395;202206;2854;8363;2389;7634;185;616;1907;6044;2092;6660
130400;202206;3253;9206;2752;8541;103;313;2435;7630;2538;7943
130406;202206;12405;40396;10426;37990;1479;5299;7608;28752;9087;34051
130410;202206;5040;16236;4331;15142;1135;4056;2327;8487;3462;12543
130420;202206;16698;52732;13984;49366;1195;4793;10807;38469;12002;43262
130423;202206;5000;14669;4349;13905;195;780;3850;12265;4045;13045
130426;202206;3461;11710;3166;11370;65;223;2854;10657;2919;10880
130430;202206;5330;13005;4545;12023;178;495;4025;10577;4203;11072
130440;202206;5998;16679;5047;15555;103;403;4701;14522;4804;14925
140002;202206;2835;7682;2449;7220;134;391;2056;6179;2190;6570
140005;202206;3772;10020;3268;9432;526;1426;2377;7138;2903;8564
140010;202206;59269;153058;47689;136365;11142;33503;21452;62876;32594;96379
140015;202206;5049;12610;4242;11710;298;744;3609;10300;3907;11044
140017;202206;6548;15399;5783;14454;336;800;4934;12475;5270;13275
140020;202206;6380;16466;5507;15389;343;1098;4472;12484;4815;13582
140023;202206;3033;8163;2419;7315;318;922;1752;5464;2070;6386
140028;202206;2325;5596;1960;5141;118;327;1561;4101;1679;4428
140030;202206;6585;14862;5897;14077;217;379;5408;13123;5625;13502
140040;202206;3103;11301;2852;10980;91;486;2632;10081;2723;10567
140045;202206;3304;11447;2786;10756;594;1792;1680;7345;2274;9137
140047;202206;7120;18991;5948;17299;663;2027;4300;12682;4963;14709
140050;202206;1795;4974;1519;4587;229;635;1062;3319;1291;3954
140060;202206;2250;5265;1974;4896;157;369;1654;4144;1811;4513
140070;202206;2215;10725;2140;10601;125;833;1869;9131;1994;9964
150010;202206;55176;124963;49728;118077;1353;2801;44314;105024;45667;107825
150013;202206;2399;5363;1997;4928;100;211;1699;4302;1799;4513
150020;202206;16728;45499;15365;43689;1579;3535;12381;36651;13960;40186
150030;202206;9853;34298;8880;33160;452;1747;7815;29617;8267;31364
150034;202206;5109;11265;4146;10098;228;527;3512;8653;3740;9180
150040;202206;18467;44332;16156;41793;1263;1571;14122;38742;15385;40313
150050;202206;8860;25966;8110;25018;194;626;7460;23233;7654;23859
150060;202206;25981;65617;20994;58330;2537;7365;14452;40496;16989;47861
150070;202206;10402;29481;9323;28224;211;790;8701;26268;8912;27058
150080;202206;105942;228158;87347;203596;23078;53860;27858;76927;50936;130787
150085;202206;10202;25222;9224;24088;115;340;8697;22789;8812;23129
150090;202206;13476;38541;12599;37090;573;1837;10999;32036;11572;33873
150095;202206;8469;18950;7498;17796;733;955;6307;15734;7040;16689
150100;202206;3269;10756;2879;10122;229;747;2285;8244;2514;8991
150110;202206;4766;18322;4384;17888;140;626;4058;16784;4198;17410
150120;202206;9188;26262;8524;25464;347;686;7600;23234;7947;23920
150125;202206;995;2355;725;1982;98;298;461;1253;559;1551
150130;202206;26013;69062;22271;63509;4024;10051;14075;43095;18099;53146
150140;202206;325756;676061;276358;612291;33429;69010;182321;406990;215750;476000
150145;202206;4805;14098;3965;12800;1213;3714;1722;6390;2935;10104
150150;202206;20732;46757;17768;43083;1264;2862;13974;34019;15238;36881
150157;202206;4213;10581;3331;9426;404;1124;2247;6584;2651;7708
150160;202206;4596;10220;4273;9789;411;945;3399;7651;3810;8596
150170;202206;31565;86006;28002;80317;4485;11249;18378;56079;22863;67328
150172;202206;6181;15024;5013;13449;284;683;3889;10611;4173;11294
150175;202206;1975;5551;1637;4973;203;690;1101;3307;1304;3997
150178;202206;12897;30248;10321;27323;706;1189;8551;23925;9257;25114
150180;202206;31351;86433;28531;83295;2174;4235;23724;73913;25898;78148
150190;202206;8411;22959;7818;22254;166;659;7251;20495;7417;21154
150195;202206;6046;17260;5608;16641;242;750;5012;14885;5254;15635
150200;202206;6766;17974;6110;17229;34;130;5742;16215;5776;16345
150210;202206;34855;100119;32687;97484;1464;3982;28553;86926;30017;90908
150215;202206;11073;29242;9543;26879;1619;4549;5708;16341;7327;20890
150220;202206;15485;38896;13499;36223;856;2293;10215;27310;11071;29603
150230;202206;15306;39001;13589;36718;1437;3077;9628;27328;11065;30405
150240;202206;40443;102137;33975;91711;7119;19672;15997;42063;23116;61735
150250;202206;4837;16843;4515;16489;462;1699;3799;14117;4261;15816
150260;202206;3204;9099;2862;8598;98;348;2449;7311;2547;7659
150270;202206;10471;27682;7397;22241;2036;6435;2204;6854;4240;13289
150275;202206;8117;22667;7381;21677;193;752;6515;18884;6708;19636
150276;202206;2672;6679;2302;6223;291;653;1599;4785;1890;5438
150277;202206;6208;14142;4955;12724;617;1602;3493;9326;4110;10928
150280;202206;8080;28842;7773;28376;424;1449;6740;25082;7164;26531
150285;202206;3860;12125;3319;11256;254;802;2523;8734;2777;9536
150290;202206;12970;31133;11737;29827;510;749;10580;27661;11090;28410
150293;202206;11361;25358;8846;22164;1069;2568;5908;15123;6977;17691
150295;202206;8467;21073;6025;17692;1936;5696;2197;7493;4133;13189
150300;202206;3066;7636;2764;7276;35;119;2559;6746;2594;6865
150304;202206;5082;13565;4227;12280;601;1537;2888;8831;3489;10368
150307;202206;6723;19718;6096;18704;334;983;4877;15098;5211;16081
150309;202206;7531;20058;6087;17723;755;2177;3940;11687;4695;13864
150310;202206;8388;30430;7883;29823;236;1162;7020;26856;7256;28018
150320;202206;10766;26716;9757;25292;639;1709;7575;19504;8214;21213
150330;202206;16137;46562;14880;44813;1624;4045;10939;34959;12563;39004
150340;202206;2809;7709;2458;7223;269;763;1831;5429;2100;6192
150345;202206;10304;26034;9153;24544;364;1069;8057;21511;8421;22580
150350;202206;10841;24296;9912;23114;541;1033;8637;20185;9178;21218
150360;202206;28346;71838;22581;64718;2367;4748;16759;50935;19126;55683
150370;202206;13206;35500;10763;32263;1267;3197;7830;25082;9097;28279
150375;202206;4286;16307;3866;15732;208;870;3412;14029;3620;14899
150380;202206;12598;29062;10255;26024;216;643;8965;22620;9181;23263
150390;202206;8087;30737;7183;29331;925;3271;5271;22591;6196;25862
150400;202206;7707;24808;7321;24173;121;500;6355;21354;6476;21854
150405;202206;10354;24872;8945;23216;613;1138;7233;19384;7846;20522
150410;202206;2259;6338;1921;5803;192;511;1357;4187;1549;4698
150420;202206;50268;126937;38984;110796;9086;25881;17326;53830;26412;79711
150430;202206;9477;25114;8610;24047;659;1401;7190;20566;7849;21967
150440;202206;6886;18699;6200;17803;645;1595;4769;14078;5414;15673
150442;202206;34732;72843;29173;66286;2189;4720;22567;50888;24756;55608
150445;202206;8372;21567;7420;20214;160;504;6695;18126;6855;18630
150450;202206;6368;22823;5908;22227;374;1807;5207;19362;5581;21169
150460;202206;9934;29059;9027;27943;408;1060;7677;24658;8085;25718
150470;202206;24166;58764;21690;55906;251;918;20545;52585;20796;53503
150475;202206;6099;17330;5162;15895;726;1954;3576;11545;4302;13499
150480;202206;16300;45930;14637;43593;2540;6020;10075;32570;12615;38590
150490;202206;9615;30678;8687;29456;572;1698;7193;25037;7765;26735
150495;202206;6413;18646;6051;18189;150;605;5517;16500;5667;17105
150497;202206;3131;9207;2497;8089;467;1530;1365;4718;1832;6248
150500;202206;3750;8916;3310;8292;219;514;2621;6489;2840;7003
150503;202206;6055;14764;4302;12541;1317;3531;1753;5694;3070;9225
150506;202206;14161;37168;11979;34239;2005;5084;8097;24877;10102;29961
150510;202206;12572;38108;10899;35330;1007;3173;8253;27103;9260;30276
150520;202206;8926;30023;8535;29551;181;1039;7947;27325;8128;28364
150530;202206;13664;43774;11805;41167;980;2849;9214;33280;10194;36129
150540;202206;6036;14365;5207;13151;295;670;4385;11070;4680;11740
150543;202206;8356;21330;6921;19560;516;1488;5366;15592;5882;17080
150548;202206;11693;33522;10428;31759;284;978;9273;28339;9557;29317
150549;202206;2290;6007;1925;5496;61;197;1595;4557;1656;4754
150550;202206;24095;65320;19710;58396;4633;13866;8712;27036;13345;40902
150553;202206;42761;109851;33015;93466;7789;22342;14662;42248;22451;64590
150555;202206;2278;5637;1770;4861;174;376;1134;3299;1308;3675
150560;202206;2200;5895;1957;5460;234;623;1272;3585;1506;4208
150563;202206;3064;8439;2482;7422;478;1499;1382;4130;1860;5629
150565;202206;5038;15136;4461;14252;118;486;3671;11756;3789;12242
150570;202206;8125;21766;7466;20900;333;982;6568;18310;6901;19292
150580;202206;12895;45159;11068;43137;1289;4037;8701;36126;9990;40163
150590;202206;9179;29256;7809;27640;171;921;7151;25241;7322;26162
150600;202206;11374;33335;10486;32254;209;808;9693;29837;9902;30645
150610;202206;3545;8772;3158;8195;116;394;2713;6882;2829;7276
150611;202206;3775;9428;3297;8778;90;313;2915;7646;3005;7959
150613;202206;16683;42590;12724;36183;2225;6753;6803;18848;9028;25601
150616;202206;4328;11276;3116;9184;623;1936;1412;4111;2035;6047
150618;202206;8041;21467;6543;19191;827;2462;4093;12326;4920;14788
150619;202206;7804;20104;6414;18234;502;1230;5068;14708;5570;15938
150620;202206;7775;23691;6741;22011;799;2320;4544;15432;5343;17752
150630;202206;7701;18169;7003;17338;200;536;6295;15470;6495;16006
150635;202206;6185;15369;5180;13764;604;1479;3484;9339;4088;10818
150640;202206;2424;6853;2211;6582;40;123;2030;6079;2070;6202
150650;202206;13818;34455;11999;31733;3005;7446;5830;16581;8835;24027
150655;202206;6229;16594;5619;15718;125;437;4999;13867;5124;14304
150658;202206;5188;14033;3844;11778;853;2673;1837;5873;2690;8546
150660;202206;6630;17221;5809;16068;860;2261;3785;10578;4645;12839
150670;202206;11128;22674;8865;20097;670;1308;7315;16988;7985;18296
150680;202206;84497;223948;66695;197169;14069;39792;34020;109459;48089;149251
150690;202206;3102;7036;2661;6534;114;235;2325;5786;2439;6021
150700;202206;7803;20310;6971;19281;715;1480;5419;15664;6134;17144
150710;202206;4352;13169;3910;12496;307;962;2954;9630;3261;10592
150715;202206;6318;15692;5190;14078;286;724;4295;11668;4581;12392
150720;202206;9202;25462;8481;24475;463;1350;7248;21042;7711;22392
150730;202206;15003;41407;12703;38071;1500;4596;9207;28271;10707;32867
150740;202206;4634;11818;4038;10921;370;785;3024;8436;3394;9221
150745;202206;6335;16256;5141;14588;651;1857;3741;10823;4392;12680
150746;202206;2004;5341;1771;5002;60;190;1495;4184;1555;4374
150747;202206;5812;15904;5146;14945;418;1064;3991;11826;4409;12890
150750;202206;4207;12062;3424;10898;308;1046;2476;8143;2784;9189
150760;202206;13346;36168;12041;34405;1709;4345;8520;25330;10229;29675
150770;202206;7998;24889;7350;24170;215;510;6737;22779;6952;23289
150775;202206;1329;3229;1041;2861;124;378;734;2012;858;2390
150780;202206;5242;14727;4646;14033;250;651;4093;12728;4343;13379
150790;202206;6991;17438;5854;16211;503;1054;3992;13068;4495;14122
150795;202206;17879;48715;15418;45171;2859;8149;9726;29427;12585;37576
150796;202206;4584;9834;3961;9136;172;354;3460;8011;3632;8365
150797;202206;4983;13614;4243;12590;393;1011;3367;10183;3760;11194
150800;202206;15702;44935;14015;42778;1685;4803;10442;32762;12127;37565
150803;202206;9489;24217;8730;23189;294;846;7794;20550;8088;21396
150805;202206;4144;11670;3524;10821;290;818;2717;8563;3007;9381
150808;202206;7580;20607;5589;17336;1955;6568;1028;3553;2983;10121
150810;202206;24223;57530;18285;50433;3885;10114;9434;29423;13319;39537
150812;202206;7030;17254;6187;15996;405;1238;4915;12291;5320;13529
150815;202206;11046;29963;9220;27813;1016;3001;7265;22414;8281;25415
150820;202206;16585;36052;14441;33498;2030;3141;10581;26880;12611;30021
150830;202206;13928;44623;12859;43336;752;1946;11047;38844;11799;40790
150835;202206;3755;10376;3288;9708;335;1020;2436;7174;2771;8194
150840;202206;9506;24369;7671;21558;1075;3369;4681;12793;5756;16162
160005;202206;1456;3475;1289;3279;53;164;1118;2821;1171;2985
160010;202206;2576;6563;2387;6362;22;99;2302;6081;2324;6180
160015;202206;4096;9496;3678;9009;60;191;3476;8457;3536;8648
160020;202206;2699;7363;2333;6895;241;626;1790;5516;2031;6142
160021;202206;1448;4900;1299;4721;67;290;1009;3772;1076;4062
160023;202206;1560;4954;1395;4686;210;671;914;3223;1124;3894
160025;202206;2162;5896;2006;5726;30;65;1931;5520;1961;5585
160027;202206;11716;27173;10575;25775;618;1558;9073;22026;9691;23584
160030;202206;93607;236858;77335;215958;14601;37565;45191;136049;59792;173614
160040;202206;6726;20490;5935;19435;295;888;5248;17413;5543;18301
160050;202206;6438;16758;5251;15256;1743;4208;2539;8929;4282;13137
160053;202206;4865;13095;4328;12392;256;621;3584;10632;3840;11253
160055;202206;1469;3234;1414;3177;22;67;1355;3014;1377;3081
160060;202206;33163;75203;27723;69082;2045;4483;22355;57571;24400;62054
160070;202206;3222;10931;2797;10291;244;832;2162;8302;2406;9134
160080;202206;3887;10589;3412;10067;56;192;3172;9468;3228;9660
170025;202206;757;1858;488;1373;88;235;180;516;268;751
170030;202206;1345;3796;989;3131;192;592;391;1276;583;1868
170035;202206;1700;4123;1243;3400;97;286;765;2001;862;2287
170040;202206;2197;5542;1727;4903;177;529;1060;3094;1237;3623
170070;202206;2215;4753;1571;3952;84;215;951;2447;1035;2662
170100;202206;2787;7260;2288;6453;295;755;1433;4145;1728;4900
170105;202206;768;2096;522;1607;123;367;165;464;288;831
170110;202206;1163;3159;891;2704;69;263;557;1606;626;1869
170130;202206;1579;4166;1191;3514;133;460;710;2051;843;2511
170190;202206;1824;4369;1405;3734;203;664;810;2030;1013;2694
170200;202206;2361;5245;1555;3969;265;691;634;1577;899;2268
170210;202206;31013;78824;23425;66584;6743;20572;4690;13798;11433;34370
170215;202206;1524;3768;1218;3353;54;186;956;2597;1010;2783
170220;202206;6667;19226;5501;17219;1817;5575;1777;6370;3594;11945
170230;202206;1415;3847;1055;3190;301;894;283;899;584;1793
170240;202206;3116;7768;2506;6827;149;487;1872;4942;2021;5429
170255;202206;4348;11814;3178;9833;598;1906;1460;4600;2058;6506
170270;202206;1001;2341;677;1861;77;202;382;1042;459;1244
170290;202206;3472;9037;2991;8416;242;531;2327;6780;2569;7311
170300;202206;2515;5877;2035;5187;159;393;1515;3802;1674;4195
170305;202206;757;1949;620;1714;76;206;330;928;406;1134
170307;202206;1197;3518;986;3134;113;386;619;1922;732;2308
170310;202206;1819;4251;1299;3453;155;429;696;1849;851;2278
170320;202206;1190;2986;900;2519;109;332;538;1513;647;1845
170330;202206;1068;3027;969;2884;31;132;829;2412;860;2544
170360;202206;651;1578;467;1295;20;78;317;818;337;896
170370;202206;1487;3583;1065;2915;188;517;492;1296;680;1813
170380;202206;2089;5541;1575;4756;116;392;938;2911;1054;3303
170382;202206;609;1644;497;1465;24;87;364;1031;388;1118
170384;202206;1907;6048;1568;5438;326;1106;834;2929;1160;4035
170386;202206;1089;2822;655;1981;69;240;245;681;314;921
170388;202206;830;2089;584;1681;75;230;300;821;375;1051
170389;202206;1035;3000;824;2636;91;325;516;1671;607;1996
170390;202206;2049;4226;1538;3624;36;94;1321;3131;1357;3225
170410;202206;704;1726;514;1419;28;99;358;934;386;1033
170460;202206;466;1190;382;1056;47;145;257;705;304;850
170510;202206;1047;2716;743;2203;36;141;476;1305;512;1446
170550;202206;7698;19102;5813;16204;1559;4730;1792;4917;3351;9647
170555;202206;1573;3906;1248;3418;127;278;624;1798;751;2076
170560;202206;1136;2971;867;2599;101;296;526;1653;627;1949
170600;202206;1559;3876;1220;3392;230;596;659;1909;889;2505
170610;202206;1877;4455;1393;3750;130;416;897;2319;1027;2735
170625;202206;501;1226;329;914;37;89;138;354;175;443
170650;202206;1614;4181;1305;3709;127;426;858;2365;985;2791
170700;202206;4028;11024;3064;9234;623;1900;1345;3969;1968;5869
170710;202206;1778;4149;1365;3551;162;426;904;2324;1066;2750
170720;202206;2049;4713;1563;3967;149;463;1059;2578;1208;3041
170730;202206;1239;3079;934;2622;104;252;564;1614;668;1866
170740;202206;2329;7075;1983;6464;162;598;1452;4648;1614;5246
170755;202206;990;2491;709;2035;121;371;307;838;428;1209
170765;202206;1308;3131;918;2529;169;448;459;1272;628;1720
170770;202206;2088;5539;1676;4920;153;501;1183;3403;1336;3904
170820;202206;4327;11659;3340;9991;624;1877;1714;5197;2338;7074
170825;202206;1177;2498;956;2219;81;182;741;1704;822;1886
170830;202206;1542;3774;1183;3196;347;973;481;1255;828;2228
170900;202206;3185;9091;2706;8412;210;662;2183;6875;2393;7537
170930;202206;4410;11335;3352;9422;780;2296;1080;2985;1860;5281
170950;202206;13040;34396;9211;27699;2629;8512;1256;4060;3885;12572
170980;202206;589;1406;423;1135;50;149;233;605;283;754
171050;202206;1862;5429;1607;5005;81;298;1282;3969;1363;4267
171070;202206;1536;4000;1309;3677;263;639;685;2230;948;2869
171090;202206;1159;2814;912;2462;135;389;500;1338;635;1727
171110;202206;651;1649;437;1265;75;225;199;526;274;751
171150;202206;1165;2723;732;2013;50;158;461;1236;511;1394
171180;202206;855;2212;556;1668;82;222;254;755;336;977
171190;202206;2291;6914;1965;6361;293;979;1235;4094;1528;5073
171195;202206;939;2734;740;2363;103;411;452;1358;555;1769
171200;202206;701;1846;517;1533;126;422;183;505;309;927
171215;202206;437;1093;343;940;37;109;196;515;233;624
171240;202206;871;2619;674;2277;21;130;464;1507;485;1637
171245;202206;886;2357;682;1953;54;173;417;1118;471;1291
171250;202206;1110;2847;805;2354;145;451;368;1075;513;1526
171270;202206;543;1789;420;1519;81;325;197;729;278;1054
171280;202206;1018;2815;817;2481;73;221;523;1625;596;1846
171320;202206;4512;11892;3520;10199;679;1930;1464;4342;2143;6272
171330;202206;3208;8273;2475;7022;594;1723;1125;3201;1719;4924
171360;202206;1691;4409;1291;3842;127;352;837;2665;964;3017
171370;202206;841;1939;643;1662;65;164;429;1100;494;1264
171380;202206;1693;4376;1407;3995;155;383;993;2994;1148;3377
171395;202206;1147;2809;781;2192;70;221;516;1400;586;1621
171420;202206;2248;5879;1701;4897;300;917;857;2406;1157;3323
171430;202206;1232;3341;1024;2981;71;237;687;1894;758;2131
171488;202206;2841;7379;2224;6393;377;1058;1188;3400;1565;4458
171500;202206;1031;2464;728;1972;80;224;461;1222;541;1446
171510;202206;951;2778;811;2533;65;233;559;1729;624;1962
171515;202206;548;1294;393;1053;35;116;251;613;286;729
171525;202206;816;2056;614;1731;46;156;402;1066;448;1222
171550;202206;381;1006;296;884;37;145;174;475;211;620
171570;202206;1238;3404;1033;3057;136;416;618;1854;754;2270
171575;202206;1917;4826;1257;3697;140;402;601;1756;741;2158
171610;202206;6794;18002;5054;15064;1161;3757;1197;3895;2358;7652
171620;202206;3195;7824;2710;7157;138;443;2295;5983;2433;6426
171630;202206;1244;2986;954;2592;125;354;629;1722;754;2076
171650;202206;2520;6680;1954;5770;480;1530;591;1829;1071;3359
171660;202206;2639;6241;1841;4974;190;521;1159;3099;1349;3620
171665;202206;1410;3732;1118;3268;227;698;521;1538;748;2236
171670;202206;2148;5408;1601;4510;230;701;736;2028;966;2729
171700;202206;1324;3468;967;2841;113;344;568;1639;681;1983
171720;202206;883;2138;678;1834;48;139;500;1333;548;1472
171750;202206;1476;3951;1001;3076;252;801;181;648;433;1449
171780;202206;1493;3460;1068;2816;97;286;730;1877;827;2163
171790;202206;1578;4782;1259;4141;186;628;643;2093;829;2721
171800;202206;820;2059;626;1779;64;203;356;963;420;1166
171820;202206;13358;35334;9909;29653;2321;7415;2768;8720;5089;16135
171830;202206;1740;5120;1478;4676;222;721;854;2796;1076;3517
171840;202206;835;2071;632;1758;28;100;389;1039;417;1139
171845;202206;743;1691;567;1430;49;163;396;941;445;1104
171850;202206;1068;3132;896;2779;54;228;670;2013;724;2241
171855;202206;1148;3270;967;2944;76;250;616;1801;692;2051
171865;202206;555;1496;472;1369;59;187;276;769;335;956
171870;202206;919;2366;643;1895;95;290;319;927;414;1217
171875;202206;1530;3973;1242;3547;40;173;962;2686;1002;2859
171880;202206;1532;3948;1321;3675;43;136;1051;2932;1094;3068
171884;202206;1215;3060;917;2564;202;530;421;1214;623;1744
171886;202206;1690;4326;1226;3645;307;1002;321;1029;628;2031
171888;202206;669;1828;456;1424;27;112;273;812;300;924
171889;202206;471;1329;327;1053;71;244;118;351;189;595
171890;202206;1358;3693;1001;3105;129;422;625;1906;754;2328
171900;202206;631;1998;491;1715;78;250;219;788;297;1038
172000;202206;649;1807;512;1571;94;284;225;684;319;968
172010;202206;1314;3867;1129;3558;102;332;726;2286;828;2618
172015;202206;416;1332;314;1133;58;193;137;500;195;693
172020;202206;3215;8296;2784;7750;193;578;2041;5859;2234;6437
172025;202206;800;2060;576;1709;48;148;397;1168;445;1316
172030;202206;1398;3905;1144;3484;92;295;832;2533;924;2828
172049;202206;1414;3298;929;2618;129;359;484;1418;613;1777
172065;202206;1651;3866;1306;3424;135;269;971;2770;1106;3039
172080;202206;2735;7427;2188;6477;124;413;1458;4243;1582;4656
172085;202206;515;1316;322;912;60;178;121;310;181;488
172090;202206;4636;10449;3631;9152;161;399;2866;7199;3027;7598
172093;202206;498;1425;354;1178;24;106;206;651;230;757
172097;202206;795;1940;533;1507;79;227;211;571;290;798
172100;202206;57347;133912;42420;111349;7712;21956;17707;46061;25419;68017
172110;202206;1835;6083;1564;5685;104;436;1210;4452;1314;4888
172120;202206;5733;15666;4506;13740;476;1602;2691;8164;3167;9766
172125;202206;461;1178;352;1009;32;112;204;540;236;652
172130;202206;686;1623;516;1345;23;91;349;832;372;923
172208;202206;3003;6672;2369;5868;229;467;1718;4304;1947;4771
172210;202206;2985;6947;2310;6121;280;683;1452;4053;1732;4736
210005;202206;21561;57733;16238;49329;3976;12627;7071;22145;11047;34772
210010;202206;2240;6170;2039;5937;50;229;1831;5279;1881;5508
210015;202206;3598;10113;3083;9418;164;506;2549;7818;2713;8324
210020;202206;8181;17827;6961;16413;108;313;6423;15110;6531;15423
210030;202206;5037;15700;4574;15000;522;1619;3532;11904;4054;13523
210040;202206;2428;4837;2131;4487;55;137;1895;3903;1950;4040
210043;202206;6635;17621;5556;16157;353;1081;4430;12952;4783;14033
210047;202206;7575;21336;5993;19274;168;750;5163;16604;5331;17354
210050;202206;2633;7787;2089;6839;171;721;1530;4868;1701;5589
210055;202206;2286;6350;2042;6015;51;181;1805;5320;1856;5501
210060;202206;8326;28381;7368;26692;697;2635;5150;19146;5847;21781
210070;202206;7750;19699;7155;18942;68;213;6727;17748;6795;17961
210080;202206;4858;14577;4558;14243;48;261;4226;13196;4274;13457
210083;202206;6755;16602;5671;15423;122;383;5313;14464;5435;14847
210087;202206;3138;8341;2660;7706;156;488;2133;6166;2289;6654
210090;202206;10215;29391;9440;28121;579;1453;7975;23933;8554;25386
210095;202206;7201;22077;6551;21237;440;1419;5312;17869;5752;19288
210100;202206;7283;21195;6294;19475;698;2215;4329;13475;5027;15690
210110;202206;3236;9269;2962;8930;65;317;2646;7914;2711;8231
210120;202206;29896;69614;25241;63809;1891;3713;19194;49837;21085;53550
210125;202206;4875;12371;4226;11633;651;1368;3089;9054;3740;10422
210130;202206;4727;11340;3838;10248;104;258;3356;8991;3460;9249
210135;202206;1870;4557;1532;4088;45;130;1324;3513;1369;3643
210140;202206;23037;56428;17915;49884;2802;7552;11076;31548;13878;39100
210150;202206;5201;11305;4585;10488;100;309;4038;9031;4138;9340
210160;202206;22599;54765;19351;50770;1572;3821;15047;40156;16619;43977
210170;202206;17687;49419;16263;47596;744;2143;14297;41954;15041;44097
210173;202206;2541;9097;2384;8844;100;521;2072;7629;2172;8150
210177;202206;3644;9525;3127;8865;417;1018;2337;6911;2754;7929
210180;202206;1616;3945;1400;3685;31;84;1255;3302;1286;3386
210190;202206;6056;14650;4986;13201;94;324;4301;11241;4395;11565
210193;202206;1522;3979;1315;3661;44;131;1012;2806;1056;2937
210197;202206;2257;6554;2036;6258;121;365;1693;5304;1814;5669
210200;202206;8850;26033;7794;24417;456;1620;6240;19525;6696;21145
210203;202206;7993;21686;6711;20021;425;1287;5402;16398;5827;17685
210207;202206;4267;9788;3420;8825;137;305;2872;7453;3009;7758
210210;202206;8383;25280;7571;24155;172;890;6471;20494;6643;21384
210215;202206;2670;7972;2302;7438;151;698;1801;5728;1952;6426
210220;202206;7495;22428;7049;21791;163;948;6338;19123;6501;20071
210230;202206;6108;16536;5518;15662;165;491;4989;14151;5154;14642
210232;202206;13121;37380;10725;33826;1640;5037;6966;23216;8606;28253
210235;202206;3827;10716;3342;10032;173;613;2792;8361;2965;8974
210237;202206;4192;10261;3523;9504;28;160;3330;8894;3358;9054
210240;202206;2835;8165;2565;7745;68;256;2119;6285;2187;6541
210250;202206;6511;17785;5865;16971;89;393;5347;15382;5436;15775
210255;202206;2961;8423;2518;7664;280;929;1628;4834;1908;5763
210260;202206;5955;16740;5185;15629;369;1186;4197;12683;4566;13869
210270;202206;5596;14028;4955;13230;80;382;4490;11834;4570;12216
210275;202206;3791;9037;3226;8351;188;445;2585;6741;2773;7186
210280;202206;6705;16682;5474;14905;174;745;4421;11621;4595;12366
210290;202206;9024;20801;8086;19669;151;385;7556;18352;7707;18737
210300;202206;36328;93859;29458;84112;4770;12830;16818;52102;21588;64932
210310;202206;3376;7983;2920;7356;55;152;2650;6644;2705;6796
210312;202206;3096;7014;2752;6645;17;87;2597;6166;2614;6253
210315;202206;3873;9015;3427;8523;119;278;3117;7824;3236;8102
210317;202206;4945;14017;4479;13468;97;454;4093;12219;4190;12673
210320;202206;27172;65545;25206;63090;319;1502;23454;57712;23773;59214
210325;202206;4006;10648;3362;9793;349;990;2617;7777;2966;8767
210330;202206;28496;71784;22839;64870;3784;8926;14802;46237;18586;55163
210340;202206;12496;31166;11164;29478;339;1102;9660;25332;9999;26434
210350;202206;10184;26711;8920;25172;151;535;7997;22498;8148;23033
210355;202206;4442;13984;3900;13138;124;551;3293;11079;3417;11630
210360;202206;13852;41285;12529;39205;537;2379;9584;29049;10121;31428
210370;202206;13566;26404;10287;22948;463;647;9241;21229;9704;21876
210375;202206;3643;9332;2697;7937;845;2612;796;2600;1641;5212
210380;202206;6139;14625;5285;13599;269;697;4495;11552;4764;12249
210390;202206;3420;9528;3172;9145;82;365;2866;8134;2948;8499
210400;202206;5064;13794;4447;13075;207;462;3938;11848;4145;12310
210405;202206;8165;19850;6606;17764;1188;2756;3873;11252;5061;14008
210407;202206;2295;6827;1911;6173;105;368;1481;4776;1586;5144
210408;202206;2968;10091;2737;9781;146;681;2187;7849;2333;8530
210409;202206;4276;13390;3837;12788;180;687;3140;10689;3320;11376
210410;202206;3993;11002;3353;9910;101;430;2748;7939;2849;8369
210420;202206;4204;12560;3717;11702;213;631;3051;9679;3264;10310
210430;202206;2444;6797;2120;6358;176;474;1694;5194;1870;5668
210440;202206;4838;12101;4184;11292;115;307;3769;10159;3884;10466
210450;202206;2564;6999;2197;6471;171;444;1730;5184;1901;5628
210455;202206;5223;12633;4009;11112;970;2699;2024;5750;2994;8449
210460;202206;4005;10908;3342;10043;94;373;2855;8516;2949;8889
210462;202206;1866;5242;1563;4785;66;194;1233;3808;1299;4002
210465;202206;2988;7964;2593;7425;128;513;2150;6001;2278;6514
210467;202206;6926;19291;5991;18096;363;1065;4961;15228;5324;16293
210470;202206;2106;5442;1558;4674;164;456;1112;3408;1276;3864
210480;202206;18943;51742;15679;47793;1756;3865;11370;37958;13126;41823
210490;202206;3810;9009;3044;7988;71;206;2589;6749;2660;6955
210500;202206;6911;24492;6347;23569;359;1651;5310;19589;5669;21240
210510;202206;6906;20217;6059;19313;122;475;5497;17728;5619;18203
210515;202206;4168;11299;3538;10548;179;582;2941;8903;3120;9485
210520;202206;2840;7758;2540;7360;106;377;2134;6103;2240;6480
210530;202206;59541;140110;46122;120873;8299;23042;17182;51290;25481;74332
210535;202206;4072;11724;3692;11183;124;464;3241;9785;3365;10249
210540;202206;16682;44992;13916;41069;1679;4501;9639;29858;11318;34359
210542;202206;7270;16027;5645;14202;508;1104;4442;11515;4950;12619
210545;202206;2466;7124;2267;6807;41;170;1972;5834;2013;6004
210547;202206;4074;13468;3579;12588;205;760;2809;10067;3014;10827
210550;202206;6474;18663;4948;16214;485;1748;3244;10897;3729;12645
210560;202206;4045;11676;3551;10894;95;372;3020;9136;3115;9508
210565;202206;1632;4715;1356;4323;86;377;1042;3322;1128;3699
210570;202206;12117;30879;10722;29170;290;826;9550;26127;9840;26953
210580;202206;3347;8104;2639;7241;208;502;1872;5436;2080;5938
210590;202206;4702;13006;4029;12163;81;400;3592;10794;3673;11194
210592;202206;3010;7999;2767;7626;24;118;2427;6557;2451;6675
210594;202206;2745;7124;2138;6202;150;414;1551;4657;1701;5071
210596;202206;3155;9945;2800;9328;289;979;2092;7161;2381;8140
210598;202206;2167;5580;1927;5258;90;258;1671;4554;1761;4812
210600;202206;3300;8560;2689;7712;258;689;1829;5273;2087;5962
210610;202206;3333;8086;2848;7509;59;252;2486;6475;2545;6727
210620;202206;3353;7620;2745;6871;160;308;2324;5841;2484;6149
210630;202206;3497;10538;3097;9857;144;582;2514;7920;2658;8502
210632;202206;6230;15530;5548;14633;191;750;4828;12437;5019;13187
210635;202206;1858;6211;1744;6001;150;469;1359;4808;1509;5277
210637;202206;2885;8668;2423;8017;157;607;1841;6171;1998;6778
210640;202206;5197;16694;4832;16273;62;325;4462;15041;4524;15366
210650;202206;7808;20890;6976;19829;118;420;6206;17613;6324;18033
210660;202206;9024;24467;8068;22936;221;937;6948;19216;7169;20153
210663;202206;3358;8012;2982;7552;265;440;2272;6203;2537;6643
210667;202206;2191;6562;1943;6192;44;150;1682;5471;1726;5621
210670;202206;5599;16090;5026;15226;109;469;4474;13446;4583;13915
210675;202206;5974;14289;5104;13230;456;988;4051;10848;4507;11836
210680;202206;5336;11605;4495;10632;108;186;4150;9851;4258;10037
210690;202206;9004;23749;7437;22000;284;933;6626;19617;6910;20550
210700;202206;3077;7985;2453;7085;160;429;1830;5392;1990;5821
210710;202206;5769;15998;5072;15089;102;470;4553;13413;4655;13883
210720;202206;3413;10045;2962;9495;82;397;2629;8350;2711;8747
210725;202206;1475;4420;1270;4110;55;190;904;3032;959;3222
210730;202206;1602;3431;1362;3111;61;134;1164;2657;1225;2791
210735;202206;5166;13733;4363;12719;231;565;3661;11029;3892;11594
210740;202206;5868;14040;4984;13035;118;274;4230;11030;4348;11304
210745;202206;4821;12228;4380;11682;66;233;3946;10470;4012;10703
210750;202206;27110;66943;23440;62312;2967;6972;15878;44371;18845;51343
210760;202206;6607;15476;5520;14330;130;243;5157;13592;5287;13835
210770;202206;6960;16133;5945;14984;65;261;5536;13807;5601;14068
210780;202206;8296;24132;7172;22299;501;1588;5624;17535;6125;19123
210790;202206;5002;14056;4435;13315;270;668;3704;11434;3974;12102
210800;202206;5349;13436;4554;12369;84;325;4077;10920;4161;11245
210805;202206;4541;14999;4203;14505;191;754;3602;12465;3793;13219
210810;202206;5429;14618;4902;13945;445;1061;3915;11545;4360;12606
210820;202206;7926;21200;6601;19130;835;2324;4073;12193;4908;14517
210825;202206;8611;22384;7758;21293;322;882;6855;18887;7177;19769
210830;202206;9445;23512;8527;22401;609;1209;7139;19385;7748;20594
210840;202206;3720;8845;3355;8383;44;181;3054;7499;3098;7680
210845;202206;7034;17501;6190;16570;43;148;5921;15892;5964;16040
210850;202206;7195;21003;5946;19176;388;1287;4684;15281;5072;16568
210860;202206;23641;54681;19521;49748;1091;2355;15885;41971;16976;44326
210870;202206;8425;19421;6677;17456;147;391;6005;15635;6152;16026
210880;202206;4600;12955;4100;12321;232;765;3217;9640;3449;10405
210890;202206;5074;12243;4619;11726;288;696;3925;9946;4213;10642
210900;202206;5375;14515;4194;12445;1522;4584;872;2982;2394;7566
210905;202206;2461;5586;2089;5122;47;82;1941;4798;1988;4880
210910;202206;7987;23197;6580;20958;739;2374;4428;14198;5167;16572
210920;202206;3517;10470;3076;9890;81;390;2760;8758;2841;9148
210923;202206;1876;4870;1600;4460;86;261;1262;3463;1348;3724
210927;202206;5247;16171;4523;15284;569;1844;3120;11048;3689;12892
210930;202206;2973;8613;2606;7948;119;439;2157;6430;2276;6869
210940;202206;4168;11235;3798;10794;350;1485;3174;8466;3524;9951
210945;202206;8530;21087;7590;20007;419;900;6263;17102;6682;18002
210950;202206;6037;15286;4666;13403;563;1261;3237;9930;3800;11191
210955;202206;1690;4870;1422;4456;323;947;769;2533;1092;3480
210960;202206;10351;28480;8892;26291;2240;6293;4578;14641;6818;20934
210970;202206;1867;4576;1535;4026;101;291;1262;3189;1363;3480
210975;202206;2009;5586;1808;5287;159;461;1361;3992;1520;4453
210980;202206;11167;23613;9772;22161;102;244;9240;20971;9342;21215
210990;202206;19343;49283;14954;43736;1391;3424;10714;32862;12105;36286
211000;202206;16326;43017;13450;39480;1668;4374;9763;30135;11431;34509
211003;202206;6613;17335;5502;16027;123;450;4802;14197;4925;14647
211010;202206;7393;22900;6632;21959;95;419;5996;20059;6091;20478
211020;202206;9560;24716;8315;23335;225;756;7233;20764;7458;21520
211023;202206;2299;6849;2111;6609;113;372;1757;5485;1870;5857
211027;202206;4125;10654;3916;10346;126;418;3585;9338;3711;9756
211030;202206;4246;11057;3746;10434;357;911;2784;7941;3141;8852
211040;202206;5012;16595;4595;15891;120;620;4085;14041;4205;14661
211050;202206;10435;24277;9370;22952;130;415;8552;20820;8682;21235
211060;202206;8004;21667;7242;20657;164;682;6451;18159;6615;18841
211065;202206;2721;6498;2278;5950;84;199;1982;5227;2066;5426
211070;202206;9252;25925;7872;23925;335;1159;6656;20178;6991;21337
211080;202206;1469;3732;1153;3252;37;189;889;2340;926;2529
211085;202206;2434;6197;2018;5665;187;374;1578;4690;1765;5064
211090;202206;3467;8950;3113;8545;33;151;2875;7844;2908;7995
211100;202206;8026;17740;7461;17085;36;123;7065;16128;7101;16251
211102;202206;3661;10969;3317;10468;269;902;2665;8419;2934;9321
211105;202206;2596;7595;2170;6856;115;394;1658;5151;1773;5545
211107;202206;5310;15555;4500;14375;179;603;3570;11892;3749;12495
211110;202206;7040;17157;5561;15015;261;752;4435;11767;4696;12519
211120;202206;53064;120962;43274;109558;7015;15983;27691;73796;34706;89779
211125;202206;2189;6194;1840;5668;44;206;1561;4768;1605;4974
211130;202206;209070;468311;179436;430217;26005;54415;109427;277225;135432;331640
211140;202206;5348;14824;4633;13907;188;605;3908;11800;4096;12405
211150;202206;10692;26383;8946;24211;396;980;7435;20378;7831;21358
211153;202206;3235;8135;2249;6908;375;1059;1399;4553;1774;5612
211157;202206;1377;3926;1160;3530;82;253;825;2501;907;2754
211160;202206;5716;13341;4608;11823;129;489;3758;9170;3887;9659
211163;202206;1701;5141;1531;4900;48;182;1335;4295;1383;4477
211167;202206;1845;5056;1707;4868;29;107;1580;4491;1609;4598
211170;202206;7675;16541;7085;15856;56;146;6750;14979;6806;15125
211172;202206;2868;7455;2424;6798;95;330;1944;5244;2039;5574
211174;202206;3094;8308;2782;7958;31;168;2626;7450;2657;7618
211176;202206;4743;12507;3690;10976;321;945;2823;8450;3144;9395
211178;202206;5906;11765;5090;10897;28;113;4924;10439;4952;10552
211180;202206;4631;14061;4239;13512;166;674;3542;11205;3708;11879
211190;202206;3641;9356;3076;8550;33;176;2794;7662;2827;7838
211195;202206;1725;4215;1491;3870;58;160;1308;3368;1366;3528
211200;202206;2404;6553;1886;5750;186;580;1318;3994;1504;4574
211210;202206;6769;19459;6051;18475;388;1309;4950;15090;5338;16399
211220;202206;45424;103725;37552;94220;3409;8081;28284;71754;31693;79835
211223;202206;5959;14719;4846;13262;622;1662;3194;8856;3816;10518
211227;202206;1907;5651;1647;5282;80;322;1329;4280;1409;4602
211230;202206;9300;23888;7892;21894;361;778;6624;18655;6985;19433
211240;202206;8576;25442;8012;24713;229;842;7302;22461;7531;23303
211245;202206;8373;21298;7259;20126;140;329;6870;19128;7010;19457
211250;202206;16543;44841;14960;42535;1201;3489;11804;33450;13005;36939
211260;202206;8951;26603;7805;25199;188;829;6967;22612;7155;23441
211270;202206;11356;33248;9647;31030;396;1638;7877;25476;8273;27114
211280;202206;16374;37212;14723;35159;565;1222;13186;31577;13751;32799
211285;202206;2243;6439;1992;6115;134;458;1530;4722;1664;5180
211290;202206;8009;22509;7141;21330;298;993;5901;17572;6199;18565
211300;202206;8114;22458;7048;20706;439;1390;5444;15739;5883;17129
211400;202206;13259;34057;10812;30734;1333;3603;7199;21508;8532;25111
220005;202206;2181;5089;1964;4793;34;102;1670;3966;1704;4068
220010;202206;1631;4370;1323;3847;38;130;1019;2920;1057;3050
220020;202206;4878;11133;4221;10261;151;417;3637;8669;3788;9086
220025;202206;2570;5269;2199;4731;74;127;1802;3767;1876;3894
220027;202206;1537;3438;1315;3138;29;93;1151;2683;1180;2776
220030;202206;4027;9143;3742;8782;108;269;3269;7569;3377;7838
220040;202206;8697;24385;7534;22257;1422;3857;4306;13206;5728;17063
220045;202206;1798;4775;1485;4283;24;129;1281;3577;1305;3706
220050;202206;5725;13379;4916;12376;57;229;4573;11340;4630;11569
220060;202206;3164;5611;2724;5106;25;49;2602;4836;2627;4885
220070;202206;2695;6376;2244;5732;71;163;1891;4790;1962;4953
220080;202206;831;2203;714;2040;17;68;612;1720;629;1788
220090;202206;1981;4410;1601;3856;74;103;1273;3162;1347;3265
220095;202206;1038;1983;985;1928;30;58;902;1756;932;1814
220100;202206;1624;3982;1301;3498;31;118;1067;2742;1098;2860
220105;202206;2344;6535;2045;6028;139;440;1538;4488;1677;4928
220110;202206;3986;9951;3487;9138;42;183;3112;8016;3154;8199
220115;202206;3126;8178;2871;7852;117;338;2539;6897;2656;7235
220117;202206;1569;3468;1228;3007;10;39;1021;2417;1031;2456
220120;202206;17226;37460;15827;35735;82;335;14994;33423;15076;33758
220130;202206;1309;3154;1094;2865;19;84;982;2503;1001;2587
220140;202206;2583;4825;2203;4395;47;118;2036;4006;2083;4124
220150;202206;7366;19385;6670;18221;159;593;5626;14990;5785;15583
220155;202206;1334;3563;1068;3085;22;72;771;2170;793;2242
220157;202206;1230;2697;1033;2410;22;62;854;1927;876;1989
220160;202206;3185;8101;2728;7295;52;186;2211;5737;2263;5923
220170;202206;1778;4380;1499;3979;29;115;1311;3424;1340;3539
220173;202206;2427;6252;1940;5407;54;196;1521;4129;1575;4325
220177;202206;2468;5902;2340;5764;6;23;2309;5673;2315;5696
220180;202206;1311;2818;1072;2439;6;30;878;1853;884;1883
220190;202206;8954;19075;7670;17411;505;1015;6032;13907;6537;14922
220191;202206;1816;4965;1642;4683;115;357;1181;3284;1296;3641
220192;202206;2309;5649;1662;4535;31;106;1361;3616;1392;3722
220194;202206;2043;5175;1783;4774;55;204;1469;3779;1524;3983
220196;202206;2416;5662;2191;5339;24;111;1929;4588;1953;4699
220198;202206;1514;3513;1282;3230;10;23;1188;3001;1198;3024
220200;202206;5703;15486;4964;14516;102;376;4242;12393;4344;12769
220202;202206;2434;6185;2064;5592;36;144;1769;4684;1805;4828
220205;202206;2873;7384;2545;6816;65;228;2157;5627;2222;5855
220207;202206;855;2396;715;2161;70;196;458;1414;528;1610
220208;202206;1988;5626;1612;4940;206;628;956;2947;1162;3575
220209;202206;1753;4717;1492;4254;28;104;1215;3421;1243;3525
220210;202206;2130;4518;1856;4116;17;61;1644;3525;1661;3586
220211;202206;1987;4195;1825;3988;24;75;1616;3472;1640;3547
220213;202206;2066;4999;1742;4457;33;114;1400;3410;1433;3524
220217;202206;2721;6766;2536;6553;143;204;2247;6031;2390;6235
220220;202206;13656;30196;11627;27296;617;1340;9121;21283;9738;22623
220225;202206;1118;2666;897;2390;2;11;837;2212;839;2223
220230;202206;6648;14973;5715;13701;131;300;5044;12048;5175;12348
220240;202206;3560;9337;2963;8328;100;400;2422;6605;2522;7005
220245;202206;2192;4240;1652;3608;11;43;1523;3293;1534;3336
220250;202206;3441;8615;3009;8081;22;100;2804;7459;2826;7559
220253;202206;1865;4629;1579;4183;34;122;1357;3502;1391;3624
220255;202206;2249;4770;1898;4286;45;158;1638;3546;1683;3704
220260;202206;5619;14578;4879;13293;238;645;3908;10582;4146;11227
220265;202206;1670;4590;1523;4405;84;306;1251;3545;1335;3851
220270;202206;6662;20280;6224;19496;179;944;5223;15747;5402;16691
220271;202206;1661;3953;1449;3661;28;104;1256;3138;1284;3242
220272;202206;1963;5279;1719;4842;55;200;1287;3458;1342;3658
220273;202206;1454;3784;1214;3362;54;189;927;2516;981;2705
220275;202206;2863;5751;2309;5016;30;57;2109;4515;2139;4572
220277;202206;2644;5771;2235;5215;70;150;1867;4263;1937;4413
220280;202206;2127;4164;1783;3742;37;72;1581;3250;1618;3322
220285;202206;1756;3809;1501;3508;11;45;1420;3273;1431;3318
220290;202206;7885;19995;6270;17789;498;1313;4472;13130;4970;14443
220300;202206;2266;5981;1770;5349;35;176;1451;4320;1486;4496
220310;202206;3614;8756;2836;7860;42;175;2467;6766;2509;6941
220320;202206;3483;9257;2698;7871;78;355;2113;5937;2191;6292
220323;202206;1867;4953;1420;4237;48;199;1153;3331;1201;3530
220325;202206;1365;3835;1144;3455;33;146;919;2711;952;2857
220327;202206;1830;4625;1604;4274;54;193;1338;3460;1392;3653
220330;202206;5782;11776;4970;10832;41;129;4618;9931;4659;10060
220335;202206;2069;5361;1877;5101;92;178;1622;4443;1714;4621
220340;202206;2070;5178;1569;4348;68;208;1021;2722;1089;2930
220342;202206;1399;3669;1250;3456;85;182;962;2702;1047;2884
220345;202206;3446;7253;2600;6095;27;88;2283;5263;2310;5351
220350;202206;3783;8935;3029;7835;210;481;2137;5523;2347;6004
220360;202206;1441;3426;1107;2900;22;64;883;2259;905;2323
220370;202206;9953;25953;8981;24472;311;918;7591;20449;7902;21367
220375;202206;1909;4713;1685;4443;8;12;1617;4286;1625;4298
220380;202206;1790;3692;1449;3219;18;47;1289;2825;1307;2872
220385;202206;1038;2183;841;1849;7;13;747;1611;754;1624
220390;202206;13240;30154;10489;26208;1898;4729;5301;13458;7199;18187
220400;202206;1717;3771;1294;3125;18;59;999;2288;1017;2347
220410;202206;1371;3443;1113;3013;31;103;921;2442;952;2545
220415;202206;967;2303;781;1995;23;49;614;1533;637;1582
220420;202206;2157;5745;1722;4917;73;249;1262;3526;1335;3775
220430;202206;3276;7239;2931;6779;54;148;2640;5977;2694;6125
220435;202206;2277;5061;1972;4604;35;104;1688;3822;1723;3926
220440;202206;3547;8541;3016;7779;61;291;2680;6573;2741;6864
220450;202206;3038;7039;2516;6395;53;193;2222;5563;2275;5756
220455;202206;1497;4034;1428;3948;9;48;1310;3614;1319;3662
220460;202206;1274;2696;1179;2571;45;75;1024;2198;1069;2273
220465;202206;2642;7547;2308;7039;161;470;1782;5511;1943;5981
220470;202206;4279;10610;3789;9834;155;379;3005;7612;3160;7991
220480;202206;3065;7397;2446;6457;199;401;1667;4406;1866;4807
220490;202206;2818;6438;2403;5931;26;119;2109;5089;2135;5208
220500;202206;3697;8238;3096;7338;121;237;2390;5554;2511;5791
220510;202206;3065;7587;2466;6568;107;259;1977;5284;2084;5543
220515;202206;2006;4286;1840;4055;67;90;1584;3467;1651;3557
220520;202206;5834;13647;5215;12771;102;263;4369;10768;4471;11031
220525;202206;1625;3612;1370;3305;11;34;1264;3038;1275;3072
220527;202206;1770;4018;1492;3614;45;91;1321;3223;1366;3314
220530;202206;1902;3977;1602;3601;180;383;1189;2784;1369;3167
220535;202206;968;2372;898;2266;36;113;728;1777;764;1890
220540;202206;3660;10614;3373;10073;215;614;2722;8151;2937;8765
220545;202206;1681;4523;1531;4295;61;243;1295;3557;1356;3800
220550;202206;9930;28738;8769;26626;464;1601;6599;19577;7063;21178
220551;202206;1659;4131;1448;3785;22;90;1224;3110;1246;3200
220552;202206;1872;5010;1509;4378;24;129;1216;3393;1240;3522
220553;202206;2296;4799;1915;4308;26;60;1726;3851;1752;3911
220554;202206;1102;2507;852;2125;94;179;584;1457;678;1636
220555;202206;3807;7818;3366;7288;31;112;2990;6422;3021;6534
220556;202206;1424;3754;1253;3450;42;182;936;2437;978;2619
220557;202206;1915;5382;1579;4677;105;370;1135;3248;1240;3618
220558;202206;1636;3908;1294;3436;27;103;1089;2797;1116;2900
220559;202206;2087;4641;1763;4146;59;105;1444;3382;1503;3487
220560;202206;2103;4172;1736;3729;23;41;1607;3421;1630;3462
220570;202206;9070;23916;8148;22596;574;1429;6480;17997;7054;19426
220580;202206;7708;19211;6959;18082;103;310;6219;16051;6322;16361
220585;202206;2335;6717;1914;5954;61;188;1545;4814;1606;5002
220590;202206;1672;3963;1378;3546;98;222;1056;2711;1154;2933
220595;202206;3118;7526;2801;7116;82;236;2426;6085;2508;6321
220600;202206;1982;3579;1723;3285;29;49;1594;3014;1623;3063
220605;202206;1705;4683;1464;4261;22;115;1177;3301;1199;3416
220610;202206;3127;8178;2912;7871;20;104;2733;7321;2753;7425
220620;202206;9324;25064;8507;23978;146;708;7765;21544;7911;22252
220630;202206;408;1130;318;973;26;83;199;586;225;669
220635;202206;2061;5626;1828;5168;65;226;1461;4007;1526;4233
220640;202206;2720;6968;2310;6390;92;291;1858;5107;1950;5398
220650;202206;2690;6279;2312;5722;142;253;1781;4511;1923;4764
220660;202206;2897;8405;2423;7612;78;352;1989;6116;2067;6468
220665;202206;1442;3937;1223;3587;36;166;1023;2908;1059;3074
220667;202206;1853;5106;1670;4792;71;256;1363;3832;1434;4088
220669;202206;1859;5066;1767;4934;43;171;1579;4304;1622;4475
220670;202206;2561;5815;2030;5073;39;108;1756;4373;1795;4481
220672;202206;3803;8540;3113;7717;98;329;2757;6676;2855;7005
220675;202206;1490;3734;1325;3452;79;218;997;2562;1076;2780
220680;202206;3481;7765;3321;7563;256;357;2876;6814;3132;7171
220690;202206;1809;4375;1563;4001;118;315;1165;2947;1283;3262
220695;202206;1065;2684;981;2539;21;55;833;2133;854;2188
220700;202206;13516;27636;11095;24499;524;1125;8844;18982;9368;20107
220710;202206;1013;2511;733;2028;23;80;560;1490;583;1570
220720;202206;2582;5345;2319;5010;20;66;2071;4371;2091;4437
220730;202206;1491;3804;1273;3469;16;73;1093;2897;1109;2970
220735;202206;1170;2426;897;2022;38;86;705;1546;743;1632
220740;202206;1560;3693;1243;3275;51;125;1025;2735;1076;2860
220750;202206;4785;10456;4208;9683;193;377;3765;8670;3958;9047
220755;202206;1706;3582;1428;3188;18;60;1214;2628;1232;2688
220760;202206;3978;8811;3497;8190;47;163;3291;7655;3338;7818
220770;202206;29578;78863;25338;72003;6541;19176;10908;31669;17449;50845
220775;202206;1522;3272;1366;3080;6;26;1328;2962;1334;2988
220777;202206;1792;4242;1395;3643;58;111;994;2695;1052;2806
220779;202206;1388;3440;1196;3148;33;107;1008;2607;1041;2714
220780;202206;6544;14808;5873;13872;309;785;4688;10914;4997;11699
220785;202206;1650;3338;1450;3088;13;34;1374;2894;1387;2928
220790;202206;11815;30058;10565;28327;233;934;9040;23852;9273;24786
220793;202206;1123;2574;905;2217;14;33;769;1866;783;1899
220795;202206;1562;3703;1355;3409;22;75;1203;3000;1225;3075
220800;202206;23946;46421;20622;42179;1062;1960;16521;33105;17583;35065
220810;202206;3489;8859;2946;7967;81;193;2362;6450;2443;6643
220820;202206;6640;14508;5838;13387;263;507;4888;11084;5151;11591
220830;202206;8512;20203;7547;18854;359;941;6147;15077;6506;16018
220840;202206;14721;39570;12413;35325;2170;5779;7155;20347;9325;26126
220850;202206;3465;9811;3079;9328;60;283;2754;8337;2814;8620
220855;202206;947;1929;838;1794;15;50;767;1617;782;1667
220860;202206;1266;2714;1105;2486;18;66;1025;2259;1043;2325
220865;202206;2583;6540;1988;5510;47;199;1498;3994;1545;4193
220870;202206;3743;8732;3105;7929;35;155;2847;7175;2882;7330
220880;202206;7212;13820;6261;12674;139;302;5743;11542;5882;11844
220885;202206;1710;4373;1424;3944;78;225;1131;3118;1209;3343
220887;202206;1812;3528;1518;3151;30;49;1400;2892;1430;2941
220890;202206;1611;4427;1386;4111;63;205;1127;3336;1190;3541
220900;202206;2490;5078;2089;4553;29;60;1866;3981;1895;4041
220910;202206;1961;4506;1664;4072;213;338;1243;3219;1456;3557
220915;202206;1062;2675;840;2288;12;48;633;1626;645;1674
220920;202206;1738;4740;1493;4426;84;290;1247;3692;1331;3982
220930;202206;2252;4987;1901;4525;19;63;1730;4137;1749;4200
220935;202206;1209;3267;946;2710;23;90;626;1683;649;1773
220937;202206;1678;4096;1418;3683;42;124;1116;2845;1158;2969
220940;202206;2064;4657;1689;4045;32;111;1417;3244;1449;3355
220945;202206;564;1748;449;1543;21;119;304;1014;325;1133
220950;202206;1572;3398;1052;2615;15;41;848;2008;863;2049
220955;202206;1826;4221;1511;3705;23;55;1290;3113;1313;3168
220960;202206;852;2086;621;1703;35;109;393;1004;428;1113
220965;202206;2023;4963;1761;4598;30;133;1523;3860;1553;3993
220970;202206;2485;4993;1859;4111;13;39;1636;3510;1649;3549
220975;202206;838;2022;717;1874;8;46;645;1627;653;1673
220980;202206;1375;3446;1223;3249;27;85;1047;2741;1074;2826
220985;202206;1636;3620;1419;3294;77;140;1114;2571;1191;2711
220987;202206;1695;4537;1495;4205;55;199;1242;3422;1297;3621
220990;202206;1882;4818;1642;4458;23;97;1383;3695;1406;3792
220995;202206;1529;3695;1257;3238;17;55;1039;2619;1056;2674
220997;202206;2705;7408;2460;7016;56;225;2173;6059;2229;6284
221000;202206;5249;12868;4597;11962;130;466;3945;10105;4075;10571
221005;202206;1743;4091;1581;3831;26;119;1351;3130;1377;3249
221010;202206;1474;2895;1159;2509;41;61;1003;2163;1044;2224
221020;202206;1733;4913;1559;4624;21;81;1213;3570;1234;3651
221030;202206;1894;4112;1606;3764;24;65;1412;3333;1436;3398
221035;202206;1815;4124;1548;3760;27;39;1369;3346;1396;3385
221037;202206;824;2010;695;1790;14;41;523;1258;537;1299
221038;202206;593;1542;462;1322;25;83;325;904;350;987
221039;202206;957;2471;786;2195;27;114;631;1705;658;1819
221040;202206;4982;13138;4302;12007;224;601;3449;9608;3673;10209
221050;202206;5133;10753;4587;10078;96;233;4143;9052;4239;9285
221060;202206;10801;26858;8891;23807;449;1059;7082;18853;7531;19912
221062;202206;1360;3848;1166;3550;62;203;943;2825;1005;3028
221063;202206;1327;3243;1147;2988;62;186;929;2355;991;2541
221065;202206;3174;7181;2764;6506;15;51;2469;5717;2484;5768
221070;202206;3786;10848;3057;9355;401;1167;1859;5790;2260;6957
221080;202206;3995;9051;3271;7987;56;203;2731;6431;2787;6634
221090;202206;1608;3694;1327;3275;16;53;1149;2772;1165;2825
221093;202206;1863;4386;1694;4106;162;320;1221;2916;1383;3236
221095;202206;1026;2446;847;2190;22;73;701;1791;723;1864
221097;202206;950;2262;717;1870;16;49;547;1337;563;1386
221100;202206;149903;357686;126273;320373;9210;26668;90628;219482;99838;246150
221110;202206;11698;31048;10657;29728;193;771;9515;26205;9708;26976
221120;202206;5459;14447;4849;13547;163;513;4197;11670;4360;12183
221130;202206;6616;15020;5154;12453;769;1749;3238;7545;4007;9294
221135;202206;2292;4872;1997;4501;71;148;1714;3942;1785;4090
221140;202206;1718;3399;1438;3061;39;76;1294;2711;1333;2787
221150;202206;1274;2919;976;2433;25;116;768;1784;793;1900
221160;202206;845;1946;745;1821;47;74;575;1429;622;1503
221170;202206;1156;2926;1066;2771;7;27;960;2443;967;2470
230010;202206;3512;8471;2876;7415;41;145;2377;5915;2418;6060
230015;202206;3872;10898;3349;9845;181;593;2409;6959;2590;7552
230020;202206;16403;44892;15284;43240;591;1862;13170;36974;13761;38836
230030;202206;14342;33186;11982;30099;324;895;10229;25511;10553;26406
230040;202206;5007;11821;4155;10496;51;216;3548;8773;3599;8989
230050;202206;2965;8652;2279;7141;287;964;1119;3221;1406;4185
230060;202206;2809;6929;2196;5904;36;143;1759;4603;1795;4746
230070;202206;5042;11626;4019;9878;612;1254;2468;6267;3080;7521
230075;202206;11038;30908;10048;29269;500;1850;8232;23389;8732;25239
230080;202206;3600;6781;2767;5762;11;21;2576;5331;2587;5352
230090;202206;5346;11586;4484;10276;172;380;3716;8286;3888;8666
230100;202206;23979;53982;20925;50058;1691;4109;15169;35861;16860;39970
230110;202206;14974;41424;12520;36790;1846;5591;6917;20016;8763;25607
230120;202206;9351;22356;8121;20477;533;1410;6107;15162;6640;16572
230125;202206;3536;8567;2867;7509;80;276;2299;5812;2379;6088
230130;202206;6630;18311;5406;15803;388;1101;3715;10726;4103;11827
230140;202206;3974;10885;3326;9638;96;422;2601;7228;2697;7650
230150;202206;1857;5047;1525;4375;183;503;939;2696;1122;3199
230160;202206;8070;17603;6976;16030;184;448;5977;13435;6161;13883
230170;202206;7171;19050;5791;16343;418;1153;4037;11203;4455;12356
230180;202206;1863;4745;1564;4195;18;80;1271;3269;1289;3349
230185;202206;5168;13129;4335;11812;365;1000;3130;8588;3495;9588
230190;202206;16521;45330;13676;40125;1578;4752;8070;23269;9648;28021
230195;202206;6430;16974;5767;15879;340;942;4448;12160;4788;13102
230200;202206;5485;14211;4516;12484;255;726;3382;9132;3637;9858
230205;202206;4943;12718;4308;11840;265;775;3404;9189;3669;9964
230210;202206;12451;26227;10577;23796;478;1087;8510;18652;8988;19739
230220;202206;17229;38789;15069;35793;808;1888;12346;28885;13154;30773
230230;202206;8152;21436;7305;19849;384;1119;5722;15166;6106;16285
230240;202206;15632;36962;13376;33285;619;1480;10673;26162;11292;27642
230250;202206;10091;26046;9295;24878;288;897;7382;19052;7670;19949
230260;202206;17394;45813;14980;41820;2290;6110;8753;24583;11043;30693
230270;202206;8642;21154;6638;17606;879;2119;3831;10558;4710;12677
230280;202206;22997;55413;18899;48840;434;1798;15284;37423;15718;39221
230290;202206;5751;14267;4790;12545;176;511;3819;9707;3995;10218
230300;202206;5565;13497;4961;12672;78;240;4408;11186;4486;11426
230310;202206;5315;14049;4462;12539;178;616;3195;8717;3373;9333
230320;202206;8905;23670;7397;21063;264;1047;5764;15913;6028;16960
230330;202206;5463;13679;4264;11480;145;468;3213;8376;3358;8844
230340;202206;4434;12594;3820;11406;218;743;2789;8068;3007;8811
230350;202206;21418;52249;18682;48426;906;2800;13626;34488;14532;37288
230360;202206;3447;8287;2695;7026;158;387;1974;5072;2132;5459
230365;202206;3539;7830;2906;6922;89;255;2487;5864;2576;6119
230370;202206;78835;187115;68212;172562;4934;14170;51095;124842;56029;139012
230380;202206;7087;18206;5563;15453;131;525;4200;11189;4331;11714
230390;202206;3824;10231;3256;9350;78;332;2578;7214;2656;7546
230393;202206;3880;10200;3086;8653;88;460;2445;6506;2533;6966
230395;202206;6470;16572;5533;15021;519;1352;3684;9922;4203;11274
230400;202206;6383;15866;5587;14638;79;391;4518;11319;4597;11710
230410;202206;14649;41201;12023;36579;870;2870;8347;25353;9217;28223
230420;202206;34090;85586;27979;75627;2815;7964;17336;45348;20151;53312
230423;202206;5280;14498;4614;13266;296;911;3369;9510;3665;10421
230425;202206;6665;18697;6087;17620;567;1638;4347;12467;4914;14105
230426;202206;3099;7552;2271;6040;46;176;1723;4411;1769;4587
230427;202206;2059;5426;1461;4225;150;430;781;2110;931;2540
230428;202206;11322;28331;9682;25991;1472;3863;5658;14937;7130;18800
230430;202206;5592;14650;4417;12645;151;541;3351;9334;3502;9875
230435;202206;7298;16986;5953;14778;820;1930;3530;8677;4350;10607
230440;202206;527954;1161720;447644;1050762;30302;79304;327620;740879;357922;820183
230445;202206;4690;11947;3781;10408;268;725;2504;6642;2772;7367
230450;202206;4259;10963;3707;10177;209;741;2787;7329;2996;8070
230460;202206;2411;6114;2063;5567;63;248;1713;4526;1776;4774
230465;202206;4883;12245;4100;10808;135;440;3192;8026;3327;8466
230470;202206;12687;38380;11365;36042;790;3000;8276;25576;9066;28576
230480;202206;1705;4426;1422;3940;63;273;1095;2838;1158;3111
230490;202206;3176;8025;2664;7095;199;603;1774;4385;1973;4988
230495;202206;6868;17745;6021;16322;720;1963;3769;10066;4489;12029
230500;202206;10227;30761;8986;28566;335;1283;7231;22964;7566;24247
230510;202206;1954;5041;1535;4221;153;425;909;2412;1062;2837
230520;202206;5441;13619;4679;12355;395;943;3378;8799;3773;9742
230523;202206;18254;50322;14525;42864;3196;9188;4239;12849;7435;22037
230526;202206;4494;11233;3796;10117;306;662;2698;7374;3004;8036
230530;202206;6238;18227;5184;16275;879;2816;3181;9945;4060;12761
230533;202206;5419;11197;4267;9496;76;209;3583;7660;3659;7869
230535;202206;5731;15223;4816;13721;354;1118;3210;9080;3564;10198
230540;202206;17278;44788;14691;40925;326;1188;12064;33203;12390;34391
230550;202206;25555;60670;20784;53048;1615;4220;14433;35622;16048;39842
230560;202206;9016;19945;7276;17338;184;406;6158;14706;6342;15112
230565;202206;3521;8946;2927;7890;98;339;2321;6088;2419;6427
230570;202206;3801;9053;3219;8259;76;238;2659;6716;2735;6954
230580;202206;14073;31303;12115;28588;648;1233;9918;23424;10566;24657
230590;202206;10710;27750;8888;24624;537;1582;6622;17858;7159;19440
230600;202206;4318;9969;3355;8363;133;297;2315;5799;2448;6096
230610;202206;7630;19120;6722;17629;444;1174;5292;13767;5736;14941
230620;202206;2362;5915;1831;4933;96;307;1192;3022;1288;3329
230625;202206;10553;26546;8971;23890;1946;5327;4067;10518;6013;15845
230630;202206;13598;34434;11932;31485;1288;3105;8042;21275;9330;24380
230640;202206;30693;86923;27646;82057;1252;4726;22318;64858;23570;69584
230650;202206;6033;14873;5089;13331;145;570;4216;10628;4361;11198
230655;202206;10719;32605;10052;31529;690;2146;8173;25765;8863;27911
230660;202206;6766;18699;5445;16395;183;853;4341;12767;4524;13620
230670;202206;6879;15168;4980;12252;148;410;3974;9445;4122;9855
230680;202206;3137;7813;2606;6931;158;344;1828;4845;1986;5189
230690;202206;7923;21842;6734;19611;398;1336;4442;12698;4840;14034
230700;202206;12186;27636;9730;23338;480;1137;7370;17163;7850;18300
230710;202206;7673;22589;6710;20638;581;1824;4633;14023;5214;15847
230720;202206;2232;6032;1847;5344;139;367;1260;3569;1399;3936
230725;202206;5244;13926;4706;13027;366;1167;3228;8602;3594;9769
230730;202206;68497;167504;53766;146639;12034;32328;19746;57535;31780;89863
230740;202206;6889;17908;5772;16139;176;530;4565;12692;4741;13222
230750;202206;9495;23521;7796;20774;170;582;6236;16112;6406;16694
230760;202206;13127;31579;11309;28901;458;1448;8656;21359;9114;22807
230763;202206;5552;13866;4558;12208;92;403;3651;9402;3743;9805
230765;202206;48805;121042;40894;108934;4685;13268;24784;63529;29469;76797
230770;202206;32714;68549;27811;62411;1954;4432;21120;46215;23074;50647
230780;202206;7437;23777;6675;22060;849;2742;4022;13427;4871;16169
230790;202206;3536;9116;3147;8526;131;469;2434;6299;2565;6768
230800;202206;9901;28220;8618;25778;1164;3455;4992;14558;6156;18013
230810;202206;12203;34531;10815;32289;489;1652;8376;24548;8865;26200
230820;202206;3994;11922;3302;10508;310;1167;2062;6212;2372;7379
230830;202206;8785;21663;7423;19502;218;636;6085;15489;6303;16125
230835;202206;4669;10382;3618;8799;131;314;2903;6922;3034;7236
230837;202206;3987;10158;3562;9469;87;343;3018;7739;3105;8082
230840;202206;10902;29353;9375;26792;773;2166;6907;19593;7680;21759
230850;202206;11657;29675;9818;26375;484;1327;7375;19485;7859;20812
230860;202206;7108;14517;5961;12941;72;196;5382;11409;5454;11605
230870;202206;20038;42565;17250;38151;886;1730;13887;30310;14773;32040
230880;202206;2308;6487;2105;6159;61;275;1649;4665;1710;4940
230890;202206;5167;15031;4653;14121;254;861;3460;10270;3714;11131
230900;202206;3738;9606;3156;8511;133;458;2326;5965;2459;6423
230910;202206;3770;8941;2941;7726;62;248;2413;6262;2475;6510
230920;202206;5406;13857;4383;12193;114;439;3400;9117;3514;9556
230930;202206;7869;20319;6447;17839;299;890;4520;12231;4819;13121
230940;202206;9528;21609;8274;19787;159;407;7101;16737;7260;17144
230945;202206;7376;19509;6274;17528;298;990;4567;12293;4865;13283
230950;202206;7059;16293;6221;15175;128;327;5326;12924;5454;13251
230960;202206;15154;40281;13110;36598;2042;5793;6786;18436;8828;24229
230970;202206;17456;42147;14835;38263;1412;3812;9914;24829;11326;28641
230980;202206;3586;8593;3109;7817;303;718;2176;5495;2479;6213
230990;202206;1917;4991;1587;4365;71;256;1146;2978;1217;3234
231000;202206;3030;7404;2401;6213;83;241;1815;4472;1898;4713
231010;202206;4489;8933;3550;7467;23;98;3201;6490;3224;6588
231020;202206;9963;27025;8785;24926;1218;3177;5578;16117;6796;19294
231025;202206;9074;22000;7960;20306;524;1288;6207;15628;6731;16916
231030;202206;8325;23059;6365;19125;839;2465;3677;10955;4516;13420
231040;202206;3536;8751;3036;7894;70;242;2535;6329;2605;6571
231050;202206;13687;31564;11193;27398;498;1327;8744;20622;9242;21949
231060;202206;3247;8337;2880;7782;82;282;2296;6259;2378;6541
231070;202206;9139;24389;7832;22128;635;1899;5397;14965;6032;16864
231080;202206;4441;11592;3678;10346;199;677;2669;7368;2868;8045
231085;202206;8289;18126;6647;16213;207;530;5378;12912;5585;13442
231090;202206;4986;12188;3633;9640;119;451;2562;6458;2681;6909
231095;202206;2480;6999;1977;5953;192;571;1297;3878;1489;4449
231100;202206;3574;9509;2930;8357;134;441;2198;6152;2332;6593
231110;202206;4185;11352;3843;10745;279;828;2763;7492;3042;8320
231120;202206;2752;7198;2300;6451;102;318;1715;4726;1817;5044
231123;202206;2176;5279;1710;4464;106;267;1215;3107;1321;3374
231126;202206;6304;15949;5127;13797;297;767;3760;9966;4057;10733
231130;202206;26598;59196;22111;53679;1256;3712;16928;39458;18184;43170
231135;202206;4794;12465;3948;10900;183;554;2816;7623;2999;8177
231140;202206;19154;49530;15440;43486;715;2628;11308;30656;12023;33284
231150;202206;6811;17199;4871;13515;737;2088;1949;5390;2686;7478
231160;202206;7761;20986;6890;19425;765;1957;4307;12277;5072;14234
231170;202206;5338;13972;4419;12319;268;816;3172;8456;3440;9272
231180;202206;17281;44558;14080;38349;2374;6454;7093;18892;9467;25346
231190;202206;4655;11997;3650;10207;89;352;2822;7648;2911;8000
231195;202206;5739;15904;4716;13930;292;969;3449;10045;3741;11014
231200;202206;9641;25010;8354;22623;162;748;7009;18070;7171;18818
231210;202206;5550;14797;4667;13322;157;610;3682;10160;3839;10770
231220;202206;15226;34346;12056;28844;580;1331;9032;20745;9612;22076
231230;202206;10828;31967;9515;29614;727;2451;7072;21801;7799;24252
231240;202206;13572;36693;11945;33832;1598;4424;7523;21162;9121;25586
231250;202206;2344;5484;1543;3846;110;247;961;2288;1071;2535
231260;202206;3728;9385;3179;8542;315;741;2190;5988;2505;6729
231270;202206;7339;17456;5936;15219;150;568;4551;11153;4701;11721
231280;202206;2011;5718;1777;5317;159;433;1216;3644;1375;4077
231290;202206;42236;117162;35411;104637;4836;14484;18643;53406;23479;67890
231300;202206;4738;12053;3697;10074;131;441;2594;6783;2725;7224
231310;202206;9009;20658;7189;17504;564;1445;5103;11921;5667;13366
231320;202206;8117;21277;6240;17937;124;424;4864;13828;4988;14252
231325;202206;2826;6674;2269;5825;169;300;1626;4188;1795;4488
231330;202206;11837;31562;9829;27836;1399;3700;6048;17339;7447;21039
231335;202206;6286;15508;5218;13860;129;457;4454;11663;4583;12120
231340;202206;21105;59111;18906;55454;1375;4142;14273;41996;15648;46138
231350;202206;18274;45428;16579;43044;284;934;14896;38236;15180;39170
231355;202206;5103;13644;4532;12637;190;626;3621;9854;3811;10480
231360;202206;9018;24836;7788;22828;362;1177;6171;17797;6533;18974
231370;202206;2390;6175;1909;5329;44;135;1459;4013;1503;4148
231375;202206;4584;13356;4094;12544;109;453;3404;10294;3513;10747
231380;202206;6742;16480;6005;15506;169;470;4991;12875;5160;13345
231390;202206;3844;10370;3427;9689;117;470;2570;6988;2687;7458
231395;202206;4834;12847;4039;11616;274;806;2812;7926;3086;8732
231400;202206;11192;29442;9338;26121;296;1255;7230;19514;7526;20769
231410;202206;17232;47700;15618;45231;767;2319;12745;36698;13512;39017
240010;202206;2952;7137;2315;6044;329;848;1197;3050;1526;3898
240020;202206;15332;38233;12825;34013;809;2489;8767;22412;9576;24901
240030;202206;4273;8273;3835;7663;98;272;3442;6619;3540;6891
240040;202206;908;2467;754;2190;24;89;507;1396;531;1485
240050;202206;3852;9591;3026;8117;62;186;2313;6028;2375;6214
240060;202206;1661;4031;1328;3442;43;128;1032;2604;1075;2732
240070;202206;2930;7462;2592;6783;189;544;1878;4681;2067;5225
240080;202206;3320;8290;2623;7106;105;331;1905;5050;2010;5381
240090;202206;2551;5757;2083;5004;24;64;1765;4154;1789;4218
240100;202206;12597;27386;10100;23264;261;757;8127;17771;8388;18528
240110;202206;5367;13964;4464;12354;169;610;3361;8944;3530;9554
240120;202206;3865;10101;3211;9250;248;843;2302;6502;2550;7345
240130;202206;4463;8216;3638;7167;47;89;3270;6365;3317;6454
240140;202206;2028;5753;1716;5197;199;678;1079;3191;1278;3869
240145;202206;7729;20117;6249;17627;692;2026;3968;11008;4660;13034
240150;202206;1147;2963;986;2655;49;165;760;1982;809;2147
240160;202206;1656;4542;1364;4011;33;136;996;2895;1029;3031
240165;202206;1094;2733;915;2408;27;93;761;1946;788;2039
240170;202206;3210;7683;2690;6807;300;741;1757;4391;2057;5132
240180;202206;3453;9541;2755;8138;607;1713;1256;3853;1863;5566
240185;202206;1504;4264;1357;4006;45;183;1081;3076;1126;3259
240190;202206;1264;3222;1066;2921;28;108;887;2412;915;2520
240200;202206;14242;31896;11565;27592;1310;3122;7055;16228;8365;19350
240210;202206;3943;8473;3235;7368;36;161;2811;6115;2847;6276
240220;202206;8359;23437;7439;22024;474;1679;5739;16794;6213;18473
240230;202206;6720;15606;5299;13349;276;593;3955;10074;4231;10667
240240;202206;2003;5482;1355;4079;166;526;471;1243;637;1769
240250;202206;3596;8296;3108;7614;54;213;2651;6275;2705;6488
240260;202206;17446;46571;15126;42809;4353;11725;6733;20930;11086;32655
240270;202206;2762;7424;2335;6726;117;351;1688;4947;1805;5298
240280;202206;1891;4496;1572;3987;67;171;1240;3096;1307;3267
240290;202206;1319;3546;1060;3031;35;146;738;1950;773;2096
240300;202206;2581;6177;1872;4949;96;250;1169;3013;1265;3263
240310;202206;9664;24104;7665;20664;945;2565;4054;10715;4999;13280
240320;202206;2189;5652;1505;4316;78;261;1051;2888;1129;3149
240325;202206;38968;94476;31864;82977;4114;11742;18199;45120;22313;56862
240330;202206;2056;5203;1580;4348;69;251;1106;2869;1175;3120
240340;202206;2395;4822;1945;4175;54;135;1629;3349;1683;3484
240350;202206;2864;6127;2549;5769;29;98;2358;5272;2387;5370
240360;202206;12793;31697;11386;29601;1733;4036;7337;19391;9070;23427
240370;202206;2502;5573;1929;4558;93;250;1418;3137;1511;3387
240375;202206;1065;2474;881;2175;35;116;693;1623;728;1739
240380;202206;2616;6792;2007;5542;192;513;1150;3112;1342;3625
240390;202206;1146;2598;787;1943;31;62;519;1190;550;1252
240400;202206;1679;3818;1267;3148;41;147;910;2105;951;2252
240410;202206;662;1858;536;1616;48;162;323;925;371;1087
240420;202206;5591;17223;4960;15999;447;1785;3368;10397;3815;12182
240430;202206;4057;9428;3380;8318;114;376;2645;6210;2759;6586
240440;202206;3155;6519;2691;5871;254;468;2007;4394;2261;4862
240450;202206;5060;12906;3986;11002;361;1172;2427;6281;2788;7453
240460;202206;3877;9326;3463;8689;291;649;2787;7044;3078;7693
240470;202206;3926;11207;2985;9300;577;1658;1427;4656;2004;6314
240480;202206;664;1682;410;1144;24;62;212;558;236;620
240485;202206;2462;6435;1972;5593;149;442;1308;3692;1457;4134
240490;202206;1845;4267;1423;3546;88;176;1011;2491;1099;2667
240500;202206;2382;6067;2048;5509;111;308;1636;4354;1747;4662
240510;202206;1863;4691;1592;4289;81;266;1261;3313;1342;3579
240520;202206;1828;3853;1388;3273;102;206;1077;2560;1179;2766
240530;202206;2661;6601;2353;6109;73;216;1995;5031;2068;5247
240540;202206;2670;6010;2376;5572;47;126;2117;4917;2164;5043
240550;202206;952;2194;848;2021;15;58;755;1742;770;1800
240560;202206;4360;9390;3745;8595;167;329;3084;7042;3251;7371
240570;202206;3107;7814;2093;5675;300;826;750;1865;1050;2691
240580;202206;9693;25600;8542;23628;552;1569;6876;18879;7428;20448
240590;202206;1009;2085;863;1866;7;18;715;1486;722;1504
240600;202206;2025;5072;1482;4033;52;154;1024;2632;1076;2786
240610;202206;5250;12352;4474;11031;186;492;3416;8089;3602;8581
240615;202206;1442;3435;1152;2961;101;266;822;2031;923;2297
240620;202206;2143;5418;1829;4898;85;270;1500;3946;1585;4216
240630;202206;2490;6047;2235;5644;314;531;1549;4143;1863;4674
240640;202206;1062;2589;834;2211;30;100;639;1630;669;1730
240650;202206;4651;12396;3923;10975;303;829;2734;7610;3037;8439
240660;202206;3873;8374;3472;7853;54;134;3204;7182;3258;7316
240670;202206;2881;7291;2284;6128;168;490;1542;3952;1710;4442
240680;202206;1827;4355;1449;3718;46;149;1143;2817;1189;2966
240690;202206;1316;2919;1025;2437;25;91;843;1891;868;1982
240700;202206;2714;7470;2169;6487;104;341;1619;4791;1723;5132
240710;202206;21098;47325;17977;42459;1619;3832;13126;29996;14745;33828
240720;202206;5936;13742;5042;12498;551;1340;3400;8428;3951;9768
240725;202206;1275;3367;976;2829;48;134;634;1775;682;1909
240730;202206;2623;6649;2053;5611;76;239;1561;4149;1637;4388
240740;202206;2156;5474;1723;4628;68;218;1230;3097;1298;3315
240750;202206;2560;7719;2150;6859;260;910;1269;4005;1529;4915
240760;202206;1948;4071;1407;3275;97;141;1083;2578;1180;2719
240770;202206;3701;9354;3107;8538;140;478;2535;6832;2675;7310
240780;202206;5740;14571;4798;13049;692;1804;3057;8340;3749;10144
240790;202206;1022;2621;836;2302;26;120;620;1619;646;1739
240800;202206;62938;134706;50194;116416;5070;12222;31758;69920;36828;82142
240810;202206;112767;262532;97087;238368;8477;22126;69433;165164;77910;187290
240820;202206;6675;18331;5837;16852;711;2088;3767;10896;4478;12984
240830;202206;9808;25858;8543;24010;322;1143;6884;19050;7206;20193
240840;202206;1240;2896;993;2509;45;101;694;1707;739;1808
240850;202206;1614;4107;1123;3099;99;264;623;1631;722;1895
240860;202206;1623;3801;1220;3118;42;130;959;2361;1001;2491
240870;202206;1208;2848;911;2359;147;376;485;1281;632;1657
240880;202206;1438;4298;1250;3934;109;406;908;2814;1017;3220
240890;202206;5629;13686;4423;11564;462;1355;2687;6478;3149;7833
240895;202206;3356;9318;3027;8793;350;951;2225;6633;2575;7584
240910;202206;3991;9906;3314;8723;56;195;2703;6898;2759;7093
240920;202206;1175;2700;944;2366;98;175;587;1508;685;1683
240930;202206;4196;8714;3416;7747;232;353;2356;5799;2588;6152
240933;202206;1834;4260;1529;3833;37;141;1311;3192;1348;3333
240940;202206;7981;17350;6342;14758;624;1421;4151;9206;4775;10627
240950;202206;1251;3423;1075;3089;39;158;853;2342;892;2500
240960;202206;770;2118;689;1954;15;57;539;1471;554;1528
240970;202206;2206;5024;1778;4345;71;238;1469;3462;1540;3700
240980;202206;4363;10632;3920;9921;82;349;3407;8301;3489;8650
240990;202206;3194;7818;2810;7152;236;717;2065;4943;2301;5660
241000;202206;1098;2617;848;2176;14;44;660;1612;674;1656
241010;202206;3483;9607;3151;8959;146;525;2501;6865;2647;7390
241020;202206;2409;5937;1823;4818;97;311;1296;3234;1393;3545
241025;202206;1906;5114;1532;4471;47;182;1102;3112;1149;3294
241030;202206;2790;8176;2241;7064;259;741;1436;4552;1695;5293
241040;202206;2414;7076;2075;6508;89;407;1579;4901;1668;5308
241050;202206;1614;4157;1293;3585;38;134;952;2562;990;2696
241060;202206;922;2361;790;2096;47;111;537;1381;584;1492
241070;202206;795;1967;657;1748;17;45;505;1292;522;1337
241080;202206;1285;3396;990;2795;38;125;699;1911;737;2036
241090;202206;2334;6159;1867;5367;88;353;1404;3893;1492;4246
241100;202206;1342;3465;1012;2813;47;115;686;1855;733;1970
241105;202206;1153;3177;931;2778;193;603;403;1194;596;1797
241110;202206;1071;2804;800;2248;47;130;511;1366;558;1496
241120;202206;8403;22305;7068;20076;809;2251;4454;12808;5263;15059
241140;202206;3771;9353;2881;7631;124;386;2119;5404;2243;5790
241142;202206;866;2207;647;1822;39;120;387;1009;426;1129
241150;202206;6725;16021;5900;14770;245;584;4607;11391;4852;11975
241160;202206;1334;3441;1035;2904;164;504;568;1492;732;1996
241170;202206;1518;3633;1277;3218;32;107;1052;2544;1084;2651
241180;202206;1182;2794;874;2242;82;219;490;1188;572;1407
241190;202206;1354;3213;1125;2796;16;60;835;1969;851;2029
241200;202206;26456;60613;23239;55629;2579;6392;15652;36019;18231;42411
241210;202206;1744;4243;1275;3397;106;311;758;1965;864;2276
241220;202206;10989;28645;9652;26496;2002;5426;4862;13571;6864;18997
241230;202206;3345;8052;2908;7403;115;308;2401;6034;2516;6342
241240;202206;1379;3660;835;2507;97;295;282;808;379;1103
241250;202206;6781;17019;5445;14704;160;689;4199;10738;4359;11427
241255;202206;2982;8064;2587;7340;150;515;1928;5281;2078;5796
241260;202206;5660;13524;4528;11703;151;503;3552;8852;3703;9355
241270;202206;1834;5020;1519;4438;123;370;1054;3043;1177;3413
241280;202206;2868;6032;2494;5387;84;186;2134;4507;2218;4693
241290;202206;3708;8365;2712;6800;77;216;2146;5218;2223;5434
241300;202206;1710;4272;1380;3718;31;116;930;2414;961;2530
241310;202206;2604;5612;2250;5123;67;120;1941;4388;2008;4508
241320;202206;1085;3279;929;2982;99;353;573;1803;672;2156
241330;202206;1993;4668;1573;4115;19;77;1389;3600;1408;3677
241335;202206;4178;10493;3649;9580;125;388;3010;7697;3135;8085
241340;202206;1903;4766;1522;4036;175;561;874;2108;1049;2669
241350;202206;2483;6180;2150;5611;117;314;1646;4212;1763;4526
241355;202206;1580;3864;1274;3295;49;99;943;2409;992;2508
241360;202206;2343;5582;1718;4385;57;159;1267;3080;1324;3239
241370;202206;1560;3870;1205;3179;65;195;868;2129;933;2324
241380;202206;807;1983;632;1690;72;178;351;924;423;1102
241390;202206;3039;8213;2664;7663;165;504;2056;5910;2221;6414
241400;202206;4191;10676;3668;9905;220;705;2831;7490;3051;8195
241410;202206;2796;7731;2262;6677;240;764;1427;4155;1667;4919
241415;202206;2082;5268;1760;4677;49;190;1415;3579;1464;3769
241420;202206;3255;8721;2903;8161;460;1399;1860;5165;2320;6564
241430;202206;795;1872;501;1325;18;48;331;816;349;864
241440;202206;9426;26062;8425;24385;304;1030;6818;19420;7122;20450
241445;202206;1565;3329;1363;3065;47;87;1195;2697;1242;2784
241450;202206;3344;7333;2759;6439;247;514;2064;4812;2311;5326
241460;202206;4441;11109;3546;9354;242;686;2419;6091;2661;6777
241470;202206;1585;3936;1286;3486;40;135;1053;2812;1093;2947
241475;202206;1422;3578;1111;3023;24;91;828;2116;852;2207
241480;202206;3502;9979;2869;8670;777;2296;1042;3416;1819;5712
241490;202206;845;1749;607;1400;14;42;490;1088;504;1130
241500;202206;929;2290;845;2196;8;19;784;2040;792;2059
250010;202206;3012;8248;2495;7207;63;228;1853;5181;1916;5409
250020;202206;1846;4493;1373;3635;82;157;1006;2649;1088;2806
250030;202206;7855;20030;6863;18532;754;2141;4920;12993;5674;15134
250040;202206;5313;13920;4640;12780;583;1583;3101;8444;3684;10027
250050;202206;4226;10212;3760;9625;156;435;3155;8090;3311;8525
250053;202206;1473;3744;1339;3546;130;291;952;2527;1082;2818
250057;202206;822;2398;752;2298;7;34;688;2099;695;2133
250060;202206;6582;15585;5836;14601;328;829;4754;11760;5082;12589
250070;202206;4572;11710;3810;10442;49;208;3052;8098;3101;8306
250073;202206;920;2202;742;1917;8;26;605;1521;613;1547
250077;202206;2999;6638;2328;5605;36;119;1953;4550;1989;4669
250080;202206;6366;13419;5294;12113;61;228;4769;10716;4830;10944
250090;202206;4282;8708;3755;8037;65;170;3326;6914;3391;7084
250100;202206;3894;11099;3494;10411;135;514;2770;8002;2905;8516
250110;202206;5576;14301;5046;13575;306;954;3898;10329;4204;11283
250115;202206;855;1887;648;1580;11;41;511;1201;522;1242
250120;202206;2119;5721;1783;5179;28;133;1429;4055;1457;4188
250130;202206;6869;15624;5842;14244;64;286;5126;12161;5190;12447
250135;202206;1550;3722;1345;3377;47;127;1139;2823;1186;2950
250140;202206;2504;6812;2307;6572;107;398;1979;5623;2086;6021
250150;202206;5353;15442;4798;14558;176;683;3863;11423;4039;12106
250153;202206;1578;3874;1279;3433;54;146;1009;2673;1063;2819
250157;202206;2323;5795;2055;5374;49;166;1706;4355;1755;4521
250160;202206;4438;10066;3556;8890;86;209;3041;7556;3127;7765
250170;202206;2157;5109;1925;4783;38;137;1647;3982;1685;4119
250180;202206;26192;55363;22447;50707;776;2302;18554;40256;19330;42558
250190;202206;4941;11774;4150;10663;365;910;2988;7502;3353;8412
250200;202206;2956;5858;2548;5343;48;126;2283;4633;2331;4759
250205;202206;948;2792;803;2563;13;59;642;2038;655;2097
250210;202206;1666;4671;1478;4370;56;235;1166;3346;1222;3581
250215;202206;1838;4697;1549;4301;96;304;882;2469;978;2773
250220;202206;763;1968;604;1714;33;116;416;1135;449;1251
250230;202206;1875;3952;1322;3161;19;58;1047;2413;1066;2471
250240;202206;3168;7739;2805;7151;36;156;2476;6160;2512;6316
250250;202206;5390;13417;4725;12514;245;506;3767;10335;4012;10841
250260;202206;1830;4850;1537;4332;58;169;1190;3346;1248;3515
250270;202206;1379;3839;1254;3687;87;277;913;2785;1000;3062
250280;202206;4616;10259;4131;9625;243;450;3259;7676;3502;8126
250290;202206;1951;4472;1637;4016;21;63;1321;3129;1342;3192
250300;202206;6888;15471;6197;14660;169;611;5337;12149;5506;12760
250310;202206;1349;3538;1106;3143;44;133;820;2302;864;2435
250320;202206;15020;30168;13062;27977;189;552;11979;25129;12168;25681
250330;202206;2971;7135;2526;6534;88;287;2166;5430;2254;5717
250340;202206;1434;3133;1235;2869;15;40;1114;2559;1129;2599
250350;202206;4488;11847;3892;10821;304;647;2982;8539;3286;9186
250355;202206;2550;6363;2253;5996;21;94;2076;5492;2097;5586
250360;202206;2069;5021;1844;4721;56;182;1536;3819;1592;4001
250370;202206;17242;38416;14496;34404;284;834;12492;28852;12776;29686
250375;202206;1508;3291;1226;2963;7;24;1142;2771;1149;2795
250380;202206;2051;4495;1887;4301;37;126;1703;3747;1740;3873
250390;202206;2202;5073;1853;4538;150;360;1410;3435;1560;3795
250400;202206;82177;191465;62332;161727;17468;46849;19441;52674;36909;99523
250403;202206;2512;5564;2231;5254;49;276;1886;4142;1935;4418
250407;202206;1613;3470;1243;2924;148;262;774;1984;922;2246
250410;202206;802;1937;686;1750;11;35;571;1396;582;1431
250415;202206;2247;5598;1964;5180;41;149;1697;4393;1738;4542
250420;202206;1407;3439;1262;3244;18;43;1147;2940;1165;2983
250430;202206;8269;17447;7086;15900;401;761;5781;12708;6182;13469
250435;202206;1820;4766;1435;4115;21;97;1087;2999;1108;3096
250440;202206;5112;12745;4416;11846;92;235;3853;10260;3945;10495
250450;202206;2062;4929;1690;4428;84;169;1320;3549;1404;3718
250460;202206;8286;20903;7264;19473;499;1345;5684;15206;6183;16551
250470;202206;1885;4398;1554;3893;42;120;1261;3046;1303;3166
250480;202206;4394;11275;3676;10388;61;187;3165;8994;3226;9181
250485;202206;802;1713;603;1442;60;103;406;950;466;1053
250490;202206;6128;12920;5415;12117;108;354;4857;10596;4965;10950
250500;202206;2302;5904;2034;5460;58;175;1658;4376;1716;4551
250510;202206;6455;14343;5522;13099;123;227;4733;11293;4856;11520
250520;202206;2162;5358;1844;4942;85;268;1437;3752;1522;4020
250523;202206;2644;5713;2316;5281;210;475;1761;3930;1971;4405
250527;202206;1975;4472;1781;4254;16;50;1628;3845;1644;3895
250530;202206;754;1774;640;1610;20;52;528;1283;548;1335
250535;202206;1536;4154;1365;3855;29;128;1088;2965;1117;3093
250540;202206;3888;7392;3279;6727;370;422;2663;5779;3033;6201
250550;202206;873;2637;774;2453;51;170;534;1665;585;1835
250560;202206;1975;5065;1710;4690;38;146;1412;3766;1450;3912
250570;202206;3108;8380;2673;7626;122;386;2064;5801;2186;6187
250580;202206;1186;2894;1042;2703;47;188;878;2184;925;2372
250590;202206;1149;2516;1039;2363;30;74;922;2040;952;2114
250600;202206;8839;22227;7296;20127;256;804;5708;15519;5964;16323
250610;202206;3287;8669;2927;8148;104;365;2406;6624;2510;6989
250620;202206;1027;2298;876;2057;48;127;668;1517;716;1644
250625;202206;2679;7205;2381;6737;49;224;2046;5644;2095;5868
250630;202206;13230;31733;11050;28226;1062;2848;7608;18752;8670;21600
250640;202206;4229;10099;3778;9511;110;336;3238;8076;3348;8412
250650;202206;1227;2602;994;2298;12;47;865;1947;877;1994
250660;202206;1808;4129;1433;3607;32;110;1183;2853;1215;2963
250670;202206;2699;7618;2431;7146;53;214;2105;6046;2158;6260
250680;202206;6808;14221;6114;13441;46;185;5714;12268;5760;12453
250690;202206;8437;16984;7107;15384;184;346;6097;13043;6281;13389
250700;202206;5233;13625;4559;12600;694;1875;2862;7950;3556;9825
250710;202206;4894;13244;4253;12351;279;927;3143;9034;3422;9961
250720;202206;3184;7923;2831;7436;55;212;2538;6565;2593;6777
250730;202206;5149;12015;4533;11204;147;513;3888;9281;4035;9794
250740;202206;2326;5291;1916;4748;120;279;1458;3615;1578;3894
250750;202206;132123;298432;112766;271899;8280;21563;83658;196246;91938;217809
250760;202206;3303;6642;2946;6112;42;154;2674;5353;2716;5507
250770;202206;4621;12762;4131;12114;565;1451;2815;8601;3380;10052
250780;202206;2080;5050;1750;4482;69;195;1400;3489;1469;3684
250790;202206;2927;7874;2537;7308;94;374;1988;5544;2082;5918
250800;202206;2784;6798;2408;6215;99;206;1933;4966;2032;5172
250810;202206;1634;3708;1359;3332;117;192;1059;2695;1176;2887
250820;202206;2307;5723;2108;5495;38;121;1908;4937;1946;5058
250830;202206;7132;19437;5883;16999;234;844;4172;11470;4406;12314
250840;202206;854;2555;743;2349;37;134;550;1748;587;1882
250850;202206;2008;5460;1775;5064;37;160;1473;4088;1510;4248
250855;202206;1249;3149;1097;2928;43;134;895;2332;938;2466
250860;202206;4016;10624;3336;9540;481;1369;1889;5360;2370;6729
250870;202206;1181;2946;989;2645;38;116;793;2076;831;2192
250880;202206;1873;4432;1546;3949;119;288;1141;2891;1260;3179
250890;202206;13101;28485;11524;26517;307;1260;9916;21564;10223;22824
250900;202206;3708;8684;3257;7948;67;200;2827;6707;2894;6907
250905;202206;2780;7236;2550;6934;40;144;2313;6271;2353;6415
250910;202206;7996;16683;6777;15340;89;279;6070;13591;6159;13870
250915;202206;2531;5246;1823;4484;24;54;1612;3992;1636;4046
250920;202206;4339;9761;3875;9086;262;531;3195;7373;3457;7904
250930;202206;2712;6603;2422;6243;84;269;1992;5013;2076;5282
250933;202206;1456;3852;1270;3534;47;170;1002;2702;1049;2872
250937;202206;903;2221;754;1990;25;80;611;1605;636;1685
250939;202206;2295;5261;2009;4898;53;135;1656;3958;1709;4093
250940;202206;4562;10948;3974;10175;50;138;3537;8978;3587;9116
250950;202206;1949;4723;1560;4204;38;143;1249;3288;1287;3431
250960;202206;1269;3440;1117;3201;29;128;920;2544;949;2672
250970;202206;9832;23163;8598;21207;194;563;7192;17185;7386;17748
250980;202206;2770;6683;2504;6322;20;93;2186;5349;2206;5442
250990;202206;2453;6736;2082;6119;90;338;1595;4539;1685;4877
251000;202206;2274;5975;1831;5231;45;181;1480;4179;1525;4360
251010;202206;2910;7472;2590;6990;40;162;2261;6024;2301;6186
251020;202206;1764;4560;1582;4284;35;159;1373;3611;1408;3770
251030;202206;1163;2907;947;2524;63;158;633;1667;696;1825
251040;202206;2122;5371;1801;4853;28;121;1529;4054;1557;4175
251050;202206;1147;3055;957;2694;48;167;684;1849;732;2016
251060;202206;1259;2482;953;2100;32;66;712;1560;744;1626
251065;202206;533;1383;389;1107;10;38;280;748;290;786
251070;202206;855;1990;712;1786;14;47;605;1470;619;1517
251080;202206;23835;53855;19531;47642;3181;7516;11329;28139;14510;35655
251090;202206;3209;8562;2678;7644;63;187;2185;6139;2248;6326
251100;202206;923;2755;799;2506;24;87;612;1825;636;1912
251110;202206;2064;5006;1710;4371;124;268;1239;3125;1363;3393
251120;202206;8798;21892;7381;20177;486;1502;5522;14858;6008;16360
251130;202206;5395;9661;4677;8877;44;105;4375;8154;4419;8259
251140;202206;4682;12336;4134;11570;92;314;3352;9299;3444;9613
251150;202206;3095;8299;2814;7861;69;330;2398;6509;2467;6839
251160;202206;2671;6721;2312;6193;29;146;2063;5392;2092;5538
251170;202206;2012;4710;1764;4395;24;91;1587;3847;1611;3938
251180;202206;3196;7485;2640;6732;232;492;1852;4817;2084;5309
251190;202206;5441;12393;4894;11780;59;271;4410;10304;4469;10575
251200;202206;5166;13327;4537;12534;114;313;3915;10853;4029;11166
251203;202206;1130;3367;1027;3133;50;160;719;2155;769;2315
251207;202206;1294;3228;966;2689;23;99;667;1785;690;1884
251210;202206;9286;21152;7564;18814;519;1026;5443;13975;5962;15001
251220;202206;1486;3191;1113;2707;98;191;820;2062;918;2253
251230;202206;5303;13775;4550;12468;114;397;3624;9586;3738;9983
251240;202206;4214;11030;3536;9888;239;620;2474;6885;2713;7505
251250;202206;13270;31726;11640;29057;622;1731;9042;21650;9664;23381
251260;202206;605;1454;540;1354;17;74;439;1046;456;1120
251270;202206;5062;14065;4494;13286;262;712;3483;10649;3745;11361
251272;202206;1520;3790;1395;3632;54;205;1194;3010;1248;3215
251274;202206;988;2590;784;2228;67;189;492;1362;559;1551
251275;202206;1629;3810;1367;3397;67;178;1084;2602;1151;2780
251276;202206;1525;3872;1325;3603;34;144;1061;2778;1095;2922
251278;202206;730;1800;647;1673;38;114;518;1309;556;1423
251280;202206;3134;6781;2862;6402;66;200;2542;5493;2608;5693
251290;202206;8713;16272;7964;15410;259;545;7049;13280;7308;13825
251300;202206;999;2696;887;2525;16;68;751;2125;767;2193
251310;202206;3174;8206;2715;7492;56;261;2265;6066;2321;6327
251315;202206;2112;5985;1891;5566;109;317;1471;4296;1580;4613
251320;202206;1884;4615;1418;3813;40;137;1072;2799;1112;2936
251330;202206;2439;5181;1977;4626;29;82;1743;4046;1772;4128
251335;202206;1240;3204;1115;3019;23;101;1003;2655;1026;2756
251340;202206;4427;9449;3513;8272;161;363;2747;6401;2908;6764
251350;202206;1216;3204;1103;3030;33;104;913;2466;946;2570
251360;202206;2150;5343;1691;4686;27;77;1357;3698;1384;3775
251365;202206;898;2175;660;1729;19;51;517;1333;536;1384
251370;202206;28861;70787;24621;64996;3405;8527;15421;41325;18826;49852
251380;202206;1671;3882;1438;3526;28;108;1250;2968;1278;3076
251385;202206;885;2141;686;1795;31;72;474;1201;505;1273
251390;202206;8177;20732;7237;19296;579;1621;5222;13665;5801;15286
251392;202206;1168;2951;987;2668;40;115;770;2066;810;2181
251394;202206;767;2008;616;1748;57;170;417;1141;474;1311
251396;202206;790;2001;665;1782;30;83;455;1168;485;1251
251398;202206;1162;2806;819;2202;25;86;602;1542;627;1628
251400;202206;1614;3337;1290;2907;25;94;1076;2297;1101;2391
251410;202206;1838;3841;1472;3321;14;45;1264;2728;1278;2773
251420;202206;2313;5479;1901;5004;48;166;1512;3880;1560;4046
251430;202206;1734;4821;1557;4514;50;184;1336;3811;1386;3995
251440;202206;1221;3148;989;2732;58;137;737;2074;795;2211
251445;202206;1867;4676;1711;4469;30;128;1473;3729;1503;3857
251450;202206;5111;13682;4537;12814;79;327;3876;10806;3955;11133
251455;202206;1004;2776;908;2607;20;79;729;2043;749;2122
251460;202206;1096;2800;893;2485;56;184;681;1853;737;2037
251465;202206;529;1419;444;1265;13;55;337;921;350;976
251470;202206;1344;3485;997;2795;124;379;523;1350;647;1729
251480;202206;1154;2799;907;2388;20;75;678;1688;698;1763
251490;202206;2267;5438;1837;4859;96;265;1385;3633;1481;3898
251500;202206;2349;5896;2133;5609;53;167;1813;4682;1866;4849
251510;202206;3018;8414;2498;7395;93;351;1756;4970;1849;5321
251520;202206;1202;2873;913;2380;92;177;569;1476;661;1653
251530;202206;17203;37039;13997;33105;160;738;12450;28662;12610;29400
251540;202206;3486;9078;3110;8431;63;255;2581;6766;2644;7021
251550;202206;4806;9710;3900;8628;133;231;3230;7165;3363;7396
251560;202206;639;1832;568;1731;41;160;412;1195;453;1355
251570;202206;1079;2840;890;2472;20;99;702;1875;722;1974
251580;202206;2408;5138;2137;4743;33;114;1848;3909;1881;4023
251590;202206;1905;4153;1616;3812;48;121;1390;3164;1438;3285
251593;202206;1093;2990;969;2776;89;290;660;1829;749;2119
251597;202206;2462;6098;2210;5765;16;79;2022;5189;2038;5268
251600;202206;7231;18164;6252;16680;253;705;5105;13437;5358;14142
251610;202206;3659;9494;3194;8692;248;658;2316;6244;2564;6902
251615;202206;1547;3421;1222;2949;20;66;1013;2347;1033;2413
251620;202206;23222;46832;18086;40634;161;413;15824;35402;15985;35815
251630;202206;5896;12266;4770;10710;245;526;3729;8075;3974;8601
251640;202206;2521;6239;2238;5824;21;98;2016;5145;2037;5243
251650;202206;5033;11338;4357;10478;160;373;3704;8799;3864;9172
251660;202206;4068;11076;3577;10235;66;295;2990;8353;3056;8648
251670;202206;5064;12173;4471;11387;71;262;4042;10122;4113;10384
251675;202206;982;2166;886;2047;60;132;733;1675;793;1807
251680;202206;3065;7162;2577;6534;84;172;2139;5434;2223;5606
251690;202206;3666;9498;3116;8585;108;313;2372;6477;2480;6790
251700;202206;2543;6551;2092;5926;49;196;1724;4727;1773;4923
251710;202206;905;2176;650;1696;49;135;385;928;434;1063
251720;202206;1503;3919;1197;3405;22;96;935;2555;957;2651
251740;202206;739;1906;586;1639;29;96;432;1159;461;1255
260005;202206;34703;68649;28921;61429;1646;3635;23012;47299;24658;50934
260010;202206;11874;28755;9783;25476;637;1759;6037;15414;6674;17173
260020;202206;8047;16564;6645;14625;83;344;5705;12146;5788;12490
260030;202206;8380;18651;7104;16869;95;350;6059;13972;6154;14322
260040;202206;8613;20047;7262;18217;543;1346;5317;13384;5860;14730
260050;202206;15773;37212;13296;34456;220;687;12322;31885;12542;32572
260060;202206;4927;10774;4212;9691;377;679;3148;7460;3525;8139
260070;202206;13366;28793;11575;26299;238;874;9870;21504;10108;22378
260080;202206;7862;15702;6832;14402;128;337;5883;12046;6011;12383
260090;202206;6060;13743;5363;12839;323;774;4280;10209;4603;10983
260100;202206;3504;8391;2957;7623;50;232;2547;6407;2597;6639
260105;202206;5650;14199;5063;13421;117;467;4291;11064;4408;11531
260110;202206;25367;65248;22497;61119;1017;3231;18491;49237;19508;52468
260120;202206;17419;41125;14793;37449;1614;3800;10158;25793;11772;29593
260130;202206;3884;8544;3369;7850;124;288;2686;6061;2810;6349
260140;202206;15240;30599;13219;28243;344;900;11621;24228;11965;25128
260150;202206;4363;8768;3806;8097;112;228;3411;7202;3523;7430
260160;202206;8110;17571;6954;16185;85;252;6429;14888;6514;15140
260170;202206;25310;53009;21725;48339;1064;2431;17800;38851;18864;41282
260180;202206;3999;9688;3406;8869;84;288;2919;7455;3003;7743
260190;202206;23898;41337;20488;37430;155;402;18806;33485;18961;33887
260200;202206;12892;28022;11137;25800;508;1004;9636;22363;10144;23367
260210;202206;12722;33248;10672;30026;359;1204;8544;23821;8903;25025
260220;202206;14194;27654;13173;26419;500;776;11606;23156;12106;23932
260230;202206;14353;28962;12543;26688;315;667;10601;22317;10916;22984
260240;202206;3174;8681;2745;7883;78;326;2164;6045;2242;6371
260250;202206;2703;6188;2317;5619;103;258;1869;4420;1972;4678
260260;202206;15779;36219;14041;33750;890;2117;10951;26307;11841;28424
260270;202206;5576;11184;4942;10468;91;308;4385;9026;4476;9334
260280;202206;14236;38704;12858;36775;351;1538;11278;31476;11629;33014
260290;202206;47556;111034;41072;102119;3708;9474;29429;71997;33137;81471
260300;202206;11781;27637;10139;25358;271;873;8591;21122;8862;21995
260310;202206;7250;15433;6497;14512;427;715;5264;11949;5691;12664
260320;202206;8648;23215;7298;21042;174;644;6037;17230;6211;17874
260330;202206;2853;8077;2457;7279;71;250;1966;5653;2037;5903
260340;202206;2449;5850;2118;5377;25;103;1867;4599;1892;4702
260345;202206;31821;74102;26923;67359;3002;8063;17037;40818;20039;48881
260350;202206;7142;13951;6232;12943;35;113;5774;11785;5809;11898
260360;202206;2857;6808;2519;6198;106;302;1768;4216;1874;4518
260370;202206;6350;16338;5414;14796;194;667;4285;11308;4479;11975
260380;202206;5767;15397;4907;14020;205;603;3801;10738;4006;11341
260390;202206;5311;14795;4315;12849;209;629;2894;8419;3103;9048
260392;202206;4252;11524;3830;10991;68;410;3307;9358;3375;9768
260400;202206;24417;48655;21276;44626;394;1116;17911;35535;18305;36651
260410;202206;90994;202513;73015;178192;13381;33703;35738;88147;49119;121850
260415;202206;5246;12157;4528;11081;51;209;3906;9263;3957;9472
260420;202206;15246;27650;13113;25319;67;216;12448;23702;12515;23918
260430;202206;3095;9027;2604;8082;207;634;1714;5292;1921;5926
260440;202206;4910;10481;4362;9768;42;152;3945;8649;3987;8801
260450;202206;6420;14894;5720;13985;289;579;4828;11906;5117;12485
260460;202206;6295;16505;5372;14971;457;1427;3592;9678;4049;11105
260470;202206;5570;12919;4723;11956;82;239;4300;10985;4382;11224
260480;202206;4476;10657;3773;9697;309;831;2682;6886;2991;7717
260490;202206;6369;12934;5596;11900;32;121;5134;10699;5166;10820
260500;202206;7017;16066;6025;14686;432;987;4371;10635;4803;11622
260510;202206;12314;26234;10464;23703;112;396;9385;20762;9497;21158
260515;202206;5088;12385;4016;10491;134;427;2916;7143;3050;7570
260520;202206;18540;40035;16091;36956;804;1879;13188;29778;13992;31657
260530;202206;11138;28859;9471;26397;125;621;8309;22676;8434;23297
260540;202206;8986;16900;8031;15738;100;257;7436;14308;7536;14565
260545;202206;111;310;75;231;11;44;26;69;37;113
260550;202206;3623;9064;2922;7926;177;582;1993;5103;2170;5685
260560;202206;6752;15906;5636;14272;136;489;4807;11865;4943;12354
260570;202206;9821;22241;8668;20758;237;688;7558;17725;7795;18413
260580;202206;5671;11498;5120;10794;23;75;4766;9921;4789;9996
260590;202206;9000;16628;7739;15259;108;262;7040;13632;7148;13894
260600;202206;39001;89620;32399;80007;1104;3257;25862;61542;26966;64799
260610;202206;8663;20721;7603;19323;411;1094;5714;14345;6125;15439
260620;202206;22743;49923;20171;46524;1167;3289;16007;35256;17174;38545
260630;202206;2707;6747;2207;5979;58;182;1813;4797;1871;4979
260640;202206;28707;55627;24530;50904;833;1785;20999;42721;21832;44506
260650;202206;7251;16869;5796;15075;523;939;4683;12445;5206;13384
260660;202206;8126;18750;7086;17456;321;876;6190;15007;6511;15883
260670;202206;2628;6305;2136;5529;76;198;1617;4027;1693;4225
260680;202206;34994;75879;29659;68645;2048;4954;21761;48740;23809;53694
260690;202206;3917;9490;3250;8478;81;284;2553;6526;2634;6810
260700;202206;8249;18303;7674;17673;34;163;7461;17116;7495;17279
260710;202206;1574;3749;1336;3407;61;194;1064;2662;1125;2856
260720;202206;32573;69250;27978;63687;1886;4360;21855;49305;23741;53665
260730;202206;9168;23839;7915;22120;198;782;6829;18682;7027;19464
260740;202206;1506;3925;1238;3505;22;82;989;2818;1011;2900
260750;202206;9291;20875;7305;18482;165;371;6386;16594;6551;16965
260760;202206;7434;15211;6480;14112;113;318;5755;12353;5868;12671
260765;202206;10072;25341;8849;23706;564;1772;6477;16865;7041;18637
260770;202206;4445;10382;3650;9109;98;316;2958;7194;3056;7510
260775;202206;6636;15534;5830;14366;159;555;4779;11203;4938;11758
260780;202206;4331;11575;3844;10808;354;1241;2486;6536;2840;7777
260790;202206;153138;312402;129123;282588;16122;34556;89120;192005;105242;226561
260795;202206;3969;8220;3456;7584;122;292;2977;6414;3099;6706
260800;202206;7094;13725;6428;12857;213;395;5676;11103;5889;11498
260805;202206;4287;10678;3659;9652;164;525;2867;7300;3031;7825
260810;202206;7949;18907;6971;17182;320;832;5564;13172;5884;14004
260820;202206;5221;10896;4631;10231;79;251;4006;8704;4085;8955
260825;202206;3412;9247;2993;8549;114;368;2323;6523;2437;6891
260830;202206;5079;13216;4241;11814;466;1084;2846;8116;3312;9200
260840;202206;5452;11649;4906;10931;269;527;4211;9314;4480;9841
260845;202206;5139;12363;4552;11428;212;618;3543;8575;3755;9193
260850;202206;5816;14368;4876;12689;373;1031;3270;8078;3643;9109
260860;202206;3916;10294;3342;9304;108;366;2715;7329;2823;7695
260870;202206;5322;11168;4569;10263;145;314;4011;9008;4156;9322
260875;202206;9634;20028;7964;17687;663;1359;5712;12734;6375;14093
260880;202206;11768;29325;10251;26932;267;873;8665;22263;8932;23136
260890;202206;15606;35615;13499;32553;904;2260;9606;22720;10510;24980
260900;202206;6506;16489;5396;14947;415;1164;3650;10031;4065;11195
260910;202206;3861;9243;3371;8534;115;324;2698;6709;2813;7033
260915;202206;6158;14994;5483;14207;45;196;5135;13195;5180;13391
260920;202206;4043;8379;3460;7762;82;170;3070;6858;3152;7028
260930;202206;4751;12654;4070;11506;168;633;3233;8768;3401;9401
260940;202206;17220;37121;14980;34085;1038;2507;11524;25480;12562;27987
260950;202206;8567;20505;6951;17915;330;1110;4813;11524;5143;12634
260960;202206;95018;186130;79206;166760;6933;14690;57451;116932;64384;131622
260970;202206;6564;15557;5794;14524;398;762;4350;11087;4748;11849
260980;202206;5317;13892;4616;13019;61;167;4173;11843;4234;12010
260990;202206;20268;50789;17090;46491;750;2344;13560;36161;14310;38505
261000;202206;19701;40949;16644;37188;514;1347;13754;29811;14268;31158
261010;202206;2579;6127;2232;5674;106;253;1876;4778;1982;5031
261020;202206;7862;18289;6866;16674;323;826;5637;13282;5960;14108
261030;202206;4695;12422;4123;11463;128;469;3291;8825;3419;9294
261040;202206;6218;16195;5084;14210;165;618;3994;10742;4159;11360
261050;202206;9270;21256;8385;20005;230;517;7050;16584;7280;17101
261060;202206;16971;38129;14758;35528;344;988;12442;29345;12786;30333
261070;202206;80893;163505;67748;146657;5768;11998;49679;105470;55447;117468
261080;202206;8115;17352;7335;16414;135;252;6841;15259;6976;15511
261090;202206;23106;48836;20511;45507;494;1276;18048;39226;18542;40502
261100;202206;10012;24512;8718;22690;646;1607;6554;16957;7200;18564
261110;202206;82443;210019;69600;187600;8497;24541;43505;114082;52002;138623
261120;202206;4416;9715;3832;8926;114;241;3300;7573;3414;7814
261130;202206;8602;18708;7552;17341;131;345;6681;15081;6812;15426
261140;202206;4421;9126;3929;8485;252;523;3078;6549;3330;7072
261150;202206;6481;14664;5714;13584;203;452;4861;11451;5064;11903
261153;202206;2174;6048;1805;5365;74;227;1241;3664;1315;3891
261160;202206;272626;575019;226396;514260;52298;117678;107992;248520;160290;366198
261170;202206;8724;17573;7647;16201;244;474;6650;13758;6894;14232
261180;202206;10789;24662;9409;22919;519;1152;7110;17299;7629;18451
261190;202206;5486;13969;4938;13130;151;658;4095;10470;4246;11128
261200;202206;4043;8224;3530;7571;110;294;3023;6268;3133;6562
261210;202206;2211;4874;1888;4430;106;191;1561;3642;1667;3833
261220;202206;17130;42051;14602;37852;1400;3752;9949;24878;11349;28630
261230;202206;4540;11788;3758;10772;52;198;3158;9072;3210;9270
261240;202206;7011;14655;6216;13510;265;564;5280;11298;5545;11862
261245;202206;4362;11002;3565;9664;70;323;2896;7499;2966;7822
261247;202206;3587;9618;2955;8523;333;888;1872;5482;2205;6370
261250;202206;31404;62194;27796;58097;4000;7720;20082;42929;24082;50649
261255;202206;4650;12566;3784;10943;160;607;2880;8057;3040;8664
261260;202206;17764;37345;15756;34825;273;1027;14546;31283;14819;32310
261270;202206;5929;11836;5231;11021;158;344;4630;9537;4788;9881
261280;202206;2877;7355;2483;6737;102;324;1961;5156;2063;5480
261290;202206;3307;7760;2767;7152;87;292;2290;5913;2377;6205
261300;202206;15825;37716;13541;34181;377;1392;10985;26479;11362;27871
261310;202206;11441;25229;9885;23180;746;1808;7499;17162;8245;18970
261320;202206;7056;17956;6089;16446;66;285;5204;13773;5270;14058
261330;202206;7507;15312;6810;14436;213;481;5988;12483;6201;12964
261340;202206;5840;13332;5169;12504;127;419;4581;10833;4708;11252
261350;202206;9766;26789;8515;24688;196;639;6795;19472;6991;20111
261360;202206;10082;21116;8567;19030;325;791;7017;15036;7342;15827
261370;202206;28205;64660;23911;59066;2207;5405;16680;40769;18887;46174
261380;202206;4975;12831;4228;11596;439;1190;2896;7928;3335;9118
261390;202206;19590;51159;16446;46335;1158;3698;11397;31310;12555;35008
261400;202206;5623;15193;4915;13823;264;838;3767;10173;4031;11011
261410;202206;11421;25419;9447;22510;337;991;7855;18020;8192;19011
261420;202206;8879;23452;7989;22419;547;1940;6240;17137;6787;19077
261430;202206;4765;10624;4131;9699;55;242;3677;8313;3732;8555
261440;202206;1612;4492;1317;3934;55;244;945;2686;1000;2930
261450;202206;16934;41194;14901;38213;614;1533;11826;30332;12440;31865
261460;202206;9036;21943;7787;20057;224;686;6445;16297;6669;16983
261470;202206;4519;10474;3880;9594;44;195;3321;8079;3365;8274
261480;202206;6423;17053;5510;15571;279;965;4366;11993;4645;12958
261485;202206;6124;15597;5373;14508;395;1232;4042;10654;4437;11886
261500;202206;7732;17381;6740;16076;657;1259;4654;11584;5311;12843
261510;202206;2096;5728;1805;5261;73;270;1402;4038;1475;4308
261520;202206;2682;7414;2395;6860;99;323;1789;4997;1888;5320
261530;202206;14259;37149;11644;32748;723;2699;7138;18424;7861;21123
261540;202206;10991;27599;10039;26302;2274;5357;5208;15039;7482;20396
261550;202206;4332;10351;3790;9539;206;619;2874;6936;3080;7555
261560;202206;10843;25653;9523;23798;401;1129;7786;19141;8187;20270
261570;202206;4052;10149;3178;8714;211;648;2196;5844;2407;6492
261580;202206;7918;18814;6870;17408;83;381;6298;15732;6381;16113
261590;202206;3221;7286;2629;6455;90;284;2079;4918;2169;5202
261600;202206;6894;14277;5914;12933;228;506;4833;10237;5061;10743
261610;202206;2492;6783;2000;5891;189;576;1279;3775;1468;4351
261618;202206;3289;6675;2911;6158;92;273;2506;5058;2598;5331
261620;202206;5289;13128;4835;12471;732;1660;3306;8993;4038;10653
261630;202206;6847;18220;5828;16316;446;1424;3837;10216;4283;11640
261640;202206;45498;90414;39002;82705;2051;3539;31077;66511;33128;70050
261650;202206;5236;10899;4465;9963;275;542;3514;7821;3789;8363
270010;202206;4885;15122;4195;13964;166;836;3352;10850;3518;11686
270020;202206;4759;10340;4139;9592;113;439;3631;8014;3744;8453
270030;202206;37754;97913;31624;88366;2444;7176;23378;64483;25822;71659
270040;202206;12238;29264;10446;27151;735;1904;8353;21678;9088;23582
270050;202206;5995;13138;5067;12103;213;464;4512;10811;4725;11275
270060;202206;2507;6021;2125;5571;149;394;1666;4332;1815;4726
270070;202206;5772;13802;5038;12804;99;424;4409;10779;4508;11203
270080;202206;1673;4172;1401;3743;81;200;1065;2796;1146;2996
270090;202206;2022;5624;1834;5285;46;190;1575;4426;1621;4616
270100;202206;7699;15610;6732;14317;170;428;5966;12348;6136;12776
270110;202206;3773;8144;3053;7311;199;351;2428;6058;2627;6409
270120;202206;2869;7399;2497;6910;73;266;2069;5591;2142;5857
270130;202206;5692;13591;4892;12640;170;549;4167;10641;4337;11190
270135;202206;2252;5021;1910;4647;27;119;1761;4230;1788;4349
270140;202206;10378;23406;8316;20598;317;1011;6503;15295;6820;16306
270150;202206;3266;8341;2991;7970;13;63;2848;7538;2861;7601
270160;202206;6225;16211;5338;15147;175;574;4794;13528;4969;14102
270170;202206;3656;10056;3076;9247;193;869;2252;6430;2445;7299
270180;202206;2551;7307;2315;7006;42;221;2057;6109;2099;6330
270190;202206;2545;5580;2304;5304;17;77;2166;4910;2183;4987
270200;202206;2948;8090;2561;7536;259;686;1798;5383;2057;6069
270210;202206;6606;14148;5633;13044;64;227;5223;11910;5287;12137
270220;202206;1915;4485;1553;3971;130;364;1123;2750;1253;3114
270230;202206;11074;27967;9267;25276;848;2386;6811;18359;7659;20745
270235;202206;6713;19342;5847;17982;214;767;4858;14780;5072;15547
270240;202206;13675;33149;11423;30155;949;2635;8666;22662;9615;25297
270250;202206;3496;7638;3111;7113;158;349;2690;6080;2848;6429
270255;202206;5050;13402;4025;11645;132;500;3147;8842;3279;9342
270260;202206;5951;17037;5375;16086;96;498;4688;13756;4784;14254
270270;202206;1172;2823;968;2578;116;278;715;1911;831;2189
270280;202206;4409;9676;3529;8608;245;526;2632;6606;2877;7132
270290;202206;8939;25877;8055;24519;146;719;7179;21545;7325;22264
270300;202206;4739;11382;3684;10229;169;411;2939;8285;3108;8696
270310;202206;7927;20424;6781;18740;145;552;5857;15891;6002;16443
270320;202206;6135;17086;5245;15435;256;901;3932;11112;4188;12013
270330;202206;4839;13930;4262;13088;203;898;3518;10605;3721;11503
270340;202206;1897;4582;1605;4186;76;146;1359;3543;1435;3689
270350;202206;2150;4568;1747;4105;122;288;1311;3079;1433;3367
270360;202206;3517;7308;3167;6914;43;135;3032;6557;3075;6692
270370;202206;1565;4478;1419;4221;33;164;1215;3553;1248;3717
270375;202206;4008;8020;3433;7394;14;46;3295;7057;3309;7103
270380;202206;6376;15625;5432;14477;585;1386;4023;10996;4608;12382
270390;202206;1378;3172;1096;2842;13;67;926;2377;939;2444
270400;202206;7649;17963;6425;16211;209;539;5210;12883;5419;13422
270410;202206;5362;14202;4665;13166;129;465;3991;11151;4120;11616
270420;202206;7137;18300;6478;17381;247;953;5622;14633;5869;15586
270430;202206;164095;360894;128879;316707;19473;49068;72688;178660;92161;227728
270440;202206;5241;13205;4566;12364;125;414;4027;10816;4152;11230
270450;202206;8937;21189;7899;19941;328;811;6725;17143;7053;17954
270460;202206;4401;8940;3747;8150;189;321;3337;7313;3526;7634
270470;202206;13109;33231;11402;30865;575;1765;9165;24537;9740;26302
270480;202206;3432;8229;2891;7480;159;481;2378;6007;2537;6488
270490;202206;1051;2657;910;2487;37;127;757;2022;794;2149
270500;202206;5630;15520;5013;14511;215;801;4132;11685;4347;12486
270510;202206;7013;16192;5877;14791;330;1005;4690;11350;5020;12355
270520;202206;4658;12074;3722;10609;717;2116;1764;5084;2481;7200
270530;202206;1489;4009;1265;3655;65;163;883;2584;948;2747
270540;202206;2559;6471;2152;5948;71;247;1839;5019;1910;5266
270550;202206;7649;18078;6048;16312;534;1384;4573;12517;5107;13901
270560;202206;3375;7997;2811;7247;161;492;2212;5529;2373;6021
270570;202206;5835;13423;5065;12351;436;1057;4022;9648;4458;10705
270580;202206;2694;6828;2437;6480;120;325;2100;5551;2220;5876
270590;202206;1680;4793;1546;4611;15;79;1465;4349;1480;4428
270600;202206;3195;8901;2892;8449;66;267;2571;7419;2637;7686
270610;202206;4193;10102;3673;9429;75;214;3308;8393;3383;8607
270620;202206;1407;3912;1287;3704;29;113;1113;3112;1142;3225
270630;202206;20404;45627;17588;41838;762;2142;14953;34777;15715;36919
270640;202206;6253;16264;5400;14957;166;627;4546;12331;4712;12958
270642;202206;2872;8469;2527;7944;170;657;1934;5940;2104;6597
270644;202206;4411;10016;3674;9086;234;550;2973;7322;3207;7872
270650;202206;3994;10061;3490;9408;234;769;2882;7633;3116;8402
270660;202206;2209;5222;1899;4804;67;204;1506;3677;1573;3881
270670;202206;21202;42619;17990;38773;463;1138;15735;32991;16198;34129
270680;202206;7216;14090;6521;13331;466;548;5784;12258;6250;12806
270690;202206;11465;25743;9572;23339;323;896;7891;18871;8214;19767
270700;202206;629;1734;549;1606;61;179;380;1098;441;1277
270710;202206;6423;17561;5634;16367;345;1130;4462;12785;4807;13915
270720;202206;4360;11031;3882;10260;90;327;3472;8985;3562;9312
270730;202206;9403;18902;8148;17583;1004;1237;6194;14790;7198;16027
270740;202206;2531;6416;2219;6057;85;266;1857;5021;1942;5287
270750;202206;6484;15466;5696;14481;104;400;5097;12760;5201;13160
270760;202206;3758;9649;3160;8837;56;253;2677;7367;2733;7620
270770;202206;25386;58813;20656;52921;3139;7604;12988;34005;16127;41609
270780;202206;2234;5217;2059;4995;50;171;1873;4466;1923;4637
270790;202206;1971;4773;1669;4371;135;353;1301;3376;1436;3729
270800;202206;13460;31960;12139;30136;523;1407;10272;25254;10795;26661
270810;202206;3866;9772;3069;8561;175;608;2284;6166;2459;6774
270820;202206;1838;5098;1566;4676;52;229;1274;3741;1326;3970
270830;202206;6050;13342;4942;12017;160;543;4118;9731;4278;10274
270840;202206;9519;26192;8310;24399;243;1061;7077;20194;7320;21255
270850;202206;10107;21749;8905;20366;505;1389;7726;17316;8231;18705
270860;202206;16591;34166;13268;30439;672;1574;10834;24482;11506;26056
270870;202206;2542;6706;2067;5924;206;537;1375;4017;1581;4554
270880;202206;8891;24945;7931;23502;217;941;6607;19074;6824;20015
270890;202206;3777;9512;3192;8690;336;910;2037;5512;2373;6422
270895;202206;4345;10643;3909;10103;65;315;3545;8916;3610;9231
270900;202206;1929;4618;1473;3902;24;85;1187;3066;1211;3151
270910;202206;4680;12436;4051;11509;143;433;3414;9575;3557;10008
270915;202206;10832;28332;8778;25118;740;2519;6112;16820;6852;19339
270920;202206;6987;17868;6209;16791;77;403;5478;14426;5555;14829
270930;202206;20561;43545;16097;38437;1982;3997;11296;28378;13278;32375
270940;202206;7105;17416;5958;16086;195;864;4847;12610;5042;13474
280010;202206;688;1856;535;1543;22;92;379;1001;401;1093
280020;202206;5868;13355;4947;11961;342;859;3764;8830;4106;9689
280030;202206;102545;214887;84496;190336;13881;31067;48467;108236;62348;139303
280040;202206;3548;8610;3099;7978;233;686;2301;5711;2534;6397
280050;202206;4804;12636;4028;11413;823;2320;2064;5862;2887;8182
280060;202206;7953;18251;6439;16090;976;2619;3767;9328;4743;11947
280067;202206;8364;18184;7147;16374;479;887;5303;12017;5782;12904
280070;202206;2000;5722;1841;5481;118;366;1533;4524;1651;4890
280100;202206;4822;11361;4069;10226;494;1111;2649;6858;3143;7969
280110;202206;1831;4015;1571;3650;22;71;1443;3272;1465;3343
280120;202206;8987;22813;7946;21205;926;2244;5750;15564;6676;17808
280130;202206;10345;22107;9006;20306;518;1242;7275;16209;7793;17451
280140;202206;7018;14333;6227;13262;588;1043;4787;10412;5375;11455
280150;202206;4649;10892;4024;10030;480;1069;2908;7273;3388;8342
280160;202206;1485;3738;1261;3386;142;410;860;2209;1002;2619
280170;202206;6404;14395;5749;13584;214;558;4880;11324;5094;11882
280190;202206;1709;3190;1528;2960;44;107;1372;2590;1416;2697
280200;202206;1452;3553;1195;3194;83;247;874;2259;957;2506
280210;202206;20170;44728;17542;41094;1850;4303;11903;27303;13753;31606
280220;202206;1932;4690;1635;4304;85;216;1306;3456;1391;3672
280230;202206;4887;11346;3994;10024;281;596;2772;6951;3053;7547
280240;202206;3757;9142;3321;8502;40;197;2895;7185;2935;7382
280250;202206;1097;2302;922;2054;60;158;715;1525;775;1683
280260;202206;2757;5709;2428;5306;43;107;2237;4859;2280;4966
280270;202206;2768;6874;2427;6383;150;427;2031;5258;2181;5685
280280;202206;4433;12338;3926;11603;505;1263;2751;8402;3256;9665
280290;202206;23764;54310;20533;49881;1763;4364;13911;33811;15674;38175
280300;202206;14928;30484;13046;28456;1582;2069;9576;22898;11158;24967
280310;202206;1557;3763;1294;3350;41;132;1008;2521;1049;2653
280320;202206;10219;24846;8823;22793;986;2500;6128;15527;7114;18027
280330;202206;5323;12170;4437;10934;314;709;3287;8016;3601;8725
280340;202206;6201;11934;5184;10809;263;402;4493;9484;4756;9886
280350;202206;34022;67913;30078;62798;971;2444;25519;51438;26490;53882
280360;202206;6378;16536;5576;15315;629;1856;3542;9657;4171;11513
280370;202206;2691;5721;2163;4861;119;210;1670;3707;1789;3917
280380;202206;1177;2843;988;2594;82;171;699;1867;781;2038
280390;202206;4645;9748;3930;8684;209;423;3234;7028;3443;7451
280400;202206;4778;10457;4170;9683;497;979;2986;7048;3483;8027
280410;202206;3125;7651;2620;6884;235;634;1695;4266;1930;4900
280420;202206;5035;11914;4552;11317;86;247;4178;10315;4264;10562
280430;202206;2640;5590;2334;5196;70;186;2005;4312;2075;4498
280440;202206;4957;11869;4372;11014;162;525;3735;9114;3897;9639
280445;202206;2607;6306;2324;5847;44;150;1830;4400;1874;4550
280450;202206;11339;25663;9811;23592;2402;5652;4666;11718;7068;17370
280460;202206;8298;17480;7524;16457;416;860;6438;13893;6854;14753
280470;202206;1912;4977;1610;4417;110;313;1164;3108;1274;3421
280480;202206;55484;119535;48224;109683;4492;10683;34604;76258;39096;86941
280490;202206;4088;11046;3436;9932;137;548;2588;7147;2725;7695
280500;202206;1258;2589;1045;2325;25;73;872;1916;897;1989
280510;202206;3609;7035;3155;6436;88;211;2727;5355;2815;5566
280520;202206;2122;4601;1844;4222;136;256;1430;3239;1566;3495
280530;202206;2657;6298;2315;5837;138;336;1819;4560;1957;4896
280540;202206;9726;24239;8753;22880;356;1004;7526;19485;7882;20489
280550;202206;7799;16399;6514;14611;131;467;5549;11911;5680;12378
280560;202206;8677;21119;8120;20325;124;437;7328;17981;7452;18418
280570;202206;7452;16368;6063;14696;295;740;4640;11128;4935;11868
280580;202206;6666;15473;5842;14325;439;966;4608;11195;5047;12161
280590;202206;3196;6889;2717;6329;147;424;2095;4623;2242;5047
280600;202206;4624;10613;4080;9843;176;437;3123;7382;3299;7819
280610;202206;3210;6717;2855;6269;122;294;2450;5210;2572;5504
280620;202206;6925;14768;5924;13506;530;901;4280;10183;4810;11084
280630;202206;4510;11070;4132;10578;230;594;3373;8630;3603;9224
280640;202206;2846;6593;2483;6183;156;305;2137;5422;2293;5727
280650;202206;1377;3384;1142;3043;103;284;809;2081;912;2365
280660;202206;4306;8531;3724;7869;169;280;3215;6790;3384;7070
280670;202206;23080;49327;19927;45286;2139;4723;14265;32280;16404;37003
280680;202206;3335;7226;2870;6569;319;572;1908;4564;2227;5136
280690;202206;1147;2509;963;2275;46;127;801;1822;847;1949
280700;202206;1349;2989;1145;2702;42;111;921;2118;963;2229
280710;202206;17625;35824;14947;32808;1094;1658;12525;28089;13619;29747
280720;202206;3031;6283;2488;5653;75;183;1958;4517;2033;4700
280730;202206;1180;2858;1008;2594;84;236;724;1784;808;2020
280740;202206;19605;38439;16979;34725;958;2132;13601;26650;14559;28782
280750;202206;3942;10246;3395;9317;227;656;2449;6587;2676;7243
280760;202206;8020;18370;6874;16806;729;1556;4683;11678;5412;13234
290010;202206;3627;6953;2405;5131;13;41;2056;4179;2069;4220
290020;202206;7280;15165;6677;14439;570;876;5559;12355;6129;13231
290030;202206;5420;11057;4432;9975;242;441;3681;8449;3923;8890
290035;202206;6154;11861;5032;10440;303;505;3861;8213;4164;8718
290040;202206;6076;11561;5193;10520;437;576;4173;8783;4610;9359
290050;202206;2328;6991;1965;6255;129;440;1334;4147;1463;4587
290060;202206;1709;3506;1243;2863;171;378;839;1896;1010;2274
290070;202206;47572;93147;41149;85290;2400;4839;32708;66366;35108;71205
290080;202206;6993;17545;6122;16289;611;1602;4472;11892;5083;13494
290090;202206;2538;4378;1827;3617;17;48;1686;3292;1703;3340
290100;202206;11640;27181;9425;24043;1588;3718;5050;13488;6638;17206
290110;202206;6405;15011;5587;13755;711;1607;3553;8796;4264;10403
290115;202206;4576;12475;3891;11303;311;891;3014;8760;3325;9651
290120;202206;7371;16827;6142;15133;177;565;5153;12403;5330;12968
290130;202206;5280;11695;4109;10164;202;473;3083;7717;3285;8190
290135;202206;5220;11070;4252;9510;190;443;3396;7263;3586;7706
290140;202206;5163;12216;3992;10692;157;466;3322;8886;3479;9352
290150;202206;3508;7161;3039;6628;140;351;2536;5387;2676;5738
290160;202206;4136;8303;3671;7675;183;341;3115;6436;3298;6777
290170;202206;4227;9058;3761;8560;122;263;3400;7740;3522;8003
290180;202206;3487;8605;2897;7683;77;283;2444;6342;2521;6625
290190;202206;5674;12676;5049;11878;155;417;4221;9895;4376;10312
290195;202206;3006;6404;2371;5613;75;223;2039;4745;2114;4968
290200;202206;4716;12136;3723;10461;174;488;2762;7705;2936;8193
290205;202206;4076;9460;3603;8781;152;445;2922;6879;3074;7324
290210;202206;16245;38208;14341;35362;1333;2677;11062;27746;12395;30423
290220;202206;3664;7463;3219;6926;95;229;2791;5870;2886;6099
290225;202206;3771;6967;2911;6085;61;156;2659;5470;2720;5626
290230;202206;3467;7217;3190;6899;103;163;2782;6084;2885;6247
290240;202206;4856;10137;3934;9034;80;260;3440;7764;3520;8024
290250;202206;4576;11856;3736;10641;133;362;3073;8866;3206;9228
290260;202206;6314;13892;5345;12507;297;740;4446;10161;4743;10901
290265;202206;3887;10611;3141;9252;252;786;2139;6204;2391;6990
290270;202206;12228;38354;11233;36687;680;2573;8853;28727;9533;31300
290280;202206;7051;19688;6050;17732;442;1456;4234;12098;4676;13554
290290;202206;11178;30482;8952;26507;873;2768;5892;17117;6765;19885
290300;202206;4919;12063;3570;9606;215;642;2517;6540;2732;7182
290310;202206;2498;4626;2031;4091;24;80;1871;3677;1895;3757
290320;202206;31678;74570;25610;65784;4567;11269;14425;37761;18992;49030
290323;202206;4423;10910;3764;9876;103;291;2958;7720;3061;8011
290327;202206;4864;12658;4123;11323;377;945;2840;7720;3217;8665
290330;202206;2887;5059;2325;4459;26;42;2151;4135;2177;4177
290340;202206;7182;15569;5558;13663;559;1226;4220;10516;4779;11742
290350;202206;5365;14042;4447;12471;276;807;3168;8823;3444;9630
290360;202206;6309;13717;5535;12725;106;269;4900;11127;5006;11396
290370;202206;5659;12774;4136;10778;150;422;3006;7757;3156;8179
290380;202206;6678;15428;5539;13918;139;317;4794;12039;4933;12356
290390;202206;17674;45663;14558;40707;1460;4054;9940;27764;11400;31818
290395;202206;3418;8747;2714;7576;71;292;2107;5738;2178;6030
290400;202206;4399;10944;3516;9535;168;510;2659;7019;2827;7529
290405;202206;5187;13879;4383;12529;361;1056;2996;8658;3357;9714
290410;202206;6334;15854;4812;13512;173;663;3629;9898;3802;10561
290420;202206;3632;8930;2973;7928;99;275;2355;6219;2454;6494
290430;202206;4155;9411;3461;8389;157;494;2724;6269;2881;6763
290440;202206;3315;7562;2359;6075;162;350;1644;4313;1806;4663
290450;202206;4550;9477;3623;8184;116;279;3083;6737;3199;7016
290460;202206;14417;37871;12033;33553;2387;6735;5211;14451;7598;21186
290470;202206;5592;11810;4205;9952;443;1046;2666;6258;3109;7304
290475;202206;7551;19892;6295;17804;97;466;5268;14601;5365;15067
290480;202206;2127;4835;1742;4287;65;229;1320;3039;1385;3268
290485;202206;5255;13996;4584;13052;163;622;3809;10663;3972;11285
290490;202206;10926;22674;9871;21286;390;903;8239;17571;8629;18474
290500;202206;4779;13278;3719;11149;624;1955;1556;4527;2180;6482
290510;202206;4214;9136;3537;8278;83;233;3162;7320;3245;7553
290515;202206;4001;10317;3463;9565;38;118;3136;8740;3174;8858
290520;202206;14018;36211;10912;30399;618;1949;7136;18860;7754;20809
290530;202206;5503;14784;4619;13381;109;452;3884;11104;3993;11556
290540;202206;4366;10072;3957;9627;66;174;3678;8929;3744;9103
290550;202206;4843;11507;4195;10754;38;111;3835;9911;3873;10022
290560;202206;7301;17454;5594;15006;421;1354;3838;9838;4259;11192
290570;202206;53622;123203;47431;115554;2378;6205;38942;93311;41320;99516
290580;202206;9821;24754;8483;22890;885;2017;6143;17253;7028;19270
290590;202206;7738;22433;6423;20140;176;650;5235;16532;5411;17182
290600;202206;21383;55646;18450;50991;972;2720;14597;40086;15569;42806
290610;202206;2825;8217;2210;7018;114;393;1528;4800;1642;5193
290620;202206;6882;18518;5926;16969;369;958;4794;13777;5163;14735
290630;202206;11436;23968;9303;21306;721;1574;7256;16665;7977;18239
290640;202206;3157;7289;2424;6267;241;475;1635;4508;1876;4983
290650;202206;17707;37628;15910;35645;1346;3087;13183;29351;14529;32438
290660;202206;4300;10288;3451;8955;147;426;2532;6511;2679;6937
290670;202206;9432;20388;8176;18578;271;730;7010;15631;7281;16361
290680;202206;12685;31700;10446;28479;259;1085;8757;23352;9016;24437
290682;202206;6181;13353;5370;12307;394;598;4097;10045;4491;10643
290685;202206;4048;8431;2939;6884;513;990;1531;3923;2044;4913
290687;202206;8449;19781;6988;17499;884;2037;4557;11614;5441;13651
290689;202206;3217;8284;2411;6868;258;789;1570;4463;1828;5252
290690;202206;6389;15295;5215;13686;279;842;3931;10091;4210;10933
290700;202206;3628;7668;3241;7202;49;167;2967;6446;3016;6613
290710;202206;10209;24775;8637;22654;254;772;7442;19363;7696;20135
290720;202206;22824;54870;20479;51373;1160;3020;16422;40297;17582;43317
290730;202206;8112;17649;6866;16193;372;692;5239;12563;5611;13255
290740;202206;1243;2942;946;2473;13;31;837;2155;850;2186
290750;202206;14979;31873;12928;28763;461;1225;10505;22162;10966;23387
290755;202206;2288;6061;1832;5267;125;337;1240;3579;1365;3916
290760;202206;4230;11514;3460;10138;237;592;2401;7181;2638;7773
290770;202206;3146;8459;2879;8138;107;235;2452;7072;2559;7307
290780;202206;8926;20835;7605;19080;344;700;5847;14900;6191;15600
290790;202206;5877;14299;5074;13159;262;647;4185;10895;4447;11542
290800;202206;8123;14905;5833;12294;335;552;4420;9441;4755;9993
290810;202206;6450;14599;5215;12853;213;488;4000;9980;4213;10468
290820;202206;6162;14354;5431;13293;399;811;3819;9403;4218;10214
290830;202206;4939;11102;4330;10175;70;242;3614;8074;3684;8316
290840;202206;20479;49615;17359;44899;1904;4150;11876;31801;13780;35951
290850;202206;9755;18741;8551;17450;577;852;7073;14613;7650;15465
290860;202206;7232;18179;6261;17063;327;798;5254;14592;5581;15390
290870;202206;5453;13850;4126;11400;296;785;2773;7584;3069;8369
290880;202206;1623;3642;1297;3230;189;437;750;2012;939;2449
290890;202206;10773;19895;9519;18512;331;531;8607;16743;8938;17274
290900;202206;2690;6652;2059;5566;151;399;1283;3400;1434;3799
290910;202206;5911;12787;4497;10704;50;136;3892;9147;3942;9283
290920;202206;6328;13819;5547;12891;202;270;4880;11868;5082;12138
290930;202206;8348;21845;6662;18947;257;960;5083;14000;5340;14960
290940;202206;3958;10476;3280;9461;166;576;2601;7400;2767;7976
290950;202206;1623;3790;1313;3340;107;276;883;2253;990;2529
290960;202206;6865;15518;6092;14585;287;600;5099;12170;5386;12770
290970;202206;3545;10022;2874;8785;119;427;2210;6679;2329;7106
290980;202206;15707;34004;13535;30847;792;1962;9505;20558;10297;22520
290990;202206;11034;26809;9771;24874;311;1122;8278;20262;8589;21384
291000;202206;3792;8939;2894;7833;131;365;2348;6415;2479;6780
291005;202206;18973;42369;16710;39564;838;2069;14039;32648;14877;34717
291010;202206;3401;9837;2711;8367;153;526;1773;5301;1926;5827
291020;202206;1466;3355;1184;2884;31;94;864;1959;895;2053
291030;202206;2888;6393;2091;5114;163;356;1352;3193;1515;3549
291040;202206;6069;15266;4945;13689;218;702;3869;10692;4087;11394
291050;202206;11959;25193;10502;23269;1207;2539;7737;16939;8944;19478
291060;202206;9537;22120;8377;20635;715;1667;6470;15865;7185;17532
291070;202206;20136;46746;16949;41850;406;1322;14394;34664;14800;35986
291072;202206;32026;71974;24285;59793;3371;8667;13701;32373;17072;41040
291075;202206;6216;14158;5574;13169;97;258;4694;10713;4791;10971
291077;202206;1897;4653;1468;3921;70;143;1019;2737;1089;2880
291080;202206;145880;322215;117521;284414;26457;61174;52271;129685;78728;190859
291085;202206;6248;14755;5053;12932;178;506;4173;10519;4351;11025
291090;202206;2474;4240;1829;3531;46;95;1570;2960;1616;3055
291100;202206;3859;7432;2734;6121;116;246;2152;4773;2268;5019
291110;202206;6730;18866;5632;17017;285;1101;4334;12669;4619;13770
291120;202206;9486;20302;8113;18615;372;933;6509;14731;6881;15664
291125;202206;2668;4273;2021;3554;67;105;1741;3023;1808;3128
291130;202206;3619;9585;2710;7880;69;318;2082;5783;2151;6101
291140;202206;5548;13618;4046;11012;584;1374;2435;6616;3019;7990
291150;202206;3129;5797;2456;5061;6;15;2336;4782;2342;4797
291160;202206;5804;14742;4804;13323;500;1414;3107;8482;3607;9896
291165;202206;2374;6180;1719;4924;29;129;1197;3291;1226;3420
291170;202206;25014;58366;20878;51709;1355;3415;13957;33217;15312;36632
291180;202206;8642;16245;6694;13737;197;469;5850;11687;6047;12156
291185;202206;3942;8872;3500;8221;185;426;2774;6450;2959;6876
291190;202206;8556;19421;7049;17550;214;613;5726;14222;5940;14835
291200;202206;3126;8006;2297;6472;80;297;1519;4017;1599;4314
291210;202206;8662;16428;6423;13892;375;681;4877;10599;5252;11280
291220;202206;5434;13203;4845;12362;379;945;3524;8859;3903;9804
291230;202206;5545;10224;4329;8902;75;115;3982;8185;4057;8300
291240;202206;4658;11239;3926;10044;73;229;3365;8464;3438;8693
291250;202206;3691;10234;2861;8750;201;601;1797;5539;1998;6140
291260;202206;1678;3573;1370;3179;42;105;1137;2635;1179;2740
291270;202206;6417;14677;5019;12740;449;1018;3624;9344;4073;10362
291280;202206;3267;7208;2431;5997;165;373;1686;4004;1851;4377
291290;202206;6405;15771;4868;13420;443;1264;3247;8775;3690;10039
291300;202206;4441;10905;3523;9428;132;392;2728;7080;2860;7472
291310;202206;5787;14337;4932;12862;134;396;4205;10787;4339;11183
291320;202206;7662;18795;6006;15994;1219;3043;3157;8699;4376;11742
291330;202206;2161;5075;1783;4458;68;185;1377;3342;1445;3527
291340;202206;4882;11545;3916;9981;198;442;2727;6883;2925;7325
291345;202206;3314;8858;2960;8343;139;430;2440;6876;2579;7306
291350;202206;8306;17918;6491;15730;108;273;5631;13586;5739;13859
291360;202206;48363;96809;38726;85632;4359;9132;26171;58866;30530;67998
291370;202206;9407;23422;8278;21725;569;1703;6288;15936;6857;17639
291380;202206;5035;10690;4491;9974;163;406;3896;8504;4059;8910
291390;202206;15089;29440;11554;25579;491;1072;9737;21303;10228;22375
291400;202206;18626;39857;15683;35651;1526;3210;11041;25296;12567;28506
291410;202206;3386;8287;2647;7056;56;181;1979;5153;2035;5334
291420;202206;2159;4850;1672;4247;25;95;1479;3712;1504;3807
291430;202206;2997;7783;2560;7062;95;362;2026;5392;2121;5754
291440;202206;7409;19312;6357;17677;433;1201;4758;13399;5191;14600
291450;202206;12287;24371;10148;21933;173;277;9191;20015;9364;20292
291460;202206;19033;44693;16594;41185;896;2447;12750;30809;13646;33256
291465;202206;10169;23177;8021;20722;204;779;6927;17629;7131;18408
291470;202206;22301;43275;18950;39478;1093;2118;14806;30889;15899;33007
291480;202206;54505;108176;41871;91668;3941;8796;26501;55626;30442;64422
291490;202206;7660;16069;6782;15095;197;463;6217;13727;6414;14190
291500;202206;6196;12761;5203;11502;119;289;4776;10537;4895;10826
291510;202206;5271;11193;3966;9547;63;245;3436;8107;3499;8352
291520;202206;5243;10910;4004;9338;341;725;3074;7167;3415;7892
291530;202206;2724;5689;1992;4766;210;467;1370;3343;1580;3810
291535;202206;4198;10876;3574;9797;180;470;2847;7850;3027;8320
291540;202206;2479;5075;1725;4171;69;173;1443;3461;1512;3634
291550;202206;7344;14370;5703;12372;513;966;4078;8818;4591;9784
291560;202206;20457;45801;15099;38858;2470;5959;8202;21846;10672;27805
291570;202206;2725;5723;2087;4996;183;276;1694;4246;1877;4522
291580;202206;7438;17251;5858;15201;306;907;4424;11120;4730;12027
291590;202206;2839;5845;2507;5465;80;211;2243;4808;2323;5019
291600;202206;6445;13542;4974;11382;434;1052;3430;7604;3864;8656
291610;202206;7517;15825;6709;14944;341;592;5645;12909;5986;13501
291620;202206;3501;7188;2662;6279;190;389;2036;4905;2226;5294
291630;202206;4089;7810;3125;6629;362;590;2365;5121;2727;5711
291640;202206;20038;43499;15457;37156;1664;3970;8987;20887;10651;24857
291650;202206;11628;24390;10317;22858;924;1324;8342;19251;9266;20575
291660;202206;2241;5167;1628;4250;108;386;1101;2675;1209;3061
291670;202206;2261;5608;1857;5022;182;434;1297;3575;1479;4009
291680;202206;4765;10535;3871;9307;431;1010;2519;6166;2950;7176
291685;202206;5371;12269;4277;10779;193;408;3328;8429;3521;8837
291690;202206;5075;9538;3522;7446;237;446;2894;6009;3131;6455
291700;202206;10656;26725;9348;24609;331;1119;7910;20227;8241;21346
291710;202206;6285;13229;4800;11228;331;792;3598;8174;3929;8966
291720;202206;4981;13995;4106;12322;857;2569;2143;6469;3000;9038
291730;202206;8403;17329;7234;15840;394;828;6089;13277;6483;14105
291733;202206;3297;7694;2776;7016;122;237;2052;5410;2174;5647
291735;202206;3099;7953;2415;6764;68;176;1768;4921;1836;5097
291740;202206;4460;10846;3153;8444;122;256;2178;5794;2300;6050
291750;202206;24535;52747;20237;46530;2694;5380;13140;30881;15834;36261
291760;202206;12773;33016;10051;28880;3022;9870;2904;7998;5926;17868
291770;202206;8626;21051;7219;18676;343;1124;5559;13660;5902;14784
291780;202206;5823;14199;5216;13393;116;375;4535;11431;4651;11806
291790;202206;3462;8008;3150;7626;318;606;2412;5991;2730;6597
291800;202206;39221;86816;30889;75260;4151;10139;18339;43520;22490;53659
291810;202206;12334;26448;10440;24176;495;970;8649;20248;9144;21218
291820;202206;4479;10695;3895;9947;128;348;3161;8026;3289;8374
291830;202206;5414;11135;4403;9811;242;401;3526;7887;3768;8288
291835;202206;7423;20594;5946;17939;573;1740;3996;12170;4569;13910
291840;202206;55997;140393;48753;129634;4655;13038;35505;93367;40160;106405
291845;202206;3770;7630;3130;6862;160;296;2649;5895;2809;6191
291850;202206;5016;12450;4192;11162;135;335;3534;9418;3669;9753
291855;202206;2712;4609;2167;4013;27;54;2034;3743;2061;3797
291860;202206;2450;6137;1669;4660;40;120;1114;3010;1154;3130
291870;202206;1442;3403;979;2609;34;109;704;1829;738;1938
291875;202206;3311;9379;2833;8405;66;287;2103;5988;2169;6275
291880;202206;6296;16131;5414;14765;332;792;4058;11221;4390;12013
291890;202206;1939;3670;1289;2917;206;439;763;1738;969;2177
291900;202206;1540;3345;1179;2813;31;86;932;2147;963;2233
291905;202206;2695;6438;2202;5685;107;329;1692;4189;1799;4518
291910;202206;4112;8217;3547;7556;90;200;3173;6766;3263;6966
291915;202206;8328;21874;6732;19227;245;716;5030;14547;5275;15263
291920;202206;36136;82449;31276;76169;1815;5424;24596;57667;26411;63091
291930;202206;3052;7046;2603;6439;257;597;1932;4810;2189;5407
291940;202206;4345;10242;2917;7937;259;635;1732;4679;1991;5314
291950;202206;10482;29850;8735;26655;446;1416;5917;17890;6363;19306
291955;202206;20223;45752;18123;43121;1175;2988;14952;35215;16127;38203
291960;202206;4327;9032;3664;8193;284;459;2909;6697;3193;7156
291970;202206;5601;12151;4725;11087;160;458;3794;8696;3954;9154
291980;202206;11588;29829;9370;26232;836;2158;6424;18147;7260;20305
291990;202206;2631;6171;2172;5615;25;87;2001;5140;2026;5227
291992;202206;4962;10579;4135;9565;305;587;3324;7725;3629;8312
291995;202206;2556;6117;2097;5422;77;271;1698;4224;1775;4495
292000;202206;3015;6494;2473;5849;68;217;2064;4797;2132;5014
292010;202206;6636;14000;5398;12246;90;338;4596;10095;4686;10433
292020;202206;5463;13811;4615;12412;160;567;3745;9705;3905;10272
292030;202206;2372;6355;2065;5827;134;405;1346;3678;1480;4083
292040;202206;5399;12002;4283;10421;198;462;3461;8393;3659;8855
292045;202206;5149;10911;4014;9305;28;87;3727;8634;3755;8721
292050;202206;7436;19020;6021;16650;293;945;4050;10922;4343;11867
292060;202206;14211;28638;13180;27386;397;754;11829;24168;12226;24922
292070;202206;7050;15832;6153;14784;395;868;5246;12625;5641;13493
292080;202206;4236;8469;3526;7580;41;135;3280;6955;3321;7090
292090;202206;5089;10209;3614;8409;196;504;2876;6627;3072;7131
292100;202206;14801;32285;12658;29642;1966;4414;7698;18481;9664;22895
292105;202206;3915;9202;3396;8510;50;189;2863;7108;2913;7297
292110;202206;7346;15534;5293;12650;733;1828;3327;7711;4060;9539
292120;202206;8301;19129;6840;16738;629;1357;4858;11830;5487;13187
292130;202206;3937;8661;3236;7787;189;512;2452;5805;2641;6317
292140;202206;6648;13278;5645;11906;202;383;4951;10303;5153;10686
292145;202206;2982;7388;2491;6591;122;254;1941;5188;2063;5442
292150;202206;17756;41715;15279;37847;433;1227;12832;31062;13265;32289
292160;202206;3432;7478;2626;6471;36;112;2035;5352;2071;5464
292170;202206;10242;24749;8566;22117;445;1365;6603;16512;7048;17877
292180;202206;3314;8457;2465;6916;186;523;1547;4224;1733;4747
292190;202206;3394;8131;2856;7360;292;766;1953;5087;2245;5853
292200;202206;10741;24242;8118;20625;1572;3976;4069;10625;5641;14601
292205;202206;4396;11012;3791;10129;107;327;3249;8687;3356;9014
292210;202206;7749;15618;6382;13937;84;299;5900;12667;5984;12966
292220;202206;2616;5491;2252;4961;112;223;1749;3729;1861;3952
292225;202206;3638;9742;3176;9072;61;279;2790;7818;2851;8097
292230;202206;10052;21972;8883;20509;277;784;7502;16926;7779;17710
292240;202206;5596;14837;4843;13471;291;784;3492;9671;3783;10455
292250;202206;6872;16096;6108;15027;280;772;4851;11655;5131;12427
292260;202206;3716;9115;3272;8559;79;252;2860;7437;2939;7689
292265;202206;4177;10072;3424;8926;68;286;2869;7253;2937;7539
292270;202206;5478;10616;4428;9389;197;310;3662;7787;3859;8097
292273;202206;3281;6430;2599;5601;147;230;1864;4260;2011;4490
292275;202206;2069;4769;1678;4263;55;153;1358;3407;1413;3560
292280;202206;3165;6608;2520;5866;126;214;2111;5055;2237;5269
292285;202206;2987;6444;2358;5622;88;167;1934;4641;2022;4808
292290;202206;8659;20285;6865;17809;194;527;5710;14685;5904;15212
292300;202206;12097;27774;9534;24362;1157;2974;6215;16040;7372;19014
292303;202206;3643;8933;3148;8178;98;215;2723;7068;2821;7283
292305;202206;2606;6497;2368;6177;57;198;2110;5429;2167;5627
292310;202206;8125;17961;7013;16607;95;360;6238;14403;6333;14763
292320;202206;6645;16764;5272;14392;182;612;4048;10763;4230;11375
292330;202206;3459;6375;2859;5715;199;297;2238;4657;2437;4954
292335;202206;5704;13599;5047;12652;215;494;4278;10771;4493;11265
292340;202206;6070;16056;4964;13985;273;729;3538;9903;3811;10632
292350;202206;3031;7367;2538;6718;135;386;2082;5474;2217;5860
292360;202206;5695;13967;4721;12397;236;661;3451;8886;3687;9547
292370;202206;12709;26233;10923;23912;98;352;10275;22119;10373;22471
292380;202206;7826;20162;6960;18673;419;1150;5394;14257;5813;15407
292390;202206;5730;9455;4391;7940;69;124;4058;7238;4127;7362
292400;202206;25898;67258;22308;61856;2087;5769;15574;43209;17661;48978
292405;202206;5332;11619;4450;10296;141;338;3582;8276;3723;8614
292410;202206;2765;5538;2366;5047;113;190;2062;4432;2175;4622
292420;202206;5474;11496;4920;10754;74;258;4494;9510;4568;9768
292430;202206;5596;15442;4240;12972;323;1102;2840;8550;3163;9652
292440;202206;10103;28502;9239;27269;130;638;8306;24282;8436;24920
292450;202206;4657;12092;3544;10011;104;342;2739;7595;2843;7937
292460;202206;6803;15175;5713;13535;162;445;4839;11150;5001;11595
292465;202206;3013;7012;2544;6432;158;308;1673;4588;1831;4896
292467;202206;2383;5851;2106;5488;308;635;1441;4032;1749;4667
292470;202206;3305;7938;2495;6690;150;361;1774;4772;1924;5133
292480;202206;7631;15340;6275;13734;172;356;5661;12324;5833;12680
292490;202206;3137;6299;2639;5642;89;165;2156;4592;2245;4757
292500;202206;8279;19453;6602;16806;377;945;4758;11841;5135;12786
292510;202206;16138;38159;12637;32851;794;2186;9096;23308;9890;25494
292520;202206;8517;19506;7495;18026;338;949;6149;14428;6487;15377
292525;202206;7613;15576;6254;14036;112;261;5640;12661;5752;12922
292530;202206;37271;89594;29811;77898;5636;15377;15656;40120;21292;55497
292540;202206;5228;8669;4171;7557;113;181;3830;6942;3943;7123
292550;202206;9425;23008;7279;20445;552;1440;5160;15269;5712;16709
292560;202206;5106;11837;4266;10685;157;467;3234;7850;3391;8317
292570;202206;4290;10209;3571;8986;60;216;3030;7351;3090;7567
292575;202206;7813;20712;7117;19785;740;1949;5326;15008;6066;16957
292580;202206;8974;19889;7385;17629;251;506;6319;14913;6570;15419
292590;202206;8206;20492;6839;18088;339;1039;5499;14190;5838;15229
292593;202206;3252;7594;2605;6508;87;214;2161;5331;2248;5545
292595;202206;6341;15303;5463;14235;179;550;4694;12142;4873;12692
292600;202206;13158;31714;11324;29076;609;1424;9010;23146;9619;24570
292610;202206;5290;11876;4471;10555;163;359;3593;8359;3756;8718
292620;202206;7987;18527;6594;16859;140;327;6020;15479;6160;15806
292630;202206;10694;23200;8612;20008;892;2120;5799;13141;6691;15261
292640;202206;9206;24612;7734;22218;402;1220;5425;15601;5827;16821
292650;202206;4876;11334;4311;10599;60;203;3953;9581;4013;9784
292660;202206;12542;32087;10631;29275;670;1741;7955;22142;8625;23883
292665;202206;2342;6495;1974;6002;88;253;1576;4913;1664;5166
292670;202206;3950;10240;3069;8628;217;687;2015;5472;2232;6159
292680;202206;4571;10969;3612;9360;126;325;2780;6971;2906;7296
292690;202206;2922;7135;2013;5678;216;540;1244;3613;1460;4153
292700;202206;11837;28921;10261;26544;697;1592;7529;19540;8226;21132
292710;202206;3287;8365;3053;8076;53;163;2844;7502;2897;7665
292720;202206;10289;21935;8682;20097;448;896;6742;16032;7190;16928
292730;202206;6007;12273;5445;11460;426;657;4373;9448;4799;10105
292740;202206;417413;899837;367606;832399;41476;94938;257758;571759;299234;666697
292750;202206;7771;17583;6824;16323;219;572;5785;13723;6004;14295
292760;202206;4609;11841;3978;10777;194;589;3061;8122;3255;8711
292770;202206;8233;18902;6762;16923;836;2073;4763;12055;5599;14128
292780;202206;2452;4361;1816;3620;53;118;1517;2858;1570;2976
292790;202206;4430;8583;3349;7421;202;411;2741;6098;2943;6509
292800;202206;12741;29882;10826;26999;509;1313;8808;21628;9317;22941
292805;202206;4318;9149;3417;8035;134;326;2800;6483;2934;6809
292810;202206;14836;30949;12107;26922;608;1503;9842;20874;10450;22377
292820;202206;7955;20846;5805;17231;410;1380;4044;11746;4454;13126
292830;202206;3301;7192;2804;6610;110;243;2358;5608;2468;5851
292840;202206;11401;24908;9769;22754;186;548;8785;20033;8971;20581
292850;202206;2977;7035;2512;6400;227;542;1748;4420;1975;4962
292860;202206;20695;40201;18687;37864;517;1109;16475;32741;16992;33850
292870;202206;24837;53626;21491;49091;1439;3157;15664;34753;17103;37910
292880;202206;13147;33249;11135;30178;395;1369;8455;21956;8850;23325
292890;202206;9282;21742;8195;20236;173;591;7261;17574;7434;18165
292895;202206;3968;7288;3054;5978;226;360;2374;4677;2600;5037
292900;202206;3309;7737;2980;7279;50;198;2534;5965;2584;6163
292905;202206;5237;11969;4170;10389;117;352;3309;7993;3426;8345
292910;202206;5909;14239;5237;13363;173;457;4193;10443;4366;10900
292920;202206;11238;28118;10388;27008;274;985;9073;23100;9347;24085
292925;202206;5959;15964;4914;14008;356;944;3467;9841;3823;10785
292930;202206;7771;20597;6750;18793;837;2403;4010;11024;4847;13427
292935;202206;3065;6253;2449;5576;26;75;2229;5072;2255;5147
292937;202206;3219;7592;2752;7002;206;485;2017;5219;2223;5704
292940;202206;3463;7905;2741;6841;350;729;1782;4646;2132;5375
292950;202206;10691;25577;9313;23629;477;1165;7182;17921;7659;19086
292960;202206;6140;13589;5130;12198;172;350;4109;9705;4281;10055
292970;202206;4518;11512;3982;10765;108;344;3309;9013;3417;9357
292975;202206;4997;9994;4432;9366;127;291;4033;8472;4160;8763
292980;202206;4418;8836;3671;7808;64;188;3252;6734;3316;6922
292990;202206;13327;33619;11140;29994;414;1292;8742;22781;9156;24073
293000;202206;3158;6937;2685;6217;120;288;2102;4804;2222;5092
293010;202206;21356;49752;17310;43814;1944;5083;11367;28418;13311;33501
293015;202206;9819;27627;7699;23660;639;1962;5237;16288;5876;18250
293020;202206;11512;29679;10383;28101;164;579;9380;25294;9544;25873
293030;202206;5928;14460;4574;12408;273;596;3086;8675;3359;9271
293040;202206;5056;11794;4122;10512;103;305;3538;8944;3641;9249
293050;202206;28336;59625;24867;54676;1649;3421;18885;40795;20534;44216
293060;202206;4318;10487;3471;8938;230;605;2514;6267;2744;6872
293070;202206;33263;70025;29548;65473;1998;4542;23434;50990;25432;55532
293075;202206;4240;11740;3673;10834;85;410;3140;9190;3225;9600
293076;202206;4050;8905;3635;8420;88;162;3216;7538;3304;7700
293077;202206;7368;18488;5940;16307;763;1965;3523;10224;4286;12189
293080;202206;5342;14407;4484;12927;91;386;3678;10376;3769;10762
293090;202206;3547;9839;2729;8450;230;668;1858;5765;2088;6433
293100;202206;6641;16270;5395;14130;257;608;4217;11001;4474;11609
293105;202206;4323;12744;3698;11515;251;786;2556;7941;2807;8727
293110;202206;2860;6282;2400;5647;73;197;1986;4555;2059;4752
293120;202206;5944;13123;5395;12360;460;674;4352;10368;4812;11042
293130;202206;4156;10430;3573;9692;116;415;3097;8244;3213;8659
293135;202206;36509;80113;27067;67587;4811;12514;11645;29338;16456;41852
293140;202206;3178;5747;2800;5301;74;119;2507;4659;2581;4778
293150;202206;5878;16261;4839;14390;371;1210;3327;9699;3698;10909
293160;202206;5138;10388;4542;9730;647;834;3358;8047;4005;8881
293170;202206;6173;10766;5301;9750;111;251;4658;8373;4769;8624
293180;202206;5191;13209;4298;11649;92;350;3476;9153;3568;9503
293190;202206;18390;41105;16170;38042;135;561;14688;33862;14823;34423
293200;202206;10589;22552;8642;19606;261;624;7277;16223;7538;16847
293210;202206;5920;14143;4994;12808;385;963;3786;9685;4171;10648
293220;202206;6654;14560;4991;11943;757;1756;3042;7122;3799;8878
293230;202206;5266;11062;3954;9394;283;604;2973;7110;3256;7714
293240;202206;5315;12295;4285;10715;222;365;3154;8273;3376;8638
293245;202206;4544;11134;4099;10494;137;431;3524;8821;3661;9252
293250;202206;6758;14816;5452;13076;311;774;4278;10120;4589;10894
293260;202206;5538;12950;4525;11430;198;379;3205;8158;3403;8537
293270;202206;8840;17070;7036;15155;602;752;5592;12850;6194;13602
293280;202206;5064;12096;4404;11173;295;651;3402;8707;3697;9358
293290;202206;19466;48541;17162;45054;1554;4140;12454;32343;14008;36483
293300;202206;7569;15821;6480;14253;489;1021;4917;10592;5406;11613
293305;202206;5122;10732;4342;9764;38;101;4008;8957;4046;9058
293310;202206;2485;5808;2096;5217;37;132;1705;4124;1742;4256
293315;202206;5379;10834;4461;9551;450;633;3480;7669;3930;8302
293317;202206;3338;6918;2970;6405;293;454;2216;4846;2509;5300
293320;202206;15054;31456;13398;29650;198;509;12283;26802;12481;27311
293325;202206;2118;4781;1677;4224;213;515;1111;2812;1324;3327
293330;202206;84599;204307;70006;180539;8999;25432;40917;99273;49916;124705
293340;202206;2456;6373;1991;5565;141;425;1356;3721;1497;4146
293345;202206;4311;10442;3456;9171;391;764;2314;6657;2705;7421
293350;202206;7045;18162;6039;16935;122;372;5352;15100;5474;15472
293360;202206;18716;40310;16157;36995;445;1130;14239;32488;14684;33618
310010;202206;1124;2397;755;1915;87;243;308;715;395;958
310020;202206;3335;8332;2533;6974;459;1322;972;2513;1431;3835
310030;202206;2208;5820;1707;4960;231;716;1099;3099;1330;3815
310040;202206;945;2324;738;1977;74;245;401;944;475;1189
310050;202206;1788;4780;1522;4369;98;383;1082;2977;1180;3360
310060;202206;3712;9364;3161;8640;125;400;2456;6760;2581;7160
310070;202206;376;842;275;699;11;33;206;516;217;549
310080;202206;857;2208;626;1801;82;251;320;873;402;1124
310090;202206;5821;13235;4792;11647;204;601;3813;8960;4017;9561
310100;202206;4236;10111;3575;9091;118;410;3008;7396;3126;7806
310110;202206;5469;13352;4266;11366;613;1862;2488;6265;3101;8127
310120;202206;744;1701;491;1319;80;263;251;573;331;836
310130;202206;457;1087;389;986;25;76;304;734;329;810
310140;202206;359;937;271;813;46;163;139;376;185;539
310150;202206;7071;16594;5383;13700;488;1490;3059;7136;3547;8626
310160;202206;11116;25512;8505;21490;1240;3483;4123;9821;5363;13304
310163;202206;1299;3609;1016;3056;217;721;320;851;537;1572
310170;202206;11153;25550;9044;22404;855;2078;6404;15727;7259;17805
310180;202206;2319;5193;1696;4232;167;496;1122;2648;1289;3144
310190;202206;3166;8497;2588;7521;622;1950;580;1579;1202;3529
310200;202206;2324;6207;1747;5194;277;963;818;2263;1095;3226
310205;202206;1304;3308;1045;2909;126;371;670;1882;796;2253
310210;202206;2773;7033;2252;6114;117;326;1594;4173;1711;4499
310220;202206;1340;3433;1022;2830;80;231;661;1745;741;1976
310230;202206;2587;6505;2101;5635;213;685;1375;3418;1588;4103
310240;202206;1172;3135;995;2836;54;188;688;1855;742;2043
310250;202206;1299;2998;1074;2660;38;110;859;2051;897;2161
310260;202206;4032;9788;2744;7494;673;2175;1020;2252;1693;4427
310270;202206;3347;6998;2707;6160;93;252;2280;5144;2373;5396
310280;202206;3074;6409;2456;5579;145;392;1796;3841;1941;4233
310285;202206;2104;6140;1744;5502;163;583;1109;3430;1272;4013
310290;202206;1647;4045;1406;3648;153;497;923;2175;1076;2672
310300;202206;1877;4876;1555;4354;155;545;881;2234;1036;2779
310310;202206;376;839;252;641;41;108;137;330;178;438
310320;202206;566;1348;396;1077;15;60;237;604;252;664
310330;202206;569;1293;340;884;41;117;149;345;190;462
310340;202206;9429;22613;7450;19301;981;2421;3940;10114;4921;12535
310350;202206;15414;35354;11021;28444;1656;4696;5764;14005;7420;18701
310360;202206;669;1406;541;1248;23;62;353;784;376;846
310370;202206;1401;4125;1212;3802;229;783;394;1328;623;2111
310375;202206;976;2259;695;1861;159;445;287;741;446;1186
310380;202206;427;945;238;654;23;64;131;337;154;401
310390;202206;641;1792;514;1551;90;302;220;601;310;903
310400;202206;13830;31929;10424;26858;716;2277;6961;16974;7677;19251
310410;202206;1211;3362;705;2280;80;300;285;809;365;1109
310420;202206;5550;13536;4126;11066;506;1526;2165;5297;2671;6823
310430;202206;1980;5051;1371;3984;226;674;582;1487;808;2161
310440;202206;743;1827;525;1444;55;183;272;681;327;864
310445;202206;1542;4087;1152;3343;94;265;785;2217;879;2482
310450;202206;5294;11988;4063;10108;233;735;3130;7464;3363;8199
310460;202206;2006;5095;1538;4269;199;622;597;1450;796;2072
310470;202206;4105;8625;3186;7419;385;778;2071;4993;2456;5771
310480;202206;1139;2769;871;2332;95;315;520;1284;615;1599
310490;202206;3297;8422;2618;7327;327;1064;1482;3848;1809;4912
310500;202206;1679;4151;1293;3546;204;605;767;2012;971;2617
310510;202206;2641;6440;1894;5109;292;871;896;2274;1188;3145
310520;202206;1321;3212;942;2514;148;406;464;1222;612;1628
310530;202206;905;2201;650;1778;102;331;245;548;347;879
310540;202206;3476;9300;2822;8091;473;1489;1377;3639;1850;5128
310550;202206;1463;3361;1055;2699;64;220;674;1567;738;1787
310560;202206;18853;46339;13693;37165;1598;4914;6721;16159;8319;21073
310570;202206;1291;3008;1007;2622;47;167;815;2058;862;2225
310590;202206;4963;12003;3980;10242;227;699;2471;5831;2698;6530
310600;202206;1589;4293;1305;3720;164;512;702;1852;866;2364
310610;202206;560;1461;355;1110;104;355;79;222;183;577
310620;202206;245119;578042;186879;476195;19402;58972;108207;247837;127609;306809
310630;202206;5356;13717;4151;11428;485;1405;2461;6482;2946;7887
310640;202206;1608;4017;1323;3514;130;425;857;2068;987;2493
310650;202206;2746;7010;2029;5709;143;498;1294;3404;1437;3902
310660;202206;1678;3953;1375;3540;30;77;1210;3072;1240;3149
310665;202206;1631;3732;1354;3370;34;114;1096;2709;1130;2823
310670;202206;72659;171568;61496;153529;5067;14705;43469;102151;48536;116856
310680;202206;902;1936;744;1719;26;95;621;1363;647;1458
310690;202206;2648;6022;1965;5000;148;455;1302;3078;1450;3533
310700;202206;573;1137;452;993;7;21;364;767;371;788
310710;202206;7111;18664;5196;15788;1083;3836;996;2718;2079;6554
310720;202206;1254;2728;993;2397;33;113;755;1746;788;1859
310730;202206;11849;28375;10126;25773;392;1283;7736;18815;8128;20098
310740;202206;7695;19696;5765;16009;726;2371;2642;6534;3368;8905
310750;202206;1517;3333;1165;2842;76;235;737;1622;813;1857
310760;202206;828;1936;597;1586;40;110;386;987;426;1097
310770;202206;1228;3148;856;2563;121;419;387;1016;508;1435
310780;202206;4954;10556;4080;9390;233;572;3091;7011;3324;7583
310790;202206;2071;6214;1787;5618;406;1450;387;1008;793;2458
310800;202206;2692;7589;1963;6159;473;1691;136;359;609;2050
310810;202206;1570;3563;1315;3163;51;157;1002;2272;1053;2429
310820;202206;1311;3206;822;2406;163;489;229;680;392;1169
310825;202206;3100;8007;2485;7061;59;300;2062;5611;2121;5911
310830;202206;2328;6001;1769;4997;307;986;820;2126;1127;3112
310840;202206;2563;6534;1935;5494;396;1297;662;1629;1058;2926
310850;202206;1554;3994;1282;3594;40;195;972;2579;1012;2774
310855;202206;3619;8829;2832;7592;188;550;2043;5316;2231;5866
310860;202206;7876;20979;6420;18341;679;1807;3948;11350;4627;13157
310870;202206;1065;2419;849;2116;60;166;621;1496;681;1662
310880;202206;1059;2983;811;2457;99;320;470;1386;569;1706
310890;202206;2553;6966;1696;5265;336;1141;275;721;611;1862
310900;202206;4628;12263;3372;9688;530;1713;1517;3957;2047;5670
310910;202206;2503;5768;1769;4640;247;707;464;1093;711;1800
310920;202206;2212;5296;1686;4537;163;507;1103;2843;1266;3350
310925;202206;1236;2863;988;2496;48;160;764;1828;812;1988
310930;202206;6347;15319;4478;12385;836;2317;2174;6230;3010;8547
310940;202206;8058;16879;6601;14862;224;637;5308;11491;5532;12128
310945;202206;1541;3677;1200;3121;143;428;721;1745;864;2173
310950;202206;2126;5996;1417;4438;239;844;420;1103;659;1947
310960;202206;818;2095;491;1434;79;252;128;346;207;598
310970;202206;1330;3769;963;3040;248;809;189;570;437;1379
310980;202206;392;862;219;573;20;54;115;288;135;342
310990;202206;1647;4092;1325;3574;149;462;804;2010;953;2472
311000;202206;4719;12051;3550;10179;620;1973;1891;5060;2511;7033
311010;202206;1142;2856;939;2516;206;574;507;1327;713;1901
311020;202206;1333;3215;885;2453;53;171;495;1305;548;1476
311030;202206;2103;4943;1522;3994;333;1015;663;1602;996;2617
311040;202206;340;987;267;836;79;271;64;180;143;451
311050;202206;3513;8322;2673;7081;401;1225;1353;3359;1754;4584
311060;202206;3975;9460;2970;7714;378;1100;1306;3060;1684;4160
311070;202206;2813;6416;2020;5229;235;770;1103;2580;1338;3350
311080;202206;1308;2746;1049;2358;40;129;831;1755;871;1884
311090;202206;2675;7774;2188;6902;432;1455;757;2332;1189;3787
311100;202206;2791;7490;1791;5554;344;1172;498;1339;842;2511
311110;202206;4356;8621;2406;5822;522;1235;643;1557;1165;2792
311115;202206;1594;3217;1333;2887;41;85;1131;2397;1172;2482
311120;202206;8023;19928;6168;16678;889;2711;2539;5954;3428;8665
311130;202206;2126;5289;1616;4604;138;464;946;2611;1084;3075
311140;202206;1781;4154;1379;3614;155;438;902;2305;1057;2743
311150;202206;1686;5023;1346;4392;173;653;732;2263;905;2916
311160;202206;4648;12420;3433;10272;618;2105;1428;3957;2046;6062
311170;202206;1062;2561;873;2316;59;172;545;1526;604;1698
311180;202206;1668;3505;1107;2702;175;432;605;1425;780;1857
311190;202206;980;2627;726;2127;111;361;295;738;406;1099
311200;202206;2564;6458;1901;5228;324;993;799;1908;1123;2901
311205;202206;1051;2798;871;2481;35;123;581;1549;616;1672
311210;202206;1207;3247;1070;3064;114;288;772;2280;886;2568
311220;202206;959;2339;820;2097;28;101;616;1453;644;1554
311230;202206;9118;25391;6924;21050;1211;3756;2707;8238;3918;11994
311240;202206;1244;2991;973;2615;168;508;486;1232;654;1740
311250;202206;1487;3872;1145;3290;209;658;433;1126;642;1784
311260;202206;3114;7174;2049;5388;259;781;1008;2313;1267;3094
311265;202206;1538;3555;1144;2937;50;157;844;2076;894;2233
311270;202206;3410;9379;2946;8652;161;683;2131;5972;2292;6655
311280;202206;1305;3312;738;2215;160;534;157;418;317;952
311290;202206;2099;5940;1894;5541;113;366;1290;3709;1403;4075
311300;202206;5308;13358;4379;11839;204;677;3548;9357;3752;10034
311310;202206;652;1682;550;1503;34;97;365;951;399;1048
311320;202206;3658;10443;3175;9423;279;1048;1735;4630;2014;5678
311330;202206;7077;15936;5629;13766;481;1317;3442;8132;3923;9449
311340;202206;12472;32259;9921;27943;2162;6595;3419;9022;5581;15617
311350;202206;2739;6232;2002;4967;204;571;1093;2401;1297;2972
311360;202206;1260;2909;879;2384;239;703;333;920;572;1623
311370;202206;5472;12387;4059;10225;427;1253;2406;5616;2833;6869
311380;202206;441;1298;328;1069;55;182;165;533;220;715
311390;202206;1969;5642;1579;5128;677;2431;392;1127;1069;3558
311400;202206;1838;4698;1336;3783;226;686;396;910;622;1596
311410;202206;2171;5939;1744;5262;223;773;989;2832;1212;3605
311420;202206;1815;4974;1368;4145;285;973;457;1152;742;2125
311430;202206;5144;12789;3475;9634;477;1398;1490;3857;1967;5255
311440;202206;3432;8914;2659;7672;698;2300;680;1850;1378;4150
311450;202206;2335;6551;1624;5154;433;1538;373;960;806;2498
311455;202206;1201;2569;845;2063;108;267;484;1158;592;1425
311460;202206;637;1795;433;1379;82;303;101;261;183;564
311470;202206;579;1687;404;1313;102;373;58;189;160;562
311480;202206;1306;2946;1078;2618;88;210;824;1987;912;2197
311490;202206;303;860;232;726;35;132;101;281;136;413
311500;202206;547;1273;429;1097;33;101;276;666;309;767
311510;202206;3931;9316;2810;7478;306;934;1419;3405;1725;4339
311520;202206;736;1884;642;1710;57;182;402;1050;459;1232
311530;202206;10497;22940;7190;17912;1436;4105;2676;6127;4112;10232
311535;202206;959;2472;695;1952;110;337;313;824;423;1161
311540;202206;584;1657;514;1538;62;217;374;1088;436;1305
311545;202206;2262;6038;1954;5562;98;317;1526;4286;1624;4603
311547;202206;1918;4060;1681;3729;39;87;1405;3022;1444;3109
311550;202206;3422;8651;2789;7583;381;1157;1291;3213;1672;4370
311560;202206;355;713;217;502;33;85;83;158;116;243
311570;202206;1707;3772;1194;3068;49;139;891;2326;940;2465
311580;202206;2566;4671;1789;3743;151;306;1268;2563;1419;2869
311590;202206;671;1648;556;1487;71;215;349;894;420;1109
311600;202206;1785;4012;1477;3597;159;444;1080;2552;1239;2996
311610;202206;2620;7396;2171;6563;136;492;1424;4126;1560;4618
311615;202206;4016;9887;3226;8630;131;438;2605;6758;2736;7196
311620;202206;632;1605;480;1362;60;189;281;750;341;939
311630;202206;1495;3897;1219;3343;111;316;771;2051;882;2367
311640;202206;870;2174;687;1892;97;288;362;922;459;1210
311650;202206;2186;5079;1754;4428;199;553;1086;2620;1285;3173
311660;202206;3464;9381;2586;7690;392;1305;744;1718;1136;3023
311670;202206;1848;4384;1380;3579;154;457;697;1737;851;2194
311680;202206;2561;6500;1975;5512;144;395;1379;3876;1523;4271
311690;202206;695;1355;516;1132;34;76;373;830;407;906
311700;202206;2385;5333;1839;4555;22;89;1544;3700;1566;3789
311710;202206;1793;4885;1326;4099;318;1058;486;1475;804;2533
311720;202206;479;1346;384;1172;50;167;204;617;254;784
311730;202206;4882;11636;3403;8890;814;2260;1406;3400;2220;5660
311740;202206;1122;2732;922;2454;71;150;728;1978;799;2128
311750;202206;4586;12542;3725;11062;323;1179;2444;6805;2767;7984
311760;202206;781;2052;598;1719;97;347;246;566;343;913
311770;202206;2537;6726;1991;5789;388;1228;808;2170;1196;3398
311780;202206;1652;4390;1221;3621;220;722;437;1135;657;1857
311783;202206;2649;6393;2171;5639;55;224;1785;4431;1840;4655
311787;202206;935;2532;728;2080;111;343;308;751;419;1094
311790;202206;1728;4556;1176;3524;234;811;374;992;608;1803
311800;202206;5630;15809;4508;13470;974;2980;833;1990;1807;4970
311810;202206;1075;2938;861;2572;55;175;581;1704;636;1879
311820;202206;1062;2334;835;2005;52;160;585;1300;637;1460
311830;202206;9823;26297;7172;20862;2034;6155;1386;3879;3420;10034
311840;202206;4378;10091;3522;8904;252;662;2640;6629;2892;7291
311850;202206;405;985;320;839;12;48;226;560;238;608
311860;202206;79950;186062;63190;158356;6742;19310;40028;93520;46770;112830
311870;202206;2121;5346;1501;4296;259;900;647;1648;906;2548
311880;202206;7264;17422;6078;15791;357;876;4548;11954;4905;12830
311890;202206;2055;4428;1602;3811;55;193;1248;2787;1303;2980
311900;202206;804;1912;612;1656;103;255;337;944;440;1199
311910;202206;4815;11343;3728;9934;672;1825;1896;5032;2568;6857
311920;202206;2489;5920;2010;5240;107;266;1404;3647;1511;3913
311930;202206;5129;10911;3855;9230;779;2085;1928;4211;2707;6296
311940;202206;18256;44608;13426;35851;1734;5117;6276;15347;8010;20464
311950;202206;2693;6565;2027;5421;189;544;1222;3233;1411;3777
311960;202206;564;1314;446;1143;50;152;232;527;282;679
311970;202206;481;1462;358;1165;69;265;91;248;160;513
311980;202206;517;1301;284;844;31;104;106;279;137;383
311990;202206;605;1377;393;1053;61;197;170;390;231;587
311995;202206;1078;2910;572;1754;29;107;88;173;117;280
312000;202206;924;2039;700;1720;36;100;513;1239;549;1339
312010;202206;1240;2993;993;2615;37;135;728;1815;765;1950
312015;202206;1525;4029;1348;3745;56;237;1088;2913;1144;3150
312020;202206;2019;5836;1441;4540;259;889;333;907;592;1796
312030;202206;2445;5112;2093;4717;53;167;1918;4254;1971;4421
312040;202206;950;2645;683;2116;112;338;300;891;412;1229
312050;202206;1346;3885;1091;3426;229;901;409;1146;638;2047
312060;202206;1087;2511;714;2001;157;458;318;858;475;1316
312070;202206;1052;2777;753;2180;40;144;465;1238;505;1382
312080;202206;3249;7521;2523;6458;137;405;1716;4093;1853;4498
312083;202206;1147;2575;892;2203;48;167;710;1666;758;1833
312087;202206;2936;6692;2386;5871;82;209;1944;4744;2026;4953
312090;202206;12861;31166;10156;26919;1120;3468;5939;14697;7059;18165
312100;202206;1882;4843;1457;4141;113;416;920;2426;1033;2842
312110;202206;1123;3301;919;2882;162;611;422;1196;584;1807
312120;202206;1152;3014;803;2385;187;655;275;685;462;1340
312125;202206;2156;5017;1830;4577;100;301;1463;3528;1563;3829
312130;202206;1296;2921;965;2391;84;251;500;1094;584;1345
312140;202206;816;2266;679;1983;125;398;318;859;443;1257
312150;202206;553;1403;473;1261;30;84;314;783;344;867
312160;202206;10810;26732;8430;22737;902;2839;4490;11218;5392;14057
312170;202206;1022;2471;784;2042;49;148;522;1314;571;1462
312180;202206;1589;3939;1302;3453;140;404;759;1909;899;2313
312190;202206;887;2272;690;1929;60;202;376;973;436;1175
312200;202206;5469;13567;4314;11761;553;1521;2543;6741;3096;8262
312210;202206;1612;3224;1222;2694;49;146;985;2092;1034;2238
312220;202206;1880;5296;1603;4806;142;463;1066;3176;1208;3639
312230;202206;20456;48871;14784;39149;2950;8845;4972;11062;7922;19907
312235;202206;2385;5386;1904;4722;218;489;1304;3180;1522;3669
312240;202206;891;2655;684;2230;141;476;224;719;365;1195
312245;202206;3451;7239;2915;6485;31;87;2637;5735;2668;5822
312247;202206;1251;2645;881;2105;106;262;554;1264;660;1526
312250;202206;1037;2625;664;1921;99;291;216;590;315;881
312260;202206;1138;2751;912;2412;49;187;719;1793;768;1980
312270;202206;811;2112;625;1746;31;118;358;891;389;1009
312280;202206;489;1346;389;1170;85;281;128;345;213;626
312290;202206;1047;2822;872;2546;150;495;316;839;466;1334
312300;202206;1225;3499;875;2681;195;653;192;474;387;1127
312310;202206;1129;3127;902;2688;117;408;470;1310;587;1718
312320;202206;2396;5697;1761;4648;363;944;482;1240;845;2184
312330;202206;1052;2777;867;2429;103;311;520;1386;623;1697
312340;202206;275;661;197;541;28;108;111;259;139;367
312350;202206;299;581;213;485;14;36;144;294;158;330
312352;202206;1735;5004;1529;4618;272;862;736;2391;1008;3253
312360;202206;3732;9964;2832;8335;538;1775;1164;3124;1702;4899
312370;202206;2324;5505;1902;4856;209;631;1206;2888;1415;3519
312380;202206;2502;5200;2066;4657;10;31;1807;3963;1817;3994
312385;202206;1444;3600;1126;3052;352;956;295;848;647;1804
312390;202206;2194;5840;1625;4783;259;850;474;1208;733;2058
312400;202206;3502;9306;2979;8471;884;2689;948;2743;1832;5432
312410;202206;15807;39180;13055;34886;1601;4633;8405;21550;10006;26183
312420;202206;4631;11394;3799;10080;726;2125;1965;4971;2691;7096
312430;202206;9818;22978;8032;19968;241;798;6142;14568;6383;15366
312440;202206;1127;3361;944;3001;446;1463;189;599;635;2062
312450;202206;1516;4117;1163;3498;276;892;482;1430;758;2322
312460;202206;551;1267;401;1053;31;94;256;651;287;745
312470;202206;528;1267;336;932;49;150;101;236;150;386
312480;202206;1188;2793;857;2310;75;245;486;1223;561;1468
312490;202206;2901;6018;2307;5218;155;396;1520;3276;1675;3672
312500;202206;1201;2666;1008;2411;39;138;776;1808;815;1946
312510;202206;5234;13170;3739;10396;816;2240;1127;2905;1943;5145
312520;202206;392;927;310;803;52;172;184;443;236;615
312530;202206;765;1657;645;1513;32;74;471;1134;503;1208
312540;202206;1781;4572;1234;3553;133;390;707;1945;840;2335
312550;202206;942;2252;710;1825;40;119;463;1082;503;1201
312560;202206;2063;5118;1594;4379;96;296;1139;3085;1235;3381
312570;202206;2980;6467;2239;5548;404;939;1161;2937;1565;3876
312580;202206;702;1828;488;1388;51;183;237;609;288;792
312590;202206;1741;4681;1353;3919;138;473;799;2093;937;2566
312595;202206;2403;6377;1979;5721;269;709;1202;3669;1471;4378
312600;202206;1426;3261;948;2317;131;406;291;703;422;1109
312610;202206;8139;19632;5574;15019;821;2482;2092;4921;2913;7403
312620;202206;2825;6671;2145;5727;63;254;1728;4588;1791;4842
312630;202206;367;961;267;784;45;165;117;309;162;474
312640;202206;605;1591;449;1340;45;171;235;651;280;822
312650;202206;2395;5488;1696;4251;58;193;1260;2921;1318;3114
312660;202206;1515;3386;1168;2824;98;242;812;1852;910;2094
312670;202206;6614;14727;5544;13117;143;583;4464;9839;4607;10422
312675;202206;1396;3352;1144;2996;44;152;934;2374;978;2526
312680;202206;1766;4130;1573;3852;45;176;1391;3291;1436;3467
312690;202206;3293;6575;2478;5563;122;238;1925;4290;2047;4528
312695;202206;1177;2802;999;2523;40;78;827;2061;867;2139
312700;202206;2341;5911;1703;4775;174;566;959;2531;1133;3097
312705;202206;1868;3695;1650;3397;11;40;1559;3173;1570;3213
312707;202206;1588;4188;1120;3351;49;206;752;2096;801;2302
312710;202206;8183;17918;5301;13603;1301;3245;1752;4660;3053;7905
312720;202206;1245;3049;951;2594;91;293;636;1627;727;1920
312730;202206;1791;4029;1288;3354;111;313;807;2027;918;2340
312733;202206;1502;3782;1130;3102;44;159;766;1956;810;2115
312735;202206;890;2165;700;1812;59;161;454;1084;513;1245
312737;202206;935;1927;672;1560;59;156;473;1052;532;1208
312738;202206;878;2081;636;1669;53;171;400;957;453;1128
312740;202206;494;1206;313;911;65;207;88;197;153;404
312750;202206;1702;4572;1253;3760;160;545;601;1675;761;2220
312760;202206;2061;5727;1493;4594;227;715;598;1765;825;2480
312770;202206;51547;118111;33549;87885;5657;16263;13367;32921;19024;49184
312780;202206;2931;7779;2477;7045;278;834;1591;4414;1869;5248
312790;202206;272;630;138;406;4;16;31;58;35;74
312800;202206;6252;16005;4923;13587;605;1976;2746;7035;3351;9011
312810;202206;1819;4647;1212;3637;312;1001;423;1167;735;2168
312820;202206;1976;4894;1602;4268;91;258;1169;3042;1260;3300
312825;202206;1711;3458;1458;3138;35;80;1262;2649;1297;2729
312830;202206;3153;8364;2035;6179;445;1449;582;1631;1027;3080
312840;202206;1668;4090;1300;3497;121;388;729;1828;850;2216
312850;202206;1193;2488;864;2029;24;93;601;1277;625;1370
312860;202206;1225;2991;839;2399;208;629;258;654;466;1283
312870;202206;6909;17575;4440;12987;717;2231;1301;3411;2018;5642
312880;202206;1646;3890;1292;3322;74;187;765;1931;839;2118
312890;202206;2650;6057;1972;4982;130;302;1152;2823;1282;3125
312900;202206;1492;3549;1225;3199;117;363;747;1946;864;2309
312910;202206;1693;3013;987;2107;151;309;508;1040;659;1349
312920;202206;1080;2768;772;2279;127;432;283;738;410;1170
312930;202206;2742;6227;2041;5195;359;931;1015;2607;1374;3538
312940;202206;1167;2929;934;2605;83;295;537;1393;620;1688
312950;202206;3671;8379;2567;6684;406;1190;1314;3194;1720;4384
312960;202206;2034;4955;1684;4433;104;237;1231;3346;1335;3583
312965;202206;1910;4704;1573;4185;150;383;1043;2776;1193;3159
312970;202206;1753;4601;1428;4105;141;508;881;2360;1022;2868
312980;202206;29206;75080;23808;65599;4131;12316;11661;30082;15792;42398
312990;202206;603;1401;418;1095;64;207;222;519;286;726
313000;202206;533;1428;406;1209;27;113;257;716;284;829
313005;202206;2832;7546;2371;6797;121;364;1749;4856;1870;5220
313010;202206;6441;16278;5187;14284;746;2295;3178;8429;3924;10724
313020;202206;1233;3593;927;2945;155;558;212;584;367;1142
313030;202206;1357;2863;949;2303;58;181;685;1569;743;1750
313040;202206;965;2783;809;2487;37;162;516;1511;553;1673
313050;202206;2082;5380;1461;4443;239;852;437;1163;676;2015
313055;202206;2175;5371;1909;4992;427;1160;1214;3117;1641;4277
313060;202206;1183;2727;887;2232;197;575;213;491;410;1066
313065;202206;1889;5032;1663;4665;45;203;1374;3717;1419;3920
313070;202206;1035;2608;804;2232;83;249;440;1161;523;1410
313080;202206;437;1160;324;960;58;196;123;303;181;499
313090;202206;6143;14751;5130;13168;300;848;3597;9039;3897;9887
313100;202206;1517;3693;1199;3235;46;166;885;2295;931;2461
313110;202206;1715;4266;1227;3417;112;362;647;1612;759;1974
313115;202206;3310;8661;2663;7492;279;941;1542;3931;1821;4872
313120;202206;4300;9694;3147;8170;193;522;2158;5590;2351;6112
313130;202206;37253;89399;28513;74129;2777;8315;16755;40414;19532;48729
313140;202206;851;1714;581;1361;35;90;444;1026;479;1116
313150;202206;1589;4272;1194;3584;359;1216;228;575;587;1791
313160;202206;1502;3516;1162;3021;26;95;891;2212;917;2307
313170;202206;13138;34881;9872;28850;1623;5200;3846;10065;5469;15265
313180;202206;2791;6817;2083;5394;187;502;1387;3423;1574;3925
313190;202206;5100;13668;3756;11056;647;2063;1429;3819;2076;5882
313200;202206;1319;3207;1125;2875;23;83;937;2299;960;2382
313210;202206;4551;11602;3770;10357;406;1283;2400;6255;2806;7538
313220;202206;2099;5235;1424;3936;171;524;661;1610;832;2134
313230;202206;3207;8263;2605;7497;67;227;2106;6115;2173;6342
313240;202206;12431;28713;8667;22923;914;2905;4803;11657;5717;14562
313250;202206;7099;19574;5473;16157;969;2917;2580;7245;3549;10162
313260;202206;900;2122;647;1720;73;267;356;809;429;1076
313270;202206;7455;15815;6195;14161;478;1043;4896;11220;5374;12263
313280;202206;521;1341;352;1015;46;156;162;438;208;594
313290;202206;1168;3495;899;3008;206;783;338;1083;544;1866
313300;202206;2082;5302;1603;4493;342;1043;565;1402;907;2445
313310;202206;1582;4408;1272;3768;203;728;457;1090;660;1818
313320;202206;2292;5743;1638;4703;329;1012;619;1808;948;2820
313330;202206;4729;11414;3604;9764;230;716;2400;6376;2630;7092
313340;202206;1761;3695;1310;3082;88;251;948;2122;1036;2373
313350;202206;3413;8906;2325;6608;240;818;1021;2465;1261;3283
313360;202206;1857;4285;1281;3379;199;627;661;1579;860;2206
313370;202206;1835;4710;1454;3984;279;810;588;1461;867;2271
313375;202206;2148;5361;1407;4035;241;810;392;987;633;1797
313380;202206;7873;18545;5784;14801;813;2423;3068;6864;3881;9287
313390;202206;901;2649;778;2431;55;237;516;1525;571;1762
313400;202206;4303;9729;3321;8330;154;454;2538;6194;2692;6648
313410;202206;1590;3830;1173;3124;274;740;599;1533;873;2273
313420;202206;18054;38609;10118;25810;2417;6713;2024;4833;4441;11546
313430;202206;1310;3212;1085;2805;83;314;751;1736;834;2050
313440;202206;7716;15348;5530;12626;215;566;4216;9368;4431;9934
313450;202206;841;2118;608;1694;109;321;216;509;325;830
313460;202206;2578;6833;2055;5997;361;1184;1011;2834;1372;4018
313470;202206;3207;7543;2569;6615;131;389;1992;5030;2123;5419
313480;202206;1247;3365;782;2393;78;272;304;832;382;1104
313490;202206;3540;8537;1969;5683;359;1127;584;1557;943;2684
313500;202206;652;1638;465;1266;49;128;209;523;258;651
313505;202206;11543;28064;9792;25678;390;1167;7807;20301;8197;21468
313507;202206;1619;3812;1293;3324;46;168;1011;2494;1057;2662
313510;202206;17108;43099;13392;36099;1300;3835;7426;18555;8726;22390
313520;202206;17709;43588;14294;38039;658;2130;11075;28367;11733;30497
313530;202206;655;1848;497;1517;63;230;213;557;276;787
313535;202206;2658;6893;2133;5908;238;622;1315;3605;1553;4227
313540;202206;956;2610;764;2170;109;340;373;942;482;1282
313545;202206;1272;3908;1078;3540;120;450;597;1888;717;2338
313550;202206;2350;6353;1958;5468;213;651;1301;3526;1514;4177
313560;202206;3330;5727;2497;4747;37;69;2213;4159;2250;4228
313570;202206;1145;3071;944;2729;177;527;456;1266;633;1793
313580;202206;6941;15734;5489;13452;401;1125;3790;8893;4191;10018
313590;202206;1296;3236;1049;2892;213;586;551;1595;764;2181
313600;202206;4982;11338;4211;10212;86;331;3731;8765;3817;9096
313610;202206;1176;2753;965;2397;79;226;637;1463;716;1689
313620;202206;6438;15998;5195;13828;471;1496;3345;8497;3816;9993
313630;202206;10257;23368;7370;19096;711;2201;4558;11254;5269;13455
313640;202206;1478;2887;983;2261;82;214;690;1553;772;1767
313650;202206;1884;5335;1483;4667;116;424;919;2923;1035;3347
313652;202206;974;2595;870;2422;56;200;655;1719;711;1919
313655;202206;1328;3014;1031;2647;78;203;747;1896;825;2099
313657;202206;1304;3211;1018;2754;36;142;754;1879;790;2021
313660;202206;1264;3119;1049;2769;68;248;766;1890;834;2138
313665;202206;6348;15413;5065;13212;384;1190;3459;8412;3843;9602
313670;202206;62054;144138;42297;111713;5318;15650;21249;52300;26567;67950
313680;202206;1234;2943;1012;2593;53;138;681;1642;734;1780
313690;202206;1099;3119;799;2527;156;542;235;684;391;1226
313695;202206;2061;5097;1536;4236;103;281;1040;2933;1143;3214
313700;202206;3223;9317;2768;8736;229;764;2196;6948;2425;7712
313710;202206;1678;3554;1207;2947;94;260;815;1947;909;2207
313720;202206;7076;18217;5177;14422;689;2111;2382;5956;3071;8067
313730;202206;1630;3245;1222;2719;84;160;805;1779;889;1939
313740;202206;1888;6420;1597;5714;356;1449;395;1249;751;2698
313750;202206;2528;6122;2029;5315;298;905;1175;2801;1473;3706
313753;202206;2456;5718;1645;4415;242;738;722;1815;964;2553
313760;202206;6753;17460;5356;14901;817;2541;2697;6827;3514;9368
313770;202206;4654;12185;3688;10689;196;543;2787;8195;2983;8738
313780;202206;4658;11415;3452;9557;417;1122;1165;3307;1582;4429
313790;202206;651;1757;561;1594;72;217;337;915;409;1132
313800;202206;1557;3295;1141;2731;95;268;658;1456;753;1724
313810;202206;1959;4455;1583;3937;56;194;1276;3066;1332;3260
313820;202206;20222;49161;13394;35184;2208;5970;3956;9557;6164;15527
313830;202206;463;1280;339;1018;60;209;142;387;202;596
313835;202206;1035;2756;853;2454;86;314;460;1196;546;1510
313840;202206;9154;22450;7251;19455;1600;4541;2049;5420;3649;9961
313850;202206;1131;2569;895;2245;139;394;471;1083;610;1477
313860;202206;3167;7774;2422;6484;307;973;1215;2908;1522;3881
313862;202206;1358;2821;695;1865;39;116;339;919;378;1035
313865;202206;2975;7183;2450;6363;82;249;1868;4661;1950;4910
313867;202206;1602;4532;1267;3893;233;728;672;2136;905;2864
313868;202206;1944;5394;1577;4732;54;210;1195;3427;1249;3637
313870;202206;1224;2947;823;2238;97;285;358;860;455;1145
313880;202206;2325;5651;1742;4674;181;589;971;2331;1152;2920
313890;202206;2701;5042;1979;4134;49;138;1560;3116;1609;3254
313900;202206;5923;15630;4188;12149;981;3099;1241;3088;2222;6187
313910;202206;849;2349;649;1951;118;373;161;476;279;849
313920;202206;3256;9036;2682;7905;448;1378;1428;4166;1876;5544
313925;202206;1924;4458;1530;3788;166;385;1007;2456;1173;2841
313930;202206;5670;14773;4570;12920;297;958;3139;8639;3436;9597
313940;202206;11321;30784;8767;26556;1610;5237;2290;7493;3900;12730
313950;202206;6490;12945;5035;11161;249;635;3682;8016;3931;8651
313960;202206;6666;15067;4480;11475;704;2105;1782;3973;2486;6078
313970;202206;1779;4374;1515;3955;49;138;1037;2604;1086;2742
313980;202206;1569;3893;1091;3176;186;616;487;1339;673;1955
313990;202206;2329;6643;1785;5529;264;1035;970;2624;1234;3659
314000;202206;12065;28115;9792;24357;652;2010;6481;15633;7133;17643
314010;202206;1598;3564;1257;3098;39;143;972;2278;1011;2421
314015;202206;2509;6373;1987;5486;197;661;1191;3045;1388;3706
314020;202206;588;1493;396;1173;124;447;49;139;173;586
314030;202206;932;2481;725;2097;104;306;339;954;443;1260
314040;202206;708;1841;595;1643;79;270;326;856;405;1126
314050;202206;2214;5434;1652;4440;101;344;1020;2501;1121;2845
314053;202206;2375;6347;1922;5484;311;815;1124;3332;1435;4147
314055;202206;2646;6127;2232;5543;78;223;1820;4534;1898;4757
314060;202206;1488;3682;1122;3104;36;128;801;2153;837;2281
314070;202206;5660;14140;4548;12254;659;1838;2480;6432;3139;8270
314080;202206;2308;5669;1662;4617;151;494;780;1927;931;2421
314085;202206;2704;6739;2161;5954;223;611;1379;3764;1602;4375
314090;202206;5857;14009;5042;12851;406;1049;3356;8753;3762;9802
314100;202206;3420;7803;2652;6756;62;178;1969;5012;2031;5190
314110;202206;5717;14983;4686;13116;498;1552;2632;6723;3130;8275
314120;202206;805;1779;377;1026;72;224;128;309;200;533
314130;202206;769;1922;527;1481;29;103;339;906;368;1009
314140;202206;5317;13440;4232;11519;402;1207;2460;6393;2862;7600
314150;202206;1657;3927;1190;3137;86;240;792;2032;878;2272
314160;202206;2711;6400;1954;5133;208;561;920;2342;1128;2903
314170;202206;1063;2715;846;2291;42;160;578;1421;620;1581
314180;202206;6392;16025;5103;14036;461;1291;2971;8074;3432;9365
314190;202206;714;1663;539;1419;60;197;330;801;390;998
314200;202206;3372;8861;2792;7925;221;642;1868;5181;2089;5823
314210;202206;2318;5689;1810;4804;282;773;696;1750;978;2523
314220;202206;1859;4755;1478;4159;219;720;716;1842;935;2562
314225;202206;1214;3288;989;2880;92;274;658;1855;750;2129
314230;202206;1018;2465;821;2196;86;234;538;1432;624;1666
314240;202206;1240;3174;968;2780;203;616;435;1230;638;1846
314250;202206;496;1377;321;996;41;141;127;346;168;487
314260;202206;1284;3091;1022;2744;225;591;474;1233;699;1824
314270;202206;3839;9841;3138;8757;97;342;2367;6470;2464;6812
314280;202206;4109;8987;2863;7177;277;784;1742;4065;2019;4849
314290;202206;5218;12353;4379;10949;260;699;3161;7617;3421;8316
314300;202206;2323;6191;1495;4462;292;930;504;1349;796;2279
314310;202206;4415;11132;3061;8886;898;2905;450;1152;1348;4057
314315;202206;1126;3231;931;2836;59;226;649;1901;708;2127
314320;202206;3717;9388;2511;7182;393;1300;1050;2725;1443;4025
314330;202206;61539;163408;47655;139324;11069;33365;13497;39237;24566;72602
314340;202206;2934;7006;1940;5283;367;1170;653;1481;1020;2651
314345;202206;1724;4512;1424;4004;109;318;1013;2752;1122;3070
314350;202206;960;2485;652;1936;134;430;153;333;287;763
314360;202206;616;1708;411;1274;60;190;123;335;183;525
314370;202206;856;2081;690;1830;47;150;475;1192;522;1342
314380;202206;1329;3436;929;2771;212;711;284;816;496;1527
314390;202206;17262;40581;12167;31976;1676;4977;5154;11792;6830;16769
314400;202206;4579;12915;3537;10922;1017;3284;1273;4094;2290;7378
314410;202206;3392;9056;2379;7112;451;1541;592;1725;1043;3266
314420;202206;900;2094;665;1730;28;91;440;1083;468;1174
314430;202206;9193;20516;6607;16470;919;2382;3319;7858;4238;10240
314435;202206;2139;5386;1676;4662;259;745;927;2501;1186;3246
314437;202206;1028;2423;751;1981;65;184;465;1190;530;1374
314440;202206;678;1859;487;1492;138;477;111;276;249;753
314450;202206;1688;4144;1395;3674;181;508;776;1908;957;2416
314460;202206;3844;10855;2903;8998;716;2383;971;2723;1687;5106
314465;202206;2657;6873;2164;5969;54;212;1687;4420;1741;4632
314467;202206;1100;2666;911;2352;77;224;637;1586;714;1810
314470;202206;2554;6855;2120;6035;327;1006;1067;2854;1394;3860
314480;202206;9130;23869;7043;19676;1030;3195;3126;7766;4156;10961
314490;202206;1214;2972;892;2362;67;202;599;1524;666;1726
314500;202206;2060;4656;1497;3941;369;964;545;1434;914;2398
314505;202206;2511;5385;2056;4769;112;247;1571;3547;1683;3794
314510;202206;2344;5841;1712;4906;429;1389;702;1911;1131;3300
314520;202206;6990;19795;5603;17143;1229;4084;1332;3673;2561;7757
314530;202206;6240;17765;5578;16597;294;1141;4243;12142;4537;13283
314535;202206;3117;7148;2503;6268;132;388;1968;4870;2100;5258
314537;202206;1390;3598;1065;3087;77;216;731;2066;808;2282
314540;202206;491;1148;356;936;15;41;209;506;224;547
314545;202206;2253;4812;2010;4531;50;130;1732;3947;1782;4077
314550;202206;860;1942;580;1504;42;141;333;760;375;901
314560;202206;5496;14998;4171;12254;536;1917;1831;4621;2367;6538
314570;202206;354;936;253;755;26;89;128;380;154;469
314580;202206;543;1527;436;1314;96;288;162;471;258;759
314585;202206;773;2197;595;1822;53;184;284;810;337;994
314587;202206;2562;6374;1995;5474;550;1407;987;2752;1537;4159
314590;202206;4952;12412;3800;10397;442;1390;1926;4822;2368;6212
314600;202206;2135;5584;1380;4206;334;1094;181;487;515;1581
314610;202206;10848;25631;8361;21801;1001;3138;4125;10917;5126;14055
314620;202206;2752;5765;2232;5112;113;232;1841;4228;1954;4460
314625;202206;1788;4302;1518;3931;34;157;1294;3237;1328;3394
314630;202206;5960;13848;4807;12266;172;509;3903;9834;4075;10343
314640;202206;872;1873;668;1558;46;135;470;1009;516;1144
314650;202206;965;2143;643;1642;61;189;388;887;449;1076
314655;202206;1713;4419;1210;3563;165;469;623;1836;788;2305
314660;202206;400;822;293;650;15;33;212;447;227;480
314670;202206;1874;3902;1301;3124;26;73;915;2104;941;2177
314675;202206;1908;4552;1614;4082;94;252;1258;3112;1352;3364
314690;202206;2339;6017;1781;5188;439;1288;722;2068;1161;3356
314700;202206;13179;34037;9146;26785;1461;4670;4050;11185;5511;15855
314710;202206;9581;25267;7139;20277;1017;3238;2898;7153;3915;10391
314720;202206;2601;7312;1849;5792;346;1169;409;1127;755;2296
314730;202206;2828;7013;2005;5547;348;1071;733;1796;1081;2867
314740;202206;3642;9502;2878;8192;435;1328;1526;4120;1961;5448
314750;202206;329;828;255;677;31;98;152;358;183;456
314760;202206;2127;5935;1371;4277;216;796;407;998;623;1794
314770;202206;1173;3240;699;2133;107;335;208;588;315;923
314780;202206;406;975;291;792;30;104;169;418;199;522
314790;202206;13870;34773;10136;28141;1567;4887;4471;11667;6038;16554
314795;202206;1717;4148;1461;3735;48;181;1156;2800;1204;2981
314800;202206;12969;31565;8687;24005;1435;4374;3005;7289;4440;11663
314810;202206;11524;28477;8713;23851;2103;6081;3318;8603;5421;14684
314820;202206;1494;3345;1170;2872;77;236;750;1743;827;1979
314830;202206;1967;5186;1617;4591;158;463;962;2612;1120;3075
314840;202206;996;2856;780;2468;53;226;552;1660;605;1886
314850;202206;2841;5384;2318;4749;36;100;2111;4264;2147;4364
314860;202206;3769;9888;3137;8793;155;579;2278;6116;2433;6695
314870;202206;7768;16187;5985;14027;289;669;4576;10837;4865;11506
314875;202206;2132;5878;1881;5543;229;560;1404;4225;1633;4785
314880;202206;925;2146;709;1815;44;128;444;1085;488;1213
314890;202206;523;1467;403;1241;55;184;194;542;249;726
314900;202206;993;2327;761;1951;88;266;392;948;480;1214
314910;202206;1927;5134;1437;4335;222;788;713;1987;935;2775
314915;202206;2466;6648;2019;5878;172;507;1307;3766;1479;4273
314920;202206;616;1459;428;1195;20;65;298;827;318;892
314930;202206;6893;18162;5359;15333;838;2699;2438;6303;3276;9002
314940;202206;472;1052;391;924;29;64;280;630;309;694
314950;202206;721;1706;504;1375;47;169;283;697;330;866
314960;202206;1052;2288;827;1939;54;138;598;1339;652;1477
314970;202206;1238;3482;962;2936;153;511;435;1222;588;1733
314980;202206;2099;4997;1649;4347;179;535;1085;2757;1264;3292
314990;202206;3105;8502;2276;6725;382;1182;611;1581;993;2763
314995;202206;1913;4934;1505;4228;52;196;989;2595;1041;2791
315000;202206;1285;3046;925;2487;89;259;592;1538;681;1797
315010;202206;458;1164;368;1024;41;143;221;580;262;723
315015;202206;2785;7128;2424;6542;221;710;1693;4413;1914;5123
315020;202206;903;2456;641;1942;64;241;315;868;379;1109
315030;202206;735;1815;509;1426;165;446;116;292;281;738
315040;202206;1101;2726;919;2443;161;451;561;1391;722;1842
315050;202206;1360;3269;1015;2753;83;266;532;1364;615;1630
315053;202206;1387;3299;1041;2715;92;284;625;1526;717;1810
315057;202206;2082;5558;1653;4842;146;356;1069;3330;1215;3686
315060;202206;774;2168;575;1780;113;374;161;459;274;833
315070;202206;832;1849;649;1564;93;259;381;804;474;1063
315080;202206;3707;9281;2854;7786;134;442;2060;5314;2194;5756
315090;202206;934;2606;704;2204;92;318;321;921;413;1239
315100;202206;1631;4512;1095;3358;134;489;498;1342;632;1831
315110;202206;2486;5483;1827;4528;153;357;1067;2597;1220;2954
315120;202206;14600;31783;10889;26336;1139;2617;6553;15817;7692;18434
315130;202206;1951;5024;1660;4541;171;548;805;2011;976;2559
315140;202206;3482;9054;2793;7891;534;1670;1461;3842;1995;5512
315150;202206;5055;11980;3658;9761;538;1659;1761;4526;2299;6185
315160;202206;2188;4989;1520;3958;251;693;779;1957;1030;2650
315170;202206;1562;4718;1123;3689;221;759;331;1038;552;1797
315180;202206;20373;47477;12179;32977;1600;4959;4608;10864;6208;15823
315190;202206;2559;5309;1966;4537;185;416;1468;3412;1653;3828
315200;202206;5121;13248;3832;11123;1046;3217;1247;3424;2293;6641
315210;202206;10170;24891;7211;19099;689;2039;3677;8622;4366;10661
315213;202206;1212;3034;1054;2815;22;86;870;2258;892;2344
315217;202206;3121;8295;2373;7063;110;469;1664;4692;1774;5161
315220;202206;9915;25145;7848;21708;639;1654;4389;12242;5028;13896
315230;202206;3396;7121;2768;6291;181;352;1830;4322;2011;4674
315240;202206;2839;7587;2353;6761;485;1447;1158;3305;1643;4752
315250;202206;16769;42421;12553;34770;1874;5697;5739;14628;7613;20325
315260;202206;1089;2772;638;1881;135;394;71;183;206;577
315270;202206;1093;2936;821;2431;132;440;329;840;461;1280
315280;202206;3496;8358;2324;6335;605;1716;526;1414;1131;3130
315290;202206;1360;3181;849;2392;194;598;324;872;518;1470
315300;202206;775;1767;573;1467;30;90;412;1034;442;1124
315310;202206;1472;3515;1129;2938;94;281;762;1813;856;2094
315320;202206;735;2055;520;1632;70;260;204;600;274;860
315330;202206;861;2613;520;1773;62;233;210;617;272;850
315340;202206;3337;7730;2313;6181;459;1256;1015;2647;1474;3903
315350;202206;2103;4981;1757;4461;158;456;1272;3102;1430;3558
315360;202206;1988;5441;1567;4632;212;660;720;1981;932;2641
315370;202206;638;1669;515;1443;76;214;252;672;328;886
315380;202206;293;771;200;582;42;120;24;48;66;168
315390;202206;1389;3678;1123;3222;102;368;649;1673;751;2041
315400;202206;4719;11790;3773;10167;428;1285;2301;5841;2729;7126
315410;202206;2750;5907;2011;4831;379;1017;494;1154;873;2171
315415;202206;1692;4344;1372;3832;349;1137;375;966;724;2103
315420;202206;1707;4541;1211;3642;257;840;328;855;585;1695
315430;202206;4128;9550;2905;7766;472;1427;1428;3647;1900;5074
315440;202206;1192;2873;936;2481;82;256;570;1385;652;1641
315445;202206;2426;5093;1810;4249;76;233;1485;3372;1561;3605
315450;202206;2550;6492;2085;5753;218;603;1363;3671;1581;4274
315460;202206;50184;126168;42281;112829;4364;14011;27255;67321;31619;81332
315470;202206;768;2021;544;1504;46;141;279;700;325;841
315480;202206;1480;3953;1097;3168;158;481;490;1302;648;1783
315490;202206;3321;7835;2333;6271;311;888;969;2419;1280;3307
315500;202206;601;1535;387;1110;30;97;217;553;247;650
315510;202206;1583;3622;1309;3242;12;55;1143;2730;1155;2785
315520;202206;1238;2971;1037;2670;42;123;850;2117;892;2240
315530;202206;850;2015;706;1778;69;211;521;1219;590;1430
315540;202206;1889;4714;1291;3603;113;392;570;1459;683;1851
315550;202206;2057;5277;1426;4133;262;896;450;1297;712;2193
315560;202206;7490;20339;6440;18531;368;1053;4676;13329;5044;14382
315570;202206;2840;6829;2039;5425;255;817;1072;2523;1327;3340
315580;202206;3708;8040;2914;6830;442;1091;1219;2673;1661;3764
315590;202206;1304;2735;1060;2383;44;166;821;1665;865;1831
315600;202206;2825;8052;1995;6465;416;1230;903;3137;1319;4367
315610;202206;1103;2612;836;2168;112;374;424;933;536;1307
315620;202206;599;1496;449;1266;48;148;235;656;283;804
315630;202206;1246;3120;951;2594;131;421;506;1230;637;1651
315640;202206;436;1013;334;889;27;93;220;546;247;639
315645;202206;1127;2759;791;2236;145;440;219;602;364;1042
315650;202206;2001;4283;1620;3760;70;160;1288;2923;1358;3083
315660;202206;2385;5821;1794;4771;168;454;1103;2858;1271;3312
315670;202206;17723;44521;13853;37709;2224;6550;7113;18047;9337;24597
315680;202206;3587;9474;2688;7855;339;1089;1425;3957;1764;5046
315690;202206;4345;10121;2628;7205;511;1365;782;2240;1293;3605
315700;202206;9902;24939;7590;20560;782;2394;4155;10351;4937;12745
315710;202206;2075;4730;1487;3878;69;214;1013;2537;1082;2751
315720;202206;4985;12837;4101;11310;197;809;2916;7589;3113;8398
315725;202206;2607;6191;2060;5348;197;496;1366;3671;1563;4167
315727;202206;657;1584;483;1288;60;186;244;602;304;788
315730;202206;696;1967;598;1787;128;413;222;586;350;999
315733;202206;1628;3845;1255;3268;180;533;579;1358;759;1891
315737;202206;1351;3463;996;2789;34;118;698;1868;732;1986
315740;202206;935;2470;760;2127;73;257;509;1319;582;1576
315750;202206;1480;3520;1151;3032;80;215;765;2010;845;2225
315760;202206;1380;2914;1158;2624;30;100;990;2155;1020;2255
315765;202206;2282;5271;1872;4752;29;100;1681;4234;1710;4334
315770;202206;1311;3421;1051;3060;357;1115;261;734;618;1849
315780;202206;35852;91176;30119;81223;1919;6421;20523;51996;22442;58417
315790;202206;4059;11640;3460;10532;333;1020;2075;6596;2408;7616
315800;202206;1484;4609;1133;3824;143;574;452;1324;595;1898
315810;202206;1564;3521;1308;3112;62;176;1037;2358;1099;2534
315820;202206;3363;7649;2734;6827;239;601;2004;4934;2243;5535
315830;202206;1407;3942;962;2975;105;360;286;727;391;1087
315840;202206;1005;2276;721;1800;46;137;403;896;449;1033
315850;202206;1370;3673;1088;3214;156;496;585;1644;741;2140
315860;202206;614;1600;447;1321;87;286;148;355;235;641
315870;202206;520;1348;413;1176;26;87;290;786;316;873
315880;202206;1298;3043;939;2441;118;360;388;861;506;1221
315890;202206;2076;5392;1703;4898;429;1285;789;2322;1218;3607
315895;202206;7303;18659;5483;15227;575;1860;2795;7028;3370;8888
315900;202206;922;2301;773;2075;79;260;508;1283;587;1543
315910;202206;645;1597;550;1461;54;162;422;1096;476;1258
315920;202206;1578;3821;930;2636;158;544;331;801;489;1345
315930;202206;1318;2729;910;2169;95;238;506;1140;601;1378
315935;202206;1189;3292;947;2839;186;572;397;1179;583;1751
315940;202206;702;1752;555;1546;82;250;297;765;379;1015
315950;202206;1359;3500;1142;3166;93;295;906;2455;999;2750
315960;202206;6441;17089;4517;13334;1042;3419;1016;2234;2058;5653
315970;202206;654;1659;527;1491;69;214;354;1010;423;1224
315980;202206;4946;10153;2885;6922;491;1267;1385;2966;1876;4233
315990;202206;3982;9713;3135;8287;323;912;1770;4453;2093;5365
316000;202206;857;1870;682;1622;57;162;441;991;498;1153
316010;202206;851;2257;630;1861;66;213;278;687;344;900
316020;202206;1057;2827;856;2452;99;328;509;1357;608;1685
316030;202206;3103;7916;2372;6643;359;1000;1433;4034;1792;5034
316040;202206;3037;8319;2195;6750;382;1353;605;1579;987;2932
316045;202206;2549;5532;2341;5279;137;198;2055;4738;2192;4936
316050;202206;445;1164;348;1007;35;99;204;542;239;641
316060;202206;816;1827;603;1547;28;89;437;1079;465;1168
316070;202206;6546;16733;5333;14497;772;2161;2766;7133;3538;9294
316080;202206;887;2600;697;2224;164;564;129;353;293;917
316090;202206;529;1359;440;1195;42;146;277;669;319;815
316095;202206;1468;4262;1139;3469;257;852;466;1311;723;2163
316100;202206;2751;7453;2040;6022;313;1059;860;2260;1173;3319
316105;202206;831;2054;661;1784;40;111;437;1192;477;1303
316110;202206;16276;41355;13537;36949;914;2958;9720;25558;10634;28516
316120;202206;1417;3609;922;2590;148;459;349;770;497;1229
316130;202206;1470;3125;985;2353;67;198;620;1382;687;1580
316140;202206;1340;3397;854;2466;144;424;305;850;449;1274
316150;202206;2505;5305;1993;4557;138;401;1133;2392;1271;2793
316160;202206;1136;2826;910;2433;41;145;663;1722;704;1867
316165;202206;1033;2281;817;1972;83;214;543;1244;626;1458
316170;202206;1484;3241;1145;2762;67;221;833;1853;900;2074
316180;202206;1770;4711;1265;3759;240;777;332;881;572;1658
316190;202206;3042;8199;1794;5312;242;733;740;1909;982;2642
316200;202206;4084;10711;3214;9267;571;1849;1381;3779;1952;5628
316210;202206;6096;16915;4373;12937;1428;4578;514;1317;1942;5895
316220;202206;776;2231;537;1768;104;350;96;336;200;686
316225;202206;1852;3878;1411;3218;48;181;1105;2286;1153;2467
316230;202206;554;1384;426;1172;85;252;211;566;296;818
316240;202206;6414;17125;5578;15663;412;1268;4131;11334;4543;12602
316245;202206;3670;10531;3307;9961;163;750;2603;7454;2766;8204
316250;202206;12727;28914;9635;23951;1834;4792;3841;9459;5675;14251
316255;202206;3432;8920;2973;8193;139;383;2214;6131;2353;6514
316257;202206;1648;3595;1222;2920;82;214;851;1918;933;2132
316260;202206;2918;6153;2310;5233;228;500;1502;3309;1730;3809
316265;202206;1258;3216;986;2761;25;79;730;1969;755;2048
316270;202206;4285;12182;3652;10873;433;1368;2055;5768;2488;7136
316280;202206;3434;8763;2894;7797;351;1045;1694;4362;2045;5407
316290;202206;4392;11185;3488;9509;422;1277;1472;3725;1894;5002
316292;202206;6686;16398;5394;14387;603;1776;3573;9127;4176;10903
316294;202206;1025;2888;784;2486;128;490;242;682;370;1172
316295;202206;3918;10294;3219;9137;227;789;2135;5719;2362;6508
316300;202206;1168;3033;921;2660;55;171;648;1835;703;2006
316310;202206;910;2334;629;1844;138;468;195;515;333;983
316320;202206;769;2035;594;1763;120;394;145;377;265;771
316330;202206;1210;2939;924;2466;61;173;685;1788;746;1961
316340;202206;1120;2870;853;2408;70;263;530;1389;600;1652
316350;202206;1549;3950;1300;3537;162;447;874;2313;1036;2760
316360;202206;745;1814;630;1634;52;134;492;1292;544;1426
316370;202206;6738;15949;5222;13436;605;1870;2839;6369;3444;8239
316380;202206;1985;4386;1581;3822;86;188;1133;2697;1219;2885
316390;202206;847;2190;628;1823;249;815;124;310;373;1125
316400;202206;1356;3617;899;2746;106;350;335;897;441;1247
316410;202206;1356;3305;1138;2984;36;127;958;2421;994;2548
316420;202206;2234;5624;1908;5186;39;173;1571;4109;1610;4282
316430;202206;1017;2529;699;1996;107;354;291;764;398;1118
316440;202206;983;2854;807;2545;137;502;239;670;376;1172
316443;202206;651;1707;467;1368;102;347;136;372;238;719
316447;202206;2468;5780;2113;5256;28;95;1874;4551;1902;4646
316450;202206;2412;6621;1841;5487;209;688;1133;3249;1342;3937
316460;202206;1463;3614;1199;3188;113;337;790;1968;903;2305
316470;202206;8393;22401;6323;18351;856;2887;2915;7486;3771;10373
316480;202206;234;585;199;541;40;110;115;298;155;408
316490;202206;374;994;274;810;49;166;94;233;143;399
316500;202206;1472;4241;1015;3190;201;682;263;730;464;1412
316510;202206;915;2776;742;2447;121;405;372;1213;493;1618
316520;202206;1586;3660;1226;3039;176;499;566;1219;742;1718
316530;202206;1225;3015;898;2446;104;361;437;1070;541;1431
316540;202206;1173;2764;953;2456;136;406;485;1123;621;1529
316550;202206;1620;4234;1362;3784;54;190;1097;2989;1151;3179
316553;202206;5354;14621;3972;11514;497;1640;1805;4533;2302;6173
316555;202206;3086;8434;2696;7929;80;306;2291;6633;2371;6939
316556;202206;598;1357;461;1123;33;103;284;574;317;677
316557;202206;1338;3762;1157;3492;394;1299;431;1237;825;2536
316560;202206;413;1116;308;956;47;172;133;379;180;551
316570;202206;1604;4230;1343;3788;311;810;464;1401;775;2211
316580;202206;437;870;292;645;31;76;166;340;197;416
316590;202206;1498;3566;1041;2727;150;359;576;1449;726;1808
316600;202206;1095;3018;953;2758;135;424;578;1606;713;2030
316610;202206;711;1997;573;1779;58;230;340;1003;398;1233
316620;202206;2581;5984;2256;5514;130;304;1814;4378;1944;4682
316630;202206;1782;4943;1494;4416;383;1088;584;1974;967;3062
316640;202206;184;477;149;421;30;101;61;140;91;241
316650;202206;1267;3413;1027;3049;69;239;700;1997;769;2236
316660;202206;210;491;98;265;13;39;29;60;42;99
316670;202206;1912;4563;1440;3837;375;1035;482;1199;857;2234
316680;202206;2659;6474;2011;5293;155;471;1386;3522;1541;3993
316690;202206;1572;4243;1172;3510;199;675;385;1031;584;1706
316695;202206;1110;3064;903;2698;18;70;607;1758;625;1828
316700;202206;543;1009;461;922;15;34;402;776;417;810
316710;202206;3844;11274;3061;9738;437;1574;1620;4860;2057;6434
316720;202206;24196;62025;18663;51949;2770;8362;9139;23733;11909;32095
316730;202206;601;1361;483;1170;54;147;270;578;324;725
316740;202206;945;2480;826;2299;107;331;570;1566;677;1897
316750;202206;453;1207;339;1018;64;202;147;406;211;608
316760;202206;4410;12703;3771;11533;1278;4306;1443;4305;2721;8611
316770;202206;1834;3812;1383;3225;34;82;1116;2640;1150;2722
316780;202206;669;1834;546;1625;206;670;124;308;330;978
316790;202206;850;2145;625;1717;83;253;202;520;285;773
316800;202206;7527;19640;6035;17064;729;2243;3077;8343;3806;10586
316805;202206;1303;2489;1056;2212;34;90;908;1861;942;1951
316810;202206;808;2041;598;1666;71;221;399;1082;470;1303
316820;202206;407;880;243;611;18;63;144;327;162;390
316830;202206;979;2377;766;2040;79;213;482;1269;561;1482
316840;202206;3328;7779;2676;6769;149;470;2053;4945;2202;5415
316850;202206;2477;5759;1881;4782;174;539;1163;2690;1337;3229
316860;202206;25167;58919;19080;49921;2464;7494;10103;24912;12567;32406
316870;202206;9781;24484;7461;20285;898;2789;3901;9616;4799;12405
316880;202206;1205;2937;1018;2680;110;350;648;1567;758;1917
316890;202206;1341;2920;836;2251;102;337;530;1347;632;1684
316900;202206;2829;7030;2257;6017;399;1097;941;2307;1340;3404
316905;202206;567;1600;464;1409;120;360;192;619;312;979
316910;202206;1150;2797;795;2203;220;646;215;558;435;1204
316920;202206;2159;4753;1598;3941;195;564;1019;2306;1214;2870
316930;202206;10270;27050;8049;23296;1594;5102;3323;8624;4917;13726
316935;202206;4969;12402;3718;10144;600;1811;1709;4245;2309;6056
316940;202206;7352;20230;5832;17307;849;2815;2670;7253;3519;10068
316950;202206;2256;4803;1749;4133;44;127;1489;3445;1533;3572
316960;202206;5977;12461;4368;10355;337;872;3116;7163;3453;8035
316970;202206;4634;11856;3925;10657;556;1569;1845;4677;2401;6246
316980;202206;874;2350;655;2009;210;716;178;518;388;1234
316990;202206;14770;37200;11235;30450;2471;7126;2488;6033;4959;13159
317000;202206;2942;7691;2577;7207;215;500;1917;5492;2132;5992
317005;202206;2977;7765;2334;6509;328;978;1313;3498;1641;4476
317010;202206;30786;69260;20925;54494;3421;9596;10267;26171;13688;35767
317020;202206;79515;182050;50137;132068;8819;25183;18553;44384;27372;69567
317030;202206;784;1944;629;1727;17;61;476;1279;493;1340
317040;202206;13102;31303;9178;24795;2083;6033;3050;8397;5133;14430
317043;202206;1041;2127;765;1762;41;103;596;1331;637;1434
317047;202206;1318;2935;923;2313;52;161;658;1569;710;1730
317050;202206;1384;4081;1011;3247;150;553;395;1057;545;1610
317052;202206;2833;6983;2263;6106;196;559;1560;4115;1756;4674
317057;202206;2367;4862;1786;4029;39;119;1377;2945;1416;3064
317060;202206;570;1472;346;1015;49;153;135;343;184;496
317065;202206;1250;3483;1025;3052;75;272;650;1791;725;2063
317070;202206;8863;23660;6861;19900;1061;3474;2951;7859;4012;11333
317075;202206;1169;2819;888;2353;99;288;505;1235;604;1523
317080;202206;7553;16548;5758;13756;1122;2839;2735;6311;3857;9150
317090;202206;5441;14392;4780;13365;270;745;3606;10024;3876;10769
317100;202206;2979;6800;1993;5222;394;1057;845;2122;1239;3179
317103;202206;2666;6149;2260;5579;87;355;1830;4277;1917;4632
317107;202206;1738;4128;1309;3345;49;166;855;1885;904;2051
317110;202206;780;1761;431;1213;75;249;162;445;237;694
317115;202206;1240;3356;1026;2967;102;313;651;1868;753;2181
317120;202206;21000;51519;17422;45925;1129;3797;11921;29300;13050;33097
317130;202206;13212;29326;9172;22791;1256;3382;3622;8854;4878;12236
317140;202206;1087;2444;843;2066;65;154;586;1434;651;1588
317150;202206;1128;2511;875;2193;39;127;707;1714;746;1841
317160;202206;3991;9065;2639;6929;245;601;1401;3843;1646;4444
317170;202206;2268;5314;1732;4378;100;312;1131;2574;1231;2886
317180;202206;2178;6394;1619;5102;318;1063;449;1290;767;2353
317190;202206;1280;3303;964;2795;136;408;529;1509;665;1917
317200;202206;7276;18223;5454;14724;1111;3159;1532;3695;2643;6854
317210;202206;1386;3118;1075;2703;39;142;781;1959;820;2101
317220;202206;360;985;309;894;58;173;174;484;232;657
320010;202206;5378;14955;4157;12505;474;1593;2381;6879;2855;8472
320013;202206;2423;6181;1735;4899;274;801;816;2365;1090;3166
320016;202206;3282;7961;2549;6841;210;570;1731;4608;1941;5178
320020;202206;5242;12630;4002;10533;597;1798;1965;5016;2562;6814
320030;202206;2040;5354;1349;3991;200;637;550;1514;750;2151
320035;202206;2246;5617;1856;4992;332;1009;1051;2714;1383;3723
320040;202206;5086;13492;4238;12011;556;1700;2357;6349;2913;8049
320050;202206;2142;4596;1846;4178;213;589;1181;2474;1394;3063
320060;202206;16410;42315;12366;34461;1929;5849;5801;14794;7730;20643
320070;202206;2150;5354;1607;4353;226;745;828;1959;1054;2704
320080;202206;6507;15786;4642;12223;810;2278;1973;4784;2783;7062
320090;202206;9835;24954;6654;18658;1367;4111;2551;6498;3918;10609
320100;202206;3808;9424;3098;8219;416;1209;1800;4611;2216;5820
320110;202206;2647;5683;1951;4626;194;575;1211;2595;1405;3170
320115;202206;2547;7431;2195;6885;707;2280;921;3013;1628;5293
320120;202206;30186;72206;21903;57885;2773;8105;11218;27354;13991;35459
320130;202206;63691;160295;52797;141582;6142;18097;32579;83203;38721;101300
320140;202206;4540;11713;3231;9194;395;1338;1595;4224;1990;5562
320150;202206;16938;41484;12294;33128;2898;8691;2128;4893;5026;13584
320160;202206;7413;19204;5540;15839;668;2133;2750;7553;3418;9686
320170;202206;2111;5640;1521;4512;391;1175;577;1767;968;2942
320180;202206;863;2542;686;2193;234;818;183;543;417;1361
320190;202206;3478;10379;2653;8606;595;2165;636;1840;1231;4005
320200;202206;1526;3972;1054;3127;225;726;311;917;536;1643
320210;202206;5336;12756;4106;10699;618;1783;2241;5436;2859;7219
320220;202206;4090;9825;3141;8306;557;1535;1555;3867;2112;5402
320225;202206;1709;4927;1188;3770;350;1212;293;903;643;2115
320230;202206;6390;16201;4849;13641;1065;3144;1609;4555;2674;7699
320240;202206;20337;48658;15307;40844;3745;10736;4883;12631;8628;23367
320245;202206;3763;10461;2774;8368;824;2645;498;1427;1322;4072
320250;202206;3248;8116;2194;5846;389;1143;930;2147;1319;3290
320255;202206;2432;6829;2115;6284;423;1328;1245;3705;1668;5033
320260;202206;1692;4519;1076;3238;232;741;269;668;501;1409
320265;202206;2726;8045;2133;6839;866;3001;336;1019;1202;4020
320270;202206;2580;6965;2008;5845;490;1602;691;1955;1181;3557
320280;202206;9495;23112;7773;20332;1153;3429;4697;11552;5850;14981
320290;202206;1556;4406;1007;3155;252;871;268;787;520;1658
320300;202206;5005;13794;4044;11948;1046;3419;1459;4086;2505;7505
320305;202206;6241;16244;4774;13532;857;2691;2300;6176;3157;8867
320310;202206;2571;6605;1819;5086;320;962;801;2033;1121;2995
320313;202206;2914;6830;2001;5209;366;1059;695;1552;1061;2611
320316;202206;1869;4954;1436;4243;231;678;785;2318;1016;2996
320320;202206;26407;65397;19143;53252;4250;12348;7233;19838;11483;32186
320330;202206;3396;8581;2666;7329;418;1186;1504;4130;1922;5316
320332;202206;9877;24673;7889;21183;1496;4352;3961;10205;5457;14557
320334;202206;2158;5764;1498;4441;281;1001;393;888;674;1889
320335;202206;1930;5350;1344;4027;244;852;435;1185;679;2037
320340;202206;6414;14203;5373;12736;429;1151;3627;8405;4056;9556
320350;202206;6307;14328;4466;11192;446;1294;2532;5816;2978;7110
320360;202206;1617;3942;1195;3179;137;378;593;1492;730;1870
320370;202206;3232;9157;2494;7633;687;2323;897;2565;1584;4888
320380;202206;3372;7974;2792;7039;255;788;1863;4384;2118;5172
320390;202206;9215;22886;6798;18251;1335;3830;2878;7217;4213;11047
320400;202206;3818;10202;2851;8196;737;2286;1089;2940;1826;5226
320405;202206;6284;15109;4774;12580;632;1773;2626;6597;3258;8370
320410;202206;5699;13824;4353;11703;724;1958;2173;5895;2897;7853
320420;202206;4507;10571;3482;8980;765;2129;1288;3121;2053;5250
320425;202206;2542;5688;1960;4753;158;402;1280;2961;1438;3363
320430;202206;3725;8942;2966;7669;399;1091;1807;4494;2206;5585
320435;202206;2704;7884;2125;6698;590;1997;820;2622;1410;4619
320440;202206;1837;4752;1380;3898;240;725;601;1548;841;2273
320450;202206;2336;6066;1865;5228;298;1021;1030;2598;1328;3619
320455;202206;5176;14921;3570;11281;839;2962;916;2522;1755;5484
320460;202206;2468;6937;1812;5612;476;1644;519;1460;995;3104
320465;202206;1759;4628;1275;3702;256;786;592;1705;848;2491
320470;202206;4704;11832;3540;9542;673;2052;1281;3039;1954;5091
320480;202206;2660;6130;2170;5329;285;688;1383;3299;1668;3987
320490;202206;29388;69602;22314;57823;3783;10035;10404;26443;14187;36478
320495;202206;1633;4236;1191;3385;282;922;257;619;539;1541
320500;202206;73291;179927;59437;156876;6829;20229;36885;91555;43714;111784
320501;202206;5751;15624;4370;13154;1225;4115;1306;3815;2531;7930
320503;202206;2897;7846;1946;5914;535;1754;528;1511;1063;3265
320506;202206;3152;8984;2388;7374;687;2291;328;964;1015;3255
320510;202206;13884;34438;11316;30197;1141;3444;7084;17943;8225;21387
320515;202206;2091;5484;1593;4467;425;1290;529;1397;954;2687
320517;202206;2557;7101;2056;6084;587;1852;748;2165;1335;4017
320520;202206;50295;121299;38787;102391;5680;16647;18701;46529;24381;63176
320530;202206;41465;100627;33118;86573;2556;8152;21632;52399;24188;60551
330010;202206;31114;73109;26184;65453;2117;6111;19386;46387;21503;52498
330015;202206;1839;4064;1472;3534;183;549;956;2111;1139;2660
330020;202206;24387;56212;20638;50976;2114;5776;15251;36733;17365;42509
330022;202206;2310;5860;1798;5047;301;877;862;2391;1163;3268
330023;202206;7798;17200;6133;14741;802;2116;3997;9200;4799;11316
330025;202206;8570;18482;5663;13820;1023;2784;2165;4853;3188;7637
330030;202206;13324;31881;10388;27317;701;2379;7211;17661;7912;20040
330040;202206;20106;47860;16653;42372;838;2767;12525;30031;13363;32798
330045;202206;120244;246708;102199;224551;4786;11583;87235;187601;92021;199184
330050;202206;3574;8664;2804;7458;432;1347;1630;3988;2062;5335
330060;202206;6916;16319;5472;13901;975;2878;2483;5718;3458;8596
330070;202206;33459;75335;27864;67669;3290;8682;18896;44798;22186;53480
330080;202206;12186;26781;10377;24321;1128;2825;7299;16865;8427;19690
330090;202206;4071;7873;2992;6434;193;391;2171;4674;2364;5065
330093;202206;3416;7454;2629;6433;132;369;2116;5033;2248;5402
330095;202206;1748;4422;1367;3741;143;432;806;2059;949;2491
330100;202206;90207;212159;78544;195807;3146;9953;63722;154497;66868;164450
330110;202206;2723;6779;2211;5980;254;790;1440;3667;1694;4457
330115;202206;3408;7531;2454;6071;427;1114;1334;3083;1761;4197
330120;202206;4401;8650;3418;7453;160;436;2723;5648;2883;6084
330130;202206;6132;14911;5096;13416;647;1774;3362;8641;4009;10415
330140;202206;5061;11096;4190;9950;234;739;3372;7652;3606;8391
330150;202206;3059;7307;2457;6370;384;1096;1460;3564;1844;4660
330160;202206;1810;4463;1400;3790;282;823;757;1890;1039;2713
330170;202206;168220;359084;141564;324396;15764;36282;104842;237497;120606;273779
330180;202206;2559;5462;2062;4803;97;299;1606;3565;1703;3864
330185;202206;13585;29486;11510;26775;418;1287;9850;22146;10268;23433
330187;202206;6486;14506;5140;12393;635;1639;3340;7631;3975;9270
330190;202206;53947;111816;46825;102410;2000;5235;39515;83835;41515;89070
330200;202206;21893;49394;18156;44827;2500;6007;12921;31901;15421;37908
330205;202206;2718;6181;2086;5182;142;420;1444;3364;1586;3784
330210;202206;4017;9124;3023;7534;365;955;1717;3978;2082;4933
330220;202206;16824;38084;12576;31273;1945;5420;6077;13719;8022;19139
330225;202206;4961;11545;3893;10001;197;619;2903;7214;3100;7833
330227;202206;23301;49741;20067;45915;525;1511;17929;40104;18454;41615
330230;202206;2367;5033;1587;4017;148;396;797;1994;945;2390
330240;202206;31151;72985;26431;66065;1996;5733;19893;47963;21889;53696
330245;202206;2090;4825;1336;3549;261;733;563;1363;824;2096
330250;202206;53267;120023;45067;108479;5242;13611;31793;74733;37035;88344
330260;202206;6136;13410;4705;11541;262;803;3717;8780;3979;9583
330270;202206;40230;88183;25642;64575;3476;9550;12126;28585;15602;38135
330280;202206;3238;7356;2555;6278;167;533;1790;4044;1957;4577
330285;202206;35313;73789;28992;65046;1322;3702;23629;50719;24951;54421
330290;202206;5560;11625;4558;10349;280;835;3646;7823;3926;8658
330300;202206;7081;15062;5361;12710;383;1024;3980;9010;4363;10034
330310;202206;3413;7461;2569;6143;146;378;1887;4312;2033;4690
330320;202206;22026;46882;17323;41090;1786;3718;13015;30813;14801;34531
330330;202206;57803;117061;46560;102396;3151;7744;36037;76523;39188;84267
330340;202206;22720;50118;16970;41568;2247;6434;9602;21566;11849;28000
330350;202206;199481;405321;168761;368883;6940;16512;146842;315633;153782;332145
330360;202206;9338;20236;8023;18653;297;701;6906;15860;7203;16561
330370;202206;6504;16731;5207;14612;912;2822;2779;7460;3691;10282
330380;202206;7905;18550;6262;15758;621;1953;4254;9984;4875;11937
330385;202206;5145;13002;4240;11713;689;2158;2386;6238;3075;8396
330390;202206;40039;94913;30897;79695;3082;9544;20365;48668;23447;58212
330395;202206;4180;9207;3450;8306;132;429;2753;6374;2885;6803
330400;202206;4420;10456;3744;9421;168;591;2926;6859;3094;7450
330410;202206;4214;9826;3144;8098;450;1407;1904;4475;2354;5882
330411;202206;3472;8761;2767;7540;174;601;1931;4936;2105;5537
330412;202206;2075;5186;1704;4600;121;402;1189;3012;1310;3414
330414;202206;30398;69435;25190;62509;1447;4150;19808;47928;21255;52078
330415;202206;5828;14431;4368;11950;407;1235;2594;6753;3001;7988
330420;202206;15801;36568;11804;30268;1176;3567;7028;16585;8204;20152
330430;202206;13854;27663;11934;25201;237;792;10408;21109;10645;21901
330440;202206;3565;8478;2769;7168;281;912;1879;4501;2160;5413
330450;202206;1818;4600;1468;4032;121;375;930;2400;1051;2775
330452;202206;23411;54181;19143;47934;1858;5415;13546;32380;15404;37795
330455;202206;801854;1687279;657044;1489341;64987;159025;480755;1055430;545742;1214455
330460;202206;1471;3684;1144;3216;194;576;623;1712;817;2288
330470;202206;7076;15764;5234;13051;1143;3095;2164;5171;3307;8266
330475;202206;12080;27783;9913;25070;1193;3575;6867;16674;8060;20249
330480;202206;7159;16951;6095;15447;456;1245;4392;10672;4848;11917
330490;202206;140695;297232;115903;264841;9814;23912;87778;196274;97592;220186
330500;202206;10295;22676;8731;20624;540;1457;6828;15682;7368;17139
330510;202206;55562;124342;43268;107684;4678;12604;30564;73935;35242;86539
330513;202206;1610;3758;1306;3346;184;505;783;1977;967;2482
330515;202206;3360;8065;2778;7276;347;1076;1808;4467;2155;5543
330520;202206;16059;37782;13499;34019;1126;3366;9682;23331;10808;26697
330530;202206;2034;4589;1493;3807;261;725;751;1855;1012;2580
330540;202206;3638;8794;2836;7491;639;1803;1252;3199;1891;5002
330550;202206;15458;33415;12310;29349;2017;5299;7570;17400;9587;22699
330555;202206;25025;46599;21169;42150;741;1655;18180;36038;18921;37693
330560;202206;4995;11800;4057;10353;533;1444;2690;6570;3223;8014
330570;202206;3645;8783;3175;8121;443;1255;2223;5556;2666;6811
330575;202206;7621;17244;6642;15662;297;846;5539;12473;5836;13319
330580;202206;26230;62206;21684;54460;3040;8133;12806;30048;15846;38181
330590;202206;1820;4380;1527;4010;208;514;1017;2741;1225;3255
330600;202206;15846;37412;13131;33227;809;2515;9310;22306;10119;24821
330610;202206;12282;29025;10118;25739;921;2641;6967;16971;7888;19612
330615;202206;2675;6458;2184;5810;358;868;1450;3947;1808;4815
330620;202206;5244;13442;4218;11768;828;2535;2022;5351;2850;7886
330630;202206;35354;79534;27987;68294;1274;4100;21103;48667;22377;52767
350010;202206;2656;6699;1659;4663;316;961;449;989;765;1950
350020;202206;854;2103;520;1477;65;204;182;469;247;673
350030;202206;4252;10997;3314;9444;655;2154;1743;4582;2398;6736
350040;202206;909;2464;553;1735;75;289;182;435;257;724
350050;202206;1711;3986;1184;3124;197;618;474;1022;671;1640
350055;202206;1108;2668;900;2358;113;311;554;1352;667;1663
350060;202206;317;753;172;459;26;83;69;173;95;256
350070;202206;4005;9997;2729;7755;426;1381;1137;2843;1563;4224
350075;202206;736;2001;569;1693;194;586;114;347;308;933
350080;202206;773;1938;548;1558;55;180;257;656;312;836
350090;202206;701;1530;442;1109;69;201;246;552;315;753
350100;202206;2966;7214;2146;5874;126;463;1425;3578;1551;4041
350110;202206;576;1354;431;1110;14;46;296;725;310;771
350115;202206;1413;3916;1156;3410;179;588;602;1621;781;2209
350120;202206;760;1723;449;1196;39;131;251;601;290;732
350130;202206;3887;9677;3081;8236;461;1321;1646;3998;2107;5319
350140;202206;859;2241;623;1819;43;161;361;960;404;1121
350150;202206;585;1665;484;1488;92;309;165;436;257;745
350160;202206;14152;34546;9990;26908;1259;3811;5946;14946;7205;18757
350170;202206;3006;7902;2528;6914;342;1056;1434;3552;1776;4608
350180;202206;1178;2717;705;1888;104;297;342;836;446;1133
350190;202206;3855;10477;2755;8051;377;1318;1365;3393;1742;4711
350200;202206;557;1447;439;1227;22;75;297;767;319;842
350210;202206;7314;16028;5177;12728;415;1229;3502;8053;3917;9282
350220;202206;3513;9205;2513;7309;452;1395;1021;2668;1473;4063
350230;202206;1217;2914;987;2597;153;462;587;1468;740;1930
350240;202206;708;1926;475;1409;91;275;124;318;215;593
350250;202206;4059;10435;3075;8860;754;2282;1082;2990;1836;5272
350260;202206;1005;2202;644;1609;64;176;386;887;450;1063
350270;202206;5306;13216;4264;11366;539;1638;2505;6141;3044;7779
350275;202206;3169;7841;2593;7002;251;835;1817;4607;2068;5442
350280;202206;21890;48122;14165;35923;2124;5693;6818;16158;8942;21851
350290;202206;3893;10207;2802;8046;467;1461;1293;3407;1760;4868
350300;202206;792;1938;612;1622;71;210;366;893;437;1103
350310;202206;1110;2939;858;2467;104;348;402;1053;506;1401
350315;202206;711;1659;507;1340;28;101;301;691;329;792
350320;202206;19272;47084;14732;39286;2507;7462;7019;17054;9526;24516
350330;202206;16538;38451;12310;30821;1059;3050;8290;19330;9349;22380
350335;202206;425;1150;333;981;39;124;153;432;192;556
350340;202206;1522;3745;937;2667;118;388;436;1116;554;1504
350350;202206;856;2035;671;1835;89;267;421;1130;510;1397
350360;202206;1276;3531;1008;3007;175;555;446;1283;621;1838
350370;202206;817;1919;591;1510;185;444;211;509;396;953
350380;202206;5572;14594;4080;11508;951;2787;1438;3786;2389;6573
350390;202206;13314;32547;10588;28171;1424;4105;6269;15646;7693;19751
350395;202206;503;1237;263;781;35;105;87;237;122;342
350400;202206;9993;23461;7159;18912;1777;4943;2207;5670;3984;10613
350410;202206;12737;33581;9607;27763;1764;5638;4190;11164;5954;16802
350420;202206;1228;3047;881;2369;150;413;294;669;444;1082
350430;202206;776;1889;599;1616;71;222;352;855;423;1077
350440;202206;2473;5702;2013;5034;115;342;1394;3287;1509;3629
350450;202206;8086;21170;6393;18298;1242;4022;3021;7913;4263;11935
350460;202206;2468;6101;1535;4318;219;640;667;1692;886;2332
350470;202206;288;676;230;588;9;26;171;416;180;442
350480;202206;1147;2721;779;2115;175;524;209;494;384;1018
350490;202206;2285;5559;1655;4574;296;915;686;1671;982;2586
350500;202206;750;1883;546;1537;68;209;227;595;295;804
350510;202206;1419;3379;1081;2802;92;274;696;1675;788;1949
350520;202206;2750;7716;2193;6705;315;1093;1033;2832;1348;3925
350530;202206;3584;8598;2742;7031;232;697;1674;3921;1906;4618
350535;202206;1757;4433;1496;4063;207;639;952;2477;1159;3116
350540;202206;2372;4966;1795;4161;155;387;1305;2842;1460;3229
350550;202206;9999;23551;7018;18694;641;2102;4250;10304;4891;12406
350560;202206;4878;12281;4024;10925;240;811;2931;7550;3171;8361
350570;202206;33921;87775;28025;77191;4190;12775;15486;40248;19676;53023
350580;202206;2500;6291;1624;4620;412;1333;505;1141;917;2474
350590;202206;5764;14817;4320;11768;506;1574;2648;6647;3154;8221
350600;202206;39742;89279;25725;65783;3607;10472;12663;29581;16270;40053
350610;202206;8503;21788;6205;17409;779;2527;3386;8755;4165;11282
350620;202206;492;1198;312;915;33;110;177;478;210;588
350630;202206;1909;4351;1419;3558;94;293;998;2294;1092;2587
350635;202206;12126;27542;9295;23234;1010;2849;6193;14738;7203;17587
350640;202206;1063;2761;589;1738;102;315;180;437;282;752
350650;202206;10440;26428;7494;20875;1228;3792;3261;8276;4489;12068
350660;202206;5676;13665;4461;11754;522;1388;2782;7139;3304;8527
350670;202206;2030;5215;1637;4630;225;675;1004;2825;1229;3500
350680;202206;1298;3341;899;2607;138;406;388;1061;526;1467
350690;202206;1605;3960;1160;3197;172;517;630;1667;802;2184
350700;202206;5783;13718;4460;11754;779;2360;2434;5946;3213;8306
350710;202206;3497;8824;2969;7958;535;1644;1630;4008;2165;5652
350715;202206;883;2384;749;2169;141;486;373;938;514;1424
350720;202206;186;450;136;375;18;47;60;150;78;197
350730;202206;715;1934;570;1645;43;149;352;922;395;1071
350740;202206;2042;5061;1417;3850;234;688;539;1299;773;1987
350745;202206;736;1779;428;1196;35;117;211;534;246;651
350750;202206;12538;31182;10013;26992;1637;5169;5168;12604;6805;17773
350760;202206;19509;44957;14760;37155;2223;6593;8135;18142;10358;24735
350770;202206;1227;2882;761;2102;63;188;442;1168;505;1356
350775;202206;812;1802;574;1461;69;171;307;759;376;930
350780;202206;2803;6419;2059;5411;541;1292;838;2478;1379;3770
350790;202206;2508;6430;1647;4853;339;1014;479;1208;818;2222
350800;202206;4285;11297;3653;10252;230;792;2601;6955;2831;7747
350810;202206;3414;7771;2603;6595;507;1295;1250;3063;1757;4358
350820;202206;1114;2505;677;1728;71;216;367;847;438;1063
350830;202206;999;2613;593;1758;105;338;178;416;283;754
350840;202206;4084;11374;3169;9720;574;1950;1472;4131;2046;6081
350850;202206;9678;24912;7708;21512;1211;3708;4322;11252;5533;14960
350860;202206;4276;10494;3716;9755;135;493;2932;7519;3067;8012
350870;202206;3165;8177;2372;6929;299;944;1292;3638;1591;4582
350880;202206;1705;4504;1387;3904;362;1047;445;1151;807;2198
350890;202206;573;1459;378;1062;48;149;136;326;184;475
350900;202206;10767;26891;7743;20921;1155;3505;4079;9879;5234;13384
350910;202206;1095;2461;934;2233;79;211;733;1693;812;1904
350920;202206;14775;34215;12582;30831;429;1404;10435;24468;10864;25872
350925;202206;4788;12268;3501;10085;567;1867;1832;4804;2399;6671
350930;202206;1708;4270;1194;3290;86;260;683;1816;769;2076
350940;202206;2927;7073;2317;6113;212;654;1590;3946;1802;4600
350945;202206;1070;2807;820;2344;134;386;388;1025;522;1411
350950;202206;111721;269797;87421;226027;9963;28387;55775;136243;65738;164630
350960;202206;7778;19910;6066;16751;800;2491;3449;8946;4249;11437
350970;202206;4350;11459;3211;9382;872;2809;996;2410;1868;5219
350980;202206;824;2059;679;1812;143;407;347;875;490;1282
350990;202206;2331;5892;1775;5011;401;1267;723;1928;1124;3195
350995;202206;999;2882;901;2697;81;300;600;1696;681;1996
351000;202206;3544;8915;2386;6724;526;1545;803;2156;1329;3701
351010;202206;444;1078;291;807;42;135;141;374;183;509
351015;202206;1106;3114;917;2742;163;533;413;1088;576;1621
351020;202206;9964;25393;7635;21498;1494;4431;3803;10148;5297;14579
351030;202206;3513;9646;2826;8319;410;1384;1577;4371;1987;5755
351040;202206;6258;14249;5274;12805;194;607;4376;10206;4570;10813
351050;202206;20633;47772;15723;40516;2479;6867;8633;21340;11112;28207
351060;202206;58329;138303;45186;116584;3765;11030;31509;77819;35274;88849
351070;202206;1680;3928;980;2793;273;804;187;482;460;1286
351080;202206;3296;7521;2451;6520;244;781;1692;4214;1936;4995
351090;202206;379;1012;291;861;54;174;108;301;162;475
351100;202206;3305;8391;2214;6275;465;1447;741;2002;1206;3449
351110;202206;7375;18183;5159;14232;739;2329;2619;6713;3358;9042
351120;202206;846;2117;597;1686;102;290;228;595;330;885
351130;202206;1346;3485;642;1915;107;359;174;438;281;797
351140;202206;2673;6988;2044;5858;419;1342;952;2420;1371;3762
351150;202206;3411;9183;2396;7105;319;1084;944;2445;1263;3529
351160;202206;1346;3962;1004;3203;197;681;247;660;444;1341
351170;202206;1743;4440;1513;4038;129;396;1072;2697;1201;3093
351190;202206;1161;3071;811;2391;183;538;278;767;461;1305
351200;202206;1919;4380;1460;3736;106;316;1046;2507;1152;2823
351210;202206;1731;4047;1137;3006;69;250;686;1625;755;1875
351220;202206;4251;10666;3682;9782;308;844;2614;6694;2922;7538
351230;202206;2493;6165;1942;5239;334;1014;985;2364;1319;3378
351240;202206;2795;6878;1787;4873;445;1223;537;1308;982;2531
351250;202206;1218;3137;736;2153;77;257;286;799;363;1056
351260;202206;1029;2439;736;1924;143;387;295;713;438;1100
351270;202206;616;1583;429;1214;50;166;212;492;262;658
351280;202206;4543;11390;3504;9543;693;1948;1490;3802;2183;5750
351290;202206;1736;3902;1141;2907;124;356;757;1830;881;2186
351300;202206;24198;61446;17632;49491;2969;9081;8678;22812;11647;31893
351310;202206;4241;9757;3240;8213;158;546;2415;5756;2573;6302
351320;202206;1033;2891;761;2361;146;493;238;640;384;1133
351330;202206;555;1331;431;1084;26;92;305;681;331;773
351340;202206;8496;21059;7096;18685;1282;3748;4125;10035;5407;13783
351350;202206;14809;34795;12357;30950;830;2400;9579;22945;10409;25345
351360;202206;4694;11453;3874;10284;737;2231;2029;4859;2766;7090
351370;202206;2402;6378;1657;4893;388;1264;497;1251;885;2515
351380;202206;54433;124840;39550;100164;4130;11570;24983;59903;29113;71473
351385;202206;461;1135;200;582;26;72;78;207;104;279
351390;202206;1608;3671;1073;2918;86;270;778;2032;864;2302
351400;202206;1247;3205;1025;2778;116;306;644;1675;760;1981
351410;202206;3053;8014;2280;6585;374;1117;1015;2788;1389;3905
351420;202206;582;1329;350;937;38;103;217;532;255;635
351430;202206;1148;2820;935;2486;51;154;705;1797;756;1951
351440;202206;4075;10210;2785;7687;546;1586;848;1985;1394;3571
351450;202206;2011;5070;1412;4028;280;938;362;778;642;1716
351460;202206;1117;2754;909;2433;115;341;582;1488;697;1829
351470;202206;1423;3404;1132;2940;68;225;776;1881;844;2106
351480;202206;2831;7689;2244;6767;364;1296;1108;3030;1472;4326
351490;202206;2516;6564;2169;5969;76;313;1744;4609;1820;4922
351492;202206;403;1017;350;910;4;14;278;707;282;721
351495;202206;252;619;202;532;19;43;120;300;139;343
351500;202206;49248;111779;38276;94514;4831;12684;24999;58650;29830;71334
351510;202206;15513;35423;11592;29047;1218;3480;7659;18166;8877;21646
351512;202206;557;1414;412;1109;80;215;160;397;240;612
351515;202206;3880;8512;2504;6281;489;1299;652;1713;1141;3012
351518;202206;2845;6900;1898;5266;264;852;896;2133;1160;2985
351519;202206;708;1867;443;1372;92;290;89;234;181;524
351520;202206;1446;3459;689;1996;72;256;338;868;410;1124
351530;202206;404;1018;246;703;39;115;113;274;152;389
351535;202206;1980;4674;1426;3741;225;629;701;1733;926;2362
351540;202206;3151;7338;2168;5665;228;713;1125;2549;1353;3262
351550;202206;8644;20455;6066;15951;599;1798;3501;8432;4100;10230
351560;202206;583;1580;466;1361;110;357;154;407;264;764
351565;202206;289;775;232;673;46;160;73;174;119;334
351570;202206;26488;65762;20841;55181;1842;5453;13834;34733;15676;40186
351580;202206;268;662;157;472;15;42;70;208;85;250
351590;202206;546;1211;286;760;27;77;161;394;188;471
351600;202206;1532;3948;1176;3276;183;527;598;1535;781;2062
351610;202206;819;1846;532;1363;41;114;300;709;341;823
351620;202206;28370;71262;21222;59586;3085;10107;10512;26876;13597;36983
351630;202206;33650;81734;27449;71766;2480;7583;19391;48043;21871;55626
351640;202206;22147;53242;17779;45913;1171;3742;12916;31378;14087;35120
351650;202206;433;1148;223;682;34;118;58;154;92;272
351660;202206;785;2117;532;1597;95;297;124;305;219;602
351670;202206;7204;18481;4810;13419;999;2733;1995;5094;2994;7827
351680;202206;502;1312;340;976;56;164;102;236;158;400
351685;202206;518;1372;410;1208;93;271;165;436;258;707
351690;202206;1377;3382;810;2319;89;298;382;1005;471;1303
351700;202206;1572;3707;1161;3029;203;594;625;1481;828;2075
351710;202206;937;2304;714;1915;61;204;423;1009;484;1213
351720;202206;1772;4319;1240;3420;199;574;569;1456;768;2030
351730;202206;1157;2771;953;2452;73;231;607;1424;680;1655
351740;202206;3929;9385;3191;8075;458;1276;1803;4173;2261;5449
351750;202206;1907;4727;1167;3422;167;519;549;1518;716;2037
351760;202206;3881;10133;2959;8409;541;1751;1431;3651;1972;5402
351770;202206;2324;6056;1910;5320;367;1021;1110;2971;1477;3992
351780;202206;1352;3289;821;2327;111;355;339;891;450;1246
351790;202206;1738;3920;1348;3386;170;442;869;2106;1039;2548
351800;202206;569;1247;295;761;39;107;119;262;158;369
351810;202206;1276;3191;1066;2881;190;525;610;1534;800;2059
351820;202206;3402;8806;2520;7154;567;1750;829;2119;1396;3869
351830;202206;5551;13603;4277;11493;359;1140;2782;6992;3141;8132
351840;202206;10758;27558;8350;23346;936;2958;5011;12915;5947;15873
351850;202206;1727;4565;1137;3406;183;617;409;989;592;1606
351860;202206;3092;8358;2382;7118;282;968;1427;4179;1709;5147
351870;202206;30283;72519;23301;61329;4931;13318;10865;28376;15796;41694
351880;202206;181717;427008;141760;361591;21726;63331;85323;202165;107049;265496
351885;202206;1119;2749;895;2401;50;186;636;1610;686;1796
351890;202206;971;2431;638;1884;122;418;156;390;278;808
351900;202206;1423;3551;1089;3057;94;254;709;1950;803;2204
351905;202206;611;1643;457;1351;49;169;228;583;277;752
351907;202206;26087;64550;20653;55278;2050;6301;13790;34920;15840;41221
351910;202206;1946;4742;1414;3694;126;371;828;1907;954;2278
351920;202206;1001;2552;773;2129;115;349;324;789;439;1138
351925;202206;1104;2787;877;2405;93;312;527;1330;620;1642
351930;202206;4215;10604;3807;9900;325;969;3042;7686;3367;8655
351940;202206;1238;3064;903;2490;136;440;435;1175;571;1615
351950;202206;1964;4047;1516;3434;63;184;1127;2408;1190;2592
351960;202206;6113;14651;4612;12120;1065;2879;1966;4848;3031;7727
351970;202206;10416;27156;8496;24044;1127;3809;5361;14171;6488;17980
351980;202206;1220;2809;827;2174;98;321;483;1142;581;1463
351990;202206;1704;3805;1257;3168;56;185;677;1501;733;1686
352000;202206;3182;8338;2739;7479;248;803;1867;4751;2115;5554
352010;202206;2739;6767;2226;5970;615;1696;629;1713;1244;3409
352020;202206;1786;4538;1414;3913;233;733;758;1923;991;2656
352030;202206;7128;17208;5731;15014;719;2214;3632;8954;4351;11168
352040;202206;4926;11833;3551;9309;570;1641;1364;3178;1934;4819
352042;202206;3930;8896;2730;7072;349;1048;1622;4071;1971;5119
352044;202206;2512;6380;1556;4588;248;820;368;888;616;1708
352050;202206;15943;40516;10920;30840;2682;8223;2795;6672;5477;14895
352060;202206;881;2247;673;1887;112;344;299;765;411;1109
352070;202206;1063;2085;712;1628;41;111;436;909;477;1020
352080;202206;530;1327;337;966;41;109;110;291;151;400
352090;202206;1827;5072;1527;4512;172;593;770;2055;942;2648
352100;202206;4315;11416;3421;9731;589;1903;1623;4313;2212;6216
352110;202206;796;2153;600;1790;121;369;240;643;361;1012
352115;202206;646;1670;537;1512;125;385;275;719;400;1104
352120;202206;1024;2727;821;2339;88;257;503;1322;591;1579
352130;202206;2306;6185;1514;4311;212;612;659;1723;871;2335
352140;202206;1437;3708;1047;2945;190;524;456;1269;646;1793
352150;202206;1041;2571;779;2130;79;248;517;1340;596;1588
352160;202206;1106;2601;807;2118;80;242;420;1043;500;1285
352170;202206;3496;8844;2784;7507;350;1075;1620;4031;1970;5106
352180;202206;2938;7562;2264;6403;471;1412;922;2444;1393;3856
352190;202206;1692;4136;1349;3620;207;597;763;1989;970;2586
352200;202206;372;1097;275;913;41;135;103;331;144;466
352210;202206;24992;54237;19828;47393;978;2850;15920;36841;16898;39691
352215;202206;753;1853;609;1622;112;318;320;819;432;1137
352220;202206;29990;67834;22551;55631;3171;8809;13421;30174;16592;38983
352230;202206;18396;48974;14540;42069;3382;10723;5819;15218;9201;25941
352240;202206;12480;30203;9740;25789;1781;5170;4971;12081;6752;17251
352250;202206;27240;71865;22511;64106;2520;7898;15343;42409;17863;50307
352260;202206;5973;14174;4199;10826;563;1696;2510;5755;3073;7451
352265;202206;1039;2803;918;2627;145;441;535;1481;680;1922
352270;202206;2101;5794;1636;4824;301;1006;660;1745;961;2751
352280;202206;2770;6535;2120;5603;249;764;1238;3023;1487;3787
352290;202206;1675;4428;1345;3799;168;508;746;1886;914;2394
352300;202206;1098;2710;739;2014;76;231;399;1005;475;1236
352310;202206;47560;119655;36409;101439;6254;18269;20252;55293;26506;73562
352320;202206;8055;19210;6344;16211;781;2312;3830;8691;4611;11003
352330;202206;2892;6900;2267;6035;270;942;1500;3655;1770;4597
352340;202206;8123;20341;6229;16960;966;2956;3298;8146;4264;11102
352350;202206;2843;7363;2258;6158;131;439;1581;4087;1712;4526
352360;202206;1650;4119;1317;3528;101;326;935;2355;1036;2681
352370;202206;1216;3234;1044;2963;25;91;835;2314;860;2405
352380;202206;1024;2574;778;2160;162;451;310;806;472;1257
352390;202206;17629;41470;12315;32297;1811;5308;7031;17060;8842;22368
352400;202206;4180;11211;3360;9678;872;2726;1388;3703;2260;6429
352410;202206;4151;9994;3253;8558;277;826;2097;5232;2374;6058
352420;202206;963;2343;652;1834;145;421;206;567;351;988
352430;202206;10123;23081;7616;18942;1027;2874;4329;10054;5356;12928
352440;202206;22416;57906;17223;48228;3751;11112;6881;18328;10632;29440
352450;202206;912;2128;503;1445;68;199;199;506;267;705
352460;202206;3537;9073;2534;7350;460;1426;1134;3045;1594;4471
352470;202206;3899;9588;3012;8169;253;798;1956;4949;2209;5747
352480;202206;5007;11348;3405;8615;432;1309;1756;3940;2188;5249
352490;202206;948;2544;757;2216;130;429;354;963;484;1392
352500;202206;12912;31754;9039;24805;3369;10713;1868;3250;5237;13963
352510;202206;4816;12337;3741;10477;516;1611;2218;5875;2734;7486
352520;202206;3371;8356;2615;7120;380;1193;1547;3791;1927;4984
352530;202206;13535;32866;9581;25699;1758;5328;3675;8339;5433;13667
352540;202206;640;1781;490;1490;80;244;198;544;278;788
352550;202206;1131;2932;781;2326;133;458;296;777;429;1235
352560;202206;728;1844;592;1607;51;183;402;997;453;1180
352570;202206;2723;7316;1819;5526;415;1381;244;490;659;1871
352580;202206;782;1920;667;1725;107;280;354;887;461;1167
352585;202206;411;1076;300;886;30;117;163;430;193;547
352590;202206;15845;39766;11622;32092;2205;6765;6296;15998;8501;22763
352600;202206;2350;5925;1895;5141;143;467;1271;3182;1414;3649
352610;202206;3220;8267;2437;6993;394;1354;1189;3172;1583;4526
352620;202206;6743;15834;5167;13631;1159;3125;2531;6541;3690;9666
352630;202206;1009;2356;759;2017;111;323;380;968;491;1291
352640;202206;3654;8835;2699;7168;259;742;1604;4005;1863;4747
352650;202206;675;1812;468;1391;69;216;183;502;252;718
352660;202206;1244;3431;1052;3060;106;388;691;1852;797;2240
352670;202206;12285;30767;8847;24291;1579;4852;4137;10120;5716;14972
352680;202206;3755;10392;2723;8139;448;1544;1319;3408;1767;4952
352690;202206;31344;74979;24908;64687;1147;3737;18339;45339;19486;49076
352700;202206;833;2021;626;1711;114;321;288;771;402;1092
352710;202206;6414;15635;4697;12638;1072;3175;2066;5093;3138;8268
352720;202206;10819;26673;8750;23045;1648;4720;4396;10773;6044;15493
352725;202206;622;1415;360;964;23;69;202;496;225;565
352730;202206;5961;16944;5346;15577;663;2146;2598;6455;3261;8601
352740;202206;2764;6314;2102;5352;206;596;1267;3029;1473;3625
352750;202206;491;1185;319;887;38;123;156;378;194;501
352760;202206;1988;5174;1580;4424;179;489;855;2295;1034;2784
352770;202206;1069;2703;762;2147;114;341;368;955;482;1296
352780;202206;748;2017;542;1591;113;315;158;454;271;769
352790;202206;473;1195;368;1000;44;121;162;383;206;504
352800;202206;1620;4592;1143;3552;270;871;225;524;495;1395
352810;202206;1411;3206;939;2400;140;344;539;1338;679;1682
352820;202206;518;1397;385;1164;78;241;102;270;180;511
352830;202206;652;1567;325;918;27;84;111;255;138;339
352840;202206;4749;12561;3881;11049;941;2909;1751;4790;2692;7699
352850;202206;13943;31705;10253;26021;2057;5851;5085;11598;7142;17449
352860;202206;1294;3394;984;2858;161;515;389;1054;550;1569
352870;202206;991;2407;698;1827;64;196;443;1095;507;1291
352880;202206;1967;4546;1397;3556;211;578;598;1385;809;1963
352885;202206;393;1012;309;871;42;134;184;490;226;624
352890;202206;801;1831;565;1366;35;104;365;778;400;882
352900;202206;21939;54394;14988;41147;2334;6723;6582;16759;8916;23482
352910;202206;441;1125;245;728;18;54;98;250;116;304
352920;202206;3218;7759;2462;6512;115;367;1786;4492;1901;4859
352930;202206;7130;18030;5437;14835;874;2737;2702;6678;3576;9415
352940;202206;29474;74180;22913;61303;3521;10361;13162;32913;16683;43274
352950;202206;650;1663;413;1238;84;272;106;266;190;538
352960;202206;853;2150;515;1465;66;199;169;373;235;572
352965;202206;296;793;207;629;48;155;54;147;102;302
352970;202206;3725;8027;2943;6836;152;398;2303;5124;2455;5522
352980;202206;1595;3852;1261;3392;273;763;706;1859;979;2622
352990;202206;5160;12830;3908;10802;628;1904;2180;5761;2808;7665
353000;202206;541;1416;324;935;48;161;106;255;154;416
353010;202206;3133;7385;2177;5671;391;1158;1005;2359;1396;3517
353020;202206;3903;9676;2416;6737;361;1103;934;2390;1295;3493
353030;202206;5502;13292;3815;10447;897;2603;1123;2894;2020;5497
353040;202206;803;1752;588;1435;78;213;355;804;433;1017
353050;202206;6080;16334;4388;12996;713;2325;2254;6278;2967;8603
353060;202206;57999;138760;48109;123518;2915;9180;36844;90443;39759;99623
353070;202206;12382;32902;9188;26243;1417;4575;4475;11477;5892;16052
353080;202206;5618;14363;3898;11134;759;2426;1581;3901;2340;6327
353090;202206;705;1978;589;1763;44;147;390;1120;434;1267
353100;202206;343;862;157;467;32;103;47;111;79;214
353110;202206;9131;22253;7358;19812;1722;4531;3664;10347;5386;14878
353120;202206;507;1237;385;1034;49;170;202;464;251;634
353130;202206;3330;7491;2238;5653;522;1433;936;2058;1458;3491
353140;202206;3344;7678;2543;6410;136;429;1834;4366;1970;4795
353150;202206;1783;4260;1310;3512;253;734;606;1524;859;2258
353160;202206;757;1883;552;1553;72;227;255;639;327;866
353170;202206;654;1627;502;1414;94;265;250;703;344;968
353180;202206;11954;28089;9397;23957;1891;5193;5107;12356;6998;17549
353190;202206;3981;10167;3149;8535;381;1178;1898;4761;2279;5939
353200;202206;2036;5227;1278;3766;181;618;458;1191;639;1809
353205;202206;516;1464;433;1285;43;140;243;684;286;824
353210;202206;1063;2223;713;1668;23;65;537;1189;560;1254
353215;202206;450;1132;353;971;42;145;175;424;217;569
353220;202206;864;2262;611;1760;120;330;154;408;274;738
353230;202206;900;2370;695;2047;166;577;236;631;402;1208
353240;202206;2782;7018;2348;6356;298;935;1473;3773;1771;4708
353250;202206;1512;3313;1012;2529;122;333;576;1392;698;1725
353260;202206;1335;2994;776;2092;114;339;366;893;480;1232
353270;202206;864;2072;722;1838;77;244;484;1140;561;1384
353280;202206;844;2150;620;1782;145;415;202;573;347;988
353282;202206;2051;5458;1730;4907;147;512;1099;2887;1246;3399
353284;202206;430;979;246;640;25;83;114;250;139;333
353286;202206;202;478;127;358;26;72;37;85;63;157
353290;202206;1640;4159;1029;2947;175;498;318;825;493;1323
353300;202206;2520;6394;1862;5165;309;970;867;2089;1176;3059
353310;202206;452;1058;338;866;25;82;217;501;242;583
353320;202206;805;1943;689;1779;21;71;534;1331;555;1402
353325;202206;836;2271;611;1800;102;294;263;724;365;1018
353330;202206;715;1725;482;1308;77;221;236;579;313;800
353340;202206;3792;9793;2929;8171;486;1554;1553;3935;2039;5489
353350;202206;4663;11022;3462;8877;778;2016;1237;2853;2015;4869
353360;202206;767;2071;622;1797;62;231;376;1007;438;1238
353370;202206;659;1773;542;1589;41;133;374;1064;415;1197
353380;202206;358;983;287;856;36;122;143;383;179;505
353390;202206;7466;17702;5640;14768;454;1362;3550;8772;4004;10134
353400;202206;618;1568;469;1305;76;248;204;447;280;695
353410;202206;611;1531;463;1268;65;180;270;705;335;885
353420;202206;558;1386;375;1025;76;200;67;145;143;345
353430;202206;2743;7066;2181;6075;390;1143;1107;2901;1497;4044
353440;202206;82979;210913;62880;172523;8430;25715;37364;95735;45794;121450
353450;202206;444;1071;308;848;38;136;163;392;201;528
353460;202206;3889;9933;2923;8223;559;1727;710;1732;1269;3459
353470;202206;10327;25847;7658;20979;1215;3705;3605;8941;4820;12646
353475;202206;1948;4643;1345;3531;142;432;764;1803;906;2235
353480;202206;1817;4528;1489;4010;79;271;1100;2820;1179;3091
353490;202206;1213;3043;877;2442;123;364;400;1027;523;1391
353500;202206;1287;2943;943;2411;190;510;535;1303;725;1813
353510;202206;1078;2946;792;2319;178;565;271;683;449;1248
353520;202206;1223;3006;799;2275;86;269;376;946;462;1215
353530;202206;2895;7175;2341;6208;268;839;1341;3269;1609;4108
353540;202206;2413;6161;1955;5472;280;864;1169;3124;1449;3988
353550;202206;7073;16863;5760;14810;752;2110;3628;8756;4380;10866
353560;202206;2669;6704;2074;5842;550;1669;731;1860;1281;3529
353570;202206;781;1969;522;1494;89;292;233;595;322;887
353580;202206;2653;6601;2068;5509;386;1030;1065;2704;1451;3734
353590;202206;846;2017;618;1647;73;193;369;952;442;1145
353600;202206;1869;4497;1424;3740;150;433;790;1975;940;2408
353610;202206;864;2382;642;1934;108;355;283;776;391;1131
353620;202206;3383;8285;2454;6766;490;1414;887;2200;1377;3614
353625;202206;700;1650;425;1166;54;170;225;579;279;749
353630;202206;1767;4942;1514;4476;233;761;819;2226;1052;2987
353640;202206;1492;3695;1185;3213;159;454;719;1875;878;2329
353650;202206;8715;22348;6794;18939;800;2494;3936;10222;4736;12716
353657;202206;420;1069;320;918;28;96;155;409;183;505
353660;202206;1567;3145;1141;2583;171;402;714;1558;885;1960
353670;202206;4997;12975;3934;11011;701;2280;1966;4934;2667;7214
353680;202206;835;2044;616;1737;79;252;377;987;456;1239
353690;202206;515;1342;238;719;32;99;62;171;94;270
353700;202206;2445;5972;2006;5282;148;459;1441;3636;1589;4095
353710;202206;6086;13378;3724;9251;451;1170;1973;4263;2424;5433
353715;202206;501;1274;294;855;17;68;119;303;136;371
353720;202206;2321;5768;1807;4995;299;886;963;2576;1262;3462
353730;202206;5372;13321;4214;11351;500;1615;2578;6341;3078;7956
353740;202206;2375;5934;1725;4822;343;1095;695;1737;1038;2832
353750;202206;1066;3044;798;2558;185;626;243;742;428;1368
353760;202206;16271;34500;12662;29832;2283;5611;7404;17017;9687;22628
353770;202206;698;1926;428;1353;64;228;72;182;136;410
353780;202206;7425;18279;6124;16041;934;2809;3746;9153;4680;11962
353790;202206;3331;9441;2510;7770;583;2031;617;1593;1200;3624
353800;202206;22036;54219;17779;47661;2592;7020;10394;27118;12986;34138
353810;202206;1464;3731;999;2780;152;467;447;1174;599;1641
353820;202206;2039;5211;1398;3997;309;972;408;1044;717;2016
353830;202206;725;1712;541;1431;80;243;261;626;341;869
353850;202206;1843;4756;1431;4020;276;785;616;1640;892;2425
353860;202206;3123;7954;2411;6822;541;1759;1171;2931;1712;4690
353870;202206;35489;88552;26318;71645;3328;10060;13996;34578;17324;44638
353880;202206;3588;9340;2877;8049;214;738;1826;4768;2040;5506
353890;202206;3566;7183;2613;5818;157;440;1875;3766;2032;4206
353900;202206;859;2293;649;1903;85;281;277;734;362;1015
353910;202206;3282;8277;2790;7542;219;696;2023;5297;2242;5993
353920;202206;2382;6130;1744;5003;453;1424;413;920;866;2344
353930;202206;5743;14431;4094;11348;722;2278;1870;4569;2592;6847
353940;202206;1467;4023;1067;3236;155;521;419;1110;574;1631
353950;202206;3972;9992;3094;8442;715;2103;1314;3278;2029;5381
353960;202206;913;2270;653;1809;159;415;191;506;350;921
353970;202206;747;1674;571;1418;46;143;417;977;463;1120
353980;202206;19045;45291;15048;38739;792;2488;11198;27317;11990;29805
353990;202206;1104;2565;715;1901;110;314;378;949;488;1263
354000;202206;2971;6892;1760;4639;411;1105;432;1028;843;2133
354010;202206;366;918;263;756;44;138;152;421;196;559
354020;202206;4460;11267;3605;9631;642;1882;1834;4434;2476;6316
354025;202206;831;2183;559;1659;80;264;179;479;259;743
354030;202206;568;1197;316;802;64;153;142;345;206;498
354040;202206;910;1989;603;1529;32;100;452;1075;484;1175
354050;202206;1154;3127;817;2539;158;568;337;989;495;1557
354060;202206;4330;11511;3168;9091;531;1730;1517;3813;2048;5543
354070;202206;4631;11340;3176;8569;505;1528;1533;3635;2038;5163
354075;202206;3383;8865;2742;7773;342;1080;1731;4629;2073;5709
354080;202206;1690;4452;1195;3521;198;622;463;1207;661;1829
354085;202206;507;957;404;831;0;0;322;613;322;613
354090;202206;1925;5111;1642;4544;95;289;1266;3381;1361;3670
354100;202206;25275;64002;18296;52359;3700;11281;8585;23473;12285;34754
354105;202206;1605;3850;1177;3120;140;444;602;1445;742;1889
354110;202206;505;1346;378;1116;67;221;152;409;219;630
354120;202206;1570;4085;1113;3130;228;699;377;926;605;1625
354130;202206;6619;16551;4530;12600;1259;3615;689;1558;1948;5173
354140;202206;23239;55247;16599;43410;2382;6948;8173;19267;10555;26215
354150;202206;3232;7415;2533;6362;612;1561;966;2386;1578;3947
354160;202206;3274;8923;2600;7662;607;1981;1025;2750;1632;4731
354165;202206;789;2209;620;1882;93;349;340;939;433;1288
354170;202206;2258;5897;1855;5172;143;458;1089;2818;1232;3276
354180;202206;474;1285;371;1083;43;121;203;556;246;677
354190;202206;1802;4856;1305;3832;88;300;693;1908;781;2208
354200;202206;1057;2441;810;2052;62;188;546;1274;608;1462
354210;202206;1129;2804;934;2506;53;180;672;1682;725;1862
354220;202206;3574;9081;2727;7503;412;1228;1446;3746;1858;4974
354230;202206;937;2160;760;1950;31;113;591;1445;622;1558
354240;202206;2051;5451;1411;4163;255;808;489;1266;744;2074
354250;202206;712;1680;469;1280;98;262;157;393;255;655
354260;202206;9855;23862;7673;20234;1147;3371;4177;10269;5324;13640
354270;202206;1171;3267;967;2894;156;504;455;1231;611;1735
354280;202206;970;2205;806;1959;46;133;595;1321;641;1454
354290;202206;1095;3257;926;2917;146;486;493;1524;639;2010
354300;202206;4084;11249;3463;10141;845;2456;1599;4590;2444;7046
354310;202206;857;2397;724;2161;153;483;341;969;494;1452
354320;202206;1111;2580;736;1977;94;286;350;817;444;1103
354323;202206;557;1261;355;903;38;96;173;393;211;489
354325;202206;1659;4773;1130;3580;212;701;246;706;458;1407
354330;202206;11509;27274;8217;20962;812;2383;5313;12459;6125;14842
354340;202206;42414;100942;30617;81196;3719;11263;18443;46168;22162;57431
354350;202206;1383;3331;1105;2885;156;464;658;1598;814;2062
354360;202206;721;1717;456;1298;112;324;132;348;244;672
354370;202206;1148;3061;936;2723;133;423;583;1627;716;2050
354380;202206;750;1920;563;1634;92;350;192;445;284;795
354390;202206;17009;39115;11766;30216;1753;4957;6285;14854;8038;19811
354400;202206;1881;5644;1474;4743;268;900;536;1673;804;2573
354410;202206;7825;19108;6126;16049;914;2690;3446;8291;4360;10981
354420;202206;1757;4318;1294;3491;158;493;738;1813;896;2306
354425;202206;3276;7605;2413;6160;485;1281;1147;2823;1632;4104
354430;202206;1821;4509;1455;3982;104;333;952;2455;1056;2788
354440;202206;699;1720;461;1262;56;167;226;551;282;718
354450;202206;560;1441;330;1001;49;166;106;265;155;431
354460;202206;956;2360;655;1841;128;395;277;721;405;1116
354470;202206;491;1217;345;955;18;65;176;423;194;488
354480;202206;1556;3390;1030;2568;85;243;663;1530;748;1773
354490;202206;929;2578;695;2078;127;390;328;892;455;1282
354500;202206;2575;6762;2071;5959;598;1782;653;1837;1251;3619
354510;202206;868;2300;702;1988;53;185;435;1105;488;1290
354515;202206;478;1301;332;1002;52;174;121;342;173;516
354520;202206;8860;22735;6447;17814;816;2632;3699;9341;4515;11973
354530;202206;5637;14762;4490;12652;1043;2907;1759;4967;2802;7874
354540;202206;1558;3871;1164;3195;228;667;490;1262;718;1929
354550;202206;681;1757;547;1519;73;238;297;752;370;990
354560;202206;2596;6015;1448;3906;158;442;807;1973;965;2415
354570;202206;1352;3291;579;1598;123;335;81;205;204;540
354580;202206;9932;25312;6811;19425;983;3127;3586;9588;4569;12715
354600;202206;2361;5825;1864;4978;274;738;1113;2811;1387;3549
354610;202206;530;1333;296;854;30;88;143;392;173;480
354620;202206;555;1442;349;1058;35;141;162;429;197;570
354625;202206;349;914;214;662;35;128;58;149;93;277
354630;202206;2768;7569;2289;6682;652;1952;644;1768;1296;3720
354640;202206;4190;11105;3237;9302;398;1347;1604;4125;2002;5472
354650;202206;989;2506;802;2205;109;292;467;1247;576;1539
354660;202206;4068;9202;2327;6432;267;870;1045;2599;1312;3469
354670;202206;1277;3408;917;2685;176;558;350;923;526;1481
354680;202206;6650;16049;5157;13707;904;2558;2932;7670;3836;10228
354690;202206;600;1746;438;1407;81;271;162;478;243;749
354700;202206;1032;2627;739;2071;76;247;403;1026;479;1273
354710;202206;562;1455;389;1122;45;131;178;449;223;580
354720;202206;349;803;170;471;62;155;43;129;105;284
354730;202206;12302;33069;9661;28197;1239;4016;5800;16055;7039;20071
354740;202206;364;963;166;514;29;101;25;58;54;159
354750;202206;3190;7866;2140;5903;314;975;926;2210;1240;3185
354760;202206;2505;6384;1824;5180;388;1211;680;1730;1068;2941
354765;202206;404;1051;179;543;19;72;57;144;76;216
354770;202206;2903;6866;2154;5555;431;1103;939;2300;1370;3403
354780;202206;68538;162499;53602;134480;3941;11858;37613;87452;41554;99310
354790;202206;1181;3086;932;2686;69;234;602;1658;671;1892
354800;202206;3084;7588;2356;6420;497;1427;1068;2677;1565;4104
354805;202206;1582;3471;1143;2847;108;263;739;1704;847;1967
354810;202206;717;2019;449;1464;68;257;144;418;212;675
354820;202206;1115;3023;805;2461;154;536;267;660;421;1196
354830;202206;594;1389;359;971;82;236;124;293;206;529
354840;202206;1024;2501;652;1753;54;157;369;895;423;1052
354850;202206;25375;61308;18477;49687;1774;5590;12027;30195;13801;35785
354860;202206;1960;5113;1282;3779;208;665;473;1282;681;1947
354870;202206;74687;177732;58802;149603;4783;14201;40034;94944;44817;109145
354880;202206;6938;16494;3611;9752;422;1328;1498;3240;1920;4568
354890;202206;19648;46828;15463;39837;2023;5913;8969;22032;10992;27945
354900;202206;444;1088;295;834;61;198;117;271;178;469
354910;202206;6935;17555;4475;13208;991;3140;1188;3105;2179;6245
354920;202206;577;1497;304;957;44;145;71;183;115;328
354925;202206;329;892;200;616;22;71;55;151;77;222
354930;202206;425;1005;291;770;37;100;143;351;180;451
354940;202206;2842;7947;2152;6514;635;2047;716;1892;1351;3939
354950;202206;1815;4274;1482;3851;95;317;1093;2676;1188;2993
354960;202206;1006;2534;729;2099;90;319;317;824;407;1143
354970;202206;4979;13013;3965;11355;351;1247;2683;7320;3034;8567
354980;202206;40568;92294;28545;72086;2748;8339;18442;42999;21190;51338
354990;202206;87535;205833;64730;166121;4283;13441;44521;105921;48804;119362
354995;202206;3720;7463;2894;6431;136;380;2352;5010;2488;5390
355000;202206;1855;4331;1415;3691;217;667;747;1768;964;2435
355010;202206;4802;12326;3184;8968;1031;2839;703;1932;1734;4771
355020;202206;4127;10858;3110;9144;621;2034;1383;3735;2004;5769
355030;202206;1617852;3807586;1213691;3059411;159251;445437;679475;1573787;838726;2019224
355040;202206;3678;8408;2873;7386;196;555;2229;5664;2425;6219
355050;202206;1270;2690;945;2253;231;576;439;952;670;1528
355060;202206;7491;19028;5603;15667;864;2809;3064;7772;3928;10581
355070;202206;11912;28546;9897;25445;1065;3240;6607;15889;7672;19129
355080;202206;1094;2999;701;2291;152;550;120;328;272;878
355090;202206;1491;3918;1201;3446;196;624;633;1664;829;2288
355100;202206;27685;67963;21966;59648;2948;8589;14119;37359;17067;45948
355110;202206;1094;2860;810;2444;214;730;101;267;315;997
355120;202206;842;2115;609;1777;70;222;286;802;356;1024
355130;202206;956;2073;532;1327;26;72;356;812;382;884
355140;202206;2469;4932;2095;4422;88;230;1837;3764;1925;3994
355150;202206;5408;13307;4395;11607;472;1370;2880;7229;3352;8599
355160;202206;2682;6937;1942;5672;422;1324;567;1520;989;2844
355170;202206;13844;32758;11033;28244;1787;4945;6213;15245;8000;20190
355180;202206;3300;8096;2428;6762;413;1348;1253;3150;1666;4498
355190;202206;2176;5464;1717;4744;579;1611;674;2003;1253;3614
355200;202206;959;2785;821;2575;222;766;354;1060;576;1826
355210;202206;3603;9255;2759;7528;511;1512;1327;3404;1838;4916
355220;202206;58709;145865;47750;125608;7276;21171;26179;63068;33455;84239
355230;202206;1395;3384;795;2233;135;388;265;651;400;1039
355240;202206;29064;73597;21052;58484;2191;6874;12665;32878;14856;39752
355250;202206;45607;114796;34975;95135;7384;21044;16596;42560;23980;63604
355255;202206;745;1813;409;1206;40;114;135;381;175;495
355260;202206;1836;4099;1359;3365;103;341;938;2139;1041;2480
355270;202206;1357;3786;1076;3246;226;714;481;1332;707;2046
355280;202206;37323;89434;27677;72364;3238;9429;15866;38532;19104;47961
355290;202206;1091;2759;843;2359;147;409;392;1039;539;1448
355300;202206;1608;4405;1330;3910;242;752;582;1556;824;2308
355310;202206;1040;2758;770;2291;97;319;429;1249;526;1568
355320;202206;623;1594;477;1329;101;329;205;464;306;793
355330;202206;3468;8338;2728;7092;111;377;2072;5102;2183;5479
355340;202206;4796;10239;3684;8797;610;1447;2074;5050;2684;6497
355350;202206;1618;4307;1242;3609;231;750;545;1462;776;2212
355360;202206;1449;3467;1128;2979;132;361;656;1621;788;1982
355365;202206;412;1016;219;688;45;137;48;142;93;279
355370;202206;6143;15045;4793;12915;1011;2450;2279;6571;3290;9021
355380;202206;3359;8471;2609;7134;492;1463;1011;2396;1503;3859
355385;202206;1682;4097;1390;3697;91;324;929;2235;1020;2559
355390;202206;936;2477;684;1961;117;371;306;779;423;1150
355395;202206;2204;5900;1610;4729;258;838;659;1668;917;2506
355400;202206;10942;29643;8846;25668;1868;6172;3802;9871;5670;16043
355410;202206;28035;73326;18477;54163;3583;11468;6361;17572;9944;29040
355420;202206;721;2171;599;1943;139;492;200;609;339;1101
355430;202206;4318;10420;3334;8704;578;1615;1685;4248;2263;5863
355440;202206;862;2243;562;1638;89;249;125;319;214;568
355450;202206;4023;9895;2788;7574;394;1208;1345;3218;1739;4426
355460;202206;574;1354;373;1013;36;116;170;423;206;539
355465;202206;538;1294;434;1133;58;160;274;693;332;853
355470;202206;1336;3239;783;2160;178;549;271;659;449;1208
355475;202206;402;880;335;798;11;29;270;624;281;653
355480;202206;4790;12460;3834;11016;483;1608;2524;7018;3007;8626
355490;202206;1045;2704;605;1828;58;206;288;795;346;1001
355495;202206;1013;2649;752;2223;101;362;313;808;414;1170
355500;202206;8033;19615;5214;14383;723;2210;2199;5403;2922;7613
355510;202206;1639;3857;1085;2953;192;557;451;1101;643;1658
355520;202206;413;945;215;620;48;127;59;172;107;299
355530;202206;364;821;151;422;7;20;77;195;84;215
355535;202206;641;1672;514;1467;110;331;250;662;360;993
355540;202206;13948;32161;11628;29004;1154;3289;8508;20393;9662;23682
355550;202206;739;2081;626;1875;65;232;345;930;410;1162
355560;202206;1306;3259;767;2235;175;551;36;111;211;662
355570;202206;342;895;194;583;34;102;54;146;88;248
355580;202206;1402;3219;869;2338;156;479;291;703;447;1182
355590;202206;184;466;141;396;14;39;81;222;95;261
355600;202206;1766;4231;1168;3204;199;584;371;979;570;1563
355610;202206;2194;5163;1489;3981;165;472;816;1992;981;2464
355620;202206;5946;15010;4523;12335;485;1612;2622;6473;3107;8085
355630;202206;2999;7614;2193;6182;290;873;1266;3333;1556;4206
355635;202206;1084;2981;796;2419;126;411;281;771;407;1182
355640;202206;3960;10351;2690;7898;620;1810;657;1912;1277;3722
355645;202206;4630;12287;3398;10148;479;1593;1893;5395;2372;6988
355650;202206;7988;20435;6364;17558;1364;3946;2961;7498;4325;11444
355660;202206;1626;4052;1120;3185;203;540;335;885;538;1425
355670;202206;4711;12048;3368;9147;424;1416;1760;4081;2184;5497
355680;202206;3308;8741;1656;5013;425;1405;143;424;568;1829
355690;202206;855;2408;585;1903;163;561;14;32;177;593
355695;202206;290;775;177;530;14;47;37;79;51;126
355700;202206;9073;24218;7631;21248;941;2975;4633;12074;5574;15049
355710;202206;11183;25366;7763;19270;1042;3022;4130;8863;5172;11885
355715;202206;536;1412;303;892;67;194;60;165;127;359
355720;202206;1673;4409;1338;3849;183;579;759;2009;942;2588
355730;202206;1185;3034;948;2635;111;370;534;1365;645;1735
410010;202206;1395;3737;1076;3104;239;731;234;633;473;1364
410020;202206;1239;3429;940;2810;259;746;258;720;517;1466
410030;202206;1854;4733;1565;4293;202;577;873;2393;1075;2970
410040;202206;15987;41634;11938;34303;2455;7633;4164;10994;6619;18627
410045;202206;889;2321;639;1818;127;389;218;546;345;935
410050;202206;2557;6232;1801;4952;268;816;716;1810;984;2626
410060;202206;2369;6378;1899;5518;454;1401;549;1500;1003;2901
410070;202206;2238;5434;1655;4446;337;975;573;1353;910;2328
410080;202206;1539;3929;1110;3202;256;757;230;623;486;1380
410090;202206;1294;2975;1073;2667;114;270;591;1554;705;1824
410100;202206;2349;6389;1636;4803;305;960;175;470;480;1430
410105;202206;590;1432;359;998;33;100;150;384;183;484
410110;202206;3762;8916;2712;7101;362;1057;1355;3259;1717;4316
410115;202206;647;1616;473;1311;58;182;193;475;251;657
410120;202206;3470;8616;3027;7964;474;1227;1920;4987;2394;6214
410130;202206;1494;3752;1312;3430;179;527;769;1903;948;2430
410140;202206;19745;46253;13254;34999;2450;6983;4016;9606;6466;16589
410150;202206;18915;43331;10282;27023;1759;4976;2974;6838;4733;11814
410160;202206;3458;9183;2823;8115;613;1949;1066;2889;1679;4838
410165;202206;714;1831;568;1538;73;232;312;785;385;1017
410170;202206;3347;8309;2181;5908;438;1284;267;619;705;1903
410180;202206;18972;50247;14833;42224;2297;7191;7458;19212;9755;26403
410185;202206;514;1426;386;1119;59;199;140;339;199;538
410190;202206;2526;6080;1840;4874;389;1040;509;1205;898;2245
410200;202206;6670;14540;3764;9719;737;2007;585;1407;1322;3414
410210;202206;3650;8829;2347;6568;376;1196;797;1905;1173;3101
410220;202206;610;1528;410;1168;68;210;131;335;199;545
410230;202206;2110;5459;1613;4496;233;756;707;1704;940;2460
410240;202206;5939;14972;4152;11628;838;2679;654;1608;1492;4287
410250;202206;2680;6278;1975;5160;162;516;954;2355;1116;2871
410260;202206;2172;5177;1365;3700;191;540;689;1767;880;2307
410270;202206;560;1440;403;1153;53;186;160;401;213;587
410275;202206;688;1840;480;1399;77;261;196;506;273;767
410280;202206;2709;6829;1864;5258;238;774;819;2048;1057;2822
410290;202206;3749;10061;2616;7768;726;2127;705;2071;1431;4198
410300;202206;797;1884;626;1622;73;222;319;729;392;951
410302;202206;373;907;229;650;18;61;115;310;133;371
410304;202206;1606;3667;1388;3285;117;304;1034;2309;1151;2613
410305;202206;1920;4376;1343;3554;102;308;899;2276;1001;2584
410310;202206;3248;8261;2675;7266;254;875;1679;4293;1933;5168
410315;202206;824;1804;515;1318;175;459;147;364;322;823
410320;202206;1120;3027;751;2314;99;325;124;348;223;673
410322;202206;736;1896;386;1106;54;173;155;373;209;546
410330;202206;1721;4023;1203;3091;192;500;402;971;594;1471
410335;202206;953;2432;708;1982;115;358;280;704;395;1062
410337;202206;920;2201;645;1685;93;265;238;537;331;802
410340;202206;539;1465;365;1057;25;86;158;361;183;447
410345;202206;2984;7574;1787;5084;377;1136;614;1542;991;2678
410347;202206;877;2183;647;1786;71;197;202;563;273;760
410350;202206;1864;4382;1350;3572;152;471;708;1686;860;2157
410360;202206;4582;11120;3478;9243;608;1689;1337;3413;1945;5102
410370;202206;16146;41713;10620;29162;1251;3813;4482;10489;5733;14302
410380;202206;1989;4703;1448;3781;240;705;508;1149;748;1854
410390;202206;3217;7496;2180;5774;443;1371;884;1997;1327;3368
410395;202206;1047;2846;836;2441;147;442;332;979;479;1421
410400;202206;8557;20718;6488;16986;767;2250;3755;9077;4522;11327
410405;202206;1005;2236;716;1810;93;259;374;862;467;1121
410410;202206;1703;4145;1539;3898;131;374;1065;2666;1196;3040
410420;202206;13544;34562;10344;28540;1566;4747;4703;11602;6269;16349
410425;202206;4046;10649;2791;8134;480;1487;1081;2833;1561;4320
410430;202206;15089;36287;10765;28675;1586;4667;4212;10238;5798;14905
410440;202206;2650;7315;2264;6624;367;1151;1195;3402;1562;4553
410442;202206;2789;7835;2246;6708;593;1859;655;1835;1248;3694
410445;202206;2547;6918;1837;5596;395;1324;290;947;685;2271
410450;202206;1707;4007;1287;3375;215;604;506;1199;721;1803
410460;202206;2683;6342;1951;5092;285;812;914;2162;1199;2974
410465;202206;3327;9045;2579;7687;472;1434;921;2482;1393;3916
410470;202206;2650;6877;1865;5510;519;1693;234;735;753;2428
410480;202206;45445;105494;26210;72587;3930;12225;7308;17118;11238;29343
410490;202206;13384;34881;9791;27763;1550;4727;4379;11328;5929;16055
410500;202206;2114;5250;1423;3979;259;760;334;764;593;1524
410510;202206;2071;4942;1434;3850;321;816;437;1177;758;1993
410520;202206;3410;10098;2991;9311;904;2952;1064;3355;1968;6307
410530;202206;1786;4219;860;2365;110;322;223;491;333;813
410540;202206;3193;8225;2205;6273;344;1100;949;2492;1293;3592
410550;202206;8863;22678;6054;16898;1024;3134;1774;4130;2798;7264
410560;202206;1812;4473;1322;3525;294;822;413;927;707;1749
410570;202206;3050;7746;2196;6312;716;2355;253;720;969;3075
410580;202206;31413;77374;23849;63997;3563;10737;12178;30000;15741;40737
410590;202206;1869;4995;1324;3774;191;578;423;998;614;1576
410600;202206;2046;5125;1603;4287;328;892;545;1448;873;2340
410610;202206;804;1969;608;1630;60;189;299;711;359;900
410620;202206;3063;8046;2171;6144;533;1541;504;1312;1037;2853
410630;202206;2938;7223;1975;5381;367;1168;510;1094;877;2262
410640;202206;5666;12772;3972;9864;876;2430;616;1545;1492;3975
410645;202206;1339;3448;1106;3163;192;593;714;2020;906;2613
410650;202206;2808;7315;1962;5643;345;1080;790;2043;1135;3123
410655;202206;998;2315;711;1831;56;144;355;848;411;992
410657;202206;684;1800;426;1267;67;214;150;377;217;591
410660;202206;4162;9982;2562;6714;409;1144;928;2107;1337;3251
410670;202206;1163;2822;699;1930;118;325;244;595;362;920
410680;202206;2742;7833;1831;5636;436;1380;360;1093;796;2473
410685;202206;589;1444;432;1178;91;275;174;440;265;715
410690;202206;160256;373275;111889;287333;16767;48573;49157;110913;65924;159486
410700;202206;2800;6822;2318;6091;483;1311;1011;2480;1494;3791
410710;202206;1030;2513;658;1823;124;371;286;717;410;1088
410712;202206;757;1984;632;1765;83;255;354;947;437;1202
410715;202206;1004;2769;636;1963;70;239;263;752;333;991
410720;202206;4137;9935;3417;8734;534;1628;1242;2966;1776;4594
410725;202206;1324;3102;802;2180;180;534;167;372;347;906
410730;202206;907;2254;656;1807;109;342;153;419;262;761
410740;202206;973;2609;733;2169;65;236;354;1026;419;1262
410750;202206;2184;5074;1752;4327;294;760;888;2046;1182;2806
410752;202206;443;1037;243;664;45;115;107;266;152;381
410753;202206;375;1059;265;828;39;138;72;205;111;343
410754;202206;1230;2991;1029;2703;66;169;733;1977;799;2146
410755;202206;632;1571;465;1269;64;170;205;510;269;680
410760;202206;4126;10307;2896;8061;666;2154;801;2057;1467;4211
410765;202206;18946;49415;15058;42184;3026;9381;4702;11310;7728;20691
410770;202206;1184;2709;832;2133;81;180;427;1101;508;1281
410773;202206;1480;3663;1282;3357;112;341;865;2168;977;2509
410775;202206;1843;4077;1606;3745;50;131;1192;2650;1242;2781
410780;202206;722;1706;484;1268;89;244;153;365;242;609
410785;202206;852;2075;624;1704;79;265;248;631;327;896
410790;202206;1152;3191;954;2814;212;663;143;334;355;997
410800;202206;3897;8196;3122;7116;79;242;2076;4497;2155;4739
410810;202206;503;1304;371;1056;43;150;155;386;198;536
410820;202206;1119;3045;617;1780;123;393;123;270;246;663
410830;202206;49436;112496;35315;89418;6053;17329;15825;36785;21878;54114
410832;202206;1219;3082;989;2689;95;318;617;1538;712;1856
410840;202206;10295;24794;6159;17115;1284;3853;1751;4153;3035;8006
410845;202206;1297;3045;1005;2608;145;402;485;1190;630;1592
410850;202206;2440;6567;2133;6036;363;1166;1009;2711;1372;3877
410855;202206;829;1988;523;1403;61;176;257;604;318;780
410860;202206;5409;12246;4292;10485;236;732;2898;6577;3134;7309
410865;202206;1637;4469;1390;4018;131;423;810;2385;941;2808
410870;202206;1391;3534;1113;3059;134;397;639;1688;773;2085
410880;202206;5370;13626;3768;10816;711;2120;717;2030;1428;4150
410890;202206;1232;3229;973;2752;165;512;403;1047;568;1559
410895;202206;1139;3384;944;2987;298;1024;260;750;558;1774
410900;202206;960;2458;672;1941;99;314;168;374;267;688
410910;202206;499;1113;317;782;12;34;184;407;196;441
410920;202206;992;2294;748;1926;104;290;373;919;477;1209
410930;202206;1979;4849;1380;3838;350;1109;249;652;599;1761
410940;202206;27718;71179;20372;58361;3795;11954;7806;21090;11601;33044
410950;202206;2234;6046;2012;5705;122;374;1600;4463;1722;4837
410960;202206;9415;21794;6645;17355;1577;4640;2850;6993;4427;11633
410965;202206;1339;3185;914;2449;90;270;555;1401;645;1671
410970;202206;4783;12266;3406;9650;849;2783;558;1286;1407;4069
410975;202206;1631;3747;1220;3115;172;511;564;1366;736;1877
410980;202206;8613;20533;5710;15524;615;1861;2682;6546;3297;8407
410990;202206;1644;3749;1129;2967;184;546;516;1311;700;1857
411000;202206;775;2042;555;1653;102;336;176;458;278;794
411005;202206;527;1252;322;848;42;117;112;250;154;367
411007;202206;2851;7294;2128;6017;405;1275;813;2128;1218;3403
411010;202206;4969;14028;3917;12017;1003;3222;570;1579;1573;4801
411020;202206;2671;7121;2210;6355;568;1718;732;2020;1300;3738
411030;202206;834;2017;582;1514;70;206;261;577;331;783
411040;202206;1160;2819;619;1689;100;277;171;384;271;661
411050;202206;2257;6691;1837;5843;402;1409;355;935;757;2344
411060;202206;2498;6376;1638;4636;344;999;420;1120;764;2119
411065;202206;454;1106;281;771;25;79;118;302;143;381
411070;202206;8708;20786;6926;17960;798;2375;3854;9421;4652;11796
411080;202206;2230;5638;1797;4890;426;1303;491;1279;917;2582
411090;202206;910;2369;594;1747;83;259;138;351;221;610
411095;202206;2919;6634;1677;4473;243;677;327;765;570;1442
411100;202206;1402;3487;964;2713;109;363;359;927;468;1290
411110;202206;731;1840;348;1032;39;109;26;52;65;161
411120;202206;1695;4264;1386;3775;285;919;567;1350;852;2269
411125;202206;6140;16879;5455;15682;1218;3545;2530;7404;3748;10949
411130;202206;818;2070;580;1633;144;393;147;446;291;839
411140;202206;2545;7399;2099;6493;526;1708;652;2019;1178;3727
411150;202206;4661;11259;3157;8376;665;1880;328;682;993;2562
411155;202206;1186;2861;785;2138;119;349;355;849;474;1198
411160;202206;437;950;291;721;35;98;86;208;121;306
411170;202206;915;2480;698;2039;144;469;302;822;446;1291
411180;202206;6793;16798;5387;14483;735;2215;2844;6964;3579;9179
411190;202206;2294;5675;1737;4702;237;714;758;1787;995;2501
411200;202206;5643;14446;4238;11971;909;2955;1316;3144;2225;6099
411210;202206;3947;8514;2836;6756;403;1091;1312;2904;1715;3995
411220;202206;1065;2586;731;1988;148;417;239;607;387;1024
411230;202206;993;2535;742;2065;164;495;239;620;403;1115
411240;202206;1816;4127;1267;3227;220;597;527;1251;747;1848
411250;202206;2593;6535;1887;5299;375;1182;608;1560;983;2742
411260;202206;361;894;241;657;32;109;99;228;131;337
411270;202206;2264;5759;1669;4604;264;765;775;1927;1039;2692
411275;202206;1762;3818;1232;2998;133;397;669;1478;802;1875
411280;202206;1598;4125;1141;3272;297;897;249;651;546;1548
411290;202206;938;2340;604;1698;64;207;323;859;387;1066
411295;202206;1405;3399;1025;2722;126;371;469;1139;595;1510
411300;202206;1158;2811;764;2062;80;238;322;732;402;970
411310;202206;1045;2268;813;1964;119;297;404;925;523;1222
411320;202206;6314;15398;4706;12653;683;2009;2197;5224;2880;7233
411325;202206;1657;4382;1362;3839;270;758;657;1905;927;2663
411330;202206;3716;9515;2732;7788;586;1845;853;2354;1439;4199
411340;202206;937;2475;560;1652;91;280;162;422;253;702
411342;202206;1218;2837;661;1744;105;308;235;538;340;846
411345;202206;1359;3215;1004;2630;68;214;691;1765;759;1979
411350;202206;3330;8543;2220;6416;569;1735;417;1078;986;2813
411360;202206;877;1963;661;1636;70;223;363;783;433;1006
411370;202206;68652;162909;50716;133293;3977;12449;30238;72969;34215;85418
411373;202206;1661;3943;1324;3444;147;409;678;1779;825;2188
411375;202206;1275;3045;894;2346;103;289;368;888;471;1177
411380;202206;1297;2897;892;2154;49;128;576;1267;625;1395
411390;202206;1738;4545;1371;3791;216;663;525;1207;741;1870
411400;202206;2702;6302;2048;5169;190;551;1141;2674;1331;3225
411410;202206;3242;8672;2413;6993;517;1602;602;1576;1119;3178
411420;202206;4900;11523;2689;7489;387;1176;533;1094;920;2270
411430;202206;4435;11138;3364;9219;673;2071;1213;2868;1886;4939
411435;202206;497;1288;302;908;50;155;83;210;133;365
411440;202206;2925;7673;2322;6568;462;1440;758;1985;1220;3425
411450;202206;2890;7252;2196;6149;267;760;1264;3530;1531;4290
411460;202206;5075;12655;3237;9200;497;1583;741;1759;1238;3342
411470;202206;954;2306;712;1886;113;341;319;756;432;1097
411480;202206;6190;15491;4514;12462;759;2458;1617;3921;2376;6379
411490;202206;1895;4587;1439;3880;158;503;645;1545;803;2048
411500;202206;1541;3963;1061;2967;173;529;228;498;401;1027
411510;202206;2656;6215;2101;5353;312;925;670;1710;982;2635
411520;202206;40084;94907;24602;65305;2929;9006;10359;23997;13288;33003
411530;202206;1080;2663;612;1785;96;321;122;318;218;639
411535;202206;572;1601;388;1194;50;164;124;335;174;499
411540;202206;3034;7087;2125;5504;90;283;1280;3196;1370;3479
411545;202206;1022;2813;848;2500;64;219;556;1614;620;1833
411550;202206;799;1897;614;1571;95;259;193;440;288;699
411560;202206;2252;6004;1255;3869;192;639;97;230;289;869
411570;202206;8379;18680;5861;14950;1362;3739;1599;3855;2961;7594
411573;202206;882;2273;720;1990;143;436;319;802;462;1238
411575;202206;2297;5868;1707;4762;300;903;541;1381;841;2284
411580;202206;5518;12576;3395;9261;537;1656;639;1504;1176;3160
411585;202206;676;1935;342;1076;65;202;61;170;126;372
411590;202206;498;1302;373;1056;40;137;194;497;234;634
411600;202206;381;917;243;695;43;128;92;241;135;369
411605;202206;1786;3978;1151;3005;160;462;557;1458;717;1920
411610;202206;3230;6913;2327;5388;59;206;1721;3654;1780;3860
411620;202206;3278;8156;2748;7351;446;1242;1443;3819;1889;5061
411630;202206;948;2294;607;1701;73;257;239;572;312;829
411640;202206;541;1347;375;1001;48;125;142;317;190;442
411650;202206;226;615;142;436;32;105;33;78;65;183
411660;202206;1030;2495;724;1927;74;226;295;687;369;913
411670;202206;1729;3907;1166;2905;103;276;664;1499;767;1775
411680;202206;1624;4160;1212;3380;233;705;454;1205;687;1910
411690;202206;4528;10985;3363;8984;681;1786;1023;2835;1704;4621
411695;202206;721;2048;504;1509;43;133;226;629;269;762
411700;202206;1898;4725;1277;3565;293;857;254;657;547;1514
411705;202206;2634;7200;2240;6543;363;1063;1374;4151;1737;5214
411710;202206;2317;5666;1596;4330;352;970;469;1156;821;2126
411720;202206;1217;2794;860;2183;121;314;339;799;460;1113
411721;202206;1121;2682;831;2163;126;331;278;684;404;1015
411722;202206;1059;2795;600;1761;108;334;180;414;288;748
411725;202206;1440;3862;935;2854;212;699;225;635;437;1334
411727;202206;1679;4451;1102;3254;244;747;127;312;371;1059
411729;202206;685;1650;391;1079;59;198;122;275;181;473
411730;202206;6214;15387;4858;12867;801;2322;2423;6105;3224;8427
411740;202206;574;1442;311;892;80;211;59;139;139;350
411745;202206;913;2513;643;1930;93;306;151;341;244;647
411750;202206;6865;17167;5144;13957;636;1913;2623;6606;3259;8519
411760;202206;8244;20573;6343;17514;1902;5384;1476;4367;3378;9751
411770;202206;3692;10086;2746;8102;596;1875;633;1658;1229;3533
411780;202206;3008;8001;2593;7298;653;1906;991;2838;1644;4744
411790;202206;3356;7737;2036;5478;334;1022;656;1511;990;2533
411800;202206;1327;3640;955;2746;191;584;221;538;412;1122
411810;202206;1768;4374;1335;3566;224;629;529;1272;753;1901
411820;202206;15996;41320;13331;36917;2936;8500;6741;18014;9677;26514
411830;202206;580;1387;442;1148;144;334;65;181;209;515
411840;202206;14333;36335;10090;27899;1595;4797;3382;8217;4977;13014
411845;202206;719;1956;438;1332;69;238;112;292;181;530
411850;202206;8978;21638;6237;16999;1497;4312;1378;3408;2875;7720
411860;202206;815;2172;617;1786;97;311;150;391;247;702
411870;202206;671;1853;482;1442;126;411;99;270;225;681
411880;202206;2790;6391;2018;5177;226;681;951;2241;1177;2922
411885;202206;1239;3139;880;2467;120;397;235;521;355;918
411890;202206;1654;4233;1196;3450;218;697;143;381;361;1078
411900;202206;943;2455;593;1737;123;381;131;363;254;744
411910;202206;1239;3476;900;2807;164;611;305;847;469;1458
411915;202206;17911;42550;12638;33251;1839;5360;5576;13174;7415;18534
411920;202206;1364;3689;1132;3270;225;715;449;1204;674;1919
411925;202206;543;1367;386;1087;69;208;174;445;243;653
411930;202206;5786;16269;4875;14689;2131;6771;596;2009;2727;8780
411940;202206;3815;10399;3027;8838;692;2104;1111;2909;1803;5013
411950;202206;17190;43715;14337;39164;1535;4882;9120;23593;10655;28475
411960;202206;6969;17480;5540;14811;1045;2961;2251;5576;3296;8537
411965;202206;547;1448;391;1133;52;163;172;450;224;613
411970;202206;1316;2805;1027;2425;196;400;477;1304;673;1704
411980;202206;1786;4038;1310;3308;262;659;602;1439;864;2098
411990;202206;45284;112674;30356;86617;5286;16538;12388;33118;17674;49656
411995;202206;5181;11969;4044;10256;1063;2993;1308;3111;2371;6104
412000;202206;2118;4683;1498;3660;43;142;1076;2432;1119;2574
412010;202206;698;2014;503;1599;67;237;121;317;188;554
412015;202206;592;1578;476;1362;66;184;257;734;323;918
412020;202206;511;1409;326;1024;52;186;116;335;168;521
412030;202206;693;1878;516;1551;67;221;212;590;279;811
412033;202206;1054;2673;743;2080;69;201;286;676;355;877
412035;202206;805;2111;522;1594;70;218;267;781;337;999
412040;202206;793;2054;467;1396;58;164;81;216;139;380
412050;202206;1732;4157;1181;3176;267;806;269;701;536;1507
412060;202206;8390;22822;6877;19869;1751;5694;2006;5468;3757;11162
412065;202206;719;1874;525;1496;98;313;153;403;251;716
412070;202206;1463;3586;1129;2972;130;402;491;1108;621;1510
412080;202206;2810;7109;2037;5667;273;884;869;2047;1142;2931
412085;202206;369;864;143;410;12;48;39;82;51;130
412090;202206;7331;17623;5411;14304;1132;3204;2280;5949;3412;9153
412100;202206;2081;5226;1542;4290;468;1439;419;1174;887;2613
412110;202206;1056;2681;688;1956;88;266;220;552;308;818
412120;202206;2615;6866;2021;5838;445;1443;621;1546;1066;2989
412125;202206;812;2159;512;1547;91;276;112;320;203;596
412130;202206;913;2185;623;1655;120;318;159;402;279;720
412135;202206;668;1739;334;990;45;161;119;299;164;460
412140;202206;2191;5098;1567;4041;252;722;395;977;647;1699
412150;202206;3186;7797;2643;6839;441;1308;1378;3213;1819;4521
412160;202206;1006;3040;561;1835;56;210;48;109;104;319
412170;202206;5161;13199;4339;11906;759;2271;2066;5177;2825;7448
412175;202206;1493;4068;1245;3636;261;778;508;1446;769;2224
412180;202206;1938;5104;1437;4210;189;637;624;1662;813;2299
412190;202206;3784;9115;2730;7263;325;975;1130;2854;1455;3829
412200;202206;2187;5956;1444;4307;355;1151;290;775;645;1926
412210;202206;753;1734;466;1263;65;202;191;461;256;663
412215;202206;3798;9710;2760;7711;611;1733;1184;3357;1795;5090
412217;202206;1122;2775;929;2443;23;77;678;1659;701;1736
412220;202206;6877;18749;5523;16285;1267;3752;1794;5166;3061;8918
412230;202206;3078;8527;2424;7350;397;1400;521;1333;918;2733
412240;202206;8909;22243;5874;16478;1002;3053;1835;4491;2837;7544
412250;202206;2249;5561;1646;4458;397;1144;351;840;748;1984
412260;202206;1520;3793;1161;3115;204;582;396;973;600;1555
412265;202206;1135;2808;909;2446;122;372;537;1315;659;1687
412270;202206;1150;3069;766;2271;110;363;296;796;406;1159
412280;202206;457;1177;350;996;84;250;89;227;173;477
412290;202206;1190;2863;860;2299;154;450;317;782;471;1232
412300;202206;1939;4823;1405;3915;249;741;376;971;625;1712
412310;202206;795;2197;607;1833;98;352;181;481;279;833
412320;202206;858;2122;546;1514;63;216;158;417;221;633
412330;202206;1789;4497;1231;3508;234;722;442;1250;676;1972
412340;202206;1340;3516;983;2805;144;482;142;359;286;841
412350;202206;3535;8949;2361;6703;466;1386;578;1436;1044;2822
412360;202206;309;802;236;659;6;24;158;419;164;443
412370;202206;1043;2778;736;2168;157;478;174;482;331;960
412380;202206;1722;4583;1230;3635;319;1020;101;304;420;1324
412382;202206;551;1300;362;979;44;155;183;401;227;556
412385;202206;2628;6622;2130;5734;590;1550;844;2344;1434;3894
412390;202206;2842;6551;2229;5585;375;1006;782;1916;1157;2922
412395;202206;841;2234;608;1725;86;234;283;764;369;998
412400;202206;1065;2668;749;2082;143;416;225;558;368;974
412402;202206;2694;6360;1878;5052;415;1101;469;1273;884;2374
412405;202206;3499;8879;2318;6762;632;1881;277;770;909;2651
412410;202206;7240;18023;5367;15045;914;2968;1732;4496;2646;7464
412420;202206;615;1475;396;1052;40;113;178;419;218;532
412430;202206;628;1548;348;971;39;114;142;365;181;479
412440;202206;3340;8322;2329;6566;541;1544;705;1910;1246;3454
412450;202206;575;1621;387;1157;61;183;43;85;104;268
412460;202206;1274;3063;996;2612;160;462;476;1190;636;1652
412470;202206;1804;5272;1480;4583;354;1212;390;1140;744;2352
412480;202206;1371;3367;939;2528;155;456;369;857;524;1313
412490;202206;1543;3578;1178;2967;87;238;683;1572;770;1810
412500;202206;2322;5541;1770;4570;304;852;633;1431;937;2283
412510;202206;2238;6446;1627;4997;448;1466;305;755;753;2221
412520;202206;1527;3720;912;2511;195;528;163;405;358;933
412530;202206;768;1979;554;1570;77;214;101;264;178;478
412535;202206;891;2277;601;1726;126;393;92;190;218;583
412540;202206;1271;3116;914;2500;157;527;254;684;411;1211
412545;202206;785;1960;560;1521;97;283;182;465;279;748
412550;202206;41483;104621;30534;83816;4441;13436;14145;34732;18586;48168
412555;202206;331;830;227;613;27;93;73;144;100;237
412560;202206;5856;15778;4407;12651;932;2941;1129;2997;2061;5938
412570;202206;5115;12246;3095;8556;552;1740;560;1332;1112;3072
412575;202206;1219;2873;979;2490;172;449;508;1189;680;1638
412580;202206;1764;4298;1262;3414;112;333;706;1766;818;2099
412590;202206;473;1218;267;793;48;167;35;80;83;247
412600;202206;1910;4728;1475;3909;128;411;854;2044;982;2455
412610;202206;960;2483;693;1928;98;301;323;769;421;1070
412620;202206;1443;3569;1106;3051;221;651;414;1058;635;1709
412625;202206;10207;26071;6637;19227;1251;3832;589;1571;1840;5403
412627;202206;1272;3439;883;2673;178;586;244;717;422;1303
412630;202206;3138;8869;2232;6961;382;1294;598;1618;980;2912
412635;202206;483;1248;310;901;32;103;103;242;135;345
412640;202206;1138;2889;659;1907;87;238;157;388;244;626
412650;202206;1904;4975;1497;4164;246;771;593;1451;839;2222
412660;202206;3041;7414;2207;5886;269;792;846;1999;1115;2791
412665;202206;445;1071;343;897;57;171;152;363;209;534
412667;202206;1982;5004;1444;3961;209;636;639;1673;848;2309
412670;202206;985;2236;674;1748;140;373;202;472;342;845
412680;202206;2365;5998;1634;4674;195;653;545;1289;740;1942
412690;202206;1316;3280;911;2510;173;511;316;789;489;1300
412700;202206;2153;5384;1808;4847;269;802;951;2432;1220;3234
412710;202206;6588;18202;4926;14830;890;2945;1370;3502;2260;6447
412720;202206;1377;3795;1109;3244;171;558;330;772;501;1330
412730;202206;3015;7471;2174;5899;369;1092;847;2082;1216;3174
412740;202206;2269;6072;1583;4766;320;1068;246;717;566;1785
412750;202206;4535;11342;3709;10135;361;1125;2303;5935;2664;7060
412760;202206;3418;8738;2862;7833;515;1616;1616;4134;2131;5750
412770;202206;12869;32385;7271;21608;944;2992;1636;4012;2580;7004
412780;202206;1392;3490;1063;2917;247;742;380;937;627;1679
412785;202206;2507;5576;1764;4388;235;590;1132;2753;1367;3343
412788;202206;1607;4316;1312;3809;328;950;527;1458;855;2408
412790;202206;1548;3915;950;2775;145;471;327;794;472;1265
412795;202206;1399;3496;788;2304;139;439;165;452;304;891
412796;202206;2600;7053;2176;6312;484;1530;718;1886;1202;3416
412800;202206;4473;10239;3223;8011;355;1065;1657;3559;2012;4624
412810;202206;14363;35399;9725;26370;1127;3598;4218;10030;5345;13628
412820;202206;7187;18822;5143;14867;1182;3592;1617;4571;2799;8163
412830;202206;371;1031;282;850;36;105;70;199;106;304
412840;202206;2126;4955;1491;3784;142;417;832;1884;974;2301
412850;202206;3096;7708;2312;6450;279;876;1128;2902;1407;3778
412853;202206;1792;4248;1491;3749;204;591;816;1765;1020;2356
412855;202206;1537;3835;862;2449;115;382;209;472;324;854
412860;202206;847;2045;569;1586;97;295;242;589;339;884
412862;202206;749;1807;508;1414;101;289;194;507;295;796
412863;202206;1433;4014;1277;3735;292;935;564;1510;856;2445
412865;202206;772;2002;564;1602;144;411;158;446;302;857
412870;202206;1025;2517;749;2082;199;616;237;656;436;1272
412880;202206;1028;2676;738;2139;141;448;240;621;381;1069
420005;202206;484;1369;291;912;28;89;144;442;172;531
420010;202206;3637;8624;2406;6564;164;476;1783;4877;1947;5353
420020;202206;511;1523;341;1099;63;242;104;262;167;504
420030;202206;126;421;86;316;25;103;20;72;45;175
420040;202206;655;1904;393;1325;90;355;34;98;124;453
420050;202206;815;1812;554;1352;119;330;309;654;428;984
420055;202206;185;548;105;348;19;71;35;107;54;178
420060;202206;168;474;119;360;20;58;45;132;65;190
420070;202206;947;2650;730;2215;165;528;338;970;503;1498
420075;202206;87;225;50;150;8;24;13;21;21;45
420080;202206;472;1283;348;986;73;229;130;326;203;555
420090;202206;480;1429;309;1041;72;265;70;198;142;463
420100;202206;1632;3846;1340;3387;71;198;1043;2586;1114;2784
420110;202206;302;917;259;825;37;133;144;451;181;584
420120;202206;699;1828;490;1384;67;215;252;638;319;853
420125;202206;418;1194;295;925;63;217;101;290;164;507
420127;202206;356;929;153;469;26;100;62;174;88;274
420130;202206;4898;12963;3773;11101;687;2263;1584;4163;2271;6426
420140;202206;4832;12398;3659;10403;1022;3133;918;2483;1940;5616
420150;202206;763;1879;553;1538;51;166;322;864;373;1030
420160;202206;230;550;95;281;15;61;26;62;41;123
420165;202206;186;523;119;373;29;96;38;95;67;191
420170;202206;329;974;236;753;40;138;80;215;120;353
420180;202206;185;573;111;388;17;80;29;86;46;166
420190;202206;238;680;139;431;31;101;46;127;77;228
420195;202206;2053;5116;1578;4371;401;1309;606;1506;1007;2815
420200;202206;7218;16866;4751;12382;620;1874;2272;5039;2892;6913
420205;202206;2342;5953;1610;4503;246;769;867;2326;1113;3095
420207;202206;2406;5925;1566;4373;257;807;654;1656;911;2463
420208;202206;383;1045;232;746;80;254;56;156;136;410
420209;202206;184;562;125;389;16;60;62;170;78;230
420210;202206;4403;10884;3172;8822;451;1486;1713;4441;2164;5927
420213;202206;925;2646;757;2311;146;491;303;896;449;1387
420215;202206;264;753;183;567;44;149;53;155;97;304
420220;202206;364;1045;241;792;39;153;90;260;129;413
420230;202206;6508;16629;5085;14064;622;1956;2861;7347;3483;9303
420240;202206;17235;46297;11376;32978;1334;4570;5502;13682;6836;18252
420243;202206;477;1201;395;1055;53;154;267;692;320;846
420245;202206;1924;4749;1464;3971;132;425;939;2390;1071;2815
420250;202206;600;1509;525;1397;41;137;388;977;429;1114
420253;202206;531;1231;379;1017;32;96;228;602;260;698
420257;202206;180;465;119;359;18;56;62;189;80;245
420260;202206;1370;3299;1034;2855;91;305;782;2113;873;2418
420270;202206;650;1640;339;941;36;111;145;359;181;470
420280;202206;1617;4481;1309;3864;175;612;618;1681;793;2293
420285;202206;132;335;94;264;16;59;32;53;48;112
420287;202206;518;1134;369;935;67;180;175;432;242;612
420290;202206;6104;16612;4791;13823;640;2143;2786;7363;3426;9506
420300;202206;8646;23449;5140;15384;934;3083;1693;4421;2627;7504
420310;202206;1009;2167;580;1438;46;148;355;780;401;928
420315;202206;902;2331;630;1895;69;235;359;1038;428;1273
420320;202206;6632;16986;4908;14249;1389;4410;1589;4319;2978;8729
420325;202206;393;1081;278;864;39;130;108;309;147;439
420330;202206;1094;3057;725;2303;126;472;236;659;362;1131
420340;202206;1250;3205;966;2702;200;618;364;886;564;1504
420350;202206;1405;3360;1042;2753;98;298;706;1811;804;2109
420360;202206;3378;8915;1880;5759;370;1216;178;535;548;1751
420370;202206;1531;3789;1228;3279;96;334;855;2125;951;2459
420380;202206;5224;13072;3600;10159;668;2104;1562;4050;2230;6154
420390;202206;1211;2917;866;2252;159;463;331;623;490;1086
420395;202206;1416;3849;1009;3054;163;556;189;412;352;968
420400;202206;1247;3269;871;2543;109;359;442;1214;551;1573
420410;202206;662;1649;518;1360;31;92;378;974;409;1066
420415;202206;394;1090;286;843;56;187;124;361;180;548
420417;202206;717;2032;562;1706;122;377;272;844;394;1221
420419;202206;174;596;125;465;48;190;13;53;61;243
420420;202206;15100;38251;10560;29922;2614;8301;3676;9443;6290;17744
420425;202206;723;1918;507;1460;43;146;257;696;300;842
420430;202206;3681;9531;2298;6597;401;1318;927;2344;1328;3662
420435;202206;334;842;193;584;33;109;96;277;129;386
420440;202206;878;2257;565;1594;135;386;198;534;333;920
420445;202206;280;655;181;480;28;85;72;156;100;241
420450;202206;925;2638;669;2064;113;428;240;614;353;1042
420455;202206;2375;5414;1770;4518;363;945;819;2068;1182;3013
420460;202206;11088;28203;8560;23660;1136;3626;4707;12190;5843;15816
420470;202206;726;1839;394;1129;66;212;111;268;177;480
420475;202206;78;205;35;110;7;29;5;8;12;37
420480;202206;6347;15107;4112;11373;662;1958;1768;4745;2430;6703
420490;202206;438;1181;307;903;49;163;138;379;187;542
420500;202206;1567;4066;1054;3169;171;597;495;1401;666;1998
420510;202206;180;495;102;330;19;65;27;77;46;142
420515;202206;122;331;81;245;12;47;29;85;41;132
420517;202206;810;2105;682;1875;72;208;409;1118;481;1326
420519;202206;353;864;251;692;27;82;128;352;155;434
420520;202206;316;828;173;555;28;85;13;34;41;119
420530;202206;929;2655;630;1993;104;383;231;613;335;996
420535;202206;238;671;100;318;15;55;30;75;45;130
420540;202206;46602;108565;32563;85441;4357;13057;13322;30376;17679;43433
420543;202206;268;771;208;632;32;113;92;245;124;358
420545;202206;1532;4460;1157;3637;259;861;394;1131;653;1992
420550;202206;4485;11219;2994;8672;475;1551;1304;3644;1779;5195
420555;202206;393;1063;273;826;30;107;153;428;183;535
420560;202206;460;1068;322;872;49;123;191;525;240;648
420570;202206;3234;8059;2451;6636;397;1196;1269;3217;1666;4413
420580;202206;2012;5233;1411;4240;300;982;444;1235;744;2217
420590;202206;3267;8553;2077;6025;349;1174;608;1401;957;2575
420600;202206;1279;3433;1023;2978;103;397;634;1734;737;2131
420610;202206;518;1450;364;1128;75;240;161;486;236;726
420620;202206;923;2242;641;1782;133;388;257;691;390;1079
420630;202206;1118;3269;823;2563;124;421;420;1208;544;1629
420640;202206;558;1486;297;958;94;315;59;179;153;494
420650;202206;4305;10926;2846;8009;415;1289;1264;3024;1679;4313
420660;202206;492;1219;318;859;73;215;69;154;142;369
420665;202206;797;2004;535;1563;86;288;246;640;332;928
420670;202206;1414;3855;893;2770;115;415;230;567;345;982
420675;202206;218;571;139;422;13;49;83;238;96;287
420680;202206;330;721;180;515;26;97;96;247;122;344
420690;202206;1019;2839;661;2011;88;295;216;548;304;843
420700;202206;3411;8667;2641;7312;200;649;1753;4633;1953;5282
420710;202206;1275;3440;1034;2944;120;432;622;1556;742;1988
420720;202206;1481;3903;1101;3224;176;562;630;1713;806;2275
420730;202206;3852;9661;2951;8205;495;1530;1559;4053;2054;5583
420740;202206;534;1539;307;1044;76;269;27;89;103;358
420750;202206;2386;6655;1598;4890;273;1012;609;1644;882;2656
420757;202206;115;283;55;170;6;19;28;88;34;107
420760;202206;401;1122;225;667;37;113;76;198;113;311
420765;202206;579;1584;305;932;42;148;172;500;214;648
420768;202206;1541;4052;1337;3719;130;365;1014;2790;1144;3155
420770;202206;430;1158;198;687;23;94;46;144;69;238
420775;202206;339;923;214;663;39;137;80;203;119;340
420780;202206;1090;2987;645;1970;105;326;97;263;202;589
420785;202206;246;616;180;486;21;70;82;169;103;239
420790;202206;1253;3518;960;2923;169;608;553;1563;722;2171
420800;202206;822;1916;501;1327;117;319;246;632;363;951
420810;202206;1706;4917;1427;4388;328;1204;689;1836;1017;3040
420820;202206;15505;37671;11439;31236;1759;5334;5816;14723;7575;20057
420830;202206;5491;13816;4168;11523;682;2074;1877;4863;2559;6937
420840;202206;575;1721;302;1083;75;270;36;117;111;387
420845;202206;3261;8058;2211;6219;425;1427;950;2488;1375;3915
420850;202206;1294;3927;852;2801;159;566;220;657;379;1223
420860;202206;461;1199;275;850;66;208;75;209;141;417
420870;202206;915;2473;661;1945;140;443;230;622;370;1065
420880;202206;1308;3736;1036;3204;203;715;443;1250;646;1965
420890;202206;9147;24124;5821;17331;840;2779;2058;5325;2898;8104
420895;202206;206;566;136;396;21;59;56;157;77;216
420900;202206;1757;4228;1094;3089;147;543;509;1204;656;1747
420910;202206;38772;99063;26153;75622;3817;12768;11534;29163;15351;41931
420915;202206;567;1948;437;1608;65;266;236;873;301;1139
420917;202206;536;1335;250;653;36;84;125;323;161;407
420920;202206;105;270;46;144;4;16;12;34;16;50
420930;202206;19886;49105;14594;40010;2229;6824;7402;18839;9631;25663
420940;202206;3781;8978;2403;6690;520;1626;597;1331;1117;2957
420945;202206;219;647;131;399;21;78;56;148;77;226
420950;202206;419;1151;266;801;39;128;80;211;119;339
420960;202206;1248;2984;911;2441;141;430;441;1058;582;1488
420970;202206;2734;7150;1884;5602;417;1291;627;1822;1044;3113
420980;202206;300;1001;254;896;98;359;72;257;170;616
420985;202206;395;1073;233;746;47;173;65;175;112;348
420990;202206;395;1168;239;791;35;122;55;163;90;285
421000;202206;639;1856;460;1474;96;333;110;275;206;608
421003;202206;515;1239;182;522;15;44;15;36;30;80
421005;202206;109;304;72;226;16;49;29;93;45;142
421010;202206;4008;10401;2932;8468;538;1767;1024;2503;1562;4270
421020;202206;444;1346;356;1178;53;205;185;576;238;781
421030;202206;1119;3042;860;2523;196;628;360;967;556;1595
421040;202206;751;1752;465;1302;47;138;277;747;324;885
421050;202206;1292;3353;882;2465;138;413;351;878;489;1291
421055;202206;186;488;109;319;17;55;61;162;78;217
421060;202206;816;2239;583;1753;92;337;285;755;377;1092
421070;202206;750;2144;468;1444;68;233;203;554;271;787
421080;202206;596;1680;470;1434;79;293;214;597;293;890
421085;202206;407;1132;186;615;20;66;36;94;56;160
421090;202206;308;781;178;493;17;60;66;156;83;216
421100;202206;961;2083;437;1233;84;260;130;312;214;572
421105;202206;1852;4757;1329;3797;201;641;638;1694;839;2335
421110;202206;1439;3519;1184;3152;122;384;731;1931;853;2315
421120;202206;1238;3631;876;2834;141;494;252;718;393;1212
421125;202206;387;954;281;758;80;236;119;298;199;534
421130;202206;6410;17579;5288;15401;971;3103;2850;7835;3821;10938
421140;202206;388;1012;262;761;45;141;110;284;155;425
421145;202206;483;1268;324;946;93;298;94;230;187;528
421150;202206;835;2253;568;1708;115;395;240;626;355;1021
421160;202206;643;1731;492;1432;71;265;299;796;370;1061
421165;202206;253;718;157;477;26;80;61;169;87;249
421170;202206;1274;3293;1074;2972;105;286;764;2128;869;2414
421175;202206;1156;2892;689;2084;112;396;314;878;426;1274
421180;202206;444;1126;247;739;32;122;116;297;148;419
421185;202206;363;907;254;696;28;89;138;345;166;434
421187;202206;306;918;192;631;37;118;72;229;109;347
421189;202206;468;1282;355;1056;53;183;150;405;203;588
421190;202206;14920;38436;10777;30724;1803;5876;4687;11888;6490;17764
421200;202206;869;2294;680;1941;91;323;392;1043;483;1366
421205;202206;251;649;184;528;37;108;76;213;113;321
421210;202206;1291;3132;732;2162;148;433;248;708;396;1141
421220;202206;1625;4582;1278;3867;334;1109;454;1228;788;2337
421223;202206;412;1048;276;813;46;155;168;468;214;623
421225;202206;1055;2885;905;2653;111;379;591;1713;702;2092
421227;202206;814;2210;535;1629;96;320;229;693;325;1013
421230;202206;664;1691;437;1270;89;289;163;452;252;741
421240;202206;308;881;140;480;22;95;24;60;46;155
421250;202206;2521;6172;1831;5077;272;765;1048;2814;1320;3579
421260;202206;255;784;65;217;15;54;7;22;22;76
421265;202206;930;2197;794;2020;50;127;671;1686;721;1813
421270;202206;417;1101;207;666;42;137;86;257;128;394
421280;202206;2577;6558;1948;5508;269;901;1086;2870;1355;3771
421290;202206;1216;3289;610;1815;100;318;140;357;240;675
421300;202206;346;904;175;557;29;104;28;87;57;191
421310;202206;242;668;166;513;42;129;80;247;122;376
421315;202206;304;761;207;569;52;130;70;200;122;330
421320;202206;702;2164;398;1308;43;137;50;90;93;227
421330;202206;704;1984;482;1498;99;327;146;411;245;738
421335;202206;426;1239;347;1100;55;202;158;473;213;675
421340;202206;1661;4379;1168;3495;168;571;565;1582;733;2153
421350;202206;1837;4504;1213;3473;214;688;488;1336;702;2024
421360;202206;2568;6567;1566;4587;374;1254;545;1298;919;2552
421370;202206;857;2621;567;1887;96;359;187;499;283;858
421380;202206;965;2373;839;2185;86;269;544;1354;630;1623
421390;202206;176;455;71;231;17;53;23;64;40;117
421400;202206;662;1742;431;1282;69;236;200;523;269;759
421410;202206;218;576;108;357;26;82;30;104;56;186
421415;202206;224;597;160;439;23;74;64;147;87;221
421420;202206;715;1887;524;1474;53;169;285;752;338;921
421430;202206;110;333;74;241;9;27;13;31;22;58
421440;202206;759;1955;463;1394;83;238;197;582;280;820
421450;202206;537;1556;325;1071;48;160;44;142;92;302
421460;202206;413;1249;229;831;13;44;18;52;31;96
421470;202206;367;991;250;760;39;123;89;278;128;401
421480;202206;3293;8527;2273;6484;334;1129;1029;2670;1363;3799
421490;202206;133;439;80;297;13;59;12;36;25;95
421500;202206;2521;7054;1763;5485;396;1443;497;1297;893;2740
421505;202206;358;916;301;834;28;96;199;529;227;625
421507;202206;494;1308;295;882;52;165;127;350;179;515
421510;202206;452;1192;311;879;39;139;159;367;198;506
421520;202206;540;1397;334;913;53;141;138;329;191;470
421530;202206;346;1005;199;673;29;132;36;85;65;217
421535;202206;479;1201;286;816;39;113;147;400;186;513
421540;202206;381;872;212;606;30;96;72;195;102;291
421545;202206;722;2056;560;1777;104;385;288;851;392;1236
421550;202206;2576;6607;1978;5565;309;939;1090;2942;1399;3881
421555;202206;195;573;76;259;7;24;14;25;21;49
421560;202206;98;315;58;206;9;36;18;48;27;84
421565;202206;1079;2666;761;2167;174;553;292;772;466;1325
421567;202206;596;1737;436;1311;113;377;122;359;235;736
421568;202206;376;1061;226;701;36;132;85;236;121;368
421569;202206;179;510;82;263;9;33;47;144;56;177
421570;202206;1637;4397;1189;3478;222;716;461;1205;683;1921
421575;202206;364;987;270;745;35;118;149;371;184;489
421580;202206;5218;13648;3421;9991;474;1625;1375;3425;1849;5050
421590;202206;197;571;150;468;31;111;62;187;93;298
421600;202206;661;1689;449;1246;82;267;163;378;245;645
421605;202206;775;1985;568;1653;108;304;245;731;353;1035
421610;202206;1146;2932;772;2223;149;443;240;683;389;1126
421620;202206;4614;11690;3038;8915;590;1943;1166;3129;1756;5072
421625;202206;157;435;83;259;12;39;24;66;36;105
421630;202206;3149;7992;2112;6080;347;1133;816;2013;1163;3146
421635;202206;440;1162;279;838;23;99;158;407;181;506
421640;202206;756;1920;529;1568;115;362;249;697;364;1059
421650;202206;2882;7501;1985;5880;414;1467;687;1798;1101;3265
421660;202206;13028;34645;9490;27794;1320;4469;4609;12241;5929;16710
421670;202206;934;2561;669;1923;122;403;309;802;431;1205
421680;202206;1822;3857;1516;3396;82;281;1257;2584;1339;2865
421690;202206;1656;4557;1152;3530;246;813;346;992;592;1805
421700;202206;678;1923;479;1478;102;338;145;382;247;720
421710;202206;236;715;127;404;16;54;55;160;71;214
421715;202206;155;384;114;298;17;50;74;188;91;238
421720;202206;2412;6332;1449;4286;310;1028;462;1164;772;2192
421725;202206;319;773;170;496;27;92;71;171;98;263
421730;202206;558;1595;355;1033;53;164;179;464;232;628
421740;202206;938;2540;636;1919;105;348;241;620;346;968
421750;202206;1020;2339;514;1424;110;332;186;460;296;792
421755;202206;202;552;113;344;18;66;42;111;60;177
421760;202206;1200;3002;792;2269;153;507;293;717;446;1224
421770;202206;2857;7216;2071;5886;423;1216;881;2445;1304;3661
421775;202206;240;614;147;429;19;64;63;161;82;225
421780;202206;1016;2817;675;2105;125;440;304;859;429;1299
421790;202206;1008;2647;574;1784;114;379;202;564;316;943
421795;202206;205;579;144;436;29;93;43;118;72;211
421800;202206;3646;9265;2751;7656;399;1235;1599;4173;1998;5408
421810;202206;680;1783;469;1406;50;163;258;747;308;910
421820;202206;1189;3359;795;2426;142;496;289;747;431;1243
421825;202206;1716;4179;1489;3840;106;319;1135;2837;1241;3156
421830;202206;2141;5914;1636;4898;338;1124;429;1152;767;2276
421835;202206;281;674;192;529;31;106;98;255;129;361
421840;202206;237;723;174;590;28;109;52;160;80;269
421850;202206;443;1245;255;867;45;168;63;169;108;337
421860;202206;338;917;198;626;33;121;63;164;96;285
421870;202206;5505;13269;4144;10786;472;1507;2450;5668;2922;7175
421875;202206;348;997;154;471;21;67;37;94;58;161
421880;202206;776;2137;517;1572;107;321;142;413;249;734
421885;202206;302;805;193;569;32;101;89;229;121;330
421890;202206;1046;2886;792;2393;116;443;475;1338;591;1781
421895;202206;471;1162;408;1070;46;104;278;759;324;863
421900;202206;1234;3202;923;2513;105;356;455;1070;560;1426
421910;202206;375;1099;225;724;34;134;58;154;92;288
421915;202206;467;1290;282;850;64;189;61;163;125;352
421917;202206;686;1507;392;1110;108;324;103;299;211;623
421920;202206;449;1320;316;1044;107;359;113;382;220;741
421930;202206;3418;8383;1954;5638;384;1222;740;1847;1124;3069
421935;202206;460;1351;372;1169;70;228;226;700;296;928
421940;202206;413;1150;196;587;28;91;59;140;87;231
421950;202206;3586;8803;2117;6014;417;1294;598;1486;1015;2780
421960;202206;185;438;102;290;11;34;36;80;47;114
421970;202206;2268;5643;1488;4086;257;838;666;1606;923;2444
421985;202206;370;1002;249;756;31;96;116;335;147;431
422000;202206;2248;5423;1837;4810;127;421;1318;3373;1445;3794
430003;202206;645;1657;439;1298;79;239;211;619;290;858
430005;202206;325;845;226;679;17;56;138;394;155;450
430010;202206;2053;4535;1570;3817;311;726;877;2154;1188;2880
430020;202206;651;1446;475;1195;53;152;294;688;347;840
430030;202206;1183;2618;688;1730;128;328;329;765;457;1093
430040;202206;11612;26085;7399;19117;1928;5206;1872;4601;3800;9807
430045;202206;594;1381;437;1109;31;93;324;791;355;884
430047;202206;276;591;110;282;23;59;35;86;58;145
430050;202206;918;2208;548;1502;101;297;238;619;339;916
430055;202206;313;741;154;420;16;52;75;175;91;227
430057;202206;96;210;42;119;13;42;8;17;21;59
430060;202206;21988;54967;17478;48052;2870;8561;9442;25154;12312;33715
430063;202206;859;2279;715;2008;139;396;411;1137;550;1533
430064;202206;1290;3265;957;2636;152;442;523;1385;675;1827
430066;202206;118;255;87;204;8;23;70;157;78;180
430070;202206;771;1963;163;510;35;109;22;54;57;163
430080;202206;1041;2480;622;1668;91;288;322;761;413;1049
430085;202206;1033;2135;639;1527;90;234;313;709;403;943
430087;202206;980;2237;811;2016;75;220;560;1349;635;1569
430090;202206;528;1323;201;632;33;116;44;120;77;236
430100;202206;1137;2646;683;1809;129;371;215;500;344;871
430105;202206;1506;3739;1035;2938;152;503;501;1355;653;1858
430107;202206;186;523;93;277;11;27;32;79;43;106
430110;202206;2545;6018;1916;5090;316;897;974;2484;1290;3381
430120;202206;1443;3921;978;2825;176;489;449;1260;625;1749
430130;202206;4015;8619;2975;7207;984;2338;678;1940;1662;4278
430140;202206;1175;2906;836;2304;126;380;448;1171;574;1551
430150;202206;630;1579;355;1038;71;221;106;289;177;510
430155;202206;256;640;128;373;22;65;27;67;49;132
430160;202206;23964;51611;19028;44899;1773;4542;12624;28829;14397;33371
430163;202206;3732;8084;2668;6514;83;287;2051;4827;2134;5114
430165;202206;342;826;121;369;14;37;22;57;36;94
430170;202206;1070;2699;386;1233;71;266;68;161;139;427
430175;202206;863;2201;747;1982;148;369;396;1057;544;1426
430180;202206;740;1758;557;1446;83;212;298;772;381;984
430185;202206;742;1847;385;1091;104;268;69;189;173;457
430187;202206;919;1852;673;1553;86;191;451;1026;537;1217
430190;202206;1616;3863;1275;3354;231;639;627;1569;858;2208
430192;202206;134;351;56;160;11;30;15;37;26;67
430195;202206;486;1356;79;259;8;24;14;38;22;62
430200;202206;1248;3409;977;2918;294;910;271;847;565;1757
430205;202206;550;1242;502;1154;11;41;465;1042;476;1083
430210;202206;7413;18622;4864;13281;745;2230;1427;3037;2172;5267
430215;202206;389;916;244;636;38;104;103;265;141;369
430220;202206;705;1706;230;722;28;90;69;184;97;274
430222;202206;264;689;180;531;22;72;66;193;88;265
430223;202206;298;736;219;604;21;64;130;349;151;413
430225;202206;19;37;13;28;0;0;10;20;10;20
430230;202206;2274;5707;1892;5160;108;343;1493;3984;1601;4327
430235;202206;461;1235;300;901;49;163;84;202;133;365
430237;202206;582;1277;450;1071;23;66;357;823;380;889
430240;202206;1526;3415;851;2246;100;321;429;990;529;1311
430245;202206;811;2094;642;1785;115;320;384;1082;499;1402
430250;202206;1129;2579;824;2107;300;806;159;358;459;1164
430258;202206;150;382;112;309;8;21;57;154;65;175
430260;202206;802;1953;551;1508;62;188;314;842;376;1030
430265;202206;242;675;164;531;23;75;64;208;87;283
430270;202206;3516;7873;2800;6817;309;881;1960;4529;2269;5410
430280;202206;5864;12813;4215;10116;713;1751;2099;4802;2812;6553
430290;202206;2529;5411;2067;4873;92;263;1673;3837;1765;4100
430300;202206;12006;27922;9184;23320;1241;3433;5302;12811;6543;16244
430310;202206;15022;35449;10762;27862;1295;3689;5900;14107;7195;17796
430320;202206;1158;2738;667;1802;54;164;410;1070;464;1234
430330;202206;762;1781;451;1177;65;174;177;414;242;588
430340;202206;713;1591;486;1243;65;164;310;759;375;923
430350;202206;9719;22316;7536;18738;814;2212;4818;11279;5632;13491
430355;202206;378;995;147;448;26;80;17;43;43;123
430360;202206;991;2261;632;1650;124;364;232;559;356;923
430367;202206;396;838;239;585;40;119;128;281;168;400
430370;202206;557;1450;229;677;44;131;57;130;101;261
430380;202206;747;1783;382;1135;76;237;97;270;173;507
430390;202206;3987;9252;2593;6810;565;1613;391;774;956;2387
430400;202206;1183;2385;845;1928;124;312;417;897;541;1209
430410;202206;623;1397;454;1137;39;112;323;774;362;886
430420;202206;3247;7885;2548;6533;363;1067;1559;3668;1922;4735
430430;202206;622;1515;284;837;56;188;51;129;107;317
430435;202206;1906;4486;1423;3676;230;637;732;1845;962;2482
430440;202206;4590;11688;3679;10236;349;1071;2313;6325;2662;7396
430450;202206;8293;18832;6773;16314;1085;2949;3851;8608;4936;11557
430460;202206;42727;101109;31885;83699;4181;12212;17925;44656;22106;56868
430461;202206;243;626;89;261;16;58;36;83;52;141
430462;202206;347;880;184;565;36;114;49;135;85;249
430463;202206;7621;18927;5686;15501;1044;3124;2684;6951;3728;10075
430465;202206;549;1303;420;1073;60;160;267;661;327;821
430466;202206;5327;12488;4299;10959;732;1934;2395;5783;3127;7717
430467;202206;556;1290;402;1064;49;153;236;570;285;723
430468;202206;1563;3598;1256;3168;101;319;937;2287;1038;2606
430469;202206;685;1862;111;348;12;34;25;49;37;83
430470;202206;6560;16095;4392;12341;1147;3576;1225;3170;2372;6746
430471;202206;718;1879;596;1665;96;280;359;954;455;1234
430480;202206;692;1873;452;1357;70;228;130;320;200;548
430485;202206;184;464;86;244;14;31;21;57;35;88
430490;202206;450;1108;247;713;23;76;118;289;141;365
430495;202206;435;1139;295;884;41;136;142;399;183;535
430500;202206;1127;2769;802;2244;242;744;258;647;500;1391
430510;202206;32104;79171;23391;63128;3842;11547;10859;26553;14701;38100
430511;202206;392;1054;154;491;17;47;19;50;36;97
430512;202206;1161;2448;909;2076;190;441;399;906;589;1347
430513;202206;891;2056;437;1145;68;190;226;531;294;721
430515;202206;428;1125;310;893;38;118;162;452;200;570
430517;202206;1432;3890;1106;3187;162;462;657;1865;819;2327
430520;202206;1547;3727;853;2296;134;384;236;555;370;939
430530;202206;1075;2597;460;1330;69;206;128;343;197;549
430535;202206;4119;9978;3021;8081;405;1094;1596;4068;2001;5162
430537;202206;477;1356;409;1222;31;82;313;935;344;1017
430540;202206;688;1604;414;1149;61;176;235;634;296;810
430543;202206;1167;2004;711;1475;140;259;250;576;390;835
430544;202206;822;2208;557;1644;141;439;202;556;343;995
430545;202206;2808;6650;2124;5668;309;834;1279;3374;1588;4208
430550;202206;402;1082;297;865;63;194;100;266;163;460
430558;202206;174;384;70;181;5;12;29;70;34;82
430560;202206;312;716;168;479;29;90;60;147;89;237
430570;202206;953;2224;673;1741;120;390;320;703;440;1093
430580;202206;933;2230;674;1839;151;405;301;875;452;1280
430583;202206;206;504;47;132;2;7;11;20;13;27
430585;202206;240;577;132;361;25;79;49;113;74;192
430587;202206;222;588;166;495;17;57;71;208;88;265
430590;202206;1553;3554;1233;3060;111;306;887;2142;998;2448
430593;202206;27;76;19;49;4;8;7;18;11;26
430595;202206;479;1214;129;409;15;45;29;68;44;113
430597;202206;502;1207;266;749;24;72;77;166;101;238
430600;202206;2168;5479;939;2664;139;392;223;552;362;944
430605;202206;1542;3757;1133;3057;145;417;560;1460;705;1877
430607;202206;750;1622;505;1215;27;69;343;788;370;857
430610;202206;6914;15335;4780;12223;1229;3501;1318;3242;2547;6743
430613;202206;299;674;84;234;13;37;21;45;34;82
430620;202206;808;1871;618;1544;118;340;327;705;445;1045
430630;202206;476;1253;153;455;28;82;42;108;70;190
430632;202206;483;1223;213;595;37;95;86;235;123;330
430635;202206;671;1434;499;1144;41;85;366;839;407;924
430637;202206;499;1171;385;1004;35;111;259;651;294;762
430640;202206;1256;3251;864;2474;125;387;362;918;487;1305
430642;202206;391;1048;276;797;43;141;119;319;162;460
430645;202206;176;400;81;205;12;30;28;57;40;87
430650;202206;2097;5293;1600;4506;457;1188;673;2106;1130;3294
430655;202206;346;815;211;556;32;96;109;248;141;344
430660;202206;5850;13956;4519;11892;774;2161;2353;5982;3127;8143
430670;202206;702;1605;522;1306;87;214;244;601;331;815
430673;202206;581;1274;264;713;43;124;102;245;145;369
430675;202206;276;793;74;247;12;39;11;32;23;71
430676;202206;6295;14679;5088;12899;610;1681;3282;8053;3892;9734
430680;202206;1275;3147;801;2233;279;747;212;537;491;1284
430690;202206;3482;8625;2781;7426;806;2192;1109;2912;1915;5104
430692;202206;229;676;182;596;9;34;141;468;150;502
430693;202206;1050;2649;646;1874;122;406;191;508;313;914
430695;202206;435;1033;266;703;34;102;137;334;171;436
430697;202206;511;1211;394;1046;65;180;231;629;296;809
430700;202206;9154;21334;5918;15622;1181;3411;1653;3802;2834;7213
430705;202206;422;948;209;576;22;66;93;229;115;295
430710;202206;1988;3864;1377;3076;109;299;972;2049;1081;2348
430720;202206;929;2141;489;1366;62;194;255;645;317;839
430730;202206;1102;2861;772;2234;105;297;369;1014;474;1311
430740;202206;778;2007;398;1217;70;226;113;336;183;562
430745;202206;484;1130;333;847;48;154;172;357;220;511
430750;202206;1749;4118;1186;3153;302;824;483;1220;785;2044
430755;202206;498;1188;342;888;32;96;186;432;218;528
430760;202206;2591;6032;2005;5162;402;1120;986;2383;1388;3503
430770;202206;8150;19076;6442;16525;692;2030;4288;10524;4980;12554
430780;202206;2258;5351;1476;4063;237;711;732;1922;969;2633
430781;202206;677;1674;437;1148;141;388;144;319;285;707
430783;202206;387;860;249;655;36;119;138;342;174;461
430786;202206;34;106;20;74;3;13;2;7;5;20
430790;202206;5388;12575;3961;10191;367;1161;2441;5781;2808;6942
430800;202206;937;1970;705;1658;50;126;500;1133;550;1259
430805;202206;402;972;270;718;15;54;189;474;204;528
430807;202206;656;1562;409;1096;53;170;212;497;265;667
430810;202206;855;1977;408;1125;59;199;161;377;220;576
430820;202206;1414;3783;858;2622;126;397;283;774;409;1171
430825;202206;300;704;119;297;17;35;42;103;59;138
430830;202206;2045;5178;1672;4505;177;425;1134;3012;1311;3437
430840;202206;1203;2725;830;2145;117;291;537;1375;654;1666
430843;202206;190;449;91;249;5;11;31;78;36;89
430845;202206;566;1233;375;920;34;98;239;533;273;631
430850;202206;2684;6726;1881;5276;483;1385;565;1647;1048;3032
430860;202206;1165;2722;584;1609;82;277;270;627;352;904
430865;202206;603;1464;389;1085;92;278;101;232;193;510
430870;202206;616;1593;274;838;51;153;61;163;112;316
430880;202206;1680;3615;1188;2859;137;377;774;1742;911;2119
430885;202206;183;476;103;311;11;30;65;195;76;225
430890;202206;1225;2899;796;2176;116;376;114;288;230;664
430900;202206;3623;7206;2562;5753;132;423;1874;3891;2006;4314
430905;202206;1039;2495;715;1911;133;379;285;694;418;1073
430910;202206;2515;6487;1941;5353;290;925;941;2272;1231;3197
430912;202206;558;1518;389;1175;41;112;235;722;276;834
430915;202206;569;1621;399;1251;118;394;115;351;233;745
430920;202206;28930;68892;22948;59323;2604;7629;14871;36798;17475;44427
430925;202206;91;194;42;111;4;13;22;54;26;67
430930;202206;12950;28652;9129;23020;1260;3315;4975;12192;6235;15507
430940;202206;1305;3204;860;2360;173;499;326;795;499;1294
430950;202206;976;2002;632;1452;49;153;444;927;493;1080
430955;202206;462;1171;127;360;20;57;41;94;61;151
430957;202206;194;601;175;562;34;106;101;332;135;438
430960;202206;1597;3628;926;2457;188;535;360;866;548;1401
430965;202206;1711;3847;1355;3322;64;149;1028;2542;1092;2691
430970;202206;427;976;238;636;36;104;122;292;158;396
430975;202206;569;1570;437;1277;76;243;188;507;264;750
430980;202206;447;975;261;668;24;72;137;314;161;386
430990;202206;676;1786;472;1350;73;242;212;574;285;816
430995;202206;629;1504;456;1231;64;184;249;632;313;816
431000;202206;1547;3557;682;1924;126;362;62;149;188;511
431010;202206;2800;7066;2029;5770;397;1239;674;1661;1071;2900
431020;202206;9266;19408;5645;14021;956;2759;2476;5331;3432;8090
431030;202206;375;998;188;606;37;129;29;95;66;224
431033;202206;4573;10302;3071;7944;629;1668;1206;3025;1835;4693
431036;202206;352;750;77;221;3;10;26;58;29;68
431040;202206;1003;2392;649;1804;64;234;349;884;413;1118
431041;202206;496;1093;352;870;55;129;180;413;235;542
431043;202206;413;992;245;676;30;100;132;333;162;433
431046;202206;114;284;46;132;7;19;7;16;14;35
431050;202206;1463;3366;1043;2710;167;425;553;1458;720;1883
431053;202206;770;1903;421;1238;70;223;138;341;208;564
431055;202206;685;1562;537;1326;46;123;391;954;437;1077
431057;202206;238;677;141;453;28;99;55;161;83;260
431060;202206;6486;15242;4445;11923;989;2859;1574;3966;2563;6825
431065;202206;461;1100;341;901;46;130;180;459;226;589
431070;202206;457;1189;283;821;68;218;64;172;132;390
431075;202206;270;730;153;470;35;119;51;148;86;267
431080;202206;637;1677;448;1292;69;217;168;443;237;660
431085;202206;869;2167;528;1432;54;156;275;718;329;874
431087;202206;461;1202;362;1004;40;110;215;579;255;689
431090;202206;463;1049;184;547;30;93;44;129;74;222
431100;202206;4370;8967;3069;7318;305;808;1947;4484;2252;5292
431110;202206;1619;3554;1134;2715;178;462;570;1238;748;1700
431112;202206;726;1770;610;1575;72;219;410;997;482;1216
431113;202206;483;1218;401;1065;73;206;229;566;302;772
431115;202206;1081;2891;843;2453;68;250;575;1582;643;1832
431120;202206;3071;7456;2135;5724;476;1409;769;1871;1245;3280
431123;202206;395;1013;264;749;47;128;140;388;187;516
431125;202206;1242;3111;930;2550;264;724;449;1260;713;1984
431127;202206;212;567;74;227;8;29;13;34;21;63
431130;202206;3644;8558;2787;7255;387;1125;1528;3801;1915;4926
431140;202206;6487;15029;4097;10674;501;1416;1773;3953;2274;5369
431142;202206;680;1593;512;1332;81;217;325;834;406;1051
431150;202206;1155;2894;841;2345;131;405;420;1123;551;1528
431160;202206;752;1938;503;1428;103;308;152;395;255;703
431162;202206;651;1558;414;1137;38;130;230;566;268;696
431164;202206;193;450;53;162;4;13;11;28;15;41
431170;202206;516;1330;377;1060;101;289;113;297;214;586
431171;202206;932;1966;781;1780;135;287;543;1229;678;1516
431173;202206;515;1273;376;1071;112;375;124;309;236;684
431175;202206;1470;3283;921;2347;136;348;378;912;514;1260
431177;202206;992;2447;768;2106;145;429;434;1155;579;1584
431179;202206;357;767;109;314;21;62;34;98;55;160
431180;202206;2621;6404;1623;4477;364;1053;414;976;778;2029
431190;202206;677;1648;288;815;35;106;70;157;105;263
431198;202206;460;1285;378;1134;89;279;162;514;251;793
431200;202206;385;942;114;306;26;71;16;40;42;111
431205;202206;253;646;136;396;39;117;43;123;82;240
431210;202206;713;1587;569;1372;127;305;268;678;395;983
431213;202206;312;771;234;629;16;40;129;337;145;377
431215;202206;692;1614;359;1011;34;111;180;468;214;579
431217;202206;186;463;128;350;24;84;61;146;85;230
431220;202206;643;1565;398;1112;44;143;215;533;259;676
431225;202206;1710;3722;1329;3134;111;282;938;2153;1049;2435
431230;202206;781;2077;615;1731;130;389;305;780;435;1169
431235;202206;191;518;25;86;1;1;5;19;6;20
431237;202206;401;1200;318;1023;55;201;151;465;206;666
431238;202206;39;114;32;100;7;21;14;39;21;60
431240;202206;5703;13093;4564;11311;495;1467;2951;6809;3446;8276
431242;202206;315;738;271;659;26;74;203;477;229;551
431244;202206;434;1034;223;599;28;87;86;200;114;287
431245;202206;1486;3320;988;2482;78;204;532;1247;610;1451
431247;202206;305;727;188;501;28;86;92;217;120;303
431250;202206;2030;4770;1547;4141;354;876;780;2216;1134;3092
431260;202206;326;838;197;588;24;86;74;200;98;286
431261;202206;305;889;251;793;25;110;144;418;169;528
431262;202206;331;917;174;564;21;72;97;312;118;384
431265;202206;1788;4075;722;2015;113;347;215;511;328;858
431267;202206;274;666;182;480;15;51;124;294;139;345
431270;202206;3162;6740;1710;4289;375;993;575;1397;950;2390
431275;202206;159;423;100;290;23;69;42;108;65;177
431280;202206;263;708;107;344;19;62;14;29;33;91
431290;202206;391;1139;254;806;47;171;48;135;95;306
431295;202206;82;198;30;84;7;23;7;15;14;38
431300;202206;334;869;82;254;7;26;31;80;38;106
431301;202206;302;837;77;243;12;43;8;20;20;63
431303;202206;737;1773;442;1196;30;98;197;453;227;551
431306;202206;2566;5889;1639;4357;184;550;725;1704;909;2254
431308;202206;36;101;32;92;10;30;16;45;26;75
431310;202206;603;1529;431;1171;66;178;208;524;274;702
431320;202206;795;2086;474;1419;77;236;156;407;233;643
431330;202206;1992;4569;1071;2950;143;459;477;1163;620;1622
431333;202206;235;598;130;373;14;50;48;115;62;165
431335;202206;38;114;23;82;8;31;2;4;10;35
431337;202206;3701;8541;2974;7468;240;793;2216;5254;2456;6047
431339;202206;494;1206;365;988;88;222;153;418;241;640
431340;202206;21081;49281;15051;39358;2101;6206;7855;19022;9956;25228
431342;202206;452;993;332;801;39;94;237;559;276;653
431344;202206;435;1059;253;720;36;108;123;338;159;446
431346;202206;234;570;83;260;14;46;13;33;27;79
431349;202206;984;2223;659;1579;102;265;370;818;472;1083
431350;202206;5309;12497;4113;10600;474;1414;2481;5995;2955;7409
431360;202206;633;1446;325;868;91;268;88;203;179;471
431365;202206;2509;5315;1988;4621;105;294;1607;3629;1712;3923
431370;202206;5563;12517;4126;10312;766;2038;2181;5343;2947;7381
431380;202206;1019;2577;821;2256;139;391;479;1304;618;1695
431390;202206;3081;7257;1993;5377;209;694;1076;2510;1285;3204
431395;202206;1788;3896;1362;3285;171;419;878;2052;1049;2471
431400;202206;341;930;196;605;36;114;39;97;75;211
431402;202206;1006;2102;751;1723;98;228;516;1141;614;1369
431403;202206;214;591;168;506;35;124;74;194;109;318
431405;202206;5935;14638;4710;12656;763;2348;2376;5897;3139;8245
431406;202206;641;1669;434;1235;103;263;169;526;272;789
431407;202206;591;1498;438;1196;57;154;288;771;345;925
431410;202206;20958;49102;14857;39051;1892;5831;8563;20637;10455;26468
431413;202206;271;740;64;213;8;22;15;47;23;69
431415;202206;784;1836;512;1378;90;278;249;583;339;861
431417;202206;632;1334;416;992;63;180;231;514;294;694
431420;202206;1897;3960;1458;3380;121;321;961;2117;1082;2438
431430;202206;642;1563;321;935;46;151;110;273;156;424
431440;202206;37857;83052;27528;67758;4548;12071;13073;29712;17621;41783
431442;202206;158;439;80;267;13;43;12;38;25;81
431445;202206;401;1108;121;387;11;28;17;40;28;68
431446;202206;309;846;235;698;25;76;127;371;152;447
431447;202206;855;2128;496;1422;87;243;153;448;240;691
431449;202206;884;2153;588;1594;104;269;257;670;361;939
431450;202206;2713;5099;2113;4273;62;144;1744;3377;1806;3521
431454;202206;41;129;32;107;8;29;15;45;23;74
431455;202206;645;1460;332;841;30;78;171;381;201;459
431460;202206;3352;7561;2285;5727;522;1330;803;1981;1325;3311
431470;202206;1590;4121;1169;3287;211;644;472;1242;683;1886
431475;202206;273;723;57;187;3;12;7;14;10;26
431477;202206;504;1237;289;813;65;169;103;270;168;439
431478;202206;245;654;55;172;10;27;7;16;17;43
431480;202206;3906;9326;3090;8043;720;1915;1452;3745;2172;5660
431490;202206;132507;294023;102116;248599;6033;18242;76398;176602;82431;194844
431500;202206;545;1326;413;1094;60;171;221;555;281;726
431505;202206;290;664;196;527;16;48;136;362;152;410
431507;202206;349;812;139;407;44;139;18;40;62;179
431510;202206;1933;4657;1328;3517;331;913;431;1142;762;2055
431513;202206;246;531;135;344;35;108;40;73;75;181
431514;202206;137;323;106;271;3;8;72;164;75;172
431515;202206;547;1267;418;1053;94;249;232;552;326;801
431517;202206;71;202;58;176;5;19;30;86;35;105
431520;202206;425;1016;185;520;25;87;81;178;106;265
431530;202206;5930;12446;3654;9068;654;1660;1662;3946;2316;5606
431531;202206;231;530;148;383;20;55;55;129;75;184
431532;202206;616;1380;394;989;73;205;180;432;253;637
431535;202206;313;788;141;414;25;77;26;68;51;145
431540;202206;1969;5771;1805;5552;79;271;1422;4419;1501;4690
431545;202206;384;947;78;219;10;23;26;72;36;95
431550;202206;2520;6032;1798;4711;251;736;983;2389;1234;3125
431555;202206;771;1661;461;1139;50;139;258;633;308;772
431560;202206;28993;65977;19977;52108;4005;10099;7671;20566;11676;30665
431570;202206;5510;11667;4666;10492;279;779;3835;8220;4114;8999
431575;202206;408;933;343;835;72;139;193;472;265;611
431580;202206;668;1672;431;1218;54;174;232;617;286;791
431590;202206;788;2055;572;1612;126;340;210;582;336;922
431595;202206;418;1065;269;763;50;145;104;266;154;411
431600;202206;1863;4239;1338;3442;234;648;624;1516;858;2164
431610;202206;1640;3821;1089;2864;162;418;506;1386;668;1804
431620;202206;527;1287;276;736;62;186;132;295;194;481
431630;202206;1487;3531;701;1978;135;406;229;587;364;993
431640;202206;7637;16350;6478;14895;679;1725;4582;10291;5261;12016
431642;202206;708;1550;442;1085;85;181;192;448;277;629
431643;202206;399;954;194;549;22;60;63;167;85;227
431645;202206;2392;4647;1922;4039;44;128;1665;3409;1709;3537
431647;202206;350;804;121;336;14;40;36;90;50;130
431650;202206;136;361;98;303;12;42;39;104;51;146
431660;202206;1024;2583;492;1496;85;302;124;327;209;629
431670;202206;1370;3135;813;2144;133;354;377;898;510;1252
431673;202206;250;642;105;330;14;47;28;74;42;121
431675;202206;414;1046;125;406;14;48;22;62;36;110
431680;202206;10214;24054;7701;19635;1494;4119;3798;9028;5292;13147
431690;202206;29282;67696;20949;53459;3112;8933;11240;27119;14352;36052
431695;202206;250;582;144;390;20;77;80;182;100;259
431697;202206;524;1164;409;995;66;151;236;577;302;728
431700;202206;1632;3798;1304;3243;209;453;707;1792;916;2245
431710;202206;16115;35207;11625;29039;1544;4102;6987;17008;8531;21110
431720;202206;7809;18067;4780;12722;1125;3088;1196;2851;2321;5939
431725;202206;42;101;31;82;8;27;16;36;24;63
431730;202206;4886;10924;3232;8445;599;1662;1515;3811;2114;5473
431740;202206;6040;13641;4099;10551;965;2787;1274;2919;2239;5706
431750;202206;9188;22358;6902;18804;1607;4563;2619;6986;4226;11549
431755;202206;348;923;92;294;11;39;21;54;32;93
431760;202206;6065;13058;4224;10189;442;1241;2665;6005;3107;7246
431770;202206;2278;4873;1746;4177;243;534;1180;2855;1423;3389
431775;202206;232;575;127;376;29;95;25;62;54;157
431780;202206;2458;5642;1611;4154;259;714;646;1589;905;2303
431790;202206;837;2119;553;1563;84;235;227;645;311;880
431795;202206;312;760;150;435;27;81;46;123;73;204
431800;202206;9513;21513;6041;16163;1581;4952;714;1851;2295;6803
431805;202206;313;791;72;256;4;12;3;5;7;17
431810;202206;3729;8142;2373;5787;350;909;1251;2846;1601;3755
431820;202206;2434;6076;1882;5212;478;1453;814;2194;1292;3647
431830;202206;10046;21195;7411;17673;2112;5680;1519;3812;3631;9492
431840;202206;3138;7409;2526;6478;334;903;1624;4114;1958;5017
431842;202206;533;1299;186;561;30;106;64;165;94;271
431843;202206;355;925;251;707;51;160;111;287;162;447
431844;202206;205;556;72;236;12;46;17;50;29;96
431845;202206;553;1384;380;1045;34;97;229;615;263;712
431846;202206;329;770;287;711;13;37;255;622;268;659
431848;202206;174;441;94;268;10;33;28;65;38;98
431849;202206;415;995;88;248;10;30;16;28;26;58
431850;202206;4871;12278;3757;10233;878;2573;1344;3427;2222;6000
431860;202206;724;1635;406;1049;46;130;247;616;293;746
431861;202206;117;315;77;231;22;74;23;58;45;132
431862;202206;541;1640;443;1456;90;336;207;637;297;973
431870;202206;25775;60538;20712;52901;2068;6095;13363;32463;15431;38558
431880;202206;4491;10912;3270;8821;417;1295;1747;4441;2164;5736
431890;202206;5614;13324;3584;9560;1021;2725;907;2433;1928;5158
431900;202206;1149;2781;754;2080;119;358;363;909;482;1267
431910;202206;861;1958;343;908;50;135;116;239;166;374
431912;202206;581;1429;465;1238;69;200;302;791;371;991
431915;202206;1285;2804;1010;2389;81;190;747;1718;828;1908
431920;202206;1455;3019;1203;2703;37;93;1048;2313;1085;2406
431930;202206;794;1948;538;1500;168;444;205;599;373;1043
431935;202206;97;251;69;199;12;38;19;47;31;85
431936;202206;345;914;205;573;41;114;99;269;140;383
431937;202206;169;425;111;319;22;58;43;116;65;174
431940;202206;3393;7563;2148;5414;164;485;1310;3093;1474;3578
431950;202206;2388;5736;1887;4951;446;1198;846;2170;1292;3368
431960;202206;3434;7873;2637;6520;746;1895;838;1995;1584;3890
431970;202206;430;1051;203;566;46;134;53;140;99;274
431971;202206;84;204;37;110;5;14;8;23;13;37
431973;202206;655;1882;442;1447;50;187;309;1004;359;1191
431975;202206;122;245;34;92;6;20;7;15;13;35
431980;202206;1285;2957;1029;2574;122;381;669;1528;791;1909
431990;202206;6921;15843;5123;13334;443;1397;3162;7865;3605;9262
432000;202206;15719;34673;11721;28729;1619;4356;7103;16501;8722;20857
432010;202206;3113;6919;2083;5271;444;1162;792;1832;1236;2994
432020;202206;1880;4756;1179;3308;296;883;309;816;605;1699
432023;202206;601;1373;295;793;40;107;132;304;172;411
432026;202206;1169;2966;894;2445;250;692;345;977;595;1669
432030;202206;500;1114;288;747;19;49;169;397;188;446
432032;202206;375;912;246;649;22;72;135;321;157;393
432035;202206;760;2025;639;1823;166;431;308;942;474;1373
432040;202206;1214;2782;482;1415;52;173;204;527;256;700
432045;202206;188;493;120;356;16;50;54;148;70;198
432050;202206;628;1459;458;1175;64;190;240;597;304;787
432055;202206;779;1869;537;1436;169;435;153;415;322;850
432057;202206;181;467;152;398;6;17;90;212;96;229
432060;202206;480;1145;144;449;19;66;39;115;58;181
432065;202206;250;651;188;529;42;118;83;229;125;347
432067;202206;887;2337;749;2044;67;216;548;1426;615;1642
432070;202206;1905;4527;1356;3558;207;620;687;1636;894;2256
432080;202206;5729;12432;4276;10269;596;1689;2207;4918;2803;6607
432085;202206;441;1122;333;959;58;185;177;488;235;673
432090;202206;3060;7244;1831;4968;346;926;801;2040;1147;2966
432100;202206;1054;2539;526;1549;95;307;118;278;213;585
432110;202206;2418;5911;1760;4793;441;1281;341;845;782;2126
432120;202206;4047;10131;3252;8853;505;1529;1710;4369;2215;5898
432130;202206;3092;7210;2569;6453;435;1115;1452;3648;1887;4763
432132;202206;246;662;134;412;23;79;62;162;85;241
432135;202206;1135;2504;772;1904;76;192;535;1313;611;1505
432140;202206;2034;5418;1595;4600;179;611;1064;2933;1243;3544
432143;202206;1716;4266;1302;3620;88;279;830;2244;918;2523
432145;202206;2007;5111;1329;3785;204;620;448;1054;652;1674
432146;202206;125;334;100;303;37;134;31;82;68;216
432147;202206;610;1613;336;1019;116;361;61;182;177;543
432149;202206;540;1242;265;709;31;83;109;260;140;343
432150;202206;4255;9998;3203;8294;587;1665;1565;3776;2152;5441
432160;202206;7011;16637;5229;13961;1288;3558;2018;5389;3306;8947
432162;202206;241;525;38;109;8;22;10;17;18;39
432163;202206;175;416;35;99;2;8;7;12;9;20
432166;202206;715;1893;579;1639;104;340;214;537;318;877
432170;202206;1733;4468;1206;3527;210;658;509;1368;719;2026
432180;202206;3433;7776;1896;5012;278;824;844;1927;1122;2751
432183;202206;429;1169;312;920;64;231;131;345;195;576
432185;202206;947;2357;562;1623;97;278;252;711;349;989
432190;202206;2382;5454;1689;4404;139;449;1100;2656;1239;3105
432195;202206;1080;2655;713;1982;132;358;280;774;412;1132
432200;202206;4095;9435;3081;7919;244;678;2109;5255;2353;5933
432210;202206;465;1130;316;853;44;126;177;418;221;544
432215;202206;730;1882;650;1761;47;108;481;1311;528;1419
432218;202206;260;608;117;317;14;46;42;84;56;130
432220;202206;4099;9096;2968;7299;519;1305;1611;3804;2130;5109
432225;202206;142;370;99;287;13;41;53;149;66;190
432230;202206;873;1999;461;1250;59;181;208;506;267;687
432232;202206;549;1295;350;972;61;189;156;385;217;574
432234;202206;317;765;167;466;37;91;38;91;75;182
432235;202206;50;137;23;67;5;16;8;20;13;36
432237;202206;339;840;303;783;11;33;255;641;266;674
432240;202206;19488;43691;14343;37016;1273;3083;9759;25233;11032;28316
432250;202206;6985;18331;5195;14861;1016;3104;2537;7001;3553;10105
432252;202206;525;1203;338;854;43;112;182;420;225;532
432253;202206;1001;2761;691;2027;179;555;115;312;294;867
432254;202206;719;1647;220;633;26;72;35;75;61;147
432255;202206;113;284;64;181;7;22;33;82;40;104
432260;202206;6223;14899;4692;12132;963;2660;2136;5138;3099;7798
432270;202206;2481;6165;2014;5346;572;1582;718;1842;1290;3424
432280;202206;1518;3662;814;2330;132;420;274;651;406;1071
432285;202206;151;447;30;86;4;10;8;22;12;32
432290;202206;391;1013;244;699;71;217;64;146;135;363
432300;202206;33228;77304;25337;65182;2512;7629;16826;41023;19338;48652
432310;202206;1113;2573;840;2098;73;189;665;1626;738;1815
432320;202206;218;489;98;275;14;44;35;80;49;124
432330;202206;194;451;65;210;11;36;12;39;23;75
432335;202206;178;520;65;240;7;23;10;30;17;53
432340;202206;364;887;162;513;25;80;50;157;75;237
432345;202206;897;1764;759;1601;12;35;661;1359;673;1394
432350;202206;379;895;197;557;29;91;67;162;96;253
432360;202206;244;709;49;161;4;12;13;34;17;46
432370;202206;389;867;229;595;23;73;133;328;156;401
432375;202206;598;1389;414;1032;105;272;162;402;267;674
432377;202206;175;520;42;144;1;3;11;24;12;27
432380;202206;2185;5691;1552;4562;230;712;803;2290;1033;3002
500020;202206;3733;8618;2631;6917;246;785;1725;4366;1971;5151
500025;202206;1327;3136;860;2277;111;294;459;1161;570;1455
500060;202206;9316;24722;6497;19003;815;2584;3744;10871;4559;13455
500070;202206;5652;13287;4064;10710;733;2047;1912;4983;2645;7030
500080;202206;1829;4249;1125;2996;185;544;445;1041;630;1585
500085;202206;2322;5512;1653;4357;432;1223;691;1709;1123;2932
500090;202206;2395;5932;1633;4683;276;868;538;1649;814;2517
500100;202206;4416;10555;3375;8934;505;1533;1610;3977;2115;5510
500110;202206;11584;26941;8028;21534;1580;4441;3681;9997;5261;14438
500124;202206;2528;6679;2028;5903;299;887;1219;3589;1518;4476
500150;202206;1737;3622;1207;2917;220;595;653;1443;873;2038
500190;202206;5873;14475;3845;10675;777;2228;1317;3383;2094;5611
500200;202206;3165;6902;2155;5268;195;504;1380;3202;1575;3706
500210;202206;5786;12624;4133;10512;1100;2831;2050;5150;3150;7981
500215;202206;1663;4270;1241;3525;121;364;717;2001;838;2365
500220;202206;3583;9118;2620;7513;415;1292;1319;3557;1734;4849
500230;202206;2372;5211;1839;4494;216;559;1236;2932;1452;3491
500240;202206;4815;13336;3533;10726;528;1735;1523;4645;2051;6380
500260;202206;3753;7635;2452;5875;248;693;1477;3302;1725;3995
500270;202206;168038;378534;108685;282747;15027;43963;48285;114057;63312;158020
500280;202206;1588;3784;1066;2998;170;493;562;1579;732;2072
500290;202206;4235;9811;2600;7052;386;1176;1014;2459;1400;3635
500295;202206;4573;10523;3039;7924;523;1539;1311;2999;1834;4538
500310;202206;1178;2252;807;1802;126;245;455;1017;581;1262
500315;202206;4829;11747;3878;10436;275;806;2950;7891;3225;8697
500320;202206;23684;59282;16409;47504;3983;11590;6321;19320;10304;30910
500325;202206;6683;13989;4725;11352;542;1383;2876;6728;3418;8111
500330;202206;7915;17010;5272;13260;500;1280;2915;7381;3415;8661
500345;202206;2503;5851;1698;4579;285;799;673;1745;958;2544
500348;202206;2700;6498;2032;5390;202;589;1326;3498;1528;4087
500350;202206;1401;3677;820;2472;95;304;298;827;393;1131
500370;202206;31631;77749;23099;64104;2835;9036;12126;32529;14961;41565
500375;202206;2976;7419;1982;5439;264;784;804;1958;1068;2742
500380;202206;4071;9678;2839;7661;784;2150;526;1466;1310;3616
500390;202206;743;1508;460;1156;63;179;266;660;329;839
500400;202206;1814;4455;1207;3293;212;662;456;1105;668;1767
500410;202206;2785;6261;1935;5045;218;514;1091;2993;1309;3507
500430;202206;3233;7537;2221;6050;329;889;928;2725;1257;3614
500440;202206;1851;4232;1030;2833;167;456;391;1116;558;1572
500450;202206;2102;4933;1329;3624;250;678;360;930;610;1608
500460;202206;4311;10864;2650;7668;461;1508;747;1976;1208;3484
500470;202206;3027;7811;1969;5720;482;1536;533;1350;1015;2886
500480;202206;2304;6785;1912;6182;167;576;1406;4598;1573;5174
500490;202206;1317;2934;796;2139;150;479;212;576;362;1055
500500;202206;4740;11926;3139;9448;908;3008;406;1321;1314;4329
500510;202206;817;1967;539;1469;34;108;362;921;396;1029
500515;202206;1908;4688;1474;4016;203;601;844;2221;1047;2822
500520;202206;3952;10605;3046;9115;650;1925;1537;4761;2187;6686
500525;202206;1117;3072;888;2733;122;394;539;1625;661;2019
500540;202206;6021;14912;3693;10841;1070;3524;615;1555;1685;5079
500560;202206;6164;15561;4937;14044;222;694;4086;11709;4308;12403
500568;202206;5234;10921;3239;7952;652;1645;1341;3044;1993;4689
500570;202206;9606;21279;6605;16493;920;2677;3478;7892;4398;10569
500580;202206;3637;8900;2647;7217;638;1787;1169;3148;1807;4935
500600;202206;4265;10109;3135;8353;746;2074;999;2653;1745;4727
500620;202206;9246;23098;6453;17932;978;2942;3159;8249;4137;11191
500625;202206;616;1587;423;1219;65;216;165;448;230;664
500627;202206;925;2366;575;1757;97;312;187;534;284;846
500630;202206;8789;18867;5120;13054;1019;2798;1650;4014;2669;6812
500635;202206;3165;9611;2414;8601;251;797;1672;6452;1923;7249
500640;202206;2094;4274;1394;3361;72;204;929;2120;1001;2324
500660;202206;23460;55092;16190;44749;4871;13720;5263;14901;10134;28621
500690;202206;3119;7559;2131;6007;417;1372;1036;2738;1453;4110
500710;202206;3723;9333;2746;7683;662;2046;900;2375;1562;4421
500720;202206;6003;14598;4025;11337;812;2486;1386;3721;2198;6207
500730;202206;1246;2928;702;1961;135;381;212;590;347;971
500740;202206;5489;12484;3576;9535;587;1699;1647;4196;2234;5895
500750;202206;1248;2939;871;2335;129;370;375;907;504;1277
500755;202206;1247;3096;803;2277;144;442;242;607;386;1049
500769;202206;6024;14271;3405;9488;686;2045;542;1346;1228;3391
500770;202206;1639;4203;1131;3372;217;672;383;1107;600;1779
500780;202206;1445;3387;942;2557;178;544;265;621;443;1165
500790;202206;8400;21343;6198;17442;1215;3697;2442;6776;3657;10473
500793;202206;2420;5781;1758;4683;347;990;731;1789;1078;2779
500795;202206;3314;7391;2620;6484;144;375;2117;5304;2261;5679
500797;202206;921;2269;619;1721;193;555;183;489;376;1044
500800;202206;4099;8936;2584;6694;720;2091;503;1366;1223;3457
500830;202206;22539;53253;15405;40633;3304;9134;5557;13883;8861;23017
500840;202206;1689;3889;1050;2687;118;312;495;1173;613;1485
510010;202206;2101;4410;1483;3628;217;503;948;2313;1165;2816
510020;202206;4809;11543;2670;7461;486;1465;773;1882;1259;3347
510025;202206;8268;19057;5387;14610;650;1951;2806;7217;3456;9168
510030;202206;3635;7549;2442;5776;248;617;1346;3064;1594;3681
510035;202206;1325;3333;861;2594;229;697;333;1104;562;1801
510040;202206;2775;5811;2079;4946;247;517;1307;3229;1554;3746
510050;202206;2545;4920;1743;3918;228;596;1166;2530;1394;3126
510060;202206;1680;4113;1112;3090;226;679;261;616;487;1295
510080;202206;1736;4301;1196;3446;209;660;556;1513;765;2173
510100;202206;792;1727;574;1398;68;189;335;756;403;945
510120;202206;314;541;177;383;10;30;142;292;152;322
510125;202206;2385;5727;1885;4987;232;717;995;2425;1227;3142
510130;202206;1843;4380;1296;3523;309;851;561;1503;870;2354
510140;202206;3478;8635;2369;7237;840;2798;814;2586;1654;5384
510160;202206;2174;4820;1672;4186;56;158;1472;3667;1528;3825
510170;202206;5756;14104;4379;11942;844;2491;2050;5414;2894;7905
510180;202206;17332;36517;11729;28812;2011;5306;5631;14173;7642;19479
510185;202206;2009;5009;1305;3993;537;1657;302;1190;839;2847
510190;202206;2699;7165;1724;5591;443;1567;378;1310;821;2877
510250;202206;20198;47648;15095;40136;2329;6761;8517;22611;10846;29372
510260;202206;2053;8442;1729;7894;259;1162;1048;5397;1307;6559
510263;202206;3995;10799;2624;8102;501;1749;581;1547;1082;3296
510267;202206;6452;17739;3811;11854;698;2374;697;1846;1395;4220
510268;202206;1512;3762;1071;3021;294;866;305;724;599;1590
510269;202206;1174;3029;774;2310;149;491;322;897;471;1388
510270;202206;3452;9299;2430;7550;363;1251;1060;3241;1423;4492
510279;202206;2082;5191;1224;3656;165;561;397;1046;562;1607
510285;202206;1256;3152;834;2418;195;628;272;707;467;1335
510300;202206;4491;10447;3399;9046;304;821;2402;6513;2706;7334
510305;202206;1655;4355;1078;3296;217;671;298;961;515;1632
510310;202206;1155;2712;803;2159;188;500;302;840;490;1340
510320;202206;4507;10499;3165;8346;674;1920;1020;2464;1694;4384
510325;202206;4947;13891;3457;11034;836;2800;961;3063;1797;5863
510330;202206;2961;8377;1995;6721;427;1503;759;2814;1186;4317
510335;202206;5687;15521;4346;13340;735;2480;2202;6748;2937;9228
510336;202206;547;1457;399;1238;61;175;213;732;274;907
510337;202206;1666;4588;1103;3622;402;1410;306;1006;708;2416
510340;202206;110363;236862;75479;188190;15608;43205;31140;73143;46748;116348
510343;202206;1387;3218;916;2445;108;332;498;1228;606;1560
510345;202206;1460;3873;1103;3197;172;496;552;1514;724;2010
510350;202206;3576;8531;2415;6710;691;2000;700;1878;1391;3878
510360;202206;2290;4377;1432;3391;58;110;1035;2584;1093;2694
510370;202206;1991;5339;1492;4553;201;657;921;2835;1122;3492
510380;202206;667;1544;393;1088;49;153;170;449;219;602
510385;202206;1384;4432;1027;3795;98;423;677;2592;775;3015
510390;202206;1596;3720;1099;3146;306;852;527;1597;833;2449
510395;202206;807;1674;536;1294;36;77;370;907;406;984
510410;202206;5728;14644;4182;12069;754;2211;2317;6866;3071;9077
510420;202206;2882;5560;1998;4412;81;180;1500;3288;1581;3468
510450;202206;618;1441;359;1004;74;213;111;290;185;503
510452;202206;995;2676;739;2206;112;369;432;1247;544;1616
510454;202206;1191;3057;922;2618;117;302;574;1735;691;2037
510455;202206;1084;2763;708;2064;140;453;270;707;410;1160
510460;202206;2269;5427;1659;4522;331;993;814;2002;1145;2995
510480;202206;5672;13112;3794;9774;710;1957;1570;3708;2280;5665
510490;202206;2003;4782;1506;4159;229;649;988;2723;1217;3372
510500;202206;1722;4024;1034;2955;227;687;299;827;526;1514
510510;202206;4504;11863;3206;9725;893;2930;1023;3112;1916;6042
510515;202206;6110;14799;4159;11486;836;2580;1477;3622;2313;6202
510517;202206;1737;4238;1177;3417;413;1275;259;697;672;1972
510520;202206;2674;5211;1479;3689;139;364;684;1795;823;2159
510523;202206;1419;3162;1011;2561;115;328;666;1628;781;1956
510525;202206;8993;23477;6733;19225;1069;3311;3094;8290;4163;11601
510530;202206;567;1419;413;1206;32;101;276;805;308;906
510550;202206;2948;8021;2226;6835;407;1361;1209;3605;1616;4966
510558;202206;2625;6727;1954;5729;241;630;1021;3221;1262;3851
510560;202206;2020;5502;1264;4014;303;1006;274;904;577;1910
510562;202206;6875;15737;5070;12778;821;2070;2535;6368;3356;8438
510590;202206;3589;8381;2600;7137;261;731;1797;5038;2058;5769
510600;202206;1427;2911;964;2264;114;289;548;1216;662;1505
510610;202206;3139;7145;2153;5843;324;993;1214;3216;1538;4209
510615;202206;3297;7672;2305;6167;306;869;1434;3818;1740;4687
510617;202206;1151;3319;924;2979;93;348;679;2234;772;2582
510618;202206;1436;3578;1032;2959;210;667;509;1410;719;2077
510619;202206;865;2134;488;1434;82;248;90;213;172;461
510620;202206;1566;3426;787;2195;274;862;61;132;335;994
510621;202206;1791;4566;1073;3237;242;773;293;769;535;1542
510622;202206;6104;16064;4064;11933;1289;4063;663;1725;1952;5788
510623;202206;3208;7512;2323;6159;533;1498;865;2283;1398;3781
510624;202206;1825;4576;972;3033;121;422;215;591;336;1013
510625;202206;3852;8936;2337;6315;415;1248;815;2118;1230;3366
510626;202206;1658;3955;1103;3090;272;853;311;882;583;1735
510627;202206;724;1770;397;1154;100;301;109;338;209;639
510628;202206;1711;3640;1110;2886;331;950;433;1071;764;2021
510629;202206;1984;5215;1366;4114;290;940;395;1166;685;2106
510630;202206;3893;10271;2473;7734;573;1909;592;1982;1165;3891
510631;202206;696;1517;522;1274;20;35;412;1020;432;1055
510637;202206;4185;9320;2979;7652;665;1879;1090;2783;1755;4662
510642;202206;6795;17546;5262;15348;896;2959;3176;9084;4072;12043
510645;202206;1183;2227;736;1672;174;379;333;784;507;1163
510650;202206;8100;19020;6370;17148;916;1577;4500;13589;5416;15166
510665;202206;2021;4243;1284;3108;280;607;501;1328;781;1935
510670;202206;495;1034;294;764;37;96;153;402;190;498
510675;202206;7420;19414;5039;15055;1286;4274;928;2565;2214;6839
510677;202206;2646;6400;1875;5285;299;942;1075;2946;1374;3888
510680;202206;816;1990;473;1380;97;316;122;303;219;619
510682;202206;1893;5091;1399;4329;438;1541;487;1413;925;2954
510685;202206;584;1580;420;1263;39;124;252;754;291;878
510700;202206;4936;11095;3416;9012;323;954;2426;6273;2749;7227
510704;202206;12765;28989;8644;22227;2088;5622;2455;5868;4543;11490
510706;202206;2649;7390;1840;6061;347;1172;772;2794;1119;3966
510710;202206;3441;8057;2192;5759;542;1378;646;1621;1188;2999
510715;202206;734;1469;490;1165;37;103;312;706;349;809
510718;202206;2614;5801;1592;4433;333;908;734;2330;1067;3238
510719;202206;523;1090;304;779;35;109;166;387;201;496
510720;202206;1062;2321;699;1811;172;465;278;684;450;1149
510724;202206;1018;2713;698;2101;101;351;330;910;431;1261
510726;202206;1085;1951;621;1399;65;153;335;753;400;906
510729;202206;690;1536;317;862;40;121;90;254;130;375
510730;202206;3433;7877;2354;6263;316;946;1272;3179;1588;4125
510735;202206;1390;3650;1113;3271;93;287;887;2599;980;2886
510740;202206;1125;2621;753;1975;78;244;462;1121;540;1365
510757;202206;540;1694;421;1508;142;578;144;481;286;1059
510760;202206;51934;109542;32409;80997;6449;17908;11806;26688;18255;44596
510770;202206;4784;10117;3349;8326;254;553;2314;5972;2568;6525
510774;202206;448;1100;319;904;54;147;182;528;236;675
510775;202206;762;1873;469;1412;105;336;131;358;236;694
510776;202206;791;1915;549;1465;101;321;249;635;350;956
510777;202206;1733;4364;1255;3757;192;694;829;2396;1021;3090
510779;202206;880;2246;646;1871;62;161;416;1258;478;1419
510780;202206;4750;11163;3501;9417;701;1805;1766;5154;2467;6959
510785;202206;2365;5971;1392;4220;338;1051;354;1127;692;2178
510787;202206;3718;9970;2468;7552;854;2714;248;714;1102;3428
510788;202206;640;1429;429;1117;65;156;204;603;269;759
510790;202206;22302;55008;14494;41495;3552;11019;2118;5538;5670;16557
510792;202206;11517;30659;7348;22727;1624;5476;1513;4207;3137;9683
510794;202206;1434;3745;1030;3105;326;1119;233;594;559;1713
510795;202206;11418;27901;7999;22109;1758;5361;2733;6987;4491;12348
510800;202206;1721;4430;1221;3619;355;1143;169;398;524;1541
510805;202206;1745;4615;1161;3556;238;808;464;1292;702;2100
510810;202206;798;1540;516;1184;166;326;238;594;404;920
510820;202206;904;1671;522;1207;28;59;329;754;357;813
510830;202206;1069;2382;812;2060;68;166;601;1575;669;1741
510835;202206;706;1573;469;1242;56;174;288;719;344;893
510840;202206;69499;139472;49456;115363;7951;17616;28918;69558;36869;87174
510850;202206;2147;5158;1376;3979;570;1867;98;160;668;2027
510860;202206;2978;7403;1942;5774;621;1979;394;1203;1015;3182
510880;202206;870;2333;635;1921;162;498;181;553;343;1051
510885;202206;705;1658;460;1290;90;258;117;318;207;576
510890;202206;939;2478;687;2035;147;478;307;895;454;1373
510895;202206;1591;3869;1049;2957;149;486;482;1219;631;1705
520005;202206;3886;9435;3065;8381;890;2085;1353;4334;2243;6419
520010;202206;3173;8081;2332;6522;489;1518;936;2300;1425;3818
520013;202206;4031;9664;2652;7220;627;1724;796;2277;1423;4001
520015;202206;595;1432;433;1192;98;271;172;504;270;775
520017;202206;1405;3342;986;2683;192;580;427;1059;619;1639
520020;202206;572;1127;441;977;29;77;362;776;391;853
520025;202206;42628;108792;36308;100016;4864;14027;23979;65631;28843;79658
520030;202206;7454;16894;6129;15130;399;1041;4715;11429;5114;12470
520050;202206;458;1082;281;764;37;91;157;431;194;522
520055;202206;2071;4870;1301;3344;213;538;581;1407;794;1945
520060;202206;2117;5192;1460;4065;302;948;378;1054;680;2002
520080;202206;2158;5235;1650;4555;301;754;830;2450;1131;3204
520082;202206;1032;2464;737;1968;118;326;339;959;457;1285
520085;202206;1180;2756;942;2419;184;469;477;1218;661;1687
520090;202206;1024;1890;738;1584;49;80;608;1322;657;1402
520110;202206;47686;120471;33455;96938;9487;30255;4281;11496;13768;41751
520120;202206;280;629;148;395;21;68;59;143;80;211
520130;202206;4511;10238;3473;8658;682;1721;1494;3653;2176;5374
520140;202206;55698;139593;39079;111803;12936;39146;5713;16917;18649;56063
520145;202206;691;1517;451;1167;94;257;194;453;288;710
520150;202206;753;1731;552;1473;71;185;285;740;356;925
520160;202206;1015;2320;696;1771;135;300;260;700;395;1000
520170;202206;5375;10632;3566;8541;237;634;2636;6220;2873;6854
520180;202206;3097;7510;2493;6667;319;1002;1568;4022;1887;5024
520215;202206;2041;4639;1482;3823;251;681;797;1999;1048;2680
520235;202206;882;1843;591;1444;104;256;306;754;410;1010
520250;202206;1910;4571;1391;3756;453;1288;339;1055;792;2343
520260;202206;878;1980;542;1446;98;256;213;558;311;814
520280;202206;985;2100;771;1785;153;347;408;955;561;1302
520310;202206;1173;2398;755;1785;195;509;289;696;484;1205
520320;202206;2165;5375;1686;4628;186;519;988;2733;1174;3252
520330;202206;5613;13734;4293;11559;650;2033;2320;5843;2970;7876
520340;202206;2712;5663;1652;4192;185;397;903;2381;1088;2778
520350;202206;3535;8167;2476;6569;701;1895;886;2384;1587;4279
520355;202206;2178;5633;1566;4489;457;1392;269;671;726;2063
520357;202206;973;2142;699;1757;36;86;552;1383;588;1469
520360;202206;905;2178;707;1868;123;349;311;781;434;1130
520380;202206;1618;3863;985;2734;146;429;372;935;518;1364
520390;202206;1314;2894;834;2265;229;662;221;645;450;1307
520393;202206;743;1681;498;1297;66;182;203;502;269;684
520396;202206;1006;2394;848;2165;47;118;603;1484;650;1602
520400;202206;1842;4175;1424;3633;103;285;1055;2679;1158;2964
520410;202206;2524;5221;1707;4046;256;701;955;2086;1211;2787
520420;202206;423;919;328;779;17;48;250;566;267;614
520425;202206;1752;4157;992;2720;272;785;177;437;449;1222
520430;202206;2771;6137;1693;4435;402;1135;279;652;681;1787
520440;202206;3427;7908;1936;5264;411;1241;456;1163;867;2404
520450;202206;15551;35251;10772;28085;3143;8370;3005;8087;6148;16457
520455;202206;871;2207;625;1829;186;551;173;528;359;1079
520460;202206;1219;2710;944;2361;148;328;660;1711;808;2039
520465;202206;1022;2352;843;2114;60;191;662;1605;722;1796
520470;202206;2629;6058;2029;5292;520;1344;984;2721;1504;4065
520480;202206;1056;2755;756;2242;175;544;285;806;460;1350
520485;202206;1742;4895;1368;4310;226;772;683;2041;909;2813
520490;202206;4906;12202;3750;10425;686;2007;2069;5683;2755;7690
520495;202206;1873;3743;1419;3141;97;218;1065;2369;1162;2587
520500;202206;1932;4549;1440;3715;200;591;787;1903;987;2494
520505;202206;1036;2042;796;1755;49;114;625;1330;674;1444
520510;202206;9949;23273;7232;19249;1302;3919;3253;8265;4555;12184
520520;202206;1378;3260;1059;2788;236;668;454;1184;690;1852
520530;202206;2911;7317;2120;5934;390;1070;1047;3090;1437;4160
520540;202206;3547;8824;2353;6560;446;1294;681;1749;1127;3043
520545;202206;1503;3493;1180;3020;246;630;589;1496;835;2126
520547;202206;1474;3580;1138;3007;231;622;596;1560;827;2182
520549;202206;17974;43937;14925;39654;1787;5229;10164;26185;11951;31414
520551;202206;5529;13551;4633;12286;442;1395;3346;8557;3788;9952
520552;202206;1094;2626;853;2277;170;453;434;1219;604;1672
520570;202206;619;1336;397;991;78;166;168;427;246;593
520580;202206;2550;5371;1910;4636;286;682;1163;2826;1449;3508
520590;202206;1578;3694;1074;2885;275;765;357;935;632;1700
520620;202206;10331;25565;8272;22614;1670;4798;4346;11755;6016;16553
520630;202206;1032;2396;726;1911;81;234;344;860;425;1094
520640;202206;2810;6405;2102;5216;484;1183;788;2024;1272;3207
520650;202206;1215;2505;864;2033;172;371;441;1084;613;1455
520660;202206;609;1447;332;963;59;193;92;264;151;457
520670;202206;1108;2773;924;2502;94;242;613;1661;707;1903
520680;202206;948;2131;753;1846;131;274;448;1123;579;1397
520690;202206;369;868;240;661;85;214;64;192;149;406
520710;202206;508;1154;343;879;19;52;227;549;246;601
520725;202206;1642;3731;1097;2820;162;470;583;1448;745;1918
520735;202206;1053;2347;711;1816;195;450;237;637;432;1087
520740;202206;2894;6121;2141;5173;461;1020;1039;2651;1500;3671
520750;202206;845;1831;597;1474;85;221;326;763;411;984
520753;202206;1507;3753;1123;3083;211;644;486;1249;697;1893
520760;202206;1646;3313;1396;3019;33;73;1273;2763;1306;2836
520780;202206;1742;3966;1259;3270;167;419;659;1682;826;2101
520790;202206;3827;8615;2633;6712;432;991;1377;3713;1809;4704
520800;202206;20646;49147;16186;42754;2414;6287;9751;26199;12165;32486
520810;202206;1454;2893;1087;2479;222;490;599;1499;821;1989
520815;202206;675;1992;506;1626;92;320;156;497;248;817
520830;202206;2100;4278;1499;3562;101;247;1165;2721;1266;2968
520840;202206;3269;8137;2627;7282;814;2472;943;2656;1757;5128
520850;202206;875;1914;675;1634;144;408;322;750;466;1158
520860;202206;10250;25447;7641;21131;1670;4803;3120;8376;4790;13179
520870;202206;158001;347598;112808;280320;20785;54084;50909;120649;71694;174733
520880;202206;10302;27588;8183;23823;1683;5099;3407;9665;5090;14764
520890;202206;5332;11506;3722;9082;564;1560;1903;4410;2467;5970
520910;202206;5406;12804;3544;9740;724;2150;964;2443;1688;4593
520915;202206;866;2204;565;1597;109;337;214;553;323;890
520920;202206;5250;10948;3762;9144;688;1454;2007;5172;2695;6626
520929;202206;773;1757;593;1498;95;194;276;743;371;937
520940;202206;1145;2853;886;2472;71;234;665;1807;736;2041
520945;202206;556;1186;397;973;28;75;252;591;280;666
520960;202206;1294;2793;996;2371;310;699;385;1017;695;1716
520970;202206;3741;9253;2821;7805;865;2500;582;1751;1447;4251
520980;202206;901;1982;658;1670;105;277;310;742;415;1019
520990;202206;3580;8335;2908;7502;442;1021;1958;5175;2400;6196
520993;202206;1408;3321;938;2489;142;419;450;1141;592;1560
520995;202206;2903;6819;2195;5813;391;983;797;2220;1188;3203
521000;202206;10900;26861;7245;20207;1168;3447;2151;5609;3319;9056
521010;202206;4394;10714;3231;8725;431;1219;1731;4518;2162;5737
521015;202206;909;2145;639;1670;51;148;402;994;453;1142
521020;202206;4728;11288;2863;7839;715;2047;575;1572;1290;3619
521030;202206;862;1569;669;1304;23;53;573;1081;596;1134
521040;202206;9668;22490;7185;18731;1694;4413;2548;7037;4242;11450
521056;202206;1158;2878;842;2360;235;627;250;766;485;1393
521060;202206;1209;2997;854;2336;168;492;314;833;482;1325
521080;202206;1254;2572;661;1673;104;276;304;715;408;991
521090;202206;3628;9316;2446;6942;585;1770;293;830;878;2600
521100;202206;2270;4784;1700;4016;219;538;1109;2618;1328;3156
521120;202206;5755;12907;4321;11097;702;1499;1826;5552;2528;7051
521130;202206;1166;2587;577;1518;53;113;296;814;349;927
521140;202206;1744;4168;1262;3302;173;446;666;1686;839;2132
521150;202206;15184;32047;9789;24389;2047;5580;4334;10621;6381;16201
521160;202206;876;1734;597;1327;66;129;382;819;448;948
521170;202206;1250;2752;910;2250;114;310;481;1113;595;1423
521180;202206;9629;23966;7683;20747;1390;4064;3788;9853;5178;13917
521190;202206;13096;30817;8243;23038;2016;5942;2276;6229;4292;12171
521200;202206;836;1912;573;1501;64;173;310;783;374;956
521205;202206;726;1651;563;1402;22;61;441;1053;463;1114
521210;202206;885;2247;507;1447;88;268;137;306;225;574
521220;202206;4423;9903;3047;7865;654;1808;1290;3287;1944;5095
521225;202206;483;946;355;806;43;96;257;587;300;683
521230;202206;1639;3845;1380;3514;588;1504;466;1252;1054;2756
521250;202206;42277;99520;34137;88291;8560;23117;17545;44512;26105;67629
521260;202206;602;1327;452;1104;70;194;262;603;332;797
521270;202206;2359;5245;2032;4849;187;388;1500;3691;1687;4079
521280;202206;2113;5349;1591;4513;333;1001;695;1984;1028;2985
521290;202206;654;1400;458;1159;48;128;290;710;338;838
521295;202206;1408;2919;1085;2518;152;288;732;1734;884;2022
521300;202206;2168;5059;1665;4327;333;817;915;2428;1248;3245
521305;202206;779;1724;535;1385;56;175;336;834;392;1009
521308;202206;5665;13962;3954;10903;349;1053;2463;6488;2812;7541
521310;202206;11938;28547;8226;22084;1477;4325;3635;9212;5112;13537
521340;202206;458;976;317;780;31;69;193;471;224;540
521350;202206;2274;5531;1728;4707;142;442;1227;3228;1369;3670
521370;202206;1444;3540;912;2669;294;924;145;449;439;1373
521375;202206;1671;4092;1128;3176;224;641;309;951;533;1592
521377;202206;1659;3315;1207;2759;137;254;889;2158;1026;2412
521380;202206;7125;18129;4573;13467;681;2032;987;3088;1668;5120
521385;202206;815;1829;614;1561;86;184;332;920;418;1104
521390;202206;786;1873;546;1490;135;406;102;281;237;687
521400;202206;3414;7540;2730;6687;282;694;1879;4555;2161;5249
521405;202206;1619;3991;1093;3018;129;359;600;1587;729;1946
521410;202206;1048;2421;827;2087;195;451;436;1139;631;1590
521440;202206;1652;3785;1266;3238;386;954;524;1390;910;2344
521450;202206;4729;13080;3496;10738;932;2908;844;2677;1776;5585
521460;202206;6996;17023;5074;13672;1359;3786;1828;4793;3187;8579
521470;202206;892;2169;618;1670;76;209;297;739;373;948
521480;202206;555;1239;379;943;81;183;152;349;233;532
521483;202206;2747;6260;1949;5081;407;1059;860;2262;1267;3321
521486;202206;2081;4731;1572;4006;146;278;1029;2650;1175;2928
521487;202206;477;1083;329;888;58;154;194;541;252;695
521490;202206;1017;2530;761;2113;35;119;539;1419;574;1538
521500;202206;2433;5821;1852;5008;177;654;1196;3019;1373;3673
521520;202206;922;2030;717;1744;114;241;391;978;505;1219
521523;202206;16057;44458;13220;40099;3785;11880;4758;14305;8543;26185
521525;202206;1268;2823;969;2403;78;235;665;1569;743;1804
521530;202206;2608;6477;1617;4514;322;896;427;1117;749;2013
521540;202206;947;2323;675;1883;138;434;285;765;423;1199
521550;202206;1908;4626;1056;2965;199;590;270;758;469;1348
521560;202206;6318;15001;4574;12662;1235;3224;1989;5945;3224;9169
521565;202206;795;1846;564;1471;90;244;263;680;353;924
521570;202206;4305;11083;2970;8606;594;1958;219;647;813;2605
521580;202206;582;1324;371;971;55;151;160;374;215;525
521590;202206;934;1964;671;1593;91;224;385;881;476;1105
521600;202206;510;1275;321;922;58;155;155;434;213;589
521630;202206;1944;4045;1236;3049;345;849;370;887;715;1736
521640;202206;2291;5113;1466;3888;328;927;466;1189;794;2116
521645;202206;613;1510;367;1058;148;415;34;80;182;495
521680;202206;1572;4117;1215;3528;349;1021;388;1122;737;2143
521690;202206;634;1489;525;1343;82;224;311;772;393;996
521710;202206;4068;9419;2653;7098;479;1416;812;1881;1291;3297
521720;202206;2834;6045;1831;4567;230;606;1035;2559;1265;3165
521730;202206;4464;11503;3428;9803;921;3052;931;2258;1852;5310
521740;202206;4949;12084;3803;10418;1215;3489;967;2639;2182;6128
521760;202206;19222;47422;15260;41772;3261;9327;7261;20492;10522;29819
521770;202206;3771;8456;2564;6611;614;1661;675;1744;1289;3405
521800;202206;8009;19852;5777;16199;1566;4361;2060;6357;3626;10718
521805;202206;1217;2394;848;1948;191;409;447;1092;638;1501
521810;202206;811;1825;590;1518;105;260;336;897;441;1157
521830;202206;6703;16955;5382;14945;339;1172;3965;10657;4304;11829
521839;202206;1042;2232;786;1839;73;209;553;1181;626;1390
521850;202206;7868;17149;4902;12690;1387;3472;715;1853;2102;5325
521860;202206;1865;4815;1262;3704;204;660;396;1048;600;1708
521870;202206;790;2084;570;1670;121;390;169;408;290;798
521878;202206;999;2416;673;1810;62;202;368;899;430;1101
521880;202206;24542;57296;17313;46268;3838;10749;7318;18967;11156;29716
521890;202206;3985;9561;2749;7456;719;1986;761;1901;1480;3887
521900;202206;1572;3564;803;2245;198;492;32;91;230;583
521910;202206;1660;3409;1181;2831;254;607;541;1297;795;1904
521920;202206;629;1565;477;1323;57;197;285;746;342;943
521925;202206;879;2166;646;1815;137;433;296;799;433;1232
521930;202206;6391;14591;4285;11451;1129;2515;1772;5228;2901;7743
521935;202206;1202;2749;827;2115;75;207;478;1157;553;1364
521940;202206;1533;3166;1004;2436;172;462;512;1176;684;1638
521945;202206;767;1846;544;1461;82;229;286;756;368;985
521950;202206;872;1973;604;1550;105;270;278;714;383;984
521960;202206;805;1982;551;1523;58;195;311;784;369;979
521970;202206;3297;7060;2468;6047;270;559;1747;4475;2017;5034
521971;202206;892;2064;622;1654;159;411;162;423;321;834
521973;202206;1755;4292;1412;3801;106;266;1055;2861;1161;3127
521975;202206;15108;36852;12236;32860;2098;5857;7184;19192;9282;25049
521980;202206;2793;6102;2122;5219;147;366;1606;3971;1753;4337
521990;202206;1449;3566;1198;3188;239;687;666;1763;905;2450
522000;202206;3183;7829;2492;6943;557;1590;1293;3784;1850;5374
522005;202206;406;909;280;724;41;116;132;340;173;456
522010;202206;5116;12025;3702;9748;753;2121;1446;3626;2199;5747
522015;202206;1226;3019;909;2534;254;710;362;1013;616;1723
522020;202206;6305;14098;4196;10903;831;2153;1832;4862;2663;7015
522026;202206;889;2212;572;1684;92;319;177;444;269;763
522028;202206;585;1384;406;1083;87;264;174;416;261;680
522040;202206;4213;8595;2984;6964;336;808;2021;4563;2357;5371
522045;202206;22533;57933;17060;48873;3719;11345;5317;14515;9036;25860
522050;202206;1382;3316;966;2604;180;543;413;971;593;1514
522060;202206;3463;8628;2494;7089;398;1095;1293;3724;1691;4819
522068;202206;2180;4899;1741;4384;96;212;1424;3599;1520;3811
522070;202206;900;1890;732;1653;22;41;631;1397;653;1438
522100;202206;952;2300;650;1782;86;244;323;845;409;1089
522108;202206;1279;2752;1003;2371;54;142;794;1839;848;1981
522119;202206;2153;4764;1707;4202;315;719;933;2422;1248;3141
522130;202206;572;1313;431;1128;39;89;325;870;364;959
522140;202206;27194;65975;19408;52452;4256;12175;6553;16503;10809;28678
522145;202206;931;2117;659;1722;136;377;334;865;470;1242
522150;202206;1258;2879;851;2249;207;542;245;648;452;1190
522155;202206;1183;2866;923;2484;148;350;557;1543;705;1893
522157;202206;838;1708;686;1531;33;68;551;1230;584;1298
522160;202206;7120;17220;4556;12741;1232;3663;520;1563;1752;5226
522170;202206;3158;7679;2440;6627;274;753;1543;4189;1817;4942
522180;202206;728;1649;479;1199;87;229;139;354;226;583
522185;202206;26443;60752;19495;51497;7156;20210;4571;13052;11727;33262
522190;202206;912;1979;634;1538;130;323;280;652;410;975
522200;202206;2200;5778;1607;4724;421;1224;451;1337;872;2561
522205;202206;1918;4418;1410;3694;340;894;592;1555;932;2449
522220;202206;1417;3212;1053;2717;125;303;676;1792;801;2095
522230;202206;1546;3536;1207;3048;231;627;658;1655;889;2282
530010;202206;236371;601487;196889;544022;25084;76101;124604;333994;149688;410095
110001;202205;4530;12023;3036;9289;690;2308;1099;3345;1789;5653
110002;202205;15611;38318;11458;31542;2895;8455;3512;9737;6407;18192
110003;202205;812;2248;582;1797;153;499;193;541;346;1040
110004;202205;14985;36651;10301;28674;2058;6098;3655;9898;5713;15996
110005;202205;2863;7103;2044;5794;400;1120;664;2011;1064;3131
110006;202205;1823;4945;1115;3451;208;687;236;684;444;1371
110007;202205;1476;3657;973;2818;293;844;293;979;586;1823
110008;202205;4016;9750;2980;8319;433;1034;1853;5724;2286;6758
110009;202205;5163;13612;3343;10369;684;2320;1309;3931;1993;6251
110010;202205;9206;26625;7014;22731;1393;4248;3642;13050;5035;17298
110011;202205;8460;21312;5848;16804;1754;5241;1249;3607;3003;8848
110012;202205;18496;44142;11904;33268;2999;8686;2070;5754;5069;14440
110013;202205;6509;17589;4593;13931;1783;5663;768;2499;2551;8162
110014;202205;4445;11037;3038;8425;436;1321;1547;4148;1983;5469
110015;202205;6734;16369;4311;11941;803;2492;1419;3470;2222;5962
110018;202205;4576;11077;2809;8099;562;1737;777;2190;1339;3927
110020;202205;94812;209848;71198;178644;15531;37906;34511;91431;50042;129337
110025;202205;5884;13611;4021;10448;640;1757;2051;5202;2691;6959
110026;202205;630;1602;462;1342;106;329;171;532;277;861
110028;202205;8301;20074;5253;14790;1277;4000;768;2159;2045;6159
110029;202205;1778;4194;1072;2990;202;561;445;1254;647;1815
110030;202205;15314;34922;9675;26605;2450;7227;1519;5086;3969;12313
110032;202205;4048;10719;2507;7599;731;2189;566;1817;1297;4006
110033;202205;4492;13083;3467;11218;1124;3755;1101;3838;2225;7593
110034;202205;3648;8226;2478;6632;821;2397;736;2240;1557;4637
110037;202205;1848;5201;1332;4267;297;959;557;1832;854;2791
110040;202205;3424;8967;2499;7329;601;1918;828;2347;1429;4265
110045;202205;5448;14865;3936;12198;1009;3293;1444;4641;2453;7934
110050;202205;1987;5149;1351;4050;404;1389;234;626;638;2015
110060;202205;1014;2871;676;2096;171;547;167;513;338;1060
110070;202205;1801;5302;1304;4230;370;1326;331;969;701;2295
110080;202205;7338;16358;5567;14209;1040;2544;3159;8606;4199;11150
110090;202205;661;1747;463;1394;110;374;127;373;237;747
110092;202205;1485;4045;1032;3190;193;589;518;1677;711;2266
110094;202205;3305;9196;2479;7661;989;3203;368;1243;1357;4446
110100;202205;2001;5498;1580;4735;491;1529;603;1860;1094;3389
110110;202205;2024;5158;1439;4245;433;1348;348;1125;781;2473
110120;202205;1469;3959;1094;3264;263;828;368;1092;631;1920
110130;202205;3173;7528;1936;5338;286;769;220;545;506;1314
110140;202205;2583;7082;1868;5704;345;1139;779;2316;1124;3455
110143;202205;1596;4093;1151;3299;312;972;340;943;652;1915
110145;202205;1096;2717;658;1903;156;444;262;796;418;1240
110146;202205;576;1448;402;1161;87;216;181;575;268;791
110147;202205;875;2161;577;1610;84;261;275;682;359;943
110148;202205;1094;2870;556;1726;139;488;75;218;214;706
110149;202205;3853;9570;2617;7672;853;2573;670;2138;1523;4711
110150;202205;3061;7410;2014;5824;590;1872;495;1591;1085;3463
110155;202205;930;2575;650;1924;132;443;259;696;391;1139
110160;202205;1619;4621;1201;3749;367;1168;308;992;675;2160
110170;202205;2352;5742;1520;4251;216;671;867;2284;1083;2955
110175;202205;2397;6484;1623;4847;301;939;638;1871;939;2810
110180;202205;1636;4153;1153;3233;141;405;606;1665;747;2070
120001;202205;3925;10496;3187;9406;457;1511;2095;6147;2552;7658
120005;202205;2196;7785;1989;7485;195;743;1555;6014;1750;6757
120010;202205;6423;16837;5519;15562;437;1204;4318;12347;4755;13551
120013;202205;2782;8438;2395;7942;568;1774;1306;4751;1874;6525
120017;202205;3174;8598;2706;7932;363;1031;1803;5579;2166;6610
120020;202205;17075;59227;15693;56740;985;4195;12759;46148;13744;50343
120025;202205;4005;9710;3274;8866;373;977;2424;6755;2797;7732
120030;202205;7144;26518;6599;25590;396;1999;5149;20192;5545;22191
120032;202205;1967;8081;1865;7891;98;607;1603;6657;1701;7264
120033;202205;4868;15973;4548;15413;95;535;4033;13500;4128;14035
120034;202205;3270;10410;2826;9688;118;624;2390;8012;2508;8636
120035;202205;4483;15452;4175;14933;234;1051;3553;12596;3787;13647
120038;202205;3381;9589;2920;8876;414;1340;1918;5826;2332;7166
120039;202205;2204;8965;2058;8696;125;710;1652;6977;1777;7687
120040;202205;60984;163597;52521;151002;6481;19916;35047;100591;41528;120507
120042;202205;4059;13035;3766;12536;148;705;3225;10563;3373;11268
120043;202205;1672;6233;1471;5945;43;291;1291;5154;1334;5445
120045;202205;6956;16482;5935;15311;373;1050;4907;12667;5280;13717
120050;202205;11293;35589;10399;34330;511;1957;8764;29046;9275;31003
120060;202205;11245;39089;10305;37736;482;2357;8951;32613;9433;34970
120070;202205;3917;11136;3385;10423;439;1212;2303;7524;2742;8736
120080;202205;5858;15014;5268;14191;673;1620;3923;10872;4596;12492
130002;202205;3784;12846;3372;12286;278;799;2849;10794;3127;11593
130006;202205;2909;9655;2423;8871;404;1372;1472;5989;1876;7361
130008;202205;3095;9832;2690;9254;150;536;2185;7709;2335;8245
130010;202205;4372;11984;3686;11198;140;357;3262;10053;3402;10410
130014;202205;4151;11084;3251;9706;501;1515;2041;6279;2542;7794
130020;202205;3252;11822;2881;11275;130;720;2372;9248;2502;9968
130030;202205;15521;37497;14350;36176;218;576;13452;33926;13670;34502
130040;202205;4664;12812;3873;11799;424;1138;2980;9392;3404;10530
130050;202205;8420;28464;7084;26754;279;1073;6318;24281;6597;25354
130060;202205;8392;31408;7146;29804;381;2201;5987;24719;6368;26920
130063;202205;7256;22448;6433;21534;197;886;5852;19581;6049;20467
130068;202205;4400;13559;3705;12633;181;927;2977;10051;3158;10978
130070;202205;8665;22458;7100;20767;416;976;5848;17662;6264;18638
130080;202205;8706;27637;7580;26384;433;1350;6558;23379;6991;24729
130083;202205;3161;9579;2792;9123;298;902;2155;7343;2453;8245
130090;202205;4322;11766;3841;11208;68;176;3498;10335;3566;10511
130100;202205;8705;25006;7334;23576;165;334;6813;22400;6978;22734
130110;202205;9517;25016;7728;22815;1190;3118;5366;17014;6556;20132
130115;202205;5655;16843;4860;15938;144;426;4266;14234;4410;14660
130120;202205;15586;51086;13680;48610;1048;4109;11287;40503;12335;44612
130130;202205;6836;18683;5297;16726;540;1616;3900;12896;4440;14512
130140;202205;8121;26305;7094;25143;331;1452;6065;21678;6396;23130
130150;202205;4400;14267;4132;13968;81;427;3813;12883;3894;13310
130160;202205;6990;20165;6026;18988;331;904;5248;16872;5579;17776
130165;202205;3726;12936;3509;12695;154;568;3135;11492;3289;12060
130170;202205;13905;36379;11319;33470;525;1768;9791;29159;10316;30927
130180;202205;4861;14896;4619;14631;39;227;4465;14097;4504;14324
130185;202205;22407;49937;18431;45675;1429;1943;15657;41005;17086;42948
130190;202205;21922;66816;17710;60816;1493;5221;13563;47601;15056;52822
130195;202205;2752;9376;2282;8779;96;437;1936;7496;2032;7933
130200;202205;3328;8226;2747;7490;128;416;2336;6313;2464;6729
130210;202205;1562;5551;1404;5360;104;555;1164;4353;1268;4908
130220;202205;2668;8153;2213;7600;73;258;1975;6906;2048;7164
130230;202205;5616;20766;4881;19783;198;1103;4304;17480;4502;18583
130240;202205;15909;39229;13205;35849;164;825;12272;32918;12436;33743
130250;202205;29691;82555;25372;77614;1453;4061;21039;66384;22492;70445
130255;202205;5588;16318;4786;14948;190;684;3952;12309;4142;12993
130260;202205;323630;808866;267062;733402;61542;165819;150023;427777;211565;593596
130270;202205;11148;35952;9223;33073;1588;5213;5943;22526;7531;27739
130280;202205;4022;14785;3691;14412;107;447;3425;13521;3532;13968
130290;202205;16372;47500;14430;45151;739;2315;12750;40327;13489;42642
130300;202205;5607;17284;5009;16490;176;801;4307;14127;4483;14928
130310;202205;8731;23297;7693;22051;430;1213;6542;19041;6972;20254
130320;202205;3900;12130;3263;11293;389;1268;2423;8702;2812;9970
130330;202205;5346;15489;4317;14282;215;851;3616;12221;3831;13072
130340;202205;28369;77336;24453;72982;1106;3356;21212;64468;22318;67824
130350;202205;4436;14917;3956;14295;139;730;3466;12464;3605;13194
130353;202205;9057;22427;7326;20266;971;2473;5232;15043;6203;17516
130356;202205;6119;17962;5151;16512;828;2496;3268;11063;4096;13559
130360;202205;3455;10433;2822;9665;60;268;2581;8843;2641;9111
130370;202205;5905;23499;5021;22247;532;2860;3547;15830;4079;18690
130380;202205;8361;34236;7788;33380;596;3066;6394;27408;6990;30474
130390;202205;7377;27731;6586;26522;487;2124;5594;22749;6081;24873
130395;202205;2811;8315;2364;7617;186;609;1878;6026;2064;6635
130400;202205;3237;9196;2743;8542;101;307;2439;7669;2540;7976
130406;202205;12189;39942;10262;37617;1381;4958;7578;28830;8959;33788
130410;202205;5016;16237;4317;15155;1130;4059;2319;8492;3449;12551
130420;202205;16499;52455;13817;49129;1140;4666;10757;38527;11897;43193
130423;202205;4981;14655;4365;13945;186;750;3889;12384;4075;13134
130426;202205;3386;11651;3101;11319;65;230;2818;10636;2883;10866
130430;202205;5219;12917;4452;11954;178;504;3935;10502;4113;11006
130440;202205;5907;16609;4963;15491;97;384;4633;14505;4730;14889
140002;202205;2720;7532;2359;7103;119;371;1993;6107;2112;6478
140005;202205;3699;9869;3210;9299;516;1405;2337;7038;2853;8443
140010;202205;58843;152275;47469;135913;11046;33226;21618;63469;32664;96695
140015;202205;4882;12475;4115;11605;289;744;3511;10228;3800;10972
140017;202205;6291;14987;5554;14077;317;765;4751;12206;5068;12971
140020;202205;6290;16323;5441;15284;328;1058;4438;12461;4766;13519
140023;202205;2976;8041;2374;7209;256;758;1768;5528;2024;6286
140028;202205;2252;5454;1897;5020;102;299;1516;4020;1618;4319
140030;202205;6433;14717;5753;13941;220;385;5261;12984;5481;13369
140040;202205;2944;10935;2703;10626;90;494;2496;9750;2586;10244
140045;202205;3157;11036;2645;10348;524;1604;1650;7266;2174;8870
140047;202205;7024;18782;5878;17143;632;1953;4293;12695;4925;14648
140050;202205;1759;4916;1490;4537;224;625;1041;3282;1265;3907
140060;202205;2199;5191;1931;4830;150;363;1621;4093;1771;4456
140070;202205;2123;10499;2051;10379;124;822;1784;8942;1908;9764
150010;202205;54179;124086;48907;117418;1303;2763;43677;104727;44980;107490
150013;202205;2367;5317;1983;4902;99;206;1685;4278;1784;4484
150020;202205;16220;44976;14927;43274;1497;3438;12122;36506;13619;39944
150030;202205;9686;34111;8744;33008;433;1724;7738;29563;8171;31287
150034;202205;5058;11208;4106;10053;234;541;3467;8591;3701;9132
150040;202205;18332;44110;16073;41641;1271;1564;14088;38712;15359;40276
150050;202205;8742;25890;8001;24950;192;625;7364;23189;7556;23814
150060;202205;25432;64788;20569;57680;2484;7258;14301;40462;16785;47720
150070;202205;10375;29448;9302;28196;211;793;8691;26275;8902;27068
150080;202205;104505;225916;86251;201795;22702;53129;27393;76397;50095;129526
150085;202205;10012;25104;9055;23997;107;346;8537;22704;8644;23050
150090;202205;13051;38290;12245;36930;623;1985;10604;31734;11227;33719
150095;202205;8193;18709;7267;17608;672;914;6176;15683;6848;16597
150100;202205;3260;10780;2878;10156;225;734;2291;8296;2516;9030
150110;202205;4723;18252;4355;17835;145;643;4035;16732;4180;17375
150120;202205;9077;26199;8433;25426;333;665;7548;23273;7881;23938
150125;202205;981;2327;719;1971;98;301;459;1255;557;1556
150130;202205;25246;67942;21656;62627;3762;9568;13936;43148;17698;52716
150140;202205;319931;669962;271571;607456;34299;70649;176475;400335;210774;470984
150145;202205;4760;14035;3965;12800;1205;3666;1760;6516;2965;10182
150150;202205;20486;46480;17599;42899;1240;2829;13892;34025;15132;36854
150157;202205;4178;10564;3317;9434;396;1109;2243;6615;2639;7724
150160;202205;4434;10081;4126;9664;403;949;3255;7511;3658;8460
150170;202205;30701;85406;27275;79920;4260;11005;18004;56046;22264;67051
150172;202205;6084;14931;4939;13388;279;672;3834;10593;4113;11265
150175;202205;1951;5540;1613;4960;210;701;1067;3269;1277;3970
150178;202205;12664;30058;10281;27369;682;1160;8569;24054;9251;25214
150180;202205;30604;85804;27838;82714;2055;4124;23315;73683;25370;77807
150190;202205;8182;22868;7601;22176;166;674;7046;20442;7212;21116
150195;202205;6015;17239;5585;16626;256;765;4982;14884;5238;15649
150200;202205;6698;17994;6072;17292;34;134;5740;16388;5774;16522
150210;202205;33537;98834;31477;96327;1434;4072;27505;85910;28939;89982
150215;202205;10723;28459;9272;26221;1550;4342;5582;16137;7132;20479
150220;202205;15150;38601;13216;36002;904;2396;9905;27047;10809;29443
150230;202205;14908;38566;13241;36334;1352;2966;9453;27183;10805;30149
150240;202205;39591;100765;33300;90644;6957;19433;15654;41607;22611;61040
150250;202205;4764;16725;4443;16371;453;1677;3734;14019;4187;15696
150260;202205;2992;8793;2682;8340;95;343;2265;7035;2360;7378
150270;202205;10382;27582;7369;22268;2029;6443;2203;6933;4232;13376
150275;202205;7956;22556;7247;21599;180;724;6404;18851;6584;19575
150276;202205;2643;6628;2277;6178;291;655;1571;4739;1862;5394
150277;202205;6089;14068;4864;12670;616;1620;3397;9231;4013;10851
150280;202205;7950;28763;7651;28307;393;1383;6689;25174;7082;26557
150285;202205;3733;12064;3218;11243;236;846;2454;8715;2690;9561
150290;202205;12836;31020;11625;29738;508;734;10498;27622;11006;28356
150293;202205;10971;24909;8660;21939;1109;2633;5725;14933;6834;17566
150295;202205;8366;20966;5996;17691;1899;5640;2228;7643;4127;13283
150300;202205;3009;7568;2707;7208;35;119;2509;6688;2544;6807
150304;202205;5033;13530;4193;12268;615;1572;2845;8784;3460;10356
150307;202205;6656;19646;6051;18680;347;1021;4831;15071;5178;16092
150309;202205;7403;19903;5997;17632;760;2207;3848;11547;4608;13754
150310;202205;8289;30362;7791;29764;234;1142;6942;26851;7176;27993
150320;202205;10533;26482;9558;25112;578;1628;7474;19460;8052;21088
150330;202205;15799;46125;14588;44432;1530;3897;10845;34902;12375;38799
150340;202205;2772;7661;2428;7185;255;702;1806;5427;2061;6129
150345;202205;10099;25841;8983;24395;375;1094;7892;21373;8267;22467
150350;202205;10622;24106;9713;22951;525;1024;8465;20064;8990;21088
150360;202205;27876;71191;22251;64257;2357;4776;16487;50554;18844;55330
150370;202205;13077;35414;10664;32220;1219;3136;7829;25197;9048;28333
150375;202205;4242;16207;3829;15641;203;868;3388;13972;3591;14840
150380;202205;12483;29044;10190;26070;208;652;8950;22765;9158;23417
150390;202205;8035;30723;7146;29349;876;3155;5355;23035;6231;26190
150400;202205;7606;24708;7237;24100;128;526;6333;21389;6461;21915
150405;202205;10286;24865;8898;23229;590;1109;7233;19480;7823;20589
150410;202205;2225;6301;1897;5780;189;514;1347;4199;1536;4713
150420;202205;49200;125016;38187;109268;8851;25264;16960;53416;25811;78680
150430;202205;9373;25065;8519;24006;681;1466;7099;20510;7780;21976
150440;202205;6786;18675;6121;17806;682;1724;4641;13941;5323;15665
150442;202205;34135;72183;28665;65729;2255;4829;21999;50295;24254;55124
150445;202205;8143;21369;7206;20032;169;530;6474;17916;6643;18446
150450;202205;6290;22809;5843;22226;378;1813;5142;19358;5520;21171
150460;202205;9845;29024;8961;27934;400;1059;7629;24677;8029;25736
150470;202205;24086;58692;21629;55866;244;898;20535;52725;20779;53623
150475;202205;6035;17232;5112;15827;707;1891;3560;11581;4267;13472
150480;202205;16006;45652;14375;43352;2351;5546;10073;32895;12424;38441
150490;202205;9526;30594;8615;29409;547;1675;7184;25092;7731;26767
150495;202205;6170;18466;5824;18025;130;571;5342;16441;5472;17012
150497;202205;3089;9142;2471;8055;455;1501;1369;4751;1824;6252
150500;202205;3729;8906;3298;8294;220;517;2604;6479;2824;6996
150503;202205;5911;14457;4203;12280;1270;3434;1733;5634;3003;9068
150506;202205;13779;36604;11685;33782;1927;4936;7931;24662;9858;29598
150510;202205;12304;37921;10690;35233;1023;3273;8009;26830;9032;30103
150520;202205;8853;30009;8475;29552;184;1058;7879;27291;8063;28349
150530;202205;13544;43567;11712;41004;991;2879;9126;33139;10117;36018
150540;202205;5950;14279;5139;13104;307;695;4307;11006;4614;11701
150543;202205;8218;21111;6829;19393;501;1464;5322;15568;5823;17032
150548;202205;11551;33392;10327;31691;273;962;9218;28370;9491;29332
150549;202205;2277;6027;1918;5522;60;193;1589;4581;1649;4774
150550;202205;23855;65069;19617;58409;4559;13746;8809;27480;13368;41226
150553;202205;41601;107489;32336;91980;7529;21641;14540;42271;22069;63912
150555;202205;2257;5612;1758;4844;171;377;1130;3298;1301;3675
150560;202205;2183;5895;1948;5472;235;627;1264;3606;1499;4233
150563;202205;2996;8324;2449;7366;468;1459;1373;4173;1841;5632
150565;202205;5012;15114;4446;14244;117;482;3663;11775;3780;12257
150570;202205;7875;21530;7252;20713;325;980;6372;18150;6697;19130
150580;202205;12495;44219;10715;42247;1221;3859;8440;35468;9661;39327
150590;202205;9057;29136;7708;27543;168;923;7067;25185;7235;26108
150600;202205;11245;33282;10373;32220;200;778;9605;29879;9805;30657
150610;202205;3500;8762;3120;8197;110;394;2690;6916;2800;7310
150611;202205;3740;9423;3269;8782;91;320;2884;7646;2975;7966
150613;202205;16431;42109;12560;35850;2157;6578;6769;18875;8926;25453
150616;202205;4246;11116;3066;9091;616;1907;1396;4114;2012;6021
150618;202205;7936;21318;6467;19091;787;2338;4083;12422;4870;14760
150619;202205;7680;19852;6320;18020;406;991;5124;14879;5530;15870
150620;202205;7635;23588;6621;21942;732;2197;4545;15628;5277;17825
150630;202205;7633;18147;6949;17334;197;536;6252;15498;6449;16034
150635;202205;6105;15298;5131;13748;594;1470;3454;9340;4048;10810
150640;202205;2408;6846;2195;6575;38;109;2023;6103;2061;6212
150650;202205;13557;34096;11786;31447;2912;7272;5791;16613;8703;23885
150655;202205;6130;16549;5537;15701;128;467;4927;13870;5055;14337
150658;202205;5129;13926;3830;11760;831;2618;1871;5997;2702;8615
150660;202205;6595;17211;5797;16091;814;2142;3855;10849;4669;12991
150670;202205;10845;22372;8640;19860;646;1249;7144;16893;7790;18142
150680;202205;82575;221385;65408;195506;13727;39457;33362;108830;47089;148287
150690;202205;3080;7022;2641;6524;131;263;2292;5758;2423;6021
150700;202205;7678;20202;6876;19209;639;1358;5431;15784;6070;17142
150710;202205;4305;13152;3876;12498;287;912;2948;9702;3235;10614
150715;202205;6211;15595;5109;14020;278;709;4219;11623;4497;12332
150720;202205;8842;25243;8179;24328;436;1365;7014;20952;7450;22317
150730;202205;14804;41129;12576;37908;1460;4491;9164;28337;10624;32828
150740;202205;4591;11763;4013;10893;363;775;3022;8462;3385;9237
150745;202205;6232;16104;5057;14465;655;1850;3656;10706;4311;12556
150746;202205;1976;5312;1749;4983;60;185;1473;4163;1533;4348
150747;202205;5735;15848;5083;14909;418;1076;3943;11811;4361;12887
150750;202205;4180;12055;3413;10904;291;989;2496;8235;2787;9224
150760;202205;13175;36021;11897;34302;1640;4209;8541;25562;10181;29771
150770;202205;7930;24795;7301;24100;214;508;6694;22719;6908;23227
150775;202205;1299;3165;1012;2799;118;362;716;1982;834;2344
150780;202205;5098;14533;4521;13860;187;482;4045;12751;4232;13233
150790;202205;6930;17440;5821;16240;509;1080;3981;13098;4490;14178
150795;202205;17412;48053;15075;44651;2846;8140;9483;29117;12329;37257
150796;202205;4423;9718;3829;9049;166;343;3327;7929;3493;8272
150797;202205;4867;13494;4157;12520;365;933;3315;10202;3680;11135
150800;202205;15341;44456;13709;42374;1549;4454;10371;32964;11920;37418
150803;202205;9325;24135;8593;23140;298;882;7663;20485;7961;21367
150805;202205;4072;11570;3467;10735;291;833;2668;8489;2959;9322
150808;202205;7458;20352;5531;17197;1916;6466;1043;3616;2959;10082
150810;202205;23927;57260;18061;50258;3781;9891;9418;29651;13199;39542
150812;202205;6886;17100;6066;15869;421;1263;4780;12141;5201;13404
150815;202205;10948;29810;9139;27686;952;2834;7274;22537;8226;25371
150820;202205;16217;35716;14107;33192;1960;3094;10377;26692;12337;29786
150830;202205;13653;44438;12596;43172;769;1999;10772;38653;11541;40652
150835;202205;3636;10127;3184;9480;326;1007;2365;7004;2691;8011
150840;202205;9326;23998;7530;21250;1064;3329;4589;12660;5653;15989
160005;202205;1423;3443;1259;3251;49;157;1095;2811;1144;2968
160010;202205;2545;6544;2361;6345;27;122;2279;6070;2306;6192
160015;202205;4053;9460;3645;8985;57;185;3450;8446;3507;8631
160020;202205;2658;7320;2304;6874;238;623;1764;5499;2002;6122
160021;202205;1439;4895;1300;4726;66;296;1015;3795;1081;4091
160023;202205;1534;4930;1372;4668;197;624;915;3286;1112;3910
160025;202205;2152;5910;2014;5759;28;62;1941;5565;1969;5627
160027;202205;11578;27039;10465;25668;607;1534;8998;21990;9605;23524
160030;202205;92159;235081;76112;214420;14367;37319;44463;135276;58830;172595
160040;202205;6599;20377;5947;19535;259;779;5349;17803;5608;18582
160050;202205;6126;16279;4962;14795;1599;4022;2404;8652;4003;12674
160053;202205;4833;13098;4324;12448;261;623;3564;10670;3825;11293
160055;202205;1351;3085;1308;3040;21;55;1248;2885;1269;2940
160060;202205;32530;74359;27213;68385;1971;4364;22010;57213;23981;61577
160070;202205;3214;10920;2802;10309;241;812;2173;8344;2414;9156
160080;202205;3899;10672;3428;10155;57;194;3187;9555;3244;9749
170025;202205;755;1852;491;1377;87;232;192;549;279;781
170030;202205;1338;3784;981;3116;204;619;379;1262;583;1881
170035;202205;1692;4113;1238;3392;100;291;766;2011;866;2302
170040;202205;2185;5556;1724;4926;176;523;1066;3131;1242;3654
170070;202205;2200;4751;1562;3956;82;206;943;2450;1025;2656
170100;202205;2738;7188;2248;6394;262;713;1437;4150;1699;4863
170105;202205;767;2099;530;1623;125;371;164;464;289;835
170110;202205;1146;3139;882;2696;71;273;542;1577;613;1850
170130;202205;1557;4139;1177;3492;132;457;697;2030;829;2487
170190;202205;1800;4347;1388;3729;208;689;787;1996;995;2685
170200;202205;2358;5259;1558;4000;262;681;643;1614;905;2295
170210;202205;30661;78277;23257;66370;6727;20575;4673;13919;11400;34494
170215;202205;1507;3747;1205;3339;52;182;950;2600;1002;2782
170220;202205;6625;19163;5487;17199;1776;5443;1825;6531;3601;11974
170230;202205;1400;3825;1042;3168;296;899;279;887;575;1786
170240;202205;3074;7736;2473;6809;146;490;1850;4943;1996;5433
170255;202205;4316;11785;3163;9836;591;1887;1458;4643;2049;6530
170270;202205;999;2344;677;1867;80;210;382;1046;462;1256
170290;202205;3447;9055;2974;8447;231;514;2329;6829;2560;7343
170300;202205;2465;5829;2002;5160;163;398;1490;3808;1653;4206
170305;202205;753;1944;620;1716;73;198;336;944;409;1142
170307;202205;1171;3460;972;3107;113;379;607;1904;720;2283
170310;202205;1805;4253;1293;3465;162;453;686;1839;848;2292
170320;202205;1181;2968;894;2507;109;329;535;1507;644;1836
170330;202205;1060;3015;962;2875;32;133;821;2399;853;2532
170360;202205;642;1570;462;1290;21;80;316;824;337;904
170370;202205;1476;3584;1055;2917;188;517;478;1282;666;1799
170380;202205;2072;5531;1570;4766;114;375;929;2908;1043;3283
170382;202205;605;1648;496;1475;25;96;364;1041;389;1137
170384;202205;1883;6026;1552;5437;329;1114;815;2916;1144;4030
170386;202205;1091;2838;663;2011;72;252;249;703;321;955
170388;202205;821;2085;581;1684;75;230;294;813;369;1043
170389;202205;1055;3078;848;2726;103;351;532;1759;635;2110
170390;202205;2038;4228;1535;3637;36;94;1315;3138;1351;3232
170410;202205;698;1729;509;1422;28;99;358;949;386;1048
170460;202205;459;1183;374;1051;44;135;262;729;306;864
170510;202205;1036;2706;741;2209;36;153;474;1309;510;1462
170550;202205;7632;19043;5774;16191;1551;4696;1762;4910;3313;9606
170555;202205;1560;3915;1242;3436;123;271;620;1807;743;2078
170560;202205;1133;2977;869;2612;104;306;526;1661;630;1967
170600;202205;1547;3850;1210;3374;235;611;652;1904;887;2515
170610;202205;1851;4441;1384;3758;133;421;885;2325;1018;2746
170625;202205;497;1220;329;916;35;89;138;348;173;437
170650;202205;1567;4125;1278;3682;129;435;832;2337;961;2772
170700;202205;3969;10941;3031;9200;615;1880;1333;3977;1948;5857
170710;202205;1750;4120;1345;3532;163;426;884;2312;1047;2738
170720;202205;2033;4686;1553;3947;172;501;1025;2518;1197;3019
170730;202205;1232;3084;925;2619;106;257;560;1624;666;1881
170740;202205;2323;7091;1979;6486;163;596;1440;4653;1603;5249
170755;202205;980;2485;701;2031;120;373;295;828;415;1201
170765;202205;1303;3133;920;2542;171;454;458;1278;629;1732
170770;202205;2074;5520;1669;4912;156;510;1176;3401;1332;3911
170820;202205;4227;11538;3267;9898;606;1823;1658;5151;2264;6974
170825;202205;1169;2491;951;2214;76;169;743;1715;819;1884
170830;202205;1516;3742;1190;3226;345;961;487;1297;832;2258
170900;202205;3156;9060;2678;8381;206;653;2167;6872;2373;7525
170930;202205;4332;11205;3314;9381;764;2249;1085;3065;1849;5314
170950;202205;12869;34062;9108;27479;2588;8373;1245;4087;3833;12460
170980;202205;581;1389;421;1123;52;147;228;592;280;739
171050;202205;1858;5430;1608;5013;84;313;1283;3983;1367;4296
171070;202205;1511;3982;1287;3660;259;634;677;2234;936;2868
171090;202205;1147;2794;901;2443;139;395;495;1346;634;1741
171110;202205;650;1650;436;1264;74;214;197;527;271;741
171150;202205;1177;2765;743;2053;52;164;466;1259;518;1423
171180;202205;855;2213;564;1683;86;228;257;763;343;991
171190;202205;2255;6861;1947;6342;294;1001;1220;4063;1514;5064
171195;202205;927;2712;732;2348;102;413;449;1352;551;1765
171200;202205;693;1832;516;1535;122;417;189;530;311;947
171215;202205;441;1097;348;945;39;111;198;517;237;628
171240;202205;870;2637;677;2303;24;149;469;1532;493;1681
171245;202205;881;2351;681;1956;57;183;421;1135;478;1318
171250;202205;1106;2848;806;2370;143;441;377;1115;520;1556
171270;202205;540;1784;417;1513;83;329;192;716;275;1045
171280;202205;1005;2794;806;2463;73;226;516;1607;589;1833
171320;202205;4482;11847;3511;10197;666;1902;1478;4396;2144;6298
171330;202205;3167;8216;2455;6998;569;1661;1127;3232;1696;4893
171360;202205;1669;4382;1279;3823;127;339;834;2671;961;3010
171370;202205;825;1914;636;1652;61;159;433;1110;494;1269
171380;202205;1673;4333;1392;3961;151;375;989;2988;1140;3363
171395;202205;1131;2804;774;2191;65;208;517;1412;582;1620
171420;202205;2225;5872;1685;4902;293;903;840;2396;1133;3299
171430;202205;1212;3306;1012;2956;71;232;683;1885;754;2117
171488;202205;2813;7360;2211;6401;370;1042;1195;3465;1565;4507
171500;202205;1035;2473;738;1999;81;225;465;1237;546;1462
171510;202205;948;2773;811;2533;65;239;561;1733;626;1972
171515;202205;549;1298;394;1056;35;116;252;616;287;732
171525;202205;809;2057;608;1729;50;171;393;1052;443;1223
171550;202205;382;1019;300;899;40;159;178;488;218;647
171570;202205;1223;3378;1018;3030;133;403;615;1866;748;2269
171575;202205;1913;4837;1265;3739;143;411;597;1759;740;2170
171610;202205;6734;17881;5028;15020;1154;3736;1192;3909;2346;7645
171620;202205;3149;7797;2679;7147;141;461;2264;5968;2405;6429
171630;202205;1212;2928;934;2551;116;341;621;1703;737;2044
171650;202205;2500;6648;1939;5750;479;1520;595;1871;1074;3391
171660;202205;2625;6225;1833;4967;194;523;1155;3115;1349;3638
171665;202205;1403;3727;1112;3263;224;677;523;1567;747;2244
171670;202205;2128;5380;1592;4499;228;671;737;2063;965;2734
171700;202205;1317;3470;968;2859;118;353;561;1636;679;1989
171720;202205;878;2128;677;1833;46;133;498;1329;544;1462
171750;202205;1457;3903;993;3053;252;798;175;625;427;1423
171780;202205;1444;3391;1059;2816;99;288;729;1894;828;2182
171790;202205;1571;4769;1259;4141;190;643;644;2107;834;2750
171800;202205;821;2061;628;1786;69;219;355;966;424;1185
171820;202205;13215;35121;9844;29565;2337;7491;2746;8722;5083;16213
171830;202205;1729;5097;1473;4661;219;711;857;2799;1076;3510
171840;202205;838;2088;637;1778;30;111;389;1041;419;1152
171845;202205;740;1690;566;1427;48;161;396;941;444;1102
171850;202205;1056;3128;891;2789;57;240;664;2026;721;2266
171855;202205;1139;3258;963;2942;75;249;612;1803;687;2052
171865;202205;547;1468;465;1345;60;196;277;769;337;965
171870;202205;909;2342;636;1877;88;269;322;938;410;1207
171875;202205;1507;3959;1222;3538;39;178;941;2666;980;2844
171880;202205;1524;3939;1314;3665;43;134;1046;2926;1089;3060
171884;202205;1187;3042;896;2555;188;525;415;1209;603;1734
171886;202205;1682;4333;1227;3655;315;1028;321;1025;636;2053
171888;202205;675;1835;462;1432;26;105;281;837;307;942
171889;202205;440;1251;316;1023;68;228;120;372;188;600
171890;202205;1346;3661;993;3081;130;424;618;1889;748;2313
171900;202205;623;1989;484;1708;75;248;218;791;293;1039
172000;202205;654;1819;521;1588;92;283;240;719;332;1002
172010;202205;1289;3845;1113;3551;105;364;724;2294;829;2658
172015;202205;415;1339;313;1138;58;196;138;515;196;711
172020;202205;3168;8228;2747;7697;181;546;2028;5852;2209;6398
172025;202205;790;2053;572;1711;46;143;391;1164;437;1307
172030;202205;1387;3895;1134;3472;89;278;827;2545;916;2823
172049;202205;1408;3298;928;2629;127;353;489;1443;616;1796
172065;202205;1646;3850;1303;3411;137;272;966;2755;1103;3027
172080;202205;2709;7368;2166;6434;125;426;1447;4221;1572;4647
172085;202205;512;1308;320;907;59;175;120;310;179;485
172090;202205;4549;10366;3565;9096;154;383;2813;7184;2967;7567
172093;202205;493;1417;355;1185;27;122;203;640;230;762
172097;202205;783;1915;535;1512;74;218;219;601;293;819
172100;202205;56684;132810;41990;110629;7579;21619;17487;45884;25066;67503
172110;202205;1796;6004;1532;5616;104;452;1184;4394;1288;4846
172120;202205;5693;15630;4475;13712;485;1621;2652;8135;3137;9756
172125;202205;455;1172;345;1000;33;115;199;535;232;650
172130;202205;686;1628;517;1350;21;83;354;852;375;935
172208;202205;2985;6658;2364;5876;220;459;1734;4368;1954;4827
172210;202205;2958;6947;2291;6130;272;683;1456;4100;1728;4783
210005;202205;21280;57249;16066;48982;3932;12488;7017;22157;10949;34645
210010;202205;2216;6145;2014;5910;53;236;1807;5252;1860;5488
210015;202205;3597;10141;3093;9467;171;539;2551;7832;2722;8371
210020;202205;8136;17848;6926;16446;105;311;6398;15162;6503;15473
210030;202205;5007;15680;4559;15000;518;1606;3529;11930;4047;13536
210040;202205;2391;4812;2099;4469;63;149;1843;3846;1906;3995
210043;202205;6617;17640;5555;16198;365;1122;4418;12961;4783;14083
210047;202205;7464;21284;5946;19289;179;775;5105;16593;5284;17368
210050;202205;2571;7708;2044;6787;178;728;1486;4832;1664;5560
210055;202205;2259;6362;2020;6032;54;194;1774;5309;1828;5503
210060;202205;8161;28113;7220;26450;681;2587;5048;18983;5729;21570
210070;202205;7720;19770;7135;19026;63;200;6715;17851;6778;18051
210080;202205;4796;14582;4503;14254;47;248;4170;13221;4217;13469
210083;202205;6628;16568;5560;15410;133;391;5185;14429;5318;14820
210087;202205;3139;8356;2663;7724;155;483;2140;6201;2295;6684
210090;202205;10105;29277;9349;28031;679;1618;7796;23735;8475;25353
210095;202205;7160;21967;6518;21139;438;1414;5315;17894;5753;19308
210100;202205;7261;21242;6282;19535;671;2108;4373;13701;5044;15809
210110;202205;3204;9289;2937;8961;62;297;2631;7981;2693;8278
210120;202205;29283;69086;24774;63450;1882;3762;18753;49447;20635;53209
210125;202205;4846;12373;4211;11652;643;1358;3094;9112;3737;10470
210130;202205;4682;11330;3807;10258;114;272;3316;8973;3430;9245
210135;202205;1851;4599;1519;4136;49;134;1303;3539;1352;3673
210140;202205;22711;55985;17672;49550;2817;7590;10865;31312;13682;38902
210150;202205;5182;11278;4567;10463;112;324;4015;9008;4127;9332
210160;202205;21904;54016;18749;50152;1460;3707;14682;39828;16142;43535
210170;202205;17355;49172;15970;47404;685;2045;14127;42006;14812;44051
210173;202205;2506;9051;2348;8795;102;545;2041;7577;2143;8122
210177;202205;3632;9528;3119;8874;414;1024;2335;6920;2749;7944
210180;202205;1588;3938;1376;3680;29;82;1234;3304;1263;3386
210190;202205;5994;14617;4929;13181;91;321;4246;11223;4337;11544
210193;202205;1509;3983;1305;3670;47;141;994;2783;1041;2924
210197;202205;2247;6544;2029;6252;121;366;1695;5325;1816;5691
210200;202205;8752;25947;7720;24369;449;1610;6197;19549;6646;21159
210203;202205;7868;21581;6611;19946;430;1303;5310;16352;5740;17655
210207;202205;4252;9792;3380;8802;146;321;2818;7412;2964;7733
210210;202205;8322;25406;7545;24327;177;916;6456;20691;6633;21607
210215;202205;2673;7996;2302;7455;156;721;1792;5716;1948;6437
210220;202205;7381;22329;6942;21705;164;946;6232;19032;6396;19978
210230;202205;6033;16468;5455;15613;201;565;4885;14014;5086;14579
210232;202205;12900;37048;10545;33545;1634;5023;6843;23084;8477;28107
210235;202205;3774;10681;3304;10010;173;613;2756;8328;2929;8941
210237;202205;4063;10179;3414;9447;30;162;3219;8835;3249;8997
210240;202205;2821;8193;2560;7784;70;263;2107;6302;2177;6565
210250;202205;6464;17780;5825;16977;83;392;5316;15392;5399;15784
210255;202205;2938;8391;2503;7644;291;973;1613;4815;1904;5788
210260;202205;5898;16698;5155;15639;349;1160;4207;12771;4556;13931
210270;202205;5576;14053;4944;13270;79;376;4478;11868;4557;12244
210275;202205;3756;9027;3209;8363;188;462;2577;6767;2765;7229
210280;202205;6545;16596;5329;14833;188;800;4262;11493;4450;12293
210290;202205;8952;20736;8035;19627;163;411;7487;18281;7650;18692
210300;202205;36010;93469;29231;83859;4638;12547;16956;52646;21594;65193
210310;202205;3354;7985;2910;7377;61;167;2629;6639;2690;6806
210312;202205;3097;7032;2756;6667;17;85;2605;6208;2622;6293
210315;202205;3817;8967;3374;8478;119;281;3062;7766;3181;8047
210317;202205;4869;13938;4408;13395;97;451;4026;12157;4123;12608
210320;202205;26770;65314;24838;62898;331;1552;23067;57432;23398;58984
210325;202205;3974;10588;3342;9753;342;959;2623;7817;2965;8776
210330;202205;28085;71312;22576;64572;3828;9018;14509;45821;18337;54839
210340;202205;12338;31062;11030;29403;360;1164;9505;25200;9865;26364
210350;202205;10005;26610;8757;25093;162;558;7830;22394;7992;22952
210355;202205;4434;13987;3893;13146;123;546;3298;11133;3421;11679
210360;202205;13779;41373;12492;39352;570;2517;9601;29393;10171;31910
210370;202205;13424;26314;10226;22936;492;678;9134;21168;9626;21846
210375;202205;3595;9257;2683;7930;838;2581;824;2725;1662;5306
210380;202205;6055;14520;5210;13506;313;770;4379;11388;4692;12158
210390;202205;3418;9561;3172;9180;86;382;2864;8153;2950;8535
210400;202205;4964;13743;4356;13036;173;415;3874;11830;4047;12245
210405;202205;8033;19689;6541;17692;1177;2744;3836;11229;5013;13973
210407;202205;2269;6805;1892;6162;103;373;1474;4787;1577;5160
210408;202205;2939;10053;2711;9745;155;696;2165;7821;2320;8517
210409;202205;4237;13386;3804;12794;163;649;3124;10714;3287;11363
210410;202205;3939;10943;3311;9877;102;421;2703;7901;2805;8322
210420;202205;4162;12502;3685;11660;215;625;3027;9678;3242;10303
210430;202205;2428;6784;2108;6355;158;429;1699;5235;1857;5664
210440;202205;4726;12015;4089;11225;70;251;3740;10178;3810;10429
210450;202205;2524;6972;2163;6453;154;414;1732;5226;1886;5640
210455;202205;5128;12489;3940;10999;997;2753;1972;5721;2969;8474
210460;202205;3987;10936;3336;10086;93;369;2859;8597;2952;8966
210462;202205;1851;5234;1554;4787;66;196;1222;3802;1288;3998
210465;202205;2960;7970;2566;7430;125;511;2124;6003;2249;6514
210467;202205;6839;19267;5929;18104;330;1039;4961;15320;5291;16359
210470;202205;2091;5414;1547;4652;169;470;1103;3399;1272;3869
210480;202205;18749;51452;15553;47590;1743;3870;11295;37854;13038;41724
210490;202205;3788;8987;3029;7975;72;213;2577;6739;2649;6952
210500;202205;6869;24504;6308;23583;362;1676;5278;19606;5640;21282
210510;202205;6658;20109;5821;19218;114;504;5278;17627;5392;18131
210515;202205;4147;11298;3528;10561;182;594;2931;8920;3113;9514
210520;202205;2828;7765;2535;7376;103;370;2131;6126;2234;6496
210530;202205;58731;138890;45591;120041;8171;22846;16805;50879;24976;73725
210535;202205;4017;11681;3650;11154;124;471;3193;9747;3317;10218
210540;202205;16609;44957;13869;41092;1657;4457;9632;29983;11289;34440
210542;202205;7217;15999;5622;14209;526;1140;4413;11530;4939;12670
210545;202205;2452;7127;2257;6819;40;164;1964;5859;2004;6023
210547;202205;4041;13448;3553;12580;216;809;2784;10042;3000;10851
210550;202205;6401;18544;4899;16141;454;1662;3250;10981;3704;12643
210560;202205;4031;11650;3549;10890;101;373;3021;9165;3122;9538
210565;202205;1621;4727;1345;4334;83;370;1041;3352;1124;3722
210570;202205;12019;30743;10645;29065;310;860;9469;26042;9779;26902
210580;202205;3345;8146;2645;7289;219;522;1846;5422;2065;5944
210590;202205;4685;13010;4025;12186;81;404;3583;10801;3664;11205
210592;202205;2971;7989;2734;7623;26;125;2386;6530;2412;6655
210594;202205;2739;7119;2132;6197;147;410;1552;4665;1699;5075
210596;202205;3120;9894;2767;9282;284;971;2078;7157;2362;8128
210598;202205;2122;5541;1905;5250;97;267;1640;4531;1737;4798
210600;202205;3277;8525;2672;7682;264;701;1809;5239;2073;5940
210610;202205;3301;8072;2830;7509;60;257;2472;6483;2532;6740
210620;202205;3332;7602;2733;6869;146;284;2339;5900;2485;6184
210630;202205;3462;10509;3083;9863;144;589;2508;7941;2652;8530
210632;202205;6106;15452;5436;14567;197;771;4715;12361;4912;13132
210635;202205;1838;6197;1729;5999;139;449;1362;4847;1501;5296
210637;202205;2853;8652;2402;8016;163;625;1824;6184;1987;6809
210640;202205;5137;16655;4781;16235;64;333;4411;15003;4475;15336
210650;202205;7752;20872;6940;19839;125;425;6166;17626;6291;18051
210660;202205;8933;24431;7991;22933;233;972;6852;19153;7085;20125
210663;202205;3291;7927;2925;7483;261;448;2232;6139;2493;6587
210667;202205;2181;6563;1937;6201;46;153;1673;5472;1719;5625
210670;202205;5481;16071;4932;15242;109;489;4380;13435;4489;13924
210675;202205;5908;14318;5055;13271;430;935;4028;10935;4458;11870
210680;202205;5270;11559;4440;10598;116;192;4080;9795;4196;9987
210690;202205;8733;23698;7216;21997;283;957;6402;19559;6685;20516
210700;202205;3047;7968;2430;7079;162;432;1805;5383;1967;5815
210710;202205;5647;15922;4972;15034;106;493;4452;13328;4558;13821
210720;202205;3388;10037;2951;9503;80;395;2617;8353;2697;8748
210725;202205;1454;4403;1261;4113;53;189;895;3027;948;3216
210730;202205;1574;3409;1340;3096;62;136;1150;2652;1212;2788
210735;202205;5138;13753;4351;12765;229;556;3660;11102;3889;11658
210740;202205;5790;13989;4926;13009;117;277;4187;11028;4304;11305
210745;202205;4810;12246;4374;11704;63;228;3948;10502;4011;10730
210750;202205;26644;66209;23069;61700;2843;6778;15712;44144;18555;50922
210760;202205;6493;15493;5416;14355;118;228;5063;13621;5181;13849
210770;202205;6903;16128;5900;14994;68;277;5487;13798;5555;14075
210780;202205;8218;24086;7124;22296;521;1632;5578;17559;6099;19191
210790;202205;4948;14033;4406;13327;279;687;3659;11404;3938;12091
210800;202205;5309;13423;4527;12372;85;331;4050;10922;4135;11253
210805;202205;4482;14890;4174;14444;189;759;3583;12425;3772;13184
210810;202205;5353;14501;4837;13842;468;1086;3830;11421;4298;12507
210820;202205;7787;20996;6487;18965;808;2295;4035;12143;4843;14438
210825;202205;8239;22168;7407;21102;341;950;6482;18626;6823;19576
210830;202205;9225;23308;8320;22212;591;1213;6988;19262;7579;20475
210840;202205;3590;8770;3239;8322;38;176;2944;7431;2982;7607
210845;202205;6989;17521;6160;16608;45;157;5888;15918;5933;16075
210850;202205;7022;20808;5791;19005;381;1302;4548;15102;4929;16404
210860;202205;23331;54407;19270;49532;1112;2373;15635;41792;16747;44165
210870;202205;8366;19404;6604;17427;147;394;5945;15643;6092;16037
210880;202205;4559;13010;4070;12392;247;808;3178;9707;3425;10515
210890;202205;4902;12108;4461;11605;322;748;3732;9752;4054;10500
210900;202205;5311;14379;4149;12352;1519;4612;863;2978;2382;7590
210905;202205;2446;5623;2080;5171;50;87;1932;4853;1982;4940
210910;202205;7870;22971;6486;20787;744;2403;4358;14086;5102;16489
210920;202205;3468;10477;3028;9900;81;397;2711;8757;2792;9154
210923;202205;1838;4869;1569;4467;91;267;1223;3443;1314;3710
210927;202205;5215;16182;4515;15317;552;1797;3139;11157;3691;12954
210930;202205;2842;8543;2493;7901;127;460;2041;6377;2168;6837
210940;202205;4166;11281;3806;10856;270;1202;3277;8872;3547;10074
210945;202205;8394;20973;7480;19920;396;879;6195;17070;6591;17949
210950;202205;5966;15183;4611;13324;553;1226;3204;9913;3757;11139
210955;202205;1679;4845;1416;4438;335;986;751;2479;1086;3465
210960;202205;10273;28397;8839;26261;2131;5999;4716;15099;6847;21098
210970;202205;1820;4532;1497;3992;109;305;1213;3131;1322;3436
210975;202205;1989;5590;1793;5297;164;480;1351;4012;1515;4492
210980;202205;11117;23655;9735;22215;106;244;9205;21033;9311;21277
210990;202205;19070;48971;14740;43486;1343;3338;10599;32835;11942;36173
211000;202205;16137;42950;13309;39470;1443;3900;9868;30632;11311;34532
211003;202205;6501;17258;5410;15968;127;463;4716;14145;4843;14608
211010;202205;7263;22865;6510;21933;102;457;5878;20011;5980;20468
211020;202205;9493;24679;8254;23301;238;785;7162;20704;7400;21489
211023;202205;2267;6808;2086;6579;103;359;1746;5478;1849;5837
211027;202205;4120;10645;3915;10344;128;420;3581;9336;3709;9756
211030;202205;4197;10991;3713;10382;357;888;2762;7938;3119;8826
211040;202205;4981;16640;4573;15953;122;633;4064;14099;4186;14732
211050;202205;10260;24185;9231;22899;136;432;8422;20787;8558;21219
211060;202205;7741;21516;6999;20526;162;696;6204;17982;6366;18678
211065;202205;2694;6478;2257;5936;88;215;1958;5196;2046;5411
211070;202205;9112;25758;7762;23804;356;1221;6533;20022;6889;21243
211080;202205;1460;3735;1152;3267;37;189;885;2349;922;2538
211085;202205;2407;6168;2002;5648;182;359;1579;4719;1761;5078
211090;202205;3427;8930;3080;8532;34;154;2845;7839;2879;7993
211100;202205;7979;17732;7432;17095;36;124;7034;16134;7070;16258
211102;202205;3629;10945;3283;10439;272;925;2634;8390;2906;9315
211105;202205;2585;7601;2167;6881;121;409;1642;5142;1763;5551
211107;202205;5288;15564;4488;14399;178;605;3559;11916;3737;12521
211110;202205;6959;17123;5530;15042;298;835;4364;11722;4662;12557
211120;202205;52175;119706;42700;108660;6867;15680;27375;73411;34242;89091
211125;202205;2163;6176;1817;5652;46;206;1542;4772;1588;4978
211130;202205;207292;466196;177974;428659;26025;54594;107193;274409;133218;329003
211140;202205;5336;14839;4634;13946;210;641;3895;11815;4105;12456
211150;202205;10509;26210;8800;24076;388;969;7332;20281;7720;21250
211153;202205;3187;8089;2229;6905;376;1083;1377;4543;1753;5626
211157;202205;1362;3923;1147;3528;81;251;818;2508;899;2759
211160;202205;5602;13245;4513;11753;130;501;3679;9144;3809;9645
211163;202205;1691;5171;1521;4929;46;183;1325;4307;1371;4490
211167;202205;1823;5058;1689;4876;33;114;1557;4482;1590;4596
211170;202205;7611;16533;7033;15869;52;141;6698;14988;6750;15129
211172;202205;2856;7439;2418;6792;94;326;1944;5265;2038;5591
211174;202205;3051;8263;2745;7920;31;170;2591;7426;2622;7596
211176;202205;4713;12482;3676;10973;221;746;2919;8676;3140;9422
211178;202205;5839;11737;5032;10883;29;116;4865;10420;4894;10536
211180;202205;4561;13984;4193;13474;173;704;3508;11185;3681;11889
211190;202205;3595;9328;3038;8529;35;187;2754;7624;2789;7811
211195;202205;1683;4179;1455;3847;66;171;1264;3329;1330;3500
211200;202205;2381;6516;1872;5737;190;583;1300;3974;1490;4557
211210;202205;6663;19288;5962;18332;368;1265;4907;15060;5275;16325
211220;202205;44385;102526;36661;93213;3328;7912;27564;71219;30892;79131
211223;202205;5897;14674;4824;13261;629;1666;3183;8907;3812;10573
211227;202205;1890;5694;1632;5329;82;333;1309;4301;1391;4634
211230;202205;9164;23739;7773;21763;372;808;6513;18520;6885;19328
211240;202205;8500;25434;7952;24728;234;868;7238;22453;7472;23321
211245;202205;8246;20270;7144;19113;144;342;6746;18093;6890;18435
211250;202205;16268;44458;14745;42240;1178;3443;11665;33350;12843;36793
211260;202205;8842;26531;7755;25179;190;863;6927;22589;7117;23452
211270;202205;11253;33190;9563;31000;392;1638;7805;25446;8197;27084
211280;202205;15852;36837;14269;34858;594;1294;12722;31248;13316;32542
211285;202205;2199;6374;1958;6064;132;456;1506;4687;1638;5143
211290;202205;7922;22468;7071;21318;299;993;5860;17627;6159;18620
211300;202205;8086;22473;7049;20773;433;1368;5462;15858;5895;17226
211400;202205;13135;33971;10714;30692;1343;3633;7108;21463;8451;25096
220005;202205;2153;5067;1943;4782;35;104;1654;3966;1689;4070
220010;202205;1618;4351;1315;3834;39;132;1010;2905;1049;3037
220020;202205;4798;11065;4150;10205;157;447;3562;8595;3719;9042
220025;202205;2527;5240;2172;4729;61;112;1798;3796;1859;3908
220027;202205;1528;3433;1311;3141;29;97;1149;2691;1178;2788
220030;202205;3980;9100;3702;8749;119;279;3222;7535;3341;7814
220040;202205;8580;24201;7437;22103;1423;3883;4225;13083;5648;16966
220045;202205;1790;4766;1482;4282;25;132;1280;3587;1305;3719
220050;202205;5530;13202;4733;12212;57;233;4392;11180;4449;11413
220060;202205;3133;5594;2700;5098;25;49;2574;4821;2599;4870
220070;202205;2671;6351;2229;5724;73;173;1871;4763;1944;4936
220080;202205;823;2197;707;2035;17;68;606;1717;623;1785
220090;202205;1966;4399;1597;3862;78;108;1279;3187;1357;3295
220095;202205;1022;1968;971;1916;41;73;878;1730;919;1803
220100;202205;1609;3963;1288;3486;32;124;1058;2737;1090;2861
220105;202205;2325;6552;2033;6053;141;450;1525;4505;1666;4955
220110;202205;3923;9908;3462;9161;36;169;3099;8060;3135;8229
220115;202205;3062;8099;2821;7793;105;305;2511;6902;2616;7207
220117;202205;1557;3459;1221;3007;9;36;1018;2431;1027;2467
220120;202205;16752;37227;15400;35564;83;345;14571;33251;14654;33596
220130;202205;1297;3141;1089;2862;19;86;975;2491;994;2577
220140;202205;2515;4759;2142;4337;52;124;1968;3932;2020;4056
220150;202205;7332;19428;6650;18284;165;603;5610;15069;5775;15672
220155;202205;1329;3555;1066;3083;24;75;767;2162;791;2237
220157;202205;1219;2699;1027;2421;27;77;839;1914;866;1991
220160;202205;3159;8083;2706;7288;52;186;2192;5742;2244;5928
220170;202205;1764;4357;1492;3964;28;110;1305;3416;1333;3526
220173;202205;2415;6245;1926;5397;53;194;1510;4123;1563;4317
220177;202205;2423;5893;2299;5758;6;23;2267;5664;2273;5687
220180;202205;1291;2811;1054;2433;6;30;859;1842;865;1872
220190;202205;8852;19015;7591;17375;496;999;5980;13916;6476;14915
220191;202205;1801;4949;1633;4677;108;355;1180;3287;1288;3642
220192;202205;2292;5638;1651;4531;32;111;1355;3621;1387;3732
220194;202205;2010;5138;1760;4754;61;223;1442;3752;1503;3975
220196;202205;2407;5663;2183;5340;24;111;1922;4592;1946;4703
220198;202205;1498;3519;1270;3241;11;25;1172;2998;1183;3023
220200;202205;5643;15434;4913;14481;91;363;4216;12405;4307;12768
220202;202205;2406;6180;2046;5609;36;149;1748;4683;1784;4832
220205;202205;2851;7414;2523;6842;67;233;2130;5635;2197;5868
220207;202205;851;2402;712;2168;68;200;459;1420;527;1620
220208;202205;1971;5591;1594;4902;195;597;965;2985;1160;3582
220209;202205;1753;4724;1497;4272;29;107;1219;3433;1248;3540
220210;202205;2114;4499;1848;4109;19;68;1641;3528;1660;3596
220211;202205;1984;4202;1821;3993;25;80;1611;3473;1636;3553
220213;202205;2044;4985;1723;4444;32;113;1382;3391;1414;3504
220217;202205;2693;6770;2513;6564;134;198;2232;6043;2366;6241
220220;202205;13464;30023;11494;27200;657;1388;8941;21115;9598;22503
220225;202205;1116;2677;894;2400;2;12;834;2220;836;2232
220230;202205;6451;14763;5529;13509;135;319;4869;11866;5004;12185
220240;202205;3493;9270;2927;8308;97;389;2396;6616;2493;7005
220245;202205;2161;4229;1629;3605;12;47;1497;3279;1509;3326
220250;202205;3415;8599;2991;8075;21;95;2791;7471;2812;7566
220253;202205;1852;4623;1568;4180;37;128;1341;3488;1378;3616
220255;202205;2231;4747;1895;4280;43;156;1635;3533;1678;3689
220260;202205;5552;14542;4829;13285;233;641;3871;10579;4104;11220
220265;202205;1629;4544;1483;4362;74;286;1225;3527;1299;3813
220270;202205;6573;20197;6147;19440;183;959;5149;15708;5332;16667
220271;202205;1651;3959;1439;3667;28;106;1244;3138;1272;3244
220272;202205;1933;5241;1698;4812;57;207;1276;3457;1333;3664
220273;202205;1442;3780;1208;3369;54;190;922;2529;976;2719
220275;202205;2841;5754;2302;5039;34;67;2097;4531;2131;4598
220277;202205;2615;5759;2212;5212;65;141;1853;4270;1918;4411
220280;202205;2095;4150;1759;3736;40;81;1552;3231;1592;3312
220285;202205;1721;3776;1469;3478;11;45;1389;3246;1400;3291
220290;202205;7831;19957;6239;17783;489;1308;4466;13163;4955;14471
220300;202205;2237;5959;1760;5353;37;182;1438;4315;1475;4497
220310;202205;3564;8706;2793;7816;43;176;2425;6720;2468;6896
220320;202205;3456;9230;2677;7858;78;355;2100;5940;2178;6295
220323;202205;1850;4926;1410;4228;48;199;1140;3315;1188;3514
220325;202205;1358;3840;1144;3477;31;143;923;2743;954;2886
220327;202205;1811;4598;1589;4255;50;187;1324;3435;1374;3622
220330;202205;5701;11699;4911;10779;40;123;4556;9873;4596;9996
220335;202205;2043;5346;1855;5093;77;169;1620;4460;1697;4629
220340;202205;2066;5180;1571;4355;67;202;1026;2737;1093;2939
220342;202205;1352;3619;1213;3420;70;176;952;2691;1022;2867
220345;202205;3422;7228;2587;6086;26;84;2279;5286;2305;5370
220350;202205;3743;8889;2998;7806;208;475;2110;5505;2318;5980
220360;202205;1421;3400;1092;2879;21;63;870;2241;891;2304
220370;202205;9753;25753;8810;24310;271;868;7490;20381;7761;21249
220375;202205;1882;4696;1661;4425;9;13;1592;4266;1601;4279
220380;202205;1772;3682;1437;3219;14;41;1284;2832;1298;2873
220385;202205;1009;2160;822;1848;7;13;732;1619;739;1632
220390;202205;12946;29824;10240;25929;1928;4817;5049;13130;6977;17947
220400;202205;1686;3719;1286;3116;20;68;990;2275;1010;2343
220410;202205;1349;3416;1099;3004;29;91;908;2440;937;2531
220415;202205;934;2245;764;1962;21;46;604;1516;625;1562
220420;202205;2149;5743;1723;4940;75;254;1266;3543;1341;3797
220430;202205;3251;7222;2917;6775;55;143;2622;5963;2677;6106
220435;202205;2237;5005;1937;4554;38;116;1662;3797;1700;3913
220440;202205;3519;8541;2999;7788;61;293;2655;6553;2716;6846
220450;202205;2995;7002;2479;6364;51;191;2194;5555;2245;5746
220455;202205;1486;4042;1423;3960;9;48;1304;3623;1313;3671
220460;202205;1243;2672;1152;2553;46;76;996;2182;1042;2258
220465;202205;2602;7481;2270;6980;157;461;1753;5468;1910;5929
220470;202205;4211;10541;3733;9782;152;374;2951;7565;3103;7939
220480;202205;3062;7411;2448;6475;226;446;1639;4370;1865;4816
220490;202205;2791;6416;2387;5922;27;120;2094;5085;2121;5205
220500;202205;3644;8191;3074;7340;114;225;2365;5542;2479;5767
220510;202205;3030;7573;2447;6573;122;276;1948;5261;2070;5537
220515;202205;1990;4274;1826;4046;61;85;1578;3468;1639;3553
220520;202205;5799;13660;5187;12791;112;279;4334;10794;4446;11073
220525;202205;1620;3623;1367;3319;11;39;1261;3049;1272;3088
220527;202205;1731;3958;1476;3594;44;91;1311;3213;1355;3304
220530;202205;1895;3976;1600;3607;193;395;1159;2753;1352;3148
220535;202205;950;2364;881;2260;38;116;713;1776;751;1892
220540;202205;3617;10588;3344;10068;201;592;2700;8141;2901;8733
220545;202205;1661;4499;1513;4275;61;249;1278;3535;1339;3784
220550;202205;9807;28524;8679;26481;457;1587;6565;19605;7022;21192
220551;202205;1652;4140;1445;3800;21;89;1222;3127;1243;3216
220552;202205;1861;4988;1503;4363;24;129;1215;3394;1239;3523
220553;202205;2293;4807;1923;4331;28;62;1728;3867;1756;3929
220554;202205;1085;2472;838;2094;82;157;578;1444;660;1601
220555;202205;3728;7764;3319;7264;35;125;2938;6387;2973;6512
220556;202205;1401;3720;1226;3409;42;183;913;2413;955;2596
220557;202205;1908;5379;1575;4683;117;395;1111;3205;1228;3600
220558;202205;1615;3888;1274;3416;23;98;1074;2784;1097;2882
220559;202205;2063;4625;1746;4142;52;92;1435;3390;1487;3482
220560;202205;2069;4161;1705;3721;28;53;1573;3407;1601;3460
220570;202205;8933;23773;8031;22469;539;1377;6409;17941;6948;19318
220580;202205;7653;19220;6916;18106;105;308;6186;16101;6291;16409
220585;202205;2304;6706;1894;5976;57;187;1526;4823;1583;5010
220590;202205;1633;3936;1343;3524;98;223;1019;2682;1117;2905
220595;202205;3061;7459;2749;7057;75;212;2392;6062;2467;6274
220600;202205;1967;3576;1711;3285;29;50;1581;3008;1610;3058
220605;202205;1700;4686;1459;4260;27;133;1172;3296;1199;3429
220610;202205;3078;8165;2870;7865;20;106;2690;7310;2710;7416
220620;202205;9239;25036;8441;23975;156;746;7696;21528;7852;22274
220630;202205;408;1133;319;977;29;94;200;588;229;682
220635;202205;2046;5602;1819;5157;58;225;1461;4013;1519;4238
220640;202205;2677;6954;2280;6397;85;286;1842;5122;1927;5408
220650;202205;2677;6286;2305;5734;160;278;1756;4499;1916;4777
220660;202205;2872;8391;2409;7619;80;354;1977;6131;2057;6485
220665;202205;1421;3911;1203;3566;31;149;1010;2898;1041;3047
220667;202205;1837;5109;1658;4800;73;257;1352;3843;1425;4100
220669;202205;1824;5037;1731;4904;43;171;1546;4281;1589;4452
220670;202205;2546;5814;2019;5078;38;107;1749;4381;1787;4488
220672;202205;3733;8460;3063;7658;95;328;2713;6628;2808;6956
220675;202205;1483;3735;1319;3455;77;212;996;2579;1073;2791
220680;202205;3443;7770;3284;7570;257;358;2864;6839;3121;7197
220690;202205;1779;4335;1540;3975;124;316;1147;2946;1271;3262
220695;202205;1063;2685;981;2544;21;53;835;2146;856;2199
220700;202205;13320;27491;10944;24406;541;1138;8660;18837;9201;19975
220710;202205;1010;2510;733;2030;22;72;560;1493;582;1565
220720;202205;2570;5343;2310;5012;20;62;2065;4383;2085;4445
220730;202205;1452;3759;1238;3431;18;82;1060;2857;1078;2939
220735;202205;1160;2416;892;2017;37;85;704;1549;741;1634
220740;202205;1542;3686;1233;3276;47;121;1018;2742;1065;2863
220750;202205;4742;10419;4172;9656;191;380;3731;8636;3922;9016
220755;202205;1692;3577;1416;3182;20;62;1200;2619;1220;2681
220760;202205;3935;8831;3464;8222;53;169;3251;7678;3304;7847
220770;202205;28888;77818;24778;71173;6418;18859;10632;31490;17050;50349
220775;202205;1507;3267;1355;3083;6;26;1314;2956;1320;2982
220777;202205;1774;4225;1378;3626;57;110;995;2704;1052;2814
220779;202205;1368;3411;1181;3129;27;94;1010;2630;1037;2724
220780;202205;6530;14847;5844;13888;307;776;4669;10947;4976;11723
220785;202205;1649;3346;1450;3100;12;32;1377;2914;1389;2946
220790;202205;11662;29963;10438;28261;232;939;8914;23772;9146;24711
220793;202205;1112;2570;895;2215;13;25;760;1872;773;1897
220795;202205;1549;3690;1344;3402;21;74;1194;2997;1215;3071
220800;202205;23690;46180;20438;42018;1114;2020;16273;32877;17387;34897
220810;202205;3379;8737;2849;7863;73;187;2323;6399;2396;6586
220820;202205;6547;14427;5767;13334;273;536;4806;10991;5079;11527
220830;202205;8252;19930;7320;18629;315;865;5988;14972;6303;15837
220840;202205;14473;39334;12194;35122;2266;6037;6846;19910;9112;25947
220850;202205;3447;9821;3069;9348;64;296;2743;8354;2807;8650
220855;202205;942;1926;833;1791;16;51;762;1616;778;1667
220860;202205;1247;2711;1091;2488;18;67;1014;2267;1032;2334
220865;202205;2580;6551;1992;5537;53;224;1507;4030;1560;4254
220870;202205;3705;8728;3082;7939;34;152;2824;7179;2858;7331
220880;202205;7094;13752;6188;12649;135;304;5686;11537;5821;11841
220885;202205;1686;4361;1408;3940;83;230;1107;3103;1190;3333
220887;202205;1799;3526;1506;3151;28;47;1390;2892;1418;2939
220890;202205;1591;4406;1373;4100;62;201;1115;3326;1177;3527
220900;202205;2471;5072;2079;4562;31;69;1852;3975;1883;4044
220910;202205;1938;4484;1649;4066;205;330;1242;3226;1447;3556
220915;202205;1051;2661;840;2293;14;51;628;1623;642;1674
220920;202205;1710;4717;1472;4413;76;276;1235;3698;1311;3974
220930;202205;2229;4978;1880;4516;17;60;1718;4141;1735;4201
220935;202205;1206;3272;959;2758;20;85;629;1702;649;1787
220937;202205;1666;4075;1410;3667;41;122;1111;2836;1152;2958
220940;202205;2037;4655;1671;4055;30;109;1398;3244;1428;3353
220945;202205;560;1740;445;1536;21;119;303;1015;324;1134
220950;202205;1566;3396;1053;2629;16;42;845;2013;861;2055
220955;202205;1786;4208;1476;3698;26;69;1254;3101;1280;3170
220960;202205;850;2086;623;1710;35;106;400;1028;435;1134
220965;202205;1997;4945;1737;4581;29;126;1501;3856;1530;3982
220970;202205;2444;4958;1836;4101;17;51;1622;3516;1639;3567
220975;202205;831;2016;709;1866;9;47;635;1613;644;1660
220980;202205;1363;3450;1212;3253;27;85;1038;2748;1065;2833
220985;202205;1618;3607;1402;3283;76;141;1106;2569;1182;2710
220987;202205;1677;4517;1481;4191;57;206;1232;3421;1289;3627
220990;202205;1865;4817;1629;4463;23;102;1369;3693;1392;3795
220995;202205;1475;3650;1209;3195;18;56;991;2574;1009;2630
220997;202205;2671;7391;2438;7021;53;207;2158;6098;2211;6305
221000;202205;5178;12818;4534;11919;132;475;3882;10056;4014;10531
221005;202205;1726;4092;1565;3830;27;123;1333;3125;1360;3248
221010;202205;1478;2906;1163;2517;44;64;1000;2157;1044;2221
221020;202205;1728;4937;1558;4657;23;91;1211;3589;1234;3680
221030;202205;1871;4088;1594;3757;26;70;1398;3322;1424;3392
221035;202205;1785;4120;1531;3773;27;39;1350;3353;1377;3392
221037;202205;819;2011;692;1797;15;42;517;1255;532;1297
221038;202205;591;1543;459;1318;26;83;321;901;347;984
221039;202205;954;2470;783;2193;27;116;627;1699;654;1815
221040;202205;4928;13091;4268;11995;217;593;3427;9613;3644;10206
221050;202205;5049;10745;4513;10076;96;235;4073;9061;4169;9296
221060;202205;10635;26725;8786;23763;446;1062;6974;18806;7420;19868
221062;202205;1337;3835;1149;3545;64;205;918;2799;982;3004
221063;202205;1311;3231;1134;2980;66;198;910;2332;976;2530
221065;202205;3106;7136;2705;6478;18;58;2404;5668;2422;5726
221070;202205;3755;10791;3039;9330;402;1153;1846;5796;2248;6949
221080;202205;3967;9025;3274;8008;55;185;2730;6466;2785;6651
221090;202205;1594;3682;1319;3271;16;57;1139;2759;1155;2816
221093;202205;1829;4354;1668;4086;154;316;1206;2906;1360;3222
221095;202205;1016;2446;838;2191;21;71;694;1790;715;1861
221097;202205;941;2255;707;1863;16;47;539;1340;555;1387
221100;202205;146121;352680;123112;316288;9317;27073;87686;215685;97003;242758
221110;202205;11459;30843;10450;29559;184;778;9342;26099;9526;26877
221120;202205;5397;14348;4795;13460;160;498;4153;11620;4313;12118
221130;202205;6541;14974;5107;12446;773;1775;3158;7449;3931;9224
221135;202205;2272;4855;1987;4496;70;149;1700;3936;1770;4085
221140;202205;1681;3379;1415;3056;34;70;1275;2710;1309;2780
221150;202205;1255;2904;982;2453;26;120;775;1804;801;1924
221160;202205;833;1935;732;1807;41;64;568;1423;609;1487
221170;202205;1148;2940;1056;2781;7;27;950;2450;957;2477
230010;202205;3484;8445;2859;7410;40;146;2366;5921;2406;6067
230015;202205;3790;10820;3328;9927;171;581;2374;6960;2545;7541
230020;202205;15874;44346;14814;42791;601;1923;12711;36512;13312;38435
230030;202205;14151;33012;11837;30007;352;955;10096;25461;10448;26416
230040;202205;4973;11826;4131;10508;51;216;3517;8764;3568;8980
230050;202205;2938;8625;2268;7153;292;971;1097;3202;1389;4173
230060;202205;2792;6932;2186;5917;36;151;1748;4605;1784;4756
230070;202205;4990;11583;3989;9866;613;1258;2433;6230;3046;7488
230075;202205;10710;30550;9752;28956;545;1927;7888;22990;8433;24917
230080;202205;3575;6768;2748;5759;12;24;2559;5332;2571;5356
230090;202205;5170;11427;4346;10178;170;403;3573;8149;3743;8552
230100;202205;23498;53366;20516;49541;1652;4028;14891;35579;16543;39607
230110;202205;14739;40987;12333;36452;1807;5476;6837;19964;8644;25440
230120;202205;9249;22271;8057;20458;500;1311;6129;15328;6629;16639
230125;202205;3611;8766;2924;7714;85;299;2340;5953;2425;6252
230130;202205;6574;18308;5381;15857;419;1184;3669;10697;4088;11881
230140;202205;3921;10850;3310;9662;98;434;2579;7235;2677;7669
230150;202205;1839;5039;1512;4374;183;504;938;2721;1121;3225
230160;202205;7994;17596;6905;16026;179;446;5915;13430;6094;13876
230170;202205;7149;19043;5795;16378;424;1163;4033;11240;4457;12403
230180;202205;1855;4739;1559;4193;18;80;1267;3271;1285;3351
230185;202205;5090;13042;4292;11771;348;969;3124;8623;3472;9592
230190;202205;16341;44976;13584;39969;1549;4686;8080;23396;9629;28082
230195;202205;6343;16881;5708;15830;358;965;4379;12076;4737;13041
230200;202205;5422;14131;4480;12447;250;703;3361;9146;3611;9849
230205;202205;4877;12718;4257;11861;254;761;3372;9234;3626;9995
230210;202205;12336;26144;10501;23772;486;1100;8423;18600;8909;19700
230220;202205;17123;38673;15008;35737;812;1897;12286;28834;13098;30731
230230;202205;8059;21381;7221;19806;423;1174;5595;15071;6018;16245
230240;202205;15342;36758;13133;33144;559;1428;10558;26186;11117;27614
230250;202205;9967;25887;9176;24722;292;910;7316;19036;7608;19946
230260;202205;17168;45671;14812;41772;2281;6157;8623;24562;10904;30719
230270;202205;8596;21154;6618;17650;855;2038;3884;10754;4739;12792
230280;202205;22627;55280;18598;48809;444;1839;14970;37341;15414;39180
230290;202205;5622;14232;4680;12544;183;521;3708;9690;3891;10211
230300;202205;5450;13394;4868;12606;83;261;4320;11117;4403;11378
230310;202205;5271;14021;4436;12543;176;612;3163;8706;3339;9318
230320;202205;8836;23647;7349;21081;265;1050;5711;15914;5976;16964
230330;202205;5382;13619;4196;11441;139;475;3178;8384;3317;8859
230340;202205;4412;12583;3812;11427;219;750;2775;8063;2994;8813
230350;202205;21156;52025;18460;48255;903;2794;13444;34378;14347;37172
230360;202205;3407;8260;2670;7022;162;396;1944;5053;2106;5449
230365;202205;3519;7817;2900;6929;87;262;2475;5851;2562;6113
230370;202205;76231;184369;65867;170104;5049;14614;48690;122021;53739;136635
230380;202205;7074;18208;5561;15471;132;533;4205;11234;4337;11767
230390;202205;3770;10213;3214;9347;82;357;2540;7215;2622;7572
230393;202205;3839;10195;3058;8668;90;473;2412;6496;2502;6969
230395;202205;6441;16576;5526;15067;516;1352;3681;9966;4197;11318
230400;202205;6282;15765;5500;14564;80;403;4447;11287;4527;11690
230410;202205;14527;41071;11939;36509;874;2884;8313;25419;9187;28303
230420;202205;33647;85104;27668;75335;2796;8005;17134;45305;19930;53310
230423;202205;5226;14459;4565;13220;303;918;3327;9495;3630;10413
230425;202205;6535;18530;5973;17485;558;1634;4272;12396;4830;14030
230426;202205;3075;7545;2260;6052;47;176;1703;4406;1750;4582
230427;202205;2062;5439;1476;4274;148;436;794;2153;942;2589
230428;202205;11265;28241;9649;25941;1458;3836;5648;14959;7106;18795
230430;202205;5531;14540;4376;12574;158;561;3312;9276;3470;9837
230435;202205;7193;16883;5909;14761;810;1888;3522;8758;4332;10646
230440;202205;517617;1151276;439017;1042497;30063;79345;320300;734785;350363;814130
230445;202205;4642;11873;3756;10367;265;726;2496;6663;2761;7389
230450;202205;4202;10922;3663;10162;212;780;2760;7347;2972;8127
230460;202205;2392;6102;2054;5570;61;233;1710;4551;1771;4784
230465;202205;4807;12202;4036;10780;138;440;3119;7978;3257;8418
230470;202205;12533;38231;11242;35953;799;3060;8187;25572;8986;28632
230480;202205;1687;4423;1407;3942;64;279;1082;2847;1146;3126
230490;202205;3129;7974;2629;7054;203;621;1746;4357;1949;4978
230495;202205;6760;17712;5940;16340;755;2028;3653;10017;4408;12045
230500;202205;10103;30602;8893;28461;320;1272;7179;22945;7499;24217
230510;202205;1929;5028;1515;4207;149;428;905;2418;1054;2846
230520;202205;5388;13585;4644;12352;431;992;3298;8729;3729;9721
230523;202205;17934;49725;14338;42520;3163;9182;4210;12831;7373;22013
230526;202205;4452;11199;3770;10109;296;653;2692;7389;2988;8042
230530;202205;6212;18188;5172;16264;876;2781;3187;10026;4063;12807
230533;202205;5376;11155;4253;9486;83;223;3571;7652;3654;7875
230535;202205;5693;15181;4796;13710;353;1107;3215;9153;3568;10260
230540;202205;17122;44624;14598;40884;337;1213;12019;33315;12356;34528
230550;202205;25101;60172;20401;52673;1585;4211;14104;35268;15689;39479
230560;202205;8937;20040;7240;17501;160;374;6146;14886;6306;15260
230565;202205;3490;8918;2906;7881;100;352;2299;6077;2399;6429
230570;202205;3758;9019;3179;8233;80;241;2617;6690;2697;6931
230580;202205;13790;31069;11872;28410;678;1293;9670;23204;10348;24497
230590;202205;10540;27573;8749;24494;551;1622;6480;17698;7031;19320
230600;202205;4256;9897;3304;8308;146;312;2272;5747;2418;6059
230610;202205;7579;19101;6688;17643;475;1241;5233;13742;5708;14983
230620;202205;2333;5882;1812;4917;101;319;1166;2987;1267;3306
230625;202205;10242;26054;8728;23485;1925;5311;3922;10328;5847;15639
230630;202205;13467;34342;11839;31439;1272;3085;8025;21369;9297;24454
230640;202205;30394;86715;27416;81969;1242;4807;22223;65034;23465;69841
230650;202205;5964;14815;5030;13282;144;588;4161;10571;4305;11159
230655;202205;10569;32486;9913;31427;671;2155;8095;25762;8766;27917
230660;202205;6696;18624;5409;16375;181;855;4320;12764;4501;13619
230670;202205;6866;15169;4987;12281;155;417;3976;9478;4131;9895
230680;202205;3120;7811;2602;6947;160;355;1819;4846;1979;5201
230690;202205;7859;21798;6691;19604;400;1349;4420;12697;4820;14046
230700;202205;12052;27625;9625;23367;519;1196;7245;17173;7764;18369
230710;202205;7603;22527;6662;20613;596;1845;4584;14028;5180;15873
230720;202205;2197;5999;1815;5314;143;378;1232;3545;1375;3923
230725;202205;5141;13754;4625;12896;372;1195;3164;8511;3536;9706
230730;202205;67476;166231;53060;145760;11897;32265;19515;57374;31412;89639
230740;202205;6860;17884;5758;16142;178;533;4564;12742;4742;13275
230750;202205;9423;23494;7749;20783;174;594;6195;16135;6369;16729
230760;202205;12989;31405;11216;28799;462;1462;8581;21298;9043;22760
230763;202205;5530;13890;4554;12254;101;443;3659;9477;3760;9920
230765;202205;47997;120036;40288;108269;4711;13471;24319;63064;29030;76535
230770;202205;32360;68315;27507;62239;2049;4635;20660;45760;22709;50395
230780;202205;7311;23628;6573;21952;836;2743;3963;13394;4799;16137
230790;202205;3500;9086;3121;8508;129;467;2414;6287;2543;6754
230800;202205;9707;27943;8476;25593;1128;3389;4976;14718;6104;18107
230810;202205;12110;34493;10755;32315;482;1664;8348;24625;8830;26289
230820;202205;3978;11913;3296;10509;310;1153;2066;6239;2376;7392
230830;202205;8717;21639;7390;19535;213;651;6068;15548;6281;16199
230835;202205;4648;10376;3611;8817;133;316;2889;6926;3022;7242
230837;202205;3880;10079;3468;9410;93;351;2915;7655;3008;8006
230840;202205;10814;29249;9308;26727;764;2161;6887;19608;7651;21769
230850;202205;11448;29509;9643;26255;477;1343;7240;19383;7717;20726
230860;202205;6951;14445;5835;12905;73;200;5256;11369;5329;11569
230870;202205;19712;42384;16985;38041;880;1721;13656;30248;14536;31969
230880;202205;2288;6469;2092;6160;64;286;1638;4666;1702;4952
230890;202205;5050;14894;4556;14013;258;897;3380;10171;3638;11068
230900;202205;3689;9568;3125;8521;138;481;2277;5923;2415;6404
230910;202205;3740;8926;2916;7717;66;253;2386;6257;2452;6510
230920;202205;5397;13880;4393;12253;110;432;3410;9177;3520;9609
230930;202205;7801;20239;6401;17800;313;901;4460;12170;4773;13071
230940;202205;9429;21544;8188;19741;163;415;7007;16667;7170;17082
230945;202205;7278;19444;6183;17483;306;1002;4474;12246;4780;13248
230950;202205;7016;16270;6181;15150;132;345;5293;12914;5425;13259
230960;202205;15017;40148;13036;36570;2042;5764;6756;18524;8798;24288
230970;202205;17114;41608;14568;37825;1391;3767;9743;24628;11134;28395
230980;202205;3502;8562;3061;7845;308;730;2120;5489;2428;6219
230990;202205;1891;4952;1565;4329;73;270;1132;2970;1205;3240
231000;202205;2963;7348;2359;6205;87;252;1775;4465;1862;4717
231010;202205;4461;8896;3535;7455;22;99;3187;6482;3209;6581
231020;202205;9706;26747;8596;24764;1179;3129;5478;16093;6657;19222
231025;202205;8932;21890;7830;20206;548;1358;6070;15494;6618;16852
231030;202205;8261;22980;6365;19184;884;2552;3604;10845;4488;13397
231040;202205;3453;8670;2967;7837;74;250;2469;6277;2543;6527
231050;202205;13576;31525;11125;27431;503;1343;8663;20602;9166;21945
231060;202205;3239;8337;2875;7786;83;289;2299;6270;2382;6559
231070;202205;9047;24354;7771;22141;618;1880;5362;14999;5980;16879
231080;202205;4391;11524;3638;10290;185;647;2654;7364;2839;8011
231085;202205;8167;17993;6560;16130;225;548;5275;12811;5500;13359
231090;202205;4955;12171;3621;9665;127;486;2538;6445;2665;6931
231095;202205;2474;6990;1970;5945;194;573;1296;3893;1490;4466
231100;202205;3531;9498;2913;8385;133;460;2198;6199;2331;6659
231110;202205;4153;11302;3817;10709;292;840;2731;7468;3023;8308
231120;202205;2706;7149;2260;6410;103;330;1679;4684;1782;5014
231123;202205;2155;5257;1733;4522;101;260;1232;3158;1333;3418
231126;202205;6243;15873;5093;13769;303;779;3728;9944;4031;10723
231130;202205;26309;59002;21903;53586;1301;3779;16707;39360;18008;43139
231135;202205;4728;12397;3915;10889;190;589;2780;7598;2970;8187
231140;202205;18895;49282;15245;43340;718;2650;11123;30507;11841;33157
231150;202205;6741;17105;4854;13518;733;2075;1980;5515;2713;7590
231160;202205;7625;20893;6769;19363;766;1965;4202;12190;4968;14155
231170;202205;5290;13917;4389;12292;280;855;3148;8450;3428;9305
231180;202205;16929;44045;13803;37968;2378;6543;6837;18467;9215;25010
231190;202205;4606;11947;3629;10212;86;339;2796;7648;2882;7987
231195;202205;5672;15793;4678;13874;298;992;3423;10012;3721;11004
231200;202205;9426;24959;8187;22651;170;788;6822;18011;6992;18799
231210;202205;5507;14783;4641;13343;165;634;3647;10152;3812;10786
231220;202205;15040;34217;11930;28796;565;1333;8930;20705;9495;22038
231230;202205;10594;31511;9323;29241;723;2454;6910;21518;7633;23972
231240;202205;13366;36376;11792;33617;1567;4406;7493;21263;9060;25669
231250;202205;2319;5497;1536;3881;102;237;946;2294;1048;2531
231260;202205;3678;9347;3172;8572;323;748;2181;6023;2504;6771
231270;202205;7242;17404;5865;15199;155;578;4476;11113;4631;11691
231280;202205;1981;5683;1757;5302;149;401;1221;3694;1370;4095
231290;202205;41840;116802;35171;104503;4878;14673;18535;53590;23413;68263
231300;202205;4690;12010;3667;10058;130;446;2571;6772;2701;7218
231310;202205;8816;20530;7047;17451;542;1400;4984;11882;5526;13282
231320;202205;8054;21259;6232;18046;121;447;4871;13946;4992;14393
231325;202205;2819;6686;2268;5851;181;330;1617;4199;1798;4529
231330;202205;11634;31307;9680;27661;1496;3899;5786;16911;7282;20810
231335;202205;6249;15505;5213;13895;130;475;4461;11728;4591;12203
231340;202205;20832;58745;18679;55145;1371;4114;14111;41859;15482;45973
231350;202205;18126;45342;16479;43027;291;961;14801;38246;15092;39207
231355;202205;5051;13622;4498;12645;190;629;3593;9878;3783;10507
231360;202205;8917;24713;7717;22744;351;1177;6139;17802;6490;18979
231370;202205;2378;6190;1905;5358;45;134;1452;4035;1497;4169
231375;202205;4572;13387;4090;12588;108;457;3405;10347;3513;10804
231380;202205;6655;16487;5936;15530;173;496;4933;12911;5106;13407
231390;202205;3822;10338;3411;9664;118;483;2560;6977;2678;7460
231395;202205;4780;12787;3993;11573;279;826;2773;7884;3052;8710
231400;202205;11046;29326;9232;26080;302;1285;7126;19447;7428;20732
231410;202205;16971;47485;15408;45089;745;2305;12564;36571;13309;38876
240010;202205;2928;7121;2294;6031;323;836;1189;3058;1512;3894
240020;202205;15181;38158;12708;33982;829;2529;8654;22377;9483;24906
240030;202205;4225;8230;3796;7634;123;306;3375;6539;3498;6845
240040;202205;902;2455;750;2182;21;80;508;1405;529;1485
240050;202205;3818;9563;3003;8109;59;182;2298;6032;2357;6214
240060;202205;1646;4013;1319;3429;39;123;1030;2605;1069;2728
240070;202205;2884;7398;2553;6728;192;539;1858;4687;2050;5226
240080;202205;3298;8283;2616;7125;112;355;1894;5058;2006;5413
240090;202205;2517;5744;2056;4998;21;56;1741;4144;1762;4200
240100;202205;12437;27268;9974;23190;264;763;8006;17703;8270;18466
240110;202205;5266;13810;4389;12240;166;606;3314;8910;3480;9516
240120;202205;3844;10084;3197;9256;242;826;2306;6555;2548;7381
240130;202205;4425;8196;3615;7167;48;92;3250;6360;3298;6452
240140;202205;2020;5744;1710;5192;197;666;1076;3196;1273;3862
240145;202205;7657;19967;6217;17553;705;2076;3938;10937;4643;13013
240150;202205;1141;2977;983;2674;50;170;756;1991;806;2161
240160;202205;1643;4532;1356;4006;34;146;994;2890;1028;3036
240165;202205;1094;2737;915;2412;26;91;763;1958;789;2049
240170;202205;3174;7639;2666;6783;303;760;1725;4341;2028;5101
240180;202205;3424;9514;2745;8155;613;1731;1241;3840;1854;5571
240185;202205;1485;4236;1342;3981;42;166;1073;3082;1115;3248
240190;202205;1255;3228;1064;2942;26;101;879;2425;905;2526
240200;202205;14060;31678;11434;27439;1283;3065;6997;16206;8280;19271
240210;202205;3904;8466;3198;7363;35;159;2781;6128;2816;6287
240220;202205;8310;23404;7402;22004;484;1723;5730;16837;6214;18560
240230;202205;6671;15576;5274;13355;265;597;3964;10120;4229;10717
240240;202205;1977;5426;1339;4045;157;488;459;1229;616;1717
240250;202205;3548;8261;3069;7591;55;221;2620;6267;2675;6488
240260;202205;16804;45489;14524;41793;4155;11331;6655;20823;10810;32154
240270;202205;2712;7400;2317;6743;117;353;1684;4988;1801;5341
240280;202205;1888;4486;1569;3977;67;171;1237;3085;1304;3256
240290;202205;1309;3548;1055;3046;38;159;736;1967;774;2126
240300;202205;2551;6148;1862;4943;102;270;1159;3001;1261;3271
240310;202205;9521;23902;7573;20544;938;2543;4015;10698;4953;13241
240320;202205;2196;5672;1525;4367;78;265;1085;2984;1163;3249
240325;202205;38208;93426;31239;82123;4133;11812;17602;44248;21735;56060
240330;202205;2040;5176;1567;4323;68;250;1097;2854;1165;3104
240340;202205;2383;4821;1933;4176;53;132;1622;3363;1675;3495
240350;202205;2817;6088;2510;5741;30;99;2321;5247;2351;5346
240360;202205;12554;31277;11190;29234;1701;3935;7208;19207;8909;23142
240370;202205;2488;5566;1923;4556;98;254;1409;3142;1507;3396
240375;202205;1063;2481;882;2184;35;115;693;1630;728;1745
240380;202205;2602;6776;1995;5530;205;536;1126;3078;1331;3614
240390;202205;1136;2587;784;1943;32;62;515;1188;547;1250
240400;202205;1679;3818;1267;3152;43;150;912;2114;955;2264
240410;202205;657;1840;533;1607;51;175;325;937;376;1112
240420;202205;5460;17035;4849;15857;445;1794;3252;10213;3697;12007
240430;202205;4030;9432;3359;8327;121;405;2625;6222;2746;6627
240440;202205;3112;6459;2657;5826;235;435;1993;4383;2228;4818
240450;202205;5005;12835;3959;10974;356;1132;2398;6300;2754;7432
240460;202205;3803;9253;3392;8619;270;627;2746;7020;3016;7647
240470;202205;3919;11228;2983;9322;567;1632;1426;4657;1993;6289
240480;202205;658;1672;424;1181;26;67;215;563;241;630
240485;202205;2451;6417;1971;5595;149;444;1311;3699;1460;4143
240490;202205;1831;4263;1412;3548;84;166;1002;2501;1086;2667
240500;202205;2352;6062;2021;5508;112;313;1606;4342;1718;4655
240510;202205;1852;4679;1587;4283;82;262;1260;3322;1342;3584
240520;202205;1811;3829;1373;3252;98;196;1061;2534;1159;2730
240530;202205;2660;6603;2357;6121;81;222;1994;5042;2075;5264
240540;202205;2647;5995;2352;5554;47;129;2094;4900;2141;5029
240550;202205;941;2182;840;2014;14;52;746;1735;760;1787
240560;202205;4234;9268;3628;8483;180;370;2964;6896;3144;7266
240570;202205;3090;7794;2090;5684;307;836;743;1875;1050;2711
240580;202205;9574;25467;8442;23526;578;1637;6762;18753;7340;20390
240590;202205;989;2063;849;1856;7;21;707;1486;714;1507
240600;202205;2019;5078;1480;4041;52;155;1021;2639;1073;2794
240610;202205;5202;12341;4449;11052;182;495;3406;8121;3588;8616
240615;202205;1438;3435;1150;2962;104;271;811;2012;915;2283
240620;202205;2119;5383;1812;4871;86;274;1483;3923;1569;4197
240630;202205;2452;6025;2198;5621;288;491;1532;4138;1820;4629
240640;202205;1056;2588;833;2220;31;101;635;1634;666;1735
240650;202205;4623;12364;3910;10976;301;830;2732;7639;3033;8469
240660;202205;3828;8361;3434;7853;53;136;3171;7172;3224;7308
240670;202205;2862;7271;2278;6128;170;492;1529;3942;1699;4434
240680;202205;1802;4333;1434;3715;51;157;1122;2800;1173;2957
240690;202205;1304;2919;1018;2443;27;100;836;1893;863;1993
240700;202205;2706;7466;2162;6487;106;341;1614;4796;1720;5137
240710;202205;20549;46763;17486;41947;1614;3868;12635;29440;14249;33308
240720;202205;5885;13687;5013;12474;541;1315;3406;8468;3947;9783
240725;202205;1270;3372;975;2838;48;138;640;1799;688;1937
240730;202205;2606;6642;2043;5615;74;232;1553;4158;1627;4390
240740;202205;2138;5455;1715;4626;70;219;1218;3096;1288;3315
240750;202205;2525;7666;2132;6837;258;897;1251;3992;1509;4889
240760;202205;1937;4064;1401;3274;97;146;1075;2570;1172;2716
240770;202205;3678;9339;3092;8535;139;481;2525;6841;2664;7322
240780;202205;5647;14476;4727;12990;676;1778;3010;8332;3686;10110
240790;202205;1010;2610;826;2294;26;116;614;1620;640;1736
240800;202205;62070;133691;49534;115685;5176;12415;31025;69115;36201;81530
240810;202205;110121;259277;94873;235732;8353;22085;67729;163435;76082;185520
240820;202205;6627;18314;5788;16844;721;2118;3729;10906;4450;13024
240830;202205;9762;25875;8529;24069;323;1141;6871;19105;7194;20246
240840;202205;1229;2890;986;2510;43;94;687;1706;730;1800
240850;202205;1603;4088;1122;3106;98;269;621;1630;719;1899
240860;202205;1599;3794;1211;3131;45;136;944;2356;989;2492
240870;202205;1207;2860;915;2378;143;366;491;1303;634;1669
240880;202205;1423;4277;1238;3918;108;415;900;2799;1008;3214
240890;202205;5534;13608;4339;11491;472;1375;2593;6385;3065;7760
240895;202205;3256;9200;2946;8701;312;875;2213;6690;2525;7565
240910;202205;3958;9887;3285;8714;62;220;2668;6866;2730;7086
240920;202205;1169;2691;938;2357;101;182;580;1497;681;1679
240930;202205;4168;8701;3403;7754;233;354;2365;5829;2598;6183
240933;202205;1812;4232;1515;3819;41;155;1303;3194;1344;3349
240940;202205;7853;17213;6240;14650;656;1476;4011;9040;4667;10516
240950;202205;1239;3411;1066;3081;38;152;849;2351;887;2503
240960;202205;755;2100;675;1941;17;60;528;1470;545;1530
240970;202205;2183;5019;1761;4350;70;241;1453;3454;1523;3695
240980;202205;4299;10588;3871;9900;84;365;3360;8269;3444;8634
240990;202205;3160;7785;2784;7134;243;729;2030;4916;2273;5645
241000;202205;1083;2597;836;2161;15;49;647;1589;662;1638
241010;202205;3392;9553;3067;8915;157;543;2400;6774;2557;7317
241020;202205;2398;5938;1816;4830;103;316;1281;3232;1384;3548
241025;202205;1911;5137;1542;4502;48;184;1107;3132;1155;3316
241030;202205;2768;8178;2226;7078;260;764;1422;4537;1682;5301
241040;202205;2387;7063;2060;6511;88;398;1567;4914;1655;5312
241050;202205;1601;4156;1283;3586;38;134;938;2544;976;2678
241060;202205;915;2346;784;2083;47;109;533;1375;580;1484
241070;202205;791;1963;654;1744;20;54;500;1283;520;1337
241080;202205;1272;3391;981;2797;43;138;683;1898;726;2036
241090;202205;2306;6132;1852;5360;83;345;1395;3895;1478;4240
241100;202205;1340;3470;1013;2822;44;110;691;1870;735;1980
241105;202205;1135;3151;913;2746;194;609;393;1177;587;1786
241110;202205;1070;2808;803;2259;49;137;514;1374;563;1511
241120;202205;8298;22191;6970;19970;831;2336;4353;12686;5184;15022
241140;202205;3756;9339;2876;7634;127;394;2117;5416;2244;5810
241142;202205;862;2202;644;1817;35;110;387;1018;422;1128
241150;202205;6627;15941;5819;14715;244;587;4545;11388;4789;11975
241160;202205;1330;3432;1031;2891;165;497;570;1509;735;2006
241170;202205;1507;3622;1267;3209;32;107;1042;2530;1074;2637
241180;202205;1168;2773;862;2221;81;218;476;1154;557;1372
241190;202205;1341;3206;1117;2793;16;60;824;1958;840;2018
241200;202205;25947;59899;22815;55046;2579;6430;15338;35668;17917;42098
241210;202205;1734;4247;1269;3402;106;309;750;1956;856;2265
241220;202205;10732;28251;9420;26153;1930;5279;4773;13553;6703;18832
241230;202205;3304;8027;2884;7400;115;308;2388;6045;2503;6353
241240;202205;1369;3623;843;2513;93;283;290;827;383;1110
241250;202205;6674;16906;5360;14618;162;698;4122;10656;4284;11354
241255;202205;2949;8026;2562;7321;148;508;1915;5291;2063;5799
241260;202205;5583;13457;4483;11694;142;476;3543;8941;3685;9417
241270;202205;1813;5006;1504;4430;122;370;1047;3059;1169;3429
241280;202205;2852;6010;2482;5373;85;188;2122;4493;2207;4681
241290;202205;3665;8355;2677;6802;78;222;2110;5206;2188;5428
241300;202205;1696;4271;1368;3722;34;124;912;2388;946;2512
241310;202205;2554;5567;2203;5081;72;123;1892;4351;1964;4474
241320;202205;1084;3283;931;2995;100;352;574;1816;674;2168
241330;202205;1981;4664;1566;4118;20;80;1380;3602;1400;3682
241335;202205;4072;10340;3575;9478;122;381;2951;7647;3073;8028
241340;202205;1861;4707;1484;3980;179;566;837;2059;1016;2625
241350;202205;2472;6181;2139;5612;118;320;1642;4234;1760;4554
241355;202205;1564;3845;1266;3290;53;105;934;2409;987;2514
241360;202205;2319;5576;1705;4391;56;163;1258;3093;1314;3256
241370;202205;1532;3852;1189;3173;76;225;842;2107;918;2332
241380;202205;799;1978;627;1688;72;182;345;915;417;1097
241390;202205;3008;8203;2644;7668;168;503;2037;5931;2205;6434
241400;202205;4169;10679;3650;9915;212;681;2826;7550;3038;8231
241410;202205;2774;7702;2249;6673;245;773;1406;4122;1651;4895
241415;202205;2074;5256;1752;4667;51;194;1406;3574;1457;3768
241420;202205;3181;8600;2839;8049;452;1401;1825;5100;2277;6501
241430;202205;796;1881;505;1341;19;50;332;822;351;872
241440;202205;9308;25949;8332;24308;316;1060;6725;19357;7041;20417
241445;202205;1551;3313;1352;3051;54;101;1181;2679;1235;2780
241450;202205;3289;7281;2730;6427;276;564;2000;4736;2276;5300
241460;202205;4408;11079;3535;9359;245;681;2408;6104;2653;6785
241470;202205;1571;3927;1279;3493;37;132;1050;2825;1087;2957
241475;202205;1413;3575;1100;3017;23;90;822;2124;845;2214
241480;202205;3455;9923;2838;8649;769;2281;1044;3460;1813;5741
241490;202205;839;1751;606;1406;15;35;485;1097;500;1132
241500;202205;909;2274;827;2181;8;19;767;2029;775;2048
250010;202205;2979;8212;2467;7184;61;230;1835;5165;1896;5395
250020;202205;1813;4476;1340;3613;70;149;992;2646;1062;2795
250030;202205;7764;19972;6791;18502;779;2204;4815;12876;5594;15080
250040;202205;5256;13857;4592;12724;552;1514;3113;8517;3665;10031
250050;202205;4168;10184;3732;9633;156;451;3140;8097;3296;8548
250053;202205;1465;3737;1331;3539;123;281;951;2531;1074;2812
250057;202205;816;2406;745;2302;8;38;682;2107;690;2145
250060;202205;6494;15434;5783;14508;323;792;4758;11866;5081;12658
250070;202205;4502;11661;3749;10407;51;211;3002;8090;3053;8301
250073;202205;909;2185;744;1923;10;29;604;1524;614;1553
250077;202205;2967;6623;2306;5605;40;134;1926;4538;1966;4672
250080;202205;6296;13407;5253;12134;61;232;4737;10748;4798;10980
250090;202205;4191;8700;3671;8036;67;173;3240;6900;3307;7073
250100;202205;3874;11086;3481;10414;139;523;2768;8056;2907;8579
250110;202205;5440;14210;4920;13496;309;979;3799;10285;4108;11264
250115;202205;851;1887;644;1580;11;41;508;1202;519;1243
250120;202205;2122;5728;1789;5195;29;138;1436;4078;1465;4216
250130;202205;6799;15638;5777;14262;66;290;5062;12176;5128;12466
250135;202205;1530;3710;1327;3368;42;119;1129;2827;1171;2946
250140;202205;2480;6794;2290;6565;101;386;1971;5630;2072;6016
250150;202205;5295;15395;4748;14518;179;711;3825;11409;4004;12120
250153;202205;1565;3866;1276;3442;49;133;1012;2702;1061;2835
250157;202205;2298;5781;2033;5363;56;179;1676;4325;1732;4504
250160;202205;4403;10073;3528;8905;93;225;3003;7542;3096;7767
250170;202205;2151;5124;1926;4808;38;134;1648;4010;1686;4144
250180;202205;25534;54698;21872;50149;736;2213;18070;39928;18806;42141
250190;202205;4876;11714;4092;10613;367;914;2925;7444;3292;8358
250200;202205;2917;5837;2521;5335;49;127;2257;4629;2306;4756
250205;202205;947;2785;802;2556;12;55;640;2029;652;2084
250210;202205;1652;4673;1471;4392;57;256;1160;3358;1217;3614
250215;202205;1825;4661;1541;4273;100;313;881;2468;981;2781
250220;202205;742;1935;589;1696;33;116;400;1113;433;1229
250230;202205;1861;3945;1314;3163;18;60;1043;2427;1061;2487
250240;202205;3116;7717;2763;7140;38;167;2434;6143;2472;6310
250250;202205;5328;13378;4670;12483;229;503;3751;10346;3980;10849
250260;202205;1824;4845;1533;4332;57;165;1191;3362;1248;3527
250270;202205;1366;3824;1243;3674;88;280;908;2778;996;3058
250280;202205;4585;10239;4106;9609;248;456;3234;7654;3482;8110
250290;202205;1914;4450;1617;4016;22;69;1304;3135;1326;3204
250300;202205;6840;15489;6158;14689;168;642;5311;12169;5479;12811
250310;202205;1340;3520;1099;3129;43;130;817;2304;860;2434
250320;202205;14798;29905;12866;27740;188;539;11813;24983;12001;25522
250330;202205;2957;7153;2511;6548;89;288;2146;5433;2235;5721
250340;202205;1421;3126;1227;2871;16;46;1104;2555;1120;2601
250350;202205;4461;11811;3877;10807;304;652;2977;8533;3281;9185
250355;202205;2522;6345;2236;5994;22;99;2060;5499;2082;5598
250360;202205;2048;5025;1826;4731;53;176;1525;3839;1578;4015
250370;202205;16525;37742;13847;33815;267;840;11883;28298;12150;29138
250375;202205;1491;3280;1211;2955;6;22;1132;2769;1138;2791
250380;202205;2031;4482;1872;4293;34;116;1693;3753;1727;3869
250390;202205;2124;4993;1789;4480;126;288;1390;3460;1516;3748
250400;202205;81067;189748;61540;160466;17416;46435;18916;52449;36332;98884
250403;202205;2362;5448;2095;5154;53;294;1742;4018;1795;4312
250407;202205;1592;3452;1232;2920;144;257;771;1991;915;2248
250410;202205;794;1929;682;1748;11;35;567;1393;578;1428
250415;202205;2166;5535;1894;5130;42;150;1620;4327;1662;4477
250420;202205;1390;3429;1244;3233;15;32;1138;2951;1153;2983
250430;202205;8177;17359;7015;15840;423;792;5695;12643;6118;13435
250435;202205;1806;4741;1440;4133;21;93;1089;3018;1110;3111
250440;202205;5081;12758;4395;11877;92;250;3832;10282;3924;10532
250450;202205;2054;4934;1687;4441;79;164;1327;3576;1406;3740
250460;202205;8222;20847;7241;19487;481;1320;5698;15292;6179;16612
250470;202205;1872;4388;1543;3883;45;120;1245;3027;1290;3147
250480;202205;4361;11245;3650;10366;55;180;3160;9023;3215;9203
250485;202205;796;1705;600;1437;61;107;403;942;464;1049
250490;202205;5965;12831;5278;12057;110;358;4736;10562;4846;10920
250500;202205;2277;5877;2015;5439;56;168;1650;4387;1706;4555
250510;202205;6393;14335;5473;13108;118;222;4713;11362;4831;11584
250520;202205;2149;5335;1837;4925;86;269;1428;3740;1514;4009
250523;202205;2610;5697;2287;5270;208;480;1748;3937;1956;4417
250527;202205;1960;4465;1767;4248;15;46;1612;3839;1627;3885
250530;202205;736;1752;627;1595;20;52;516;1270;536;1322
250535;202205;1525;4145;1357;3849;27;119;1083;2965;1110;3084
250540;202205;3841;7366;3238;6707;343;395;2654;5800;2997;6195
250550;202205;866;2623;768;2440;53;176;526;1650;579;1826
250560;202205;1969;5063;1709;4697;38;144;1415;3780;1453;3924
250570;202205;3094;8386;2662;7637;116;370;2066;5840;2182;6210
250580;202205;1171;2882;1033;2697;47;191;869;2177;916;2368
250590;202205;1138;2513;1029;2361;30;75;910;2031;940;2106
250600;202205;8811;22259;7279;20171;260;822;5706;15604;5966;16426
250610;202205;3268;8661;2911;8143;103;368;2401;6646;2504;7014
250620;202205;1017;2293;869;2055;46;122;660;1510;706;1632
250625;202205;2674;7198;2373;6726;46;214;2044;5653;2090;5867
250630;202205;12962;31472;10826;28039;1050;2844;7409;18543;8459;21387
250640;202205;4184;10065;3737;9487;103;321;3227;8109;3330;8430
250650;202205;1210;2584;982;2285;14;54;858;1942;872;1996
250660;202205;1797;4124;1431;3624;34;113;1180;2867;1214;2980
250670;202205;2665;7602;2404;7141;58;235;2083;6049;2141;6284
250680;202205;6714;14271;6043;13517;47;188;5649;12351;5696;12539
250690;202205;8413;16972;7093;15380;188;349;6081;13043;6269;13392
250700;202205;5177;13558;4519;12566;732;1933;2772;7843;3504;9776
250710;202205;4852;13197;4226;12329;282;926;3128;9048;3410;9974
250720;202205;3159;7902;2812;7425;54;209;2524;6566;2578;6775
250730;202205;5092;11943;4488;11145;149;509;3834;9212;3983;9721
250740;202205;2313;5286;1906;4745;122;285;1448;3602;1570;3887
250750;202205;128805;293850;110068;268158;7864;20842;82107;194885;89971;215727
250760;202205;3263;6624;2911;6099;39;139;2630;5313;2669;5452
250770;202205;4566;12697;4083;12055;533;1409;2823;8624;3356;10033
250780;202205;2061;5050;1739;4495;66;189;1389;3499;1455;3688
250790;202205;2904;7844;2523;7297;96;384;1970;5523;2066;5907
250800;202205;2752;6786;2384;6214;106;214;1903;4964;2009;5178
250810;202205;1606;3663;1338;3298;108;184;1052;2678;1160;2862
250820;202205;2258;5729;2071;5519;39;125;1866;4942;1905;5067
250830;202205;6970;19211;5744;16812;235;851;4039;11285;4274;12136
250840;202205;844;2537;737;2335;35;130;548;1747;583;1877
250850;202205;1981;5437;1757;5056;36;171;1459;4077;1495;4248
250855;202205;1196;3078;1047;2860;46;142;843;2259;889;2401
250860;202205;3959;10555;3283;9467;483;1378;1857;5326;2340;6704
250870;202205;1168;2944;983;2652;36;114;788;2081;824;2195
250880;202205;1869;4433;1544;3952;119;296;1140;2891;1259;3187
250890;202205;12901;28385;11364;26461;321;1283;9752;21502;10073;22785
250900;202205;3623;8590;3183;7869;74;220;2762;6645;2836;6865
250905;202205;2755;7186;2532;6890;43;145;2302;6259;2345;6404
250910;202205;7889;16635;6674;15294;88;278;5982;13574;6070;13852
250915;202205;2521;5242;1821;4488;24;54;1618;4013;1642;4067
250920;202205;4269;9727;3809;9059;257;519;3133;7357;3390;7876
250930;202205;2687;6596;2408;6247;83;262;1997;5090;2080;5352
250933;202205;1443;3844;1262;3532;46;171;994;2694;1040;2865
250937;202205;894;2208;746;1980;26;81;603;1598;629;1679
250939;202205;2269;5233;1981;4871;56;133;1625;3926;1681;4059
250940;202205;4548;10973;3969;10214;43;123;3547;9054;3590;9177
250950;202205;1941;4723;1555;4212;38;146;1248;3303;1286;3449
250960;202205;1257;3437;1108;3203;30;133;908;2534;938;2667
250970;202205;9676;23030;8471;21112;203;594;7070;17091;7273;17685
250980;202205;2748;6667;2489;6313;20;92;2175;5350;2195;5442
250990;202205;2411;6696;2043;6081;85;326;1572;4547;1657;4873
251000;202205;2264;5974;1825;5231;45;180;1476;4193;1521;4373
251010;202205;2894;7503;2584;7036;39;159;2259;6085;2298;6244
251020;202205;1753;4565;1573;4292;37;165;1362;3612;1399;3777
251030;202205;1155;2886;940;2507;60;151;629;1656;689;1807
251040;202205;2108;5363;1790;4848;31;132;1515;4040;1546;4172
251050;202205;1148;3058;961;2703;50;178;687;1850;737;2028
251060;202205;1247;2467;944;2087;31;65;710;1556;741;1621
251065;202205;534;1388;390;1112;10;38;283;759;293;797
251070;202205;844;1983;703;1781;15;49;598;1472;613;1521
251080;202205;23502;53503;19274;47410;3199;7526;11062;27957;14261;35483
251090;202205;3199;8570;2700;7708;64;188;2195;6182;2259;6370
251100;202205;913;2743;790;2497;25;101;619;1866;644;1967
251110;202205;2050;4999;1702;4377;120;259;1232;3135;1352;3394
251120;202205;8741;21937;7331;20228;496;1516;5466;14928;5962;16444
251130;202205;5357;9643;4649;8870;44;104;4346;8143;4390;8247
251140;202205;4666;12344;4124;11587;86;305;3355;9343;3441;9648
251150;202205;3066;8289;2793;7860;72;336;2377;6505;2449;6841
251160;202205;2631;6705;2281;6190;31;155;2029;5373;2060;5528
251170;202205;1993;4698;1747;4386;24;91;1570;3840;1594;3931
251180;202205;3150;7474;2597;6723;210;460;1840;4837;2050;5297
251190;202205;5351;12366;4820;11771;56;255;4364;10387;4420;10642
251200;202205;5081;13250;4466;12472;104;304;3878;10850;3982;11154
251203;202205;1115;3339;1014;3115;45;145;722;2182;767;2327
251207;202205;1284;3221;961;2690;21;91;671;1812;692;1903
251210;202205;9212;21094;7513;18789;503;1004;5424;13987;5927;14991
251220;202205;1478;3197;1111;2720;96;190;821;2080;917;2270
251230;202205;5244;13744;4507;12458;119;404;3587;9601;3706;10005
251240;202205;4186;10989;3527;9877;246;626;2467;6876;2713;7502
251250;202205;13101;31557;11494;28912;655;1780;8872;21469;9527;23249
251260;202205;601;1445;537;1347;18;79;434;1035;452;1114
251270;202205;4967;14025;4408;13255;239;701;3434;10645;3673;11346
251272;202205;1485;3760;1362;3605;57;209;1157;2976;1214;3185
251274;202205;987;2600;784;2240;63;184;497;1387;560;1571
251275;202205;1609;3787;1349;3374;69;192;1065;2574;1134;2766
251276;202205;1519;3874;1320;3606;34;146;1057;2780;1091;2926
251278;202205;718;1782;637;1658;37;112;507;1291;544;1403
251280;202205;3099;6736;2835;6369;63;190;2520;5481;2583;5671
251290;202205;8442;16059;7712;15216;276;587;6803;13070;7079;13657
251300;202205;993;2694;885;2531;16;68;753;2140;769;2208
251310;202205;3171;8204;2715;7501;57;257;2266;6080;2323;6337
251315;202205;2102;5970;1887;5563;112;327;1468;4297;1580;4624
251320;202205;1872;4610;1406;3807;39;142;1067;2803;1106;2945
251330;202205;2421;5173;1966;4627;33;86;1728;4050;1761;4136
251335;202205;1233;3200;1108;3018;23;101;996;2653;1019;2754
251340;202205;4372;9439;3478;8285;161;374;2717;6408;2878;6782
251350;202205;1207;3200;1101;3037;33;104;914;2479;947;2583
251360;202205;2134;5325;1682;4679;25;70;1359;3722;1384;3792
251365;202205;897;2180;671;1760;16;41;521;1345;537;1386
251370;202205;28111;69717;23996;64073;3284;8324;15051;40854;18335;49178
251380;202205;1659;3879;1427;3524;28;111;1241;2961;1269;3072
251385;202205;878;2129;681;1785;31;67;470;1195;501;1262
251390;202205;7817;20345;6907;18951;585;1680;4916;13317;5501;14997
251392;202205;1159;2932;980;2652;39;114;764;2055;803;2169
251394;202205;760;1991;609;1731;58;171;410;1126;468;1297
251396;202205;770;1973;651;1771;30;80;441;1157;471;1237
251398;202205;1155;2800;813;2198;25;86;597;1540;622;1626
251400;202205;1597;3317;1276;2890;25;96;1066;2294;1091;2390
251410;202205;1817;3830;1454;3316;14;45;1247;2724;1261;2769
251420;202205;2308;5491;1901;5021;48;165;1513;3894;1561;4059
251430;202205;1721;4819;1547;4518;50;186;1325;3812;1375;3998
251440;202205;1210;3150;984;2741;59;134;734;2094;793;2228
251445;202205;1852;4675;1699;4472;31;134;1463;3736;1494;3870
251450;202205;5021;13593;4474;12765;86;359;3817;10759;3903;11118
251455;202205;999;2774;904;2608;21;79;729;2057;750;2136
251460;202205;1080;2776;882;2472;58;187;671;1848;729;2035
251465;202205;524;1419;444;1273;13;55;336;925;349;980
251470;202205;1337;3475;992;2792;131;384;508;1335;639;1719
251480;202205;1149;2806;904;2400;19;71;678;1710;697;1781
251490;202205;2252;5419;1827;4848;94;257;1377;3629;1471;3886
251500;202205;2319;5876;2108;5596;46;140;1799;4709;1845;4849
251510;202205;2991;8376;2474;7365;93;345;1733;4954;1826;5299
251520;202205;1197;2865;908;2369;90;178;569;1473;659;1651
251530;202205;16639;36447;13467;32554;158;737;11944;28162;12102;28899
251540;202205;3462;9057;3087;8408;65;258;2563;6760;2628;7018
251550;202205;4747;9678;3853;8610;143;242;3165;7130;3308;7372
251560;202205;632;1823;562;1721;42;169;407;1188;449;1357
251570;202205;1074;2835;885;2467;20;104;704;1887;724;1991
251580;202205;2373;5124;2109;4735;35;134;1820;3889;1855;4023
251590;202205;1895;4154;1610;3820;53;128;1381;3173;1434;3301
251593;202205;1084;2982;961;2770;89;290;652;1822;741;2112
251597;202205;2416;6108;2168;5782;16;79;1979;5202;1995;5281
251600;202205;7150;18097;6186;16642;259;732;5045;13398;5304;14130
251610;202205;3609;9460;3154;8680;238;646;2279;6225;2517;6871
251615;202205;1516;3415;1205;2957;21;67;995;2347;1016;2414
251620;202205;23005;46678;17946;40574;165;427;15704;35357;15869;35784
251630;202205;5849;12242;4738;10712;252;529;3687;8058;3939;8587
251640;202205;2503;6230;2223;5815;24;112;2001;5132;2025;5244
251650;202205;5017;11342;4350;10497;160;371;3731;8918;3891;9289
251660;202205;4048;11085;3566;10263;69;305;2984;8399;3053;8704
251670;202205;4987;12141;4404;11370;71;263;3966;10082;4037;10345
251675;202205;968;2151;873;2032;62;136;717;1654;779;1790
251680;202205;3028;7132;2551;6517;74;164;2122;5421;2196;5585
251690;202205;3647;9472;3118;8593;106;310;2389;6523;2495;6833
251700;202205;2508;6512;2065;5900;52;202;1703;4721;1755;4923
251710;202205;899;2180;645;1698;46;128;381;934;427;1062
251720;202205;1487;3911;1187;3406;22;93;925;2558;947;2651
251740;202205;710;1860;572;1614;31;103;421;1148;452;1251
260005;202205;34323;68318;28653;61237;1783;3840;22608;46984;24391;50824
260010;202205;11740;28684;9680;25443;648;1762;5930;15383;6578;17145
260020;202205;7980;16545;6612;14652;85;355;5679;12182;5764;12537
260030;202205;8209;18587;6954;16827;102;385;5901;13888;6003;14273
260040;202205;8555;20010;7230;18216;606;1464;5214;13282;5820;14746
260050;202205;15616;37195;13136;34446;222;693;12175;31900;12397;32593
260060;202205;4883;10766;4182;9698;377;681;3128;7471;3505;8152
260070;202205;13206;28684;11448;26230;259;930;9731;21407;9990;22337
260080;202205;7742;15677;6727;14390;124;343;5798;12061;5922;12404
260090;202205;5857;13593;5189;12715;306;758;4142;10117;4448;10875
260100;202205;3450;8385;2916;7633;50;233;2503;6409;2553;6642
260105;202205;5597;14181;5020;13413;120;492;4266;11095;4386;11587
260110;202205;25187;65091;22378;61070;994;3198;18453;49370;19447;52568
260120;202205;17198;41006;14624;37398;1580;3794;10066;25822;11646;29616
260130;202205;3858;8504;3357;7825;132;303;2676;6061;2808;6364
260140;202205;14834;30288;12848;27971;373;969;11261;24003;11634;24972
260150;202205;4273;8725;3718;8055;107;223;3326;7157;3433;7380
260160;202205;7960;17515;6826;16155;90;269;6298;14843;6388;15112
260170;202205;24987;52741;21476;48166;1102;2485;17528;38659;18630;41144
260180;202205;3973;9670;3390;8865;85;289;2913;7475;2998;7764
260190;202205;23532;41094;20180;37250;164;419;18471;33238;18635;33657
260200;202205;12781;27934;11053;25741;509;1016;9559;22320;10068;23336
260210;202205;12664;33254;10657;30099;371;1245;8533;23898;8904;25143
260220;202205;14105;27615;13100;26401;521;809;11519;23110;12040;23919
260230;202205;14091;28801;12328;26568;319;673;10439;22258;10758;22931
260240;202205;3166;8705;2744;7919;81;334;2164;6087;2245;6421
260250;202205;2665;6164;2293;5615;107;270;1851;4432;1958;4702
260260;202205;15554;35966;13854;33541;857;2066;10844;26184;11701;28250
260270;202205;5568;11220;4941;10513;89;291;4391;9095;4480;9386
260280;202205;14003;38635;12645;36735;365;1603;11059;31400;11424;33003
260290;202205;46884;110226;40512;101473;3730;9503;28973;71681;32703;81184
260300;202205;11627;27572;10023;25354;274;887;8489;21149;8763;22036
260310;202205;7187;15392;6444;14487;446;741;5190;11891;5636;12632
260320;202205;8623;23203;7285;21035;181;665;6033;17247;6214;17912
260330;202205;2847;8085;2457;7299;74;257;1960;5654;2034;5911
260340;202205;2407;5825;2084;5358;25;98;1833;4576;1858;4674
260345;202205;31214;73298;26415;66692;3063;8220;16486;40056;19549;48276
260350;202205;7036;13964;6144;12973;37;118;5684;11808;5721;11926
260360;202205;2842;6805;2530;6251;99;271;1781;4284;1880;4555
260370;202205;6242;16310;5331;14803;208;686;4188;11297;4396;11983
260380;202205;5711;15344;4862;13992;198;613;3768;10709;3966;11322
260390;202205;5265;14738;4296;12841;216;644;2860;8365;3076;9009
260392;202205;4127;11445;3720;10936;76;451;3190;9260;3266;9711
260400;202205;24045;48356;20965;44407;415;1164;17591;35271;18006;36435
260410;202205;89683;200821;72037;176986;13266;33456;35174;87779;48440;121235
260415;202205;5181;12129;4476;11066;54;221;3857;9255;3911;9476
260420;202205;14970;27558;12868;25264;69;229;12207;23647;12276;23876
260430;202205;3088;9024;2605;8103;213;642;1702;5281;1915;5923
260440;202205;4822;10399;4289;9700;44;158;3875;8583;3919;8741
260450;202205;6348;14851;5663;13965;285;580;4787;11896;5072;12476
260460;202205;6178;16394;5268;14875;460;1454;3492;9550;3952;11004
260470;202205;5506;12950;4666;11995;82;235;4247;11008;4329;11243
260480;202205;4469;10706;3778;9767;323;860;2662;6900;2985;7760
260490;202205;6297;12943;5542;11924;38;137;5073;10707;5111;10844
260500;202205;6934;16003;5967;14656;441;1011;4315;10609;4756;11620
260510;202205;12048;26040;10224;23537;115;397;9154;20620;9269;21017
260515;202205;5084;12392;4017;10504;138;442;2917;7158;3055;7600
260520;202205;18425;40044;16024;37039;693;1683;13376;30376;14069;32059
260530;202205;11146;28949;9489;26499;127;630;8331;22794;8458;23424
260540;202205;8819;16780;7879;15632;97;245;7286;14207;7383;14452
260545;202205;108;306;73;228;11;44;26;70;37;114
260550;202205;3581;9021;2891;7901;174;566;1988;5172;2162;5738
260560;202205;6583;15756;5518;14202;139;492;4684;11784;4823;12276
260570;202205;9627;22149;8506;20703;254;735;7379;17605;7633;18340
260580;202205;5563;11438;5023;10747;26;89;4671;9867;4697;9956
260590;202205;8721;16534;7479;15187;127;305;6757;13496;6884;13801
260600;202205;38287;88864;31823;79452;1111;3309;25349;61086;26460;64395
260610;202205;8558;20623;7544;19294;429;1126;5664;14332;6093;15458
260620;202205;22147;49374;19644;46043;1234;3401;15464;34790;16698;38191
260630;202205;2686;6737;2193;5983;57;186;1806;4808;1863;4994
260640;202205;28153;55194;24044;50540;840;1791;20533;42386;21373;44177
260650;202205;7172;16819;5739;15068;525;949;4635;12471;5160;13420
260660;202205;8101;18960;7084;17692;313;873;6193;15225;6506;16098
260670;202205;2595;6273;2111;5516;73;188;1588;3997;1661;4185
260680;202205;34390;75211;29205;68177;2075;5016;21368;48423;23443;53439
260690;202205;3898;9479;3236;8474;79;277;2548;6545;2627;6822
260700;202205;8127;18317;7560;17694;34;165;7351;17144;7385;17309
260710;202205;1559;3747;1324;3410;61;197;1054;2667;1115;2864
260720;202205;31985;68663;27499;63222;1915;4446;21378;48861;23293;53307
260730;202205;9071;23758;7846;22089;209;797;6747;18630;6956;19427
260740;202205;1492;3933;1233;3529;22;82;979;2829;1001;2911
260750;202205;9181;20811;7282;18508;166;372;6359;16617;6525;16989
260760;202205;7325;15103;6394;14036;112;316;5669;12273;5781;12589
260765;202205;9862;25101;8663;23506;551;1744;6320;16712;6871;18456
260770;202205;4419;10357;3633;9096;101;321;2945;7196;3046;7517
260775;202205;6512;15413;5728;14277;164;572;4686;11122;4850;11694
260780;202205;4264;11526;3795;10791;360;1247;2444;6559;2804;7806
260790;202205;149635;308237;126176;279121;15789;34112;86949;189788;102738;223900
260795;202205;3875;8158;3368;7526;128;301;2871;6315;2999;6616
260800;202205;7017;13694;6370;12849;218;407;5613;11081;5831;11488
260805;202205;4227;10661;3615;9660;177;559;2806;7258;2983;7817
260810;202205;7841;18853;6892;17173;335;863;5473;13136;5808;13999
260820;202205;5134;10859;4551;10201;77;249;3912;8629;3989;8878
260825;202205;3385;9219;2974;8532;114;371;2307;6518;2421;6889
260830;202205;5024;13153;4209;11778;482;1116;2809;8077;3291;9193
260840;202205;5380;11632;4841;10923;263;535;4163;9318;4426;9853
260845;202205;5068;12299;4499;11394;212;607;3485;8536;3697;9143
260850;202205;5784;14386;4852;12719;372;1047;3261;8136;3633;9183
260860;202205;3863;10229;3299;9262;94;329;2693;7341;2787;7670
260870;202205;5246;11107;4500;10207;137;318;3970;8979;4107;9297
260875;202205;9528;19968;7882;17655;678;1385;5625;12698;6303;14083
260880;202205;11514;29115;10065;26802;284;921;8469;22113;8753;23034
260890;202205;15435;35503;13367;32495;889;2231;9545;22752;10434;24983
260900;202205;6439;16426;5346;14913;402;1172;3661;10105;4063;11277
260910;202205;3815;9236;3336;8544;111;328;2672;6721;2783;7049
260915;202205;6046;15015;5382;14251;51;227;5024;13210;5075;13437
260920;202205;4006;8399;3439;7799;86;183;3055;6905;3141;7088
260930;202205;4698;12608;4035;11487;170;645;3199;8739;3369;9384
260940;202205;17137;37238;14929;34243;1082;2559;11445;25624;12527;28183
260950;202205;8462;20453;6872;17910;336;1132;4759;11577;5095;12709
260960;202205;92882;183831;77371;164835;6885;14714;55825;115307;62710;130021
260970;202205;6443;15459;5692;14447;412;784;4243;10992;4655;11776
260980;202205;5277;13896;4594;13049;59;168;4159;11895;4218;12063
260990;202205;20190;50814;17052;46572;775;2421;13563;36376;14338;38797
261000;202205;19538;40907;16519;37184;529;1394;13636;29795;14165;31189
261010;202205;2558;6134;2213;5685;106;259;1867;4810;1973;5069
261020;202205;7795;18310;6818;16727;331;850;5611;13405;5942;14255
261030;202205;4663;12375;4103;11436;129;467;3282;8834;3411;9301
261040;202205;6139;16132;5026;14170;172;633;3937;10706;4109;11339
261050;202205;9152;21154;8286;19935;243;535;6957;16525;7200;17060
261060;202205;16733;37930;14561;35382;331;966;12280;29244;12611;30210
261070;202205;79404;161599;66574;145188;5528;11536;49065;105114;54593;116650
261080;202205;7958;17191;7201;16281;130;248;6720;15147;6850;15395
261090;202205;22642;48633;20107;45380;490;1296;17670;39092;18160;40388
261100;202205;9823;24301;8560;22517;647;1617;6419;16837;7066;18454
261110;202205;80714;207394;68246;185656;8332;24212;42814;113751;51146;137963
261120;202205;4345;9681;3778;8912;115;251;3247;7560;3362;7811
261130;202205;8402;18598;7380;17275;133;371;6524;15044;6657;15415
261140;202205;4347;9084;3873;8466;252;524;3028;6523;3280;7047
261150;202205;6364;14622;5602;13545;184;439;4789;11448;4973;11887
261153;202205;2161;6044;1800;5376;75;236;1235;3669;1310;3905
261160;202205;266936;567547;221773;508223;51083;115504;106619;248054;157702;363558
261170;202205;8614;17516;7566;16192;246;478;6573;13768;6819;14246
261180;202205;10684;24602;9313;22864;560;1211;6985;17220;7545;18431
261190;202205;5338;13900;4799;13070;160;690;3952;10383;4112;11073
261200;202205;3988;8190;3490;7556;125;316;2966;6233;3091;6549
261210;202205;2199;4870;1878;4428;109;195;1549;3636;1658;3831
261220;202205;16931;41894;14455;37762;1428;3819;9768;24708;11196;28527
261230;202205;4520;11809;3744;10806;54;205;3149;9113;3203;9318
261240;202205;6887;14560;6104;13431;282;599;5153;11190;5435;11789
261245;202205;4296;10948;3527;9651;69;323;2863;7500;2932;7823
261247;202205;3549;9568;2922;8483;324;854;1871;5534;2195;6388
261250;202205;31017;61787;27470;57753;4406;8355;19245;41810;23651;50165
261255;202205;4617;12537;3761;10930;157;601;2868;8070;3025;8671
261260;202205;17583;37271;15602;34782;282;1020;14371;31209;14653;32229
261270;202205;5872;11788;5188;10989;159;352;4590;9512;4749;9864
261280;202205;2846;7340;2462;6737;99;319;1941;5153;2040;5472
261290;202205;3282;7765;2747;7162;89;298;2276;5931;2365;6229
261300;202205;15464;37523;13243;34068;407;1483;10645;26268;11052;27751
261310;202205;11250;25058;9718;23050;716;1772;7376;17077;8092;18849
261320;202205;6982;17914;6027;16425;68;303;5148;13765;5216;14068
261330;202205;7367;15221;6685;14358;196;473;5896;12423;6092;12896
261340;202205;5648;13181;4991;12363;126;426;4415;10705;4541;11131
261350;202205;9696;26684;8483;24662;189;656;6785;19466;6974;20122
261360;202205;9987;21043;8484;18978;321;801;6966;15030;7287;15831
261370;202205;27858;64348;23619;58822;2199;5393;16439;40618;18638;46011
261380;202205;4905;12803;4161;11564;427;1193;2836;7873;3263;9066
261390;202205;19261;50721;16217;46052;1170;3745;11215;31140;12385;34885
261400;202205;5605;15233;4901;13862;281;876;3738;10190;4019;11066
261410;202205;11330;25374;9381;22514;337;1000;7791;18022;8128;19022
261420;202205;8667;23258;7793;22239;560;1980;6074;17041;6634;19021
261430;202205;4705;10582;4077;9665;56;246;3618;8259;3674;8505
261440;202205;1592;4469;1300;3914;55;245;930;2673;985;2918
261450;202205;16635;40974;14660;38080;553;1416;11703;30429;12256;31845
261460;202205;8982;21947;7758;20103;230;698;6410;16321;6640;17019
261470;202205;4482;10474;3853;9605;45;190;3302;8117;3347;8307
261480;202205;6345;17012;5445;15544;280;955;4311;11984;4591;12939
261485;202205;5933;15293;5207;14238;392;1235;3915;10487;4307;11722
261500;202205;7627;17251;6662;15978;637;1238;4609;11541;5246;12779
261510;202205;2075;5708;1789;5251;75;273;1384;4022;1459;4295
261520;202205;2646;7405;2367;6865;93;317;1769;4999;1862;5316
261530;202205;14053;37019;11498;32721;760;2804;6927;18168;7687;20972
261540;202205;10912;27481;9970;26202;2273;5333;5177;15035;7450;20368
261550;202205;4255;10295;3728;9502;217;643;2806;6891;3023;7534
261560;202205;10650;25506;9350;23673;411;1151;7594;18972;8005;20123
261570;202205;3993;10053;3133;8638;213;645;2149;5773;2362;6418
261580;202205;7770;18699;6732;17300;83;389;6162;15610;6245;15999
261590;202205;3185;7262;2598;6437;92;288;2043;4894;2135;5182
261600;202205;6638;14144;5677;12820;230;529;4586;10061;4816;10590
261610;202205;2455;6739;1973;5863;178;558;1276;3777;1454;4335
261618;202205;3268;6668;2894;6159;105;293;2478;5041;2583;5334
261620;202205;5218;13062;4778;12430;731;1673;3268;8959;3999;10632
261630;202205;6774;18108;5764;16224;451;1441;3802;10214;4253;11655
261640;202205;44978;90062;38647;82534;2119;3642;30715;66355;32834;69997
261650;202205;5157;10852;4407;9939;287;563;3443;7766;3730;8329
270010;202205;4847;15104;4167;13959;166;839;3333;10870;3499;11709
270020;202205;4680;10308;4081;9583;117;459;3573;8001;3690;8460
270030;202205;37242;97115;31270;87818;2418;7156;23126;64177;25544;71333
270040;202205;12151;29256;10385;27178;753;1912;8300;21757;9053;23669
270050;202205;5964;13140;5053;12125;233;477;4480;10818;4713;11295
270060;202205;2486;6017;2106;5566;143;384;1653;4329;1796;4713
270070;202205;5694;13798;4977;12823;104;452;4339;10764;4443;11216
270080;202205;1664;4181;1397;3760;79;202;1067;2813;1146;3015
270090;202205;2005;5627;1817;5287;47;194;1558;4423;1605;4617
270100;202205;7514;15530;6557;14237;175;434;5790;12261;5965;12695
270110;202205;3743;8106;3028;7281;201;348;2401;6029;2602;6377
270120;202205;2851;7388;2481;6900;72;269;2059;5590;2131;5859
270130;202205;5659;13619;4869;12673;193;585;4127;10647;4320;11232
270135;202205;2241;5017;1903;4647;28;121;1755;4233;1783;4354
270140;202205;10349;23381;8307;20604;342;1057;6480;15285;6822;16342
270150;202205;3260;8360;2988;7994;13;63;2843;7549;2856;7612
270160;202205;6207;16242;5319;15183;180;573;4782;13596;4962;14169
270170;202205;3646;10053;3071;9252;196;884;2262;6488;2458;7372
270180;202205;2526;7289;2294;6992;39;204;2040;6120;2079;6324
270190;202205;2505;5555;2267;5281;17;79;2131;4890;2148;4969
270200;202205;2930;8072;2546;7524;254;674;1787;5389;2041;6063
270210;202205;6549;14098;5582;13000;64;226;5174;11866;5238;12092
270220;202205;1889;4472;1531;3964;136;378;1088;2707;1224;3085
270230;202205;10965;27812;9190;25172;861;2395;6726;18261;7587;20656
270235;202205;6643;19257;5783;17907;202;735;4816;14753;5018;15488
270240;202205;13520;32992;11288;30032;977;2679;8512;22517;9489;25196
270250;202205;3420;7570;3043;7052;159;355;2627;6026;2786;6381
270255;202205;5024;13384;4001;11628;133;501;3119;8811;3252;9312
270260;202205;5945;17030;5378;16098;96;500;4698;13784;4794;14284
270270;202205;1177;2840;975;2597;117;275;720;1931;837;2206
270280;202205;4396;9713;3518;8647;239;527;2639;6657;2878;7184
270290;202205;8878;25816;8007;24475;146;721;7155;21567;7301;22288
270300;202205;4654;11311;3611;10173;157;403;2897;8289;3054;8692
270310;202205;7891;20421;6759;18754;146;562;5843;15912;5989;16474
270320;202205;6088;17043;5220;15425;262;917;3905;11094;4167;12011
270330;202205;4754;13845;4193;13027;211;911;3441;10525;3652;11436
270340;202205;1883;4582;1592;4186;79;150;1345;3546;1424;3696
270350;202205;2132;4557;1731;4097;123;296;1298;3062;1421;3358
270360;202205;3469;7279;3124;6890;45;142;2988;6526;3033;6668
270370;202205;1562;4483;1417;4226;34;167;1212;3556;1246;3723
270375;202205;3992;8025;3420;7402;14;46;3284;7068;3298;7114
270380;202205;6244;15525;5307;14382;588;1399;3913;10897;4501;12296
270390;202205;1377;3196;1096;2866;13;67;927;2406;940;2473
270400;202205;7601;17910;6396;16198;209;535;5197;12911;5406;13446
270410;202205;5293;14141;4600;13106;119;436;3950;11170;4069;11606
270420;202205;6997;18180;6337;17253;238;930;5498;14530;5736;15460
270430;202205;162114;358280;127462;314818;19655;49643;71259;176724;90914;226367
270440;202205;5218;13189;4545;12351;120;408;4013;10818;4133;11226
270450;202205;8728;20957;7706;19731;317;774;6563;16983;6880;17757
270460;202205;4340;8908;3695;8128;169;296;3311;7322;3480;7618
270470;202205;13006;33128;11321;30798;579;1767;9099;24540;9678;26307
270480;202205;3410;8225;2876;7489;159;471;2359;6020;2518;6491
270490;202205;1044;2654;908;2490;36;126;757;2029;793;2155
270500;202205;5587;15479;4974;14470;215;791;4093;11642;4308;12433
270510;202205;6896;16104;5769;14715;332;1015;4591;11291;4923;12306
270520;202205;4647;12094;3716;10632;720;2126;1748;5081;2468;7207
270530;202205;1477;3996;1257;3647;61;146;886;2606;947;2752
270540;202205;2524;6439;2131;5934;71;257;1822;5010;1893;5267
270550;202205;7586;18037;6013;16308;540;1377;4535;12522;5075;13899
270560;202205;3332;7964;2779;7225;157;485;2193;5541;2350;6026
270570;202205;5700;13320;4950;12271;474;1120;3854;9486;4328;10606
270580;202205;2650;6785;2397;6439;120;322;2059;5508;2179;5830
270590;202205;1684;4824;1549;4642;15;79;1468;4379;1483;4458
270600;202205;3161;8911;2864;8468;67;278;2544;7429;2611;7707
270610;202205;4181;10093;3662;9423;74;213;3298;8385;3372;8598
270620;202205;1398;3899;1277;3690;29;113;1103;3093;1132;3206
270630;202205;19950;45183;17194;41471;752;2143;14607;34475;15359;36618
270640;202205;6160;16196;5352;14965;169;645;4499;12321;4668;12966
270642;202205;2827;8420;2483;7897;171;680;1895;5891;2066;6571
270644;202205;4349;9939;3626;9027;264;598;2887;7206;3151;7804
270650;202205;3921;10026;3424;9381;240;776;2806;7583;3046;8359
270660;202205;2192;5221;1889;4814;69;211;1492;3674;1561;3885
270670;202205;20974;42468;17805;38671;470;1159;15550;32877;16020;34036
270680;202205;7111;14044;6424;13295;461;543;5689;12224;6150;12767
270690;202205;11316;25585;9453;23219;345;943;7757;18737;8102;19680
270700;202205;621;1724;544;1602;59;175;380;1104;439;1279
270710;202205;6388;17534;5609;16354;358;1162;4432;12759;4790;13921
270720;202205;4295;10968;3826;10214;85;317;3429;8964;3514;9281
270730;202205;9328;18832;8093;17534;999;1232;6201;14891;7200;16123
270740;202205;2531;6433;2221;6077;90;280;1859;5038;1949;5318
270750;202205;6436;15458;5650;14483;103;403;5057;12777;5160;13180
270760;202205;3722;9615;3127;8809;56;254;2648;7343;2704;7597
270770;202205;25050;58392;20435;52639;3123;7558;12852;33949;15975;41507
270780;202205;2216;5212;2047;4999;51;169;1867;4485;1918;4654
270790;202205;1969;4800;1669;4400;132;346;1300;3399;1432;3745
270800;202205;13287;31814;11993;30020;529;1422;10151;25180;10680;26602
270810;202205;3833;9758;3050;8567;181;612;2256;6140;2437;6752
270820;202205;1793;5033;1531;4622;52;235;1242;3689;1294;3924
270830;202205;6001;13291;4895;11965;152;544;4097;9722;4249;10266
270840;202205;9474;26167;8291;24436;241;1034;7087;20358;7328;21392
270850;202205;10040;21726;8854;20362;519;1398;7642;17282;8161;18680
270860;202205;16464;34037;13171;30352;705;1608;10725;24400;11430;26008
270870;202205;2525;6682;2055;5909;213;545;1361;4005;1574;4550
270880;202205;8806;24837;7868;23442;217;944;6548;19031;6765;19975
270890;202205;3724;9412;3148;8608;317;874;2035;5544;2352;6418
270895;202205;4284;10611;3862;10089;65;313;3505;8921;3570;9234
270900;202205;1927;4633;1470;3916;25;97;1182;3065;1207;3162
270910;202205;4636;12399;4013;11479;147;439;3368;9519;3515;9958
270915;202205;10740;28240;8710;25059;741;2525;6054;16785;6795;19310
270920;202205;6947;17839;6232;16824;82;412;5483;14436;5565;14848
270930;202205;20373;43365;15967;38314;2040;4066;11108;28199;13148;32265
270940;202205;7060;17402;5922;16081;197;856;4807;12610;5004;13466
280010;202205;688;1864;543;1570;21;88;383;1019;404;1107
280020;202205;5707;13264;4810;11914;340;868;3636;8768;3976;9636
280030;202205;99960;211610;82325;187595;13745;30905;46773;106265;60518;137170
280040;202205;3509;8601;3073;7986;249;705;2257;5697;2506;6402
280050;202205;4767;12620;4003;11418;836;2353;2034;5852;2870;8205
280060;202205;7831;18099;6343;15976;987;2638;3642;9148;4629;11786
280067;202205;8290;18151;7090;16366;471;877;5266;12023;5737;12900
280070;202205;1995;5721;1841;5487;121;374;1537;4540;1658;4914
280100;202205;4776;11333;4029;10204;492;1114;2627;6854;3119;7968
280110;202205;1814;4023;1559;3663;24;77;1428;3276;1452;3353
280120;202205;8907;22755;7882;21174;929;2245;5691;15551;6620;17796
280130;202205;10212;22025;8908;20274;487;1203;7204;16199;7691;17402
280140;202205;6906;14279;6140;13233;584;1048;4714;10386;5298;11434
280150;202205;4627;10912;4012;10066;472;1068;2916;7340;3388;8408
280160;202205;1455;3712;1240;3377;134;401;840;2193;974;2594
280170;202205;6285;14322;5644;13526;230;602;4771;11253;5001;11855
280190;202205;1686;3183;1509;2959;43;107;1351;2582;1394;2689
280200;202205;1445;3564;1191;3208;84;246;865;2257;949;2503
280210;202205;20005;44609;17422;41039;1867;4325;11787;27258;13654;31583
280220;202205;1899;4671;1606;4292;79;206;1292;3466;1371;3672
280230;202205;4868;11354;3992;10055;276;587;2789;7024;3065;7611
280240;202205;3730;9132;3298;8499;42;204;2876;7195;2918;7399
280250;202205;1078;2289;904;2045;59;157;699;1519;758;1676
280260;202205;2745;5712;2415;5308;44;108;2221;4859;2265;4967
280270;202205;2737;6858;2400;6367;148;420;2004;5252;2152;5672
280280;202205;4378;12291;3878;11568;504;1277;2717;8414;3221;9691
280290;202205;23389;53911;20248;49605;1762;4414;13743;33683;15505;38097
280300;202205;14542;30281;12701;28298;1570;2066;9246;22720;10816;24786
280310;202205;1548;3764;1289;3355;45;140;1000;2520;1045;2660
280320;202205;10029;24711;8661;22699;974;2524;6024;15510;6998;18034
280330;202205;5279;12135;4406;10915;319;729;3268;8028;3587;8757
280340;202205;6154;11937;5147;10824;261;401;4464;9519;4725;9920
280350;202205;33023;67128;29188;62162;1018;2540;24585;50666;25603;53206
280360;202205;6268;16391;5494;15208;623;1882;3497;9627;4120;11509
280370;202205;2662;5701;2160;4887;110;193;1669;3725;1779;3918
280380;202205;1172;2842;984;2595;82;174;695;1864;777;2038
280390;202205;4546;9696;3850;8660;201;419;3162;7002;3363;7421
280400;202205;4672;10347;4075;9585;518;1006;2877;6940;3395;7946
280410;202205;3094;7614;2598;6861;232;636;1675;4248;1907;4884
280420;202205;4978;11868;4508;11288;82;247;4136;10274;4218;10521
280430;202205;2589;5551;2291;5170;72;193;1958;4277;2030;4470
280440;202205;4921;11869;4339;11014;161;541;3707;9119;3868;9660
280445;202205;2584;6277;2308;5832;46;156;1824;4422;1870;4578
280450;202205;11297;25625;9790;23593;2482;5759;4441;11449;6923;17208
280460;202205;8188;17357;7432;16359;432;884;6347;13817;6779;14701
280470;202205;1892;4958;1593;4401;114;304;1143;3103;1257;3407
280480;202205;54680;118755;47599;109146;4519;10725;34078;75893;38597;86618
280490;202205;4079;11057;3435;9955;137;546;2589;7185;2726;7731
280500;202205;1250;2588;1037;2324;24;72;866;1919;890;1991
280510;202205;3544;7026;3098;6432;91;212;2660;5321;2751;5533
280520;202205;2077;4579;1805;4209;134;251;1403;3239;1537;3490
280530;202205;2640;6278;2304;5826;141;350;1806;4534;1947;4884
280540;202205;9642;24197;8690;22860;342;986;7502;19539;7844;20525
280550;202205;7705;16342;6445;14592;132;477;5490;11906;5622;12383
280560;202205;8585;21088;8036;20302;128;454;7237;17928;7365;18382
280570;202205;7298;16341;5935;14695;299;755;4503;11078;4802;11833
280580;202205;6485;15358;5680;14227;452;1014;4436;11061;4888;12075
280590;202205;3166;6877;2697;6326;150;435;2079;4627;2229;5062
280600;202205;4568;10588;4037;9840;186;455;3076;7350;3262;7805
280610;202205;3183;6717;2836;6277;124;289;2427;5218;2551;5507
280620;202205;6829;14675;5861;13452;520;895;4252;10159;4772;11054
280630;202205;4421;11003;4047;10515;210;574;3332;8616;3542;9190
280640;202205;2783;6545;2427;6144;146;296;2106;5413;2252;5709
280650;202205;1368;3375;1135;3035;107;291;799;2070;906;2361
280660;202205;4273;8534;3694;7875;168;278;3188;6803;3356;7081
280670;202205;22727;48944;19660;45014;2017;4525;14261;32450;16278;36975
280680;202205;3308;7198;2848;6546;318;568;1898;4566;2216;5134
280690;202205;1139;2508;959;2280;47;128;795;1824;842;1952
280700;202205;1345;2993;1145;2712;43;111;925;2141;968;2252
280710;202205;17572;35867;14917;32874;1087;1659;12513;28188;13600;29847
280720;202205;3016;6302;2474;5670;81;200;1932;4515;2013;4715
280730;202205;1167;2842;999;2582;85;242;724;1787;809;2029
280740;202205;19405;38246;16830;34592;972;2156;13432;26461;14404;28617
280750;202205;3923;10236;3382;9311;235;660;2431;6581;2666;7241
280760;202205;7902;18295;6796;16773;740;1600;4586;11588;5326;13188
290010;202205;3581;6940;2371;5128;13;40;2018;4163;2031;4203
290020;202205;7202;15133;6616;14428;570;873;5511;12382;6081;13255
290030;202205;5369;11026;4390;9962;233;436;3667;8466;3900;8902
290035;202205;6070;11817;4981;10431;304;513;3821;8208;4125;8721
290040;202205;5909;11449;5052;10439;445;589;4028;8687;4473;9276
290050;202205;2308;6973;1947;6238;127;455;1322;4125;1449;4580
290060;202205;1682;3490;1227;2862;174;381;813;1865;987;2246
290070;202205;47008;92513;40741;84858;2359;4797;32479;66276;34838;71073
290080;202205;6869;17421;6013;16179;572;1544;4418;11868;4990;13412
290090;202205;2508;4367;1804;3613;17;48;1661;3281;1678;3329
290100;202205;11618;27196;9426;24101;1608;3753;5048;13556;6656;17309
290110;202205;6323;14946;5535;13746;700;1576;3534;8848;4234;10424
290115;202205;4539;12461;3866;11307;306;879;2992;8758;3298;9637
290120;202205;7336;16835;6115;15155;185;593;5127;12426;5312;13019
290130;202205;5237;11688;4084;10182;207;490;3067;7729;3274;8219
290135;202205;5158;11008;4220;9508;191;447;3363;7261;3554;7708
290140;202205;5134;12212;3979;10715;156;474;3314;8907;3470;9381
290150;202205;3430;7123;2967;6594;147;369;2459;5325;2606;5694
290160;202205;4062;8251;3609;7640;169;330;3067;6406;3236;6736
290170;202205;4155;9022;3709;8549;113;252;3357;7724;3470;7976
290180;202205;3450;8566;2869;7656;77;282;2413;6311;2490;6593
290190;202205;5563;12611;4953;11831;161;445;4112;9805;4273;10250
290195;202205;2957;6372;2330;5591;68;208;2012;4749;2080;4957
290200;202205;4698;12121;3715;10462;167;484;2757;7701;2924;8185
290205;202205;4041;9433;3582;8778;163;477;2898;6871;3061;7348
290210;202205;15405;37483;13646;34860;1158;2540;10682;27512;11840;30052
290220;202205;3614;7436;3171;6897;95;233;2752;5859;2847;6092
290225;202205;3754;7018;2896;6138;71;168;2631;5504;2702;5672
290230;202205;3417;7180;3143;6862;96;157;2755;6071;2851;6228
290240;202205;4785;10068;3886;8999;74;247;3411;7762;3485;8009
290250;202205;4522;11833;3712;10661;139;375;3047;8868;3186;9243
290260;202205;6256;13865;5307;12515;300;745;4408;10164;4708;10909
290265;202205;3866;10603;3130;9258;241;740;2145;6269;2386;7009
290270;202205;12017;38154;11047;36527;645;2531;8761;28761;9406;31292
290280;202205;6981;19590;6000;17667;437;1447;4226;12159;4663;13606
290290;202205;11109;30397;8913;26477;862;2750;5889;17164;6751;19914
290300;202205;4881;12042;3553;9616;224;664;2491;6531;2715;7195
290310;202205;2440;4583;1981;4057;26;88;1820;3636;1846;3724
290320;202205;31271;74048;25349;65491;4644;11435;14143;37448;18787;48883
290323;202205;4398;10893;3753;9887;107;295;2941;7718;3048;8013
290327;202205;4835;12659;4115;11368;377;939;2845;7792;3222;8731
290330;202205;2856;5038;2298;4443;26;42;2123;4114;2149;4156
290340;202205;7074;15488;5471;13608;536;1188;4151;10476;4687;11664
290350;202205;5327;13990;4417;12435;290;830;3125;8774;3415;9604
290360;202205;6274;13705;5516;12733;111;278;4871;11116;4982;11394
290370;202205;5663;12857;4155;10880;150;417;3030;7881;3180;8298
290380;202205;6616;15432;5490;13937;141;326;4748;12045;4889;12371
290390;202205;17402;45274;14374;40473;1490;4125;9750;27512;11240;31637
290395;202205;3382;8703;2690;7553;71;303;2088;5724;2159;6027
290400;202205;4378;10898;3506;9508;163;485;2658;7030;2821;7515
290405;202205;5164;13884;4367;12543;368;1063;2987;8689;3355;9752
290410;202205;6288;15829;4780;13499;171;645;3605;9904;3776;10549
290420;202205;3621;8920;2965;7922;101;294;2356;6229;2457;6523
290430;202205;4090;9371;3409;8366;160;510;2664;6212;2824;6722
290440;202205;3270;7504;2317;6021;162;351;1617;4297;1779;4648
290450;202205;4467;9420;3566;8154;121;282;3012;6678;3133;6960
290460;202205;14228;37530;11903;33321;2365;6659;5171;14459;7536;21118
290470;202205;5500;11756;4130;9912;461;1082;2572;6188;3033;7270
290475;202205;7493;19868;6265;17830;106;508;5238;14607;5344;15115
290480;202205;2121;4835;1739;4290;72;234;1312;3037;1384;3271
290485;202205;5196;13943;4549;13039;153;607;3800;10710;3953;11317
290490;202205;10647;22472;9620;21126;380;896;8013;17446;8393;18342
290500;202205;4741;13227;3705;11143;622;1942;1540;4526;2162;6468
290510;202205;4164;9133;3496;8285;88;245;3121;7323;3209;7568
290515;202205;3985;10348;3452;9608;39;121;3124;8775;3163;8896
290520;202205;13866;36065;10823;30382;655;2017;7006;18765;7661;20782
290530;202205;5449;14743;4575;13356;109;446;3845;11097;3954;11543
290540;202205;4262;9932;3866;9506;57;154;3619;8882;3676;9036
290550;202205;4785;11505;4151;10763;37;113;3795;9923;3832;10036
290560;202205;7213;17368;5537;14977;422;1361;3797;9854;4219;11215
290570;202205;51782;120248;45803;112881;2233;5881;37692;91536;39925;97417
290580;202205;9672;24604;8355;22770;878;2007;6041;17188;6919;19195
290590;202205;7645;22333;6366;20101;181;678;5185;16481;5366;17159
290600;202205;21244;55560;18361;50987;988;2721;14533;40203;15521;42924
290610;202205;2812;8203;2205;7017;115;398;1527;4806;1642;5204
290620;202205;6825;18448;5883;16915;365;953;4775;13794;5140;14747
290630;202205;11267;23886;9150;21235;758;1640;7065;16516;7823;18156
290640;202205;3124;7279;2402;6274;237;468;1628;4517;1865;4985
290650;202205;17013;36842;15263;34909;1458;3289;12437;28460;13895;31749
290660;202205;4246;10228;3421;8930;137;404;2510;6499;2647;6903
290670;202205;9307;20339;8079;18557;280;745;6888;15553;7168;16298
290680;202205;12581;31648;10387;28491;262;1094;8716;23389;8978;24483
290682;202205;6128;13339;5332;12314;393;599;4079;10069;4472;10668
290685;202205;4002;8390;2904;6855;475;924;1549;3990;2024;4914
290687;202205;8193;19453;6774;17224;855;2004;4426;11474;5281;13478
290689;202205;3187;8251;2408;6884;258;799;1567;4471;1825;5270
290690;202205;6279;15154;5129;13585;266;823;3886;10060;4152;10883
290700;202205;3550;7615;3181;7171;48;168;2904;6412;2952;6580
290710;202205;10069;24668;8533;22600;267;807;7326;19263;7593;20070
290720;202205;22342;54548;20109;51216;1126;3033;16168;40316;17294;43349
290730;202205;7946;17535;6749;16136;343;657;5228;12626;5571;13283
290740;202205;1229;2933;948;2493;12;38;834;2148;846;2186
290750;202205;14594;31576;12626;28588;499;1303;10195;21968;10694;23271
290755;202205;2274;6052;1820;5262;128;348;1232;3576;1360;3924
290760;202205;4209;11492;3450;10133;238;588;2391;7177;2629;7765
290770;202205;3109;8461;2848;8148;109;239;2417;7077;2526;7316
290780;202205;8820;20718;7549;19059;351;727;5814;14906;6165;15633
290790;202205;5831;14247;5057;13139;259;641;4179;10917;4438;11558
290800;202205;8096;14910;5820;12321;323;543;4426;9478;4749;10021
290810;202205;6341;14518;5138;12821;224;494;3916;9928;4140;10422
290820;202205;6109;14343;5398;13329;399;820;3802;9461;4201;10281
290830;202205;4898;11046;4303;10152;67;231;3602;8101;3669;8332
290840;202205;20133;49204;17092;44621;1920;4173;11685;31654;13605;35827
290850;202205;9526;18576;8385;17355;608;910;6896;14523;7504;15433
290860;202205;7114;18098;6149;16985;339;830;5142;14506;5481;15336
290870;202205;5428;13823;4109;11386;313;813;2746;7561;3059;8374
290880;202205;1613;3638;1290;3231;190;411;742;2029;932;2440
290890;202205;10410;19675;9214;18353;195;392;8490;16779;8685;17171
290900;202205;2676;6633;2066;5581;150;397;1282;3398;1432;3795
290910;202205;5859;12752;4462;10694;49;135;3855;9123;3904;9258
290920;202205;6296;13811;5529;12900;201;269;4865;11879;5066;12148
290930;202205;8281;21804;6626;18961;264;993;5056;14003;5320;14996
290940;202205;3916;10418;3273;9468;168;579;2610;7465;2778;8044
290950;202205;1622;3803;1315;3356;108;278;882;2257;990;2535
290960;202205;6778;15502;6032;14602;308;636;5028;12164;5336;12800
290970;202205;3508;9935;2851;8727;122;449;2205;6678;2327;7127
290980;202205;15480;33737;13321;30614;819;2006;9286;20310;10105;22316
290990;202205;10959;26744;9723;24843;309;1121;8244;20273;8553;21394
291000;202205;3769;8938;2883;7849;133;376;2332;6415;2465;6791
291005;202205;18621;42046;16427;39334;920;2216;13694;32328;14614;34544
291010;202205;3370;9790;2695;8349;166;560;1749;5265;1915;5825
291020;202205;1449;3324;1171;2860;30;90;851;1932;881;2022
291030;202205;2846;6372;2061;5106;160;356;1335;3201;1495;3557
291040;202205;6057;15307;4963;13772;219;698;3884;10764;4103;11462
291050;202205;11491;24663;10084;22809;1131;2419;7471;16731;8602;19150
291060;202205;9309;21922;8168;20458;691;1659;6309;15747;7000;17406
291070;202205;19902;46527;16800;41759;426;1378;14222;34523;14648;35901
291072;202205;31558;71489;23929;59442;3357;8684;13376;32007;16733;40691
291075;202205;6181;14126;5552;13164;97;252;4691;10771;4788;11023
291077;202205;1862;4624;1447;3912;64;137;1008;2735;1072;2872
291080;202205;142962;318809;115305;281947;26287;61004;50382;127434;76669;188438
291085;202205;6182;14700;5011;12923;176;496;4145;10554;4321;11050
291090;202205;2444;4217;1808;3514;40;76;1557;2968;1597;3044
291100;202205;3808;7414;2698;6117;122;258;2108;4745;2230;5003
291110;202205;6699;18808;5616;16978;291;1120;4337;12695;4628;13815
291120;202205;9359;20174;8007;18510;370;927;6409;14643;6779;15570
291125;202205;2644;4262;2009;3560;66;103;1724;3024;1790;3127
291130;202205;3608;9591;2710;7906;73;340;2078;5791;2151;6131
291140;202205;5484;13547;4001;10968;579;1374;2416;6622;2995;7996
291150;202205;3079;5776;2417;5051;6;19;2301;4779;2307;4798
291160;202205;5716;14600;4760;13261;484;1369;3118;8570;3602;9939
291165;202205;2360;6165;1719;4935;33;141;1192;3281;1225;3422
291170;202205;24849;58337;20691;51515;1353;3437;13831;33160;15184;36597
291180;202205;8404;16077;6496;13617;187;441;5661;11577;5848;12018
291185;202205;3871;8824;3441;8189;188;437;2726;6435;2914;6872
291190;202205;8522;19444;7030;17591;218;623;5713;14271;5931;14894
291200;202205;3105;7980;2282;6457;80;290;1510;4027;1590;4317
291210;202205;8530;16339;6322;13847;345;650;4832;10595;5177;11245
291220;202205;5372;13138;4810;12336;383;952;3523;8933;3906;9885
291230;202205;5487;10206;4275;8889;72;112;3931;8178;4003;8290
291240;202205;4590;11156;3867;9970;74;232;3311;8405;3385;8637
291250;202205;3671;10224;2850;8753;201;606;1797;5560;1998;6166
291260;202205;1661;3566;1353;3172;47;113;1124;2629;1171;2742
291270;202205;6346;14617;4976;12712;428;976;3611;9367;4039;10343
291280;202205;3232;7176;2408;5997;174;385;1654;3985;1828;4370
291290;202205;6349;15749;4831;13419;438;1274;3233;8821;3671;10095
291300;202205;4399;10856;3492;9404;131;400;2707;7057;2838;7457
291310;202205;5751;14287;4906;12826;152;415;4161;10737;4313;11152
291320;202205;7600;18724;5979;15970;1207;3004;3158;8764;4365;11768
291330;202205;2149;5061;1778;4457;64;179;1379;3348;1443;3527
291340;202205;4859;11536;3896;9968;193;442;2725;6899;2918;7341
291345;202205;3281;8851;2939;8354;133;422;2431;6898;2564;7320
291350;202205;8206;17872;6405;15711;108;268;5575;13655;5683;13923
291360;202205;47447;95914;38023;84989;4293;9048;25656;58527;29949;67575
291370;202205;9254;23321;8142;21648;576;1689;6170;15927;6746;17616
291380;202205;4934;10599;4420;9924;159;388;3830;8474;3989;8862
291390;202205;14914;29322;11419;25504;493;1065;9606;21250;10099;22315
291400;202205;18280;39486;15400;35369;1549;3266;10774;25014;12323;28280
291410;202205;3369;8295;2635;7064;57;185;1971;5172;2028;5357
291420;202205;2143;4856;1661;4258;25;98;1467;3720;1492;3818
291430;202205;2989;7802;2558;7087;103;387;2025;5422;2128;5809
291440;202205;7320;19225;6286;17616;411;1164;4731;13416;5142;14580
291450;202205;12180;24387;10064;21973;187;286;9088;20037;9275;20323
291460;202205;18637;44292;16272;40899;824;2332;12537;30683;13361;33015
291465;202205;10008;23061;7889;20641;192;757;6807;17563;6999;18320
291470;202205;22204;43314;18903;39570;1127;2162;14736;30975;15863;33137
291480;202205;53517;107103;41195;91055;3777;8483;26307;55805;30084;64288
291490;202205;7432;15851;6570;14895;169;425;6037;13567;6206;13992
291500;202205;6102;12740;5130;11500;108;267;4718;10555;4826;10822
291510;202205;5165;11157;3874;9536;63;254;3350;8083;3413;8337
291520;202205;5186;10857;3967;9307;343;723;3020;7108;3363;7831
291530;202205;2718;5705;1988;4783;206;454;1369;3380;1575;3834
291535;202205;4128;10794;3517;9741;186;486;2786;7782;2972;8268
291540;202205;2453;5058;1711;4172;68;164;1424;3443;1492;3607
291550;202205;7210;14286;5589;12309;512;974;3965;8733;4477;9707
291560;202205;20326;45670;14994;38751;2387;5675;8251;22203;10638;27878
291570;202205;2688;5721;2059;5004;175;267;1666;4247;1841;4514
291580;202205;7380;17226;5820;15201;322;926;4358;11069;4680;11995
291590;202205;2777;5788;2450;5413;78;205;2194;4770;2272;4975
291600;202205;6370;13474;4924;11353;439;1064;3388;7557;3827;8621
291610;202205;7220;15699;6459;14867;256;499;5574;13031;5830;13530
291620;202205;3453;7159;2622;6261;181;377;2012;4909;2193;5286
291630;202205;4049;7808;3094;6638;319;543;2376;5163;2695;5706
291640;202205;19832;43325;15307;37052;1657;3989;8888;20831;10545;24820
291650;202205;11329;24162;10052;22675;873;1295;8179;19170;9052;20465
291660;202205;2234;5160;1632;4262;113;401;1107;2692;1220;3093
291670;202205;2221;5553;1828;4986;157;384;1303;3621;1460;4005
291680;202205;4729;10491;3844;9272;433;1007;2515;6185;2948;7192
291685;202205;5330;12231;4255;10770;209;436;3299;8429;3508;8865
291690;202205;4971;9491;3423;7399;289;516;2739;5871;3028;6387
291700;202205;10415;26575;9157;24518;341;1129;7710;20101;8051;21230
291710;202205;6199;13187;4730;11211;341;816;3507;8103;3848;8919
291720;202205;4946;13932;4093;12299;848;2542;2156;6525;3004;9067
291730;202205;8199;17190;7086;15767;416;880;5921;13146;6337;14026
291733;202205;3274;7680;2760;7010;124;241;2046;5418;2170;5659
291735;202205;3093;7949;2417;6774;70;163;1779;4967;1849;5130
291740;202205;4420;10811;3147;8464;122;255;2172;5800;2294;6055
291750;202205;24202;52329;19983;46224;2675;5362;12907;30626;15582;35988
291760;202205;12677;32890;9994;28826;3011;9855;2916;8095;5927;17950
291770;202205;8510;20974;7121;18622;344;1117;5474;13661;5818;14778
291780;202205;5759;14159;5169;13371;122;388;4492;11427;4614;11815
291790;202205;3411;7999;3105;7617;310;599;2388;6006;2698;6605
291800;202205;38397;85888;30157;74413;4326;10410;17418;42339;21744;52749
291810;202205;12078;26235;10232;24025;490;969;8454;20064;8944;21033
291820;202205;4421;10666;3847;9933;125;342;3112;8001;3237;8343
291830;202205;5351;11107;4355;9797;235;404;3492;7887;3727;8291
291835;202205;7350;20502;5901;17886;572;1727;3968;12162;4540;13889
291840;202205;55096;139379;48055;128891;4534;12834;35206;93543;39740;106377
291845;202205;3701;7593;3068;6832;150;287;2605;5874;2755;6161
291850;202205;4972;12439;4164;11177;137;340;3494;9395;3631;9735
291855;202205;2686;4596;2144;4003;29;56;2007;3724;2036;3780
291860;202205;2434;6114;1663;4658;35;105;1108;3005;1143;3110
291870;202205;1418;3370;964;2590;34;107;684;1794;718;1901
291875;202205;3281;9358;2817;8416;73;315;2081;5975;2154;6290
291880;202205;6241;16199;5374;14848;301;718;4053;11360;4354;12078
291890;202205;1925;3666;1280;2918;222;461;739;1716;961;2177
291900;202205;1531;3344;1169;2810;32;93;926;2155;958;2248
291905;202205;2676;6418;2187;5675;116;358;1672;4166;1788;4524
291910;202205;4096;8218;3537;7564;79;178;3177;6799;3256;6977
291915;202205;8249;21807;6689;19211;245;727;5000;14552;5245;15279
291920;202205;35248;81249;30490;75082;1816;5424;23869;56725;25685;62149
291930;202205;2964;6936;2538;6357;243;578;1898;4789;2141;5367
291940;202205;4331;10244;2921;7966;266;653;1733;4700;1999;5353
291950;202205;10372;29684;8657;26550;432;1409;5901;17933;6333;19342
291955;202205;19849;45160;17806;42603;1155;2933;14693;34843;15848;37776
291960;202205;4234;8981;3585;8160;278;457;2837;6648;3115;7105
291970;202205;5546;12121;4674;11059;166;478;3744;8659;3910;9137
291980;202205;11495;29723;9310;26180;896;2277;6299;17970;7195;20247
291990;202205;2632;6185;2173;5629;28;98;2001;5149;2029;5247
291992;202205;4852;10461;4040;9463;283;564;3258;7705;3541;8269
291995;202205;2534;6131;2083;5445;81;286;1675;4214;1756;4500
292000;202205;2993;6482;2453;5839;69;220;2039;4777;2108;4997
292010;202205;6573;13995;5353;12254;93;344;4557;10122;4650;10466
292020;202205;5442;13790;4596;12396;163;569;3727;9695;3890;10264
292030;202205;2341;6309;2042;5794;145;432;1323;3641;1468;4073
292040;202205;5353;11969;4250;10409;203;472;3429;8375;3632;8847
292045;202205;5099;10910;3969;9308;27;86;3679;8627;3706;8713
292050;202205;7376;18968;5989;16650;302;965;4023;10938;4325;11903
292060;202205;13873;28339;12877;27121;369;719;11575;23966;11944;24685
292070;202205;6861;15673;5991;14658;381;883;5140;12569;5521;13452
292080;202205;4204;8481;3500;7598;44;135;3250;6968;3294;7103
292090;202205;5055;10187;3591;8396;190;498;2867;6627;3057;7125
292100;202205;14665;32157;12581;29593;2054;4552;7533;18338;9587;22890
292105;202205;3917;9208;3401;8520;48;176;2875;7141;2923;7317
292110;202205;7249;15502;5271;12652;768;1887;3266;7636;4034;9523
292120;202205;8235;19116;6787;16737;606;1326;4843;11894;5449;13220
292130;202205;3877;8590;3198;7749;188;503;2437;5821;2625;6324
292140;202205;6581;13225;5600;11882;206;392;4904;10279;5110;10671
292145;202205;2956;7376;2468;6582;137;278;1898;5148;2035;5426
292150;202205;17514;41582;15091;37794;420;1256;12670;31013;13090;32269
292160;202205;3426;7490;2626;6488;38;114;2034;5378;2072;5492
292170;202205;10150;24664;8519;22110;441;1364;6573;16543;7014;17907
292180;202205;3290;8417;2450;6897;179;498;1537;4214;1716;4712
292190;202205;3359;8099;2833;7345;326;821;1896;5030;2222;5851
292200;202205;10585;23996;8029;20465;1551;3911;4006;10543;5557;14454
292205;202205;4373;10999;3778;10135;105;330;3230;8685;3335;9015
292210;202205;7660;15588;6295;13909;94;320;5803;12623;5897;12943
292220;202205;2585;5468;2227;4950;105;216;1737;3729;1842;3945
292225;202205;3612;9736;3164;9084;60;270;2786;7854;2846;8124
292230;202205;9966;21911;8840;20506;272;787;7490;16974;7762;17761
292240;202205;5461;14645;4747;13368;295;804;3406;9568;3701;10372
292250;202205;6814;16051;6072;15014;280;776;4830;11678;5110;12454
292260;202205;3690;9119;3253;8570;83;268;2831;7428;2914;7696
292265;202205;4130;10033;3389;8902;68;290;2834;7224;2902;7514
292270;202205;5324;10505;4285;9289;198;338;3540;7705;3738;8043
292273;202205;3258;6427;2592;5619;142;218;1862;4282;2004;4500
292275;202205;2040;4749;1659;4257;55;150;1337;3413;1392;3563
292280;202205;3129;6586;2498;5860;125;213;2096;5052;2221;5265
292285;202205;2960;6433;2348;5633;90;169;1926;4656;2016;4825
292290;202205;8580;20245;6799;17784;187;521;5654;14685;5841;15206
292300;202205;11958;27580;9443;24243;1135;2929;6219;16136;7354;19065
292303;202205;3607;8915;3121;8178;98;212;2701;7088;2799;7300
292305;202205;2574;6460;2343;6153;60;212;2086;5403;2146;5615
292310;202205;8013;17877;6937;16573;97;357;6172;14394;6269;14751
292320;202205;6613;16815;5261;14464;186;627;4032;10800;4218;11427
292330;202205;3415;6363;2828;5721;198;295;2210;4657;2408;4952
292335;202205;5635;13533;4992;12602;225;509;4223;10723;4448;11232
292340;202205;6056;16058;4964;14013;274;739;3550;9963;3824;10702
292350;202205;3014;7363;2532;6730;135;385;2079;5492;2214;5877
292360;202205;5648;13937;4692;12387;244;672;3409;8853;3653;9525
292370;202205;12488;26038;10735;23754;96;352;10092;21958;10188;22310
292380;202205;7725;20103;6879;18647;433;1197;5297;14206;5730;15403
292390;202205;5680;9423;4354;7922;69;126;4027;7230;4096;7356
292400;202205;25553;66943;22068;61687;2090;5782;15438;43313;17528;49095
292405;202205;5273;11545;4412;10251;142;351;3562;8260;3704;8611
292410;202205;2724;5518;2324;5023;112;196;2029;4414;2141;4610
292420;202205;5386;11446;4845;10713;72;256;4421;9473;4493;9729
292430;202205;5535;15377;4211;12975;316;1073;2827;8598;3143;9671
292440;202205;9950;28377;9102;27160;129;642;8187;24211;8316;24853
292450;202205;4613;12039;3523;9992;104;347;2724;7597;2828;7944
292460;202205;6699;15105;5633;13499;182;475;4733;11051;4915;11526
292465;202205;2985;6976;2526;6410;169;327;1660;4581;1829;4908
292467;202205;2358;5818;2088;5465;308;647;1429;4015;1737;4662
292470;202205;3283;7911;2484;6689;140;326;1789;4842;1929;5168
292480;202205;7524;15318;6190;13736;171;356;5579;12306;5750;12662
292490;202205;3102;6287;2618;5646;91;179;2162;4621;2253;4800
292500;202205;8147;19348;6501;16734;371;947;4675;11795;5046;12742
292510;202205;15964;37990;12504;32770;792;2206;8993;23260;9785;25466
292520;202205;8437;19405;7448;17965;346;966;6111;14399;6457;15365
292525;202205;7512;15508;6177;14002;118;277;5547;12602;5665;12879
292530;202205;36633;88649;29332;77183;5492;15038;15463;40006;20955;55044
292540;202205;5184;8639;4144;7542;115;186;3797;6916;3912;7102
292550;202205;9298;22781;7176;20251;551;1462;5117;15197;5668;16659
292560;202205;5037;11765;4224;10647;168;490;3190;7819;3358;8309
292570;202205;4233;10175;3525;8965;59;213;2990;7339;3049;7552
292575;202205;7721;20601;7047;19709;724;1897;5290;15003;6014;16900
292580;202205;8862;19890;7303;17666;222;486;6269;14971;6491;15457
292590;202205;8143;20452;6794;18086;360;1075;5438;14163;5798;15238
292593;202205;3193;7516;2587;6500;88;217;2145;5331;2233;5548
292595;202205;6221;15177;5363;14136;173;561;4624;12062;4797;12623
292600;202205;13010;31556;11224;28976;625;1433;8919;23095;9544;24528
292610;202205;5195;11799;4418;10550;155;348;3541;8330;3696;8678
292620;202205;7852;18471;6494;16841;144;342;5918;15447;6062;15789
292630;202205;10524;23060;8498;19954;993;2258;5557;12889;6550;15147
292640;202205;9112;24501;7690;22199;367;1117;5465;15811;5832;16928
292650;202205;4826;11313;4276;10600;63;213;3913;9565;3976;9778
292660;202205;12446;31941;10550;29166;666;1729;7900;22085;8566;23814
292665;202205;2331;6478;1974;6003;87;256;1579;4917;1666;5173
292670;202205;3920;10188;3052;8599;205;638;2024;5521;2229;6159
292680;202205;4538;10935;3589;9349;135;349;2750;6942;2885;7291
292690;202205;2903;7106;2001;5660;223;557;1232;3603;1455;4160
292700;202205;11653;28771;10116;26453;720;1636;7378;19437;8098;21073
292710;202205;3235;8347;3006;8063;56;172;2789;7465;2845;7637
292720;202205;10215;21934;8629;20118;441;892;6721;16090;7162;16982
292730;202205;5904;12191;5365;11408;430;672;4290;9399;4720;10071
292740;202205;404902;884482;356163;818534;40852;94383;247974;560414;288826;654797
292750;202205;7623;17460;6698;16227;212;562;5658;13609;5870;14171
292760;202205;4550;11772;3930;10723;189;592;3025;8080;3214;8672
292770;202205;8063;18668;6622;16735;846;2091;4631;11871;5477;13962
292780;202205;2425;4367;1792;3632;57;124;1488;2861;1545;2985
292790;202205;4401;8561;3328;7406;199;402;2730;6098;2929;6500
292800;202205;12628;29802;10750;26978;498;1282;8780;21751;9278;23033
292805;202205;4250;9117;3358;8013;126;305;2745;6463;2871;6768
292810;202205;14624;30788;11939;26806;660;1595;9613;20644;10273;22239
292820;202205;7933;20825;5802;17252;429;1450;4028;11721;4457;13171
292830;202205;3279;7183;2784;6603;112;255;2341;5598;2453;5853
292840;202205;11066;24737;9461;22630;195;585;8476;19877;8671;20462
292850;202205;2958;7045;2515;6437;228;536;1747;4449;1975;4985
292860;202205;20197;39730;18260;37483;585;1209;15987;32317;16572;33526
292870;202205;24236;52813;21030;48475;1380;3043;15384;34551;16764;37594
292880;202205;13033;33091;11096;30169;393;1369;8579;22404;8972;23773
292890;202205;9123;21620;8065;20154;174;592;7160;17566;7334;18158
292895;202205;3944;7268;3034;5963;239;382;2343;4646;2582;5028
292900;202205;3231;7676;2918;7241;54;210;2464;5894;2518;6104
292905;202205;5186;11911;4147;10383;118;349;3286;7990;3404;8339
292910;202205;5759;14090;5137;13270;174;460;4106;10375;4280;10835
292920;202205;11145;28103;10315;27021;275;989;9007;23135;9282;24124
292925;202205;5917;15934;4902;14045;337;907;3471;9903;3808;10810
292930;202205;7637;20534;6657;18806;790;2339;4043;11284;4833;13623
292935;202205;3049;6281;2437;5608;25;80;2221;5105;2246;5185
292937;202205;3154;7496;2699;6920;198;459;1990;5213;2188;5672
292940;202205;3435;7884;2725;6840;340;715;1777;4661;2117;5376
292950;202205;10603;25511;9247;23602;474;1163;7159;18022;7633;19185
292960;202205;6040;13511;5051;12149;165;344;4050;9669;4215;10013
292970;202205;4418;11402;3899;10679;106;357;3255;8957;3361;9314
292975;202205;4977;9962;4424;9353;130;281;4026;8480;4156;8761
292980;202205;4373;8813;3630;7790;71;200;3205;6704;3276;6904
292990;202205;13232;33560;11081;29990;438;1330;8657;22713;9095;24043
293000;202205;3133;6916;2674;6223;114;285;2105;4835;2219;5120
293010;202205;21124;49557;17132;43686;1967;5111;11206;28329;13173;33440
293015;202205;9786;27654;7708;23756;642;1959;5244;16403;5886;18362
293020;202205;11240;29555;10141;28019;161;599;9155;25200;9316;25799
293030;202205;5864;14403;4527;12370;271;608;3058;8643;3329;9251
293040;202205;4974;11709;4079;10476;93;290;3529;8983;3622;9273
293050;202205;27922;59330;24533;54491;1632;3404;18631;40739;20263;44143
293060;202205;4268;10442;3435;8922;225;606;2477;6221;2702;6827
293070;202205;31761;68309;28296;64072;1995;4609;22339;49820;24334;54429
293075;202205;4224;11758;3665;10863;89;427;3133;9210;3222;9637
293076;202205;4004;8881;3615;8425;92;172;3203;7547;3295;7719
293077;202205;7291;18457;5882;16299;739;1945;3481;10213;4220;12158
293080;202205;5259;14378;4426;12947;90;397;3618;10361;3708;10758
293090;202205;3527;9801;2723;8443;220;650;1861;5777;2081;6427
293100;202205;6588;16194;5383;14116;261;610;4222;11051;4483;11661
293105;202205;4300;12714;3686;11507;249;786;2554;7960;2803;8746
293110;202205;2794;6239;2345;5621;71;205;1939;4522;2010;4727
293120;202205;5873;13095;5327;12332;459;676;4289;10339;4748;11015
293130;202205;4111;10434;3539;9712;130;447;3051;8238;3181;8685
293135;202205;36068;79547;26800;67265;4777;12453;11627;29571;16404;42024
293140;202205;3137;5734;2769;5300;75;120;2479;4662;2554;4782
293150;202205;5792;16216;4768;14364;368;1214;3281;9716;3649;10930
293160;202205;5131;10402;4540;9749;664;858;3340;8051;4004;8909
293170;202205;6116;10757;5280;9781;109;244;4642;8412;4751;8656
293180;202205;5144;13154;4257;11596;92;353;3445;9116;3537;9469
293190;202205;18147;40939;15970;37947;139;579;14497;33788;14636;34367
293200;202205;10433;22464;8512;19549;244;619;7181;16174;7425;16793
293210;202205;5829;14056;4915;12734;388;956;3700;9600;4088;10556
293220;202205;6535;14455;4914;11909;760;1777;2961;7045;3721;8822
293230;202205;5144;10960;3858;9314;279;604;2897;7040;3176;7644
293240;202205;5265;12273;4253;10721;216;354;3129;8279;3345;8633
293245;202205;4489;11097;4055;10468;139;429;3481;8799;3620;9228
293250;202205;6706;14743;5423;13046;301;747;4271;10153;4572;10900
293260;202205;5483;12932;4494;11445;197;386;3173;8144;3370;8530
293270;202205;8745;17006;6965;15116;612;776;5510;12789;6122;13565
293280;202205;5042;12108;4389;11195;303;660;3378;8714;3681;9374
293290;202205;18941;47875;16756;44582;1537;4143;12159;32080;13696;36223
293300;202205;7444;15738;6441;14295;510;1040;4846;10608;5356;11648
293305;202205;5054;10714;4297;9772;37;101;3969;8972;4006;9073
293310;202205;2453;5767;2076;5196;38;133;1690;4110;1728;4243
293315;202205;5298;10763;4392;9497;442;637;3429;7626;3871;8263
293317;202205;3321;6898;2960;6393;292;455;2223;4866;2515;5321
293320;202205;14757;31282;13138;29520;209;556;12026;26663;12235;27219
293325;202205;2094;4761;1655;4206;220;519;1084;2784;1304;3303
293330;202205;82913;201948;68818;179012;9051;25553;39941;98267;48992;123820
293340;202205;2437;6371;1976;5570;148;432;1329;3709;1477;4141
293345;202205;4230;10351;3385;9089;386;747;2265;6618;2651;7365
293350;202205;6990;18178;5993;16969;114;366;5329;15188;5443;15554
293360;202205;18624;40410;16070;37105;425;1126;14241;32676;14666;33802
310010;202205;1115;2381;751;1906;87;242;306;712;393;954
310020;202205;3288;8255;2527;6972;463;1324;962;2507;1425;3831
310030;202205;2170;5757;1679;4910;227;715;1088;3094;1315;3809
310040;202205;940;2314;737;1977;78;261;396;939;474;1200
310050;202205;1759;4737;1499;4332;100;379;1058;2945;1158;3324
310060;202205;3682;9339;3144;8637;130;427;2462;6787;2592;7214
310070;202205;376;839;274;694;11;33;204;508;215;541
310080;202205;841;2179;621;1785;78;238;320;877;398;1115
310090;202205;5718;13131;4718;11592;216;623;3744;8928;3960;9551
310100;202205;4213;10101;3558;9088;119;414;2997;7411;3116;7825
310110;202205;5400;13265;4222;11324;613;1865;2447;6234;3060;8099
310120;202205;731;1667;483;1293;75;240;249;573;324;813
310130;202205;442;1056;379;964;20;59;304;747;324;806
310140;202205;351;920;263;796;46;165;131;363;177;528
310150;202205;6981;16474;5324;13638;489;1512;2996;7038;3485;8550
310160;202205;10951;25278;8390;21331;1230;3452;4030;9715;5260;13167
310163;202205;1291;3608;1012;3065;214;718;321;873;535;1591
310170;202205;11036;25433;8961;22344;863;2095;6304;15644;7167;17739
310180;202205;2272;5116;1664;4182;160;489;1094;2599;1254;3088
310190;202205;3145;8462;2579;7509;622;1952;574;1572;1196;3524
310200;202205;2320;6219;1749;5218;270;938;835;2337;1105;3275
310205;202205;1300;3296;1042;2897;127;374;666;1868;793;2242
310210;202205;2765;7040;2250;6126;113;317;1598;4201;1711;4518
310220;202205;1337;3442;1022;2847;82;237;658;1751;740;1988
310230;202205;2552;6481;2076;5633;222;713;1347;3384;1569;4097
310240;202205;1163;3144;988;2848;55;190;681;1869;736;2059
310250;202205;1285;2986;1064;2655;37;106;850;2046;887;2152
310260;202205;3937;9604;2692;7390;664;2148;991;2213;1655;4361
310270;202205;3313;6992;2681;6166;94;257;2258;5149;2352;5406
310280;202205;3040;6387;2434;5570;155;417;1763;3805;1918;4222
310285;202205;2079;6126;1737;5516;165;586;1107;3454;1272;4040
310290;202205;1615;3972;1385;3593;156;504;906;2142;1062;2646
310300;202205;1859;4846;1549;4343;162;558;880;2246;1042;2804
310310;202205;370;839;248;644;40;110;136;331;176;441
310320;202205;568;1358;398;1087;15;60;239;614;254;674
310330;202205;566;1291;342;890;44;124;147;344;191;468
310340;202205;9359;22541;7412;19284;990;2463;3941;10180;4931;12643
310350;202205;15172;34940;10866;28194;1655;4691;5680;13963;7335;18654
310360;202205;667;1409;541;1253;23;62;352;784;375;846
310370;202205;1397;4107;1207;3783;231;786;385;1298;616;2084
310375;202205;972;2268;702;1883;149;407;317;841;466;1248
310380;202205;424;940;235;651;24;67;126;327;150;394
310390;202205;617;1735;496;1502;88;296;207;565;295;861
310400;202205;13665;31658;10308;26666;699;2241;6874;16863;7573;19104
310410;202205;1204;3346;700;2265;77;282;279;794;356;1076
310420;202205;5467;13383;4063;10943;512;1544;2114;5202;2626;6746
310430;202205;1963;5024;1363;3971;221;664;580;1493;801;2157
310440;202205;734;1812;518;1430;55;183;269;677;324;860
310445;202205;1523;4048;1137;3318;93;268;778;2207;871;2475
310450;202205;5186;11914;3978;10068;215;709;3065;7452;3280;8161
310460;202205;1986;5045;1534;4250;201;633;610;1488;811;2121
310470;202205;4101;8637;3192;7457;383;765;2084;5038;2467;5803
310480;202205;1132;2757;870;2333;94;305;526;1306;620;1611
310490;202205;3270;8367;2602;7300;324;1068;1484;3859;1808;4927
310500;202205;1657;4119;1274;3518;197;604;748;1966;945;2570
310510;202205;2606;6382;1866;5066;285;848;888;2267;1173;3115
310520;202205;1320;3228;945;2543;158;423;458;1222;616;1645
310530;202205;888;2159;637;1742;105;347;239;530;344;877
310540;202205;3446;9254;2817;8103;468;1477;1398;3709;1866;5186
310550;202205;1443;3348;1045;2703;71;249;657;1543;728;1792
310560;202205;18561;45814;13506;36842;1611;4938;6569;15948;8180;20886
310570;202205;1263;2979;990;2607;47;160;795;2039;842;2199
310590;202205;4906;11951;3932;10195;228;715;2440;5814;2668;6529
310600;202205;1568;4264;1294;3712;162;503;699;1865;861;2368
310610;202205;550;1440;353;1105;108;359;75;216;183;575
310620;202205;238501;565914;181938;467201;19119;58360;104731;242646;123850;301006
310630;202205;5323;13661;4141;11408;477;1384;2480;6576;2957;7960
310640;202205;1569;3976;1295;3487;135;449;826;2031;961;2480
310650;202205;2735;7001;2029;5718;147;502;1293;3420;1440;3922
310660;202205;1661;3957;1363;3549;33;86;1196;3075;1229;3161
310665;202205;1621;3722;1348;3366;30;104;1095;2719;1125;2823
310670;202205;71567;169948;60674;152348;4944;14439;42962;101722;47906;116161
310680;202205;889;1923;733;1708;28;102;611;1353;639;1455
310690;202205;2600;5972;1940;4979;152;467;1279;3048;1431;3515
310700;202205;568;1136;448;993;7;21;359;765;366;786
310710;202205;7049;18566;5155;15721;1069;3813;993;2729;2062;6542
310720;202205;1241;2709;985;2390;33;113;752;1750;785;1863
310730;202205;11746;28308;10055;25753;396;1294;7672;18809;8068;20103
310740;202205;7576;19487;5681;15859;720;2354;2592;6436;3312;8790
310750;202205;1503;3323;1155;2839;76;229;724;1616;800;1845
310760;202205;820;1930;595;1586;42;116;382;981;424;1097
310770;202205;1220;3136;852;2562;120;414;385;1009;505;1423
310780;202205;4931;10570;4072;9433;230;557;3088;7066;3318;7623
310790;202205;2042;6153;1761;5564;395;1407;375;994;770;2401
310800;202205;2656;7520;1958;6157;478;1715;140;380;618;2095
310810;202205;1556;3545;1304;3150;52;157;989;2255;1041;2412
310820;202205;1302;3183;819;2397;163;486;224;668;387;1154
310825;202205;3062;7955;2457;7023;56;290;2044;5608;2100;5898
310830;202205;2308;5978;1763;5002;305;992;809;2112;1114;3104
310840;202205;2532;6485;1916;5470;394;1309;636;1565;1030;2874
310850;202205;1537;3978;1265;3581;44;214;962;2583;1006;2797
310855;202205;3587;8800;2804;7566;182;534;2027;5317;2209;5851
310860;202205;7770;20837;6342;18247;673;1814;3912;11338;4585;13152
310870;202205;1047;2391;832;2090;57;157;608;1480;665;1637
310880;202205;1054;2986;825;2520;102;324;468;1400;570;1724
310890;202205;2537;6934;1681;5234;329;1126;275;723;604;1849
310900;202205;4553;12112;3326;9593;523;1698;1506;3955;2029;5653
310910;202205;2491;5743;1765;4633;242;690;460;1088;702;1778
310920;202205;2189;5262;1685;4536;160;490;1106;2857;1266;3347
310925;202205;1224;2855;984;2499;50;163;760;1836;810;1999
310930;202205;6304;15285;4469;12414;843;2345;2147;6194;2990;8539
310940;202205;8002;16839;6556;14829;220;628;5281;11496;5501;12124
310945;202205;1509;3622;1181;3089;144;437;705;1726;849;2163
310950;202205;2113;5960;1419;4438;248;875;429;1124;677;1999
310960;202205;812;2081;489;1435;80;255;129;356;209;611
310970;202205;1315;3738;959;3031;245;798;189;568;434;1366
310980;202205;388;864;218;579;21;55;112;287;133;342
310990;202205;1605;4023;1291;3513;143;458;785;1983;928;2441
311000;202205;4601;11888;3458;10078;627;2015;1814;4971;2441;6986
311010;202205;1139;2856;941;2530;199;565;509;1336;708;1901
311020;202205;1323;3202;882;2445;50;162;491;1296;541;1458
311030;202205;2079;4895;1512;3982;325;996;662;1611;987;2607
311040;202205;331;969;268;845;74;254;78;231;152;485
311050;202205;3481;8268;2649;7044;390;1206;1354;3383;1744;4589
311060;202205;3890;9336;2923;7658;382;1127;1294;3084;1676;4211
311070;202205;2796;6409;2015;5236;232;762;1114;2614;1346;3376
311080;202205;1301;2741;1045;2357;43;131;824;1749;867;1880
311090;202205;2660;7749;2174;6876;437;1482;753;2319;1190;3801
311100;202205;2746;7400;1764;5505;346;1194;476;1297;822;2491
311110;202205;4324;8582;2398;5823;507;1219;662;1604;1169;2823
311115;202205;1589;3227;1330;2898;43;91;1124;2398;1167;2489
311120;202205;7946;19779;6117;16588;880;2681;2509;5957;3389;8638
311130;202205;2113;5282;1608;4605;133;452;948;2627;1081;3079
311140;202205;1762;4138;1369;3611;156;441;898;2318;1054;2759
311150;202205;1674;5005;1336;4379;172;650;727;2263;899;2913
311160;202205;4596;12331;3392;10198;624;2136;1398;3905;2022;6041
311170;202205;1048;2545;859;2299;52;154;536;1519;588;1673
311180;202205;1639;3453;1084;2657;174;432;583;1382;757;1814
311190;202205;976;2621;723;2127;110;363;291;732;401;1095
311200;202205;2536;6416;1876;5190;324;997;773;1870;1097;2867
311205;202205;1044;2779;868;2470;38;132;578;1538;616;1670
311210;202205;1197;3232;1061;3050;113;288;771;2285;884;2573
311220;202205;948;2321;809;2077;26;96;609;1445;635;1541
311230;202205;9047;25258;6894;21021;1182;3689;2732;8329;3914;12018
311240;202205;1233;2971;965;2600;168;504;478;1221;646;1725
311250;202205;1468;3845;1131;3267;206;650;442;1155;648;1805
311260;202205;3107;7174;2046;5400;259;775;1008;2339;1267;3114
311265;202205;1515;3538;1128;2930;48;158;828;2064;876;2222
311270;202205;3377;9349;2916;8630;164;702;2115;5983;2279;6685
311280;202205;1278;3247;718;2162;151;506;153;410;304;916
311290;202205;2095;5945;1894;5554;112;370;1291;3729;1403;4099
311300;202205;5267;13361;4347;11853;213;704;3508;9344;3721;10048
311310;202205;650;1685;552;1512;36;100;365;958;401;1058
311320;202205;3639;10409;3172;9426;277;1041;1744;4673;2021;5714
311330;202205;6987;15854;5573;13731;467;1298;3422;8160;3889;9458
311340;202205;12321;32001;9819;27783;2134;6549;3434;9153;5568;15702
311350;202205;2723;6223;2000;4982;197;554;1108;2464;1305;3018
311360;202205;1252;2903;872;2379;239;700;327;924;566;1624
311370;202205;5415;12303;4030;10188;400;1202;2418;5665;2818;6867
311380;202205;439;1291;327;1064;56;183;160;521;216;704
311390;202205;1953;5622;1567;5112;655;2369;405;1171;1060;3540
311400;202205;1824;4678;1338;3797;234;698;389;909;623;1607
311410;202205;2156;5917;1732;5244;221;774;985;2838;1206;3612
311420;202205;1786;4914;1347;4093;281;983;448;1126;729;2109
311430;202205;5075;12661;3435;9567;462;1353;1474;3855;1936;5208
311440;202205;3433;8927;2659;7684;695;2294;679;1851;1374;4145
311450;202205;2300;6465;1609;5105;422;1502;372;959;794;2461
311455;202205;1189;2549;836;2047;107;264;478;1151;585;1415
311460;202205;632;1789;428;1369;80;298;101;257;181;555
311470;202205;577;1686;404;1320;105;383;58;191;163;574
311480;202205;1297;2939;1070;2612;85;205;822;1993;907;2198
311490;202205;303;856;232;726;35;132;102;285;137;417
311500;202205;542;1269;426;1096;32;100;273;665;305;765
311510;202205;3889;9242;2791;7454;304;927;1399;3390;1703;4317
311520;202205;731;1877;640;1710;56;180;404;1057;460;1237
311530;202205;10318;22704;7051;17725;1408;4051;2624;6113;4032;10164
311535;202205;946;2433;682;1909;106;323;303;793;409;1116
311540;202205;574;1646;504;1527;63;227;367;1082;430;1309
311545;202205;2231;5993;1936;5544;99;330;1517;4284;1616;4614
311547;202205;1913;4072;1678;3743;50;104;1387;3010;1437;3114
311550;202205;3378;8603;2748;7531;384;1166;1267;3196;1651;4362
311560;202205;356;717;220;508;37;93;83;160;120;253
311570;202205;1703;3774;1195;3077;48;132;896;2350;944;2482
311580;202205;2524;4621;1759;3706;148;300;1248;2554;1396;2854
311590;202205;670;1644;555;1483;72;216;347;889;419;1105
311600;202205;1778;3987;1475;3583;145;403;1102;2601;1247;3004
311610;202205;2603;7382;2165;6566;136;490;1424;4136;1560;4626
311615;202205;3961;9836;3186;8605;128;431;2574;6763;2702;7194
311620;202205;626;1591;480;1370;60;190;281;755;341;945
311630;202205;1485;3872;1213;3322;134;354;737;1989;871;2343
311640;202205;857;2173;683;1902;95;291;356;923;451;1214
311650;202205;2183;5086;1758;4446;204;548;1077;2622;1281;3170
311660;202205;3417;9279;2558;7629;399;1309;719;1682;1118;2991
311670;202205;1838;4386;1373;3584;153;457;697;1753;850;2210
311680;202205;2549;6505;1967;5526;144;396;1368;3881;1512;4277
311690;202205;675;1336;510;1132;33;73;370;838;403;911
311700;202205;2363;5318;1827;4560;22;89;1531;3702;1553;3791
311710;202205;1779;4835;1311;4050;312;1027;482;1471;794;2498
311720;202205;474;1339;381;1169;49;165;202;616;251;781
311730;202205;4805;11503;3348;8784;810;2262;1357;3311;2167;5573
311740;202205;1107;2706;914;2439;74;154;718;1963;792;2117
311750;202205;4528;12407;3688;10977;319;1172;2427;6798;2746;7970
311760;202205;771;2026;596;1715;98;343;247;571;345;914
311770;202205;2519;6704;1987;5795;389;1221;805;2179;1194;3400
311780;202205;1615;4325;1206;3592;217;717;438;1145;655;1862
311783;202205;2620;6397;2148;5649;59;244;1765;4438;1824;4682
311787;202205;939;2550;741;2123;109;340;320;792;429;1132
311790;202205;1724;4546;1175;3520;232;791;376;1016;608;1807
311800;202205;5707;16083;4566;13719;950;2906;828;2004;1778;4910
311810;202205;1054;2910;845;2551;56;179;568;1691;624;1870
311820;202205;1043;2303;818;1977;50;157;571;1281;621;1438
311830;202205;9665;25967;7064;20632;2032;6161;1357;3853;3389;10014
311840;202205;4332;10037;3480;8856;247;647;2616;6624;2863;7271
311850;202205;401;975;317;832;14;52;218;539;232;591
311860;202205;78470;183453;62042;156306;6672;19128;39252;92471;45924;111599
311870;202205;2107;5323;1491;4280;260;899;635;1629;895;2528
311880;202205;7231;17375;6057;15764;364;886;4529;11940;4893;12826
311890;202205;2038;4444;1602;3852;58;203;1236;2792;1294;2995
311900;202205;806;1924;619;1680;105;259;341;963;446;1222
311910;202205;4773;11306;3697;9913;698;1859;1850;5010;2548;6869
311920;202205;2459;5885;1985;5218;113;280;1373;3606;1486;3886
311930;202205;5031;10775;3771;9107;780;2089;1844;4081;2624;6170
311940;202205;18082;44368;13356;35800;1722;5089;6283;15492;8005;20581
311950;202205;2664;6522;2013;5403;193;543;1221;3250;1414;3793
311960;202205;556;1302;442;1136;49;150;232;530;281;680
311970;202205;477;1451;356;1162;68;260;92;256;160;516
311980;202205;515;1313;284;858;32;115;105;286;137;401
311990;202205;596;1367;389;1052;65;213;167;387;232;600
311995;202205;1074;2902;573;1763;31;111;87;176;118;287
312000;202205;914;2029;692;1712;37;104;504;1222;541;1326
312010;202205;1212;2961;969;2590;37;141;710;1801;747;1942
312015;202205;1532;4060;1361;3789;58;239;1096;2951;1154;3190
312020;202205;2005;5814;1441;4554;264;900;335;924;599;1824
312030;202205;2409;5103;2069;4720;48;160;1901;4271;1949;4431
312040;202205;940;2629;677;2114;107;324;302;910;409;1234
312050;202205;1348;3882;1095;3436;229;897;411;1148;640;2045
312060;202205;1076;2497;709;1995;154;449;326;880;480;1329
312070;202205;1035;2742;748;2189;41;147;457;1228;498;1375
312080;202205;3212;7464;2494;6414;133;398;1713;4115;1846;4513
312083;202205;1118;2544;869;2179;49;168;685;1641;734;1809
312087;202205;2921;6688;2375;5875;84;211;1942;4767;2026;4978
312090;202205;12677;30894;10038;26765;1116;3448;5838;14588;6954;18036
312100;202205;1851;4814;1438;4129;101;396;931;2489;1032;2885
312110;202205;1110;3271;913;2875;161;614;415;1186;576;1800
312120;202205;1138;2976;799;2365;185;645;272;676;457;1321
312125;202205;2141;4997;1820;4567;102;310;1455;3521;1557;3831
312130;202205;1279;2907;948;2368;87;260;482;1065;569;1325
312140;202205;798;2228;664;1957;114;371;316;864;430;1235
312150;202205;543;1392;463;1249;26;81;310;778;336;859
312160;202205;10662;26582;8342;22673;917;2904;4414;11180;5331;14084
312170;202205;1013;2462;778;2039;47;145;513;1299;560;1444
312180;202205;1576;3924;1290;3438;141;402;751;1909;892;2311
312190;202205;876;2245;678;1905;63;209;364;950;427;1159
312200;202205;5423;13512;4293;11738;600;1619;2470;6617;3070;8236
312210;202205;1587;3204;1202;2681;50;150;965;2075;1015;2225
312220;202205;1862;5252;1590;4772;133;437;1059;3155;1192;3592
312230;202205;19812;47580;14321;38213;2877;8707;4748;10696;7625;19403
312235;202205;2363;5379;1887;4723;203;473;1297;3180;1500;3653
312240;202205;882;2631;679;2214;143;483;226;724;369;1207
312245;202205;3385;7217;2853;6464;33;93;2568;5697;2601;5790
312247;202205;1246;2630;881;2103;103;255;564;1291;667;1546
312250;202205;1027;2610;656;1908;98;299;217;603;315;902
312260;202205;1127;2735;900;2395;47;181;711;1790;758;1971
312270;202205;807;2119;622;1760;33;126;352;890;385;1016
312280;202205;482;1332;383;1157;80;271;127;340;207;611
312290;202205;1030;2780;856;2502;152;502;304;811;456;1313
312300;202205;1212;3472;864;2657;194;651;185;462;379;1113
312310;202205;1109;3074;897;2669;117;400;475;1324;592;1724
312320;202205;2379;5679;1746;4633;358;936;474;1233;832;2169
312330;202205;1035;2739;855;2397;101;306;515;1372;616;1678
312340;202205;276;666;198;546;28;108;112;264;140;372
312350;202205;300;584;214;488;14;36;147;300;161;336
312352;202205;1727;4984;1521;4598;280;871;729;2389;1009;3260
312360;202205;3665;9834;2784;8249;519;1721;1151;3126;1670;4847
312370;202205;2293;5472;1878;4832;206;622;1189;2879;1395;3501
312380;202205;2485;5190;2053;4651;11;38;1801;3977;1812;4015
312385;202205;1422;3560;1111;3025;347;947;289;837;636;1784
312390;202205;2181;5825;1615;4776;251;823;468;1216;719;2039
312400;202205;3462;9232;2952;8416;853;2605;972;2807;1825;5412
312410;202205;15519;38680;12844;34498;1587;4616;8249;21311;9836;25927
312420;202205;4591;11337;3782;10073;726;2126;1958;4985;2684;7111
312430;202205;9705;22922;7956;19969;256;831;6045;14498;6301;15329
312440;202205;1123;3367;941;3006;439;1445;187;606;626;2051
312450;202205;1497;4085;1153;3480;263;842;489;1469;752;2311
312460;202205;542;1259;396;1047;32;99;254;653;286;752
312470;202205;524;1258;333;921;47;138;104;242;151;380
312480;202205;1182;2793;854;2315;71;233;484;1222;555;1455
312490;202205;2833;5942;2268;5177;163;417;1476;3222;1639;3639
312500;202205;1191;2660;997;2404;39;138;767;1808;806;1946
312510;202205;5126;12943;3712;10353;826;2281;1119;2919;1945;5200
312520;202205;383;909;301;784;51;168;177;429;228;597
312530;202205;762;1652;643;1510;34;77;471;1135;505;1212
312540;202205;1772;4561;1226;3545;134;391;696;1933;830;2324
312550;202205;935;2255;707;1832;42;122;456;1082;498;1204
312560;202205;2048;5127;1596;4416;97;294;1139;3111;1236;3405
312570;202205;2944;6416;2226;5531;414;952;1149;2930;1563;3882
312580;202205;697;1817;483;1378;52;185;231;598;283;783
312590;202205;1732;4674;1352;3929;131;459;802;2109;933;2568
312595;202205;2374;6329;1959;5686;264;692;1207;3701;1471;4393
312600;202205;1418;3252;937;2306;129;397;280;693;409;1090
312610;202205;8079;19533;5537;14952;814;2472;2103;4990;2917;7462
312620;202205;2811;6666;2132;5726;66;268;1713;4583;1779;4851
312630;202205;362;953;261;774;43;158;114;308;157;466
312640;202205;600;1575;446;1330;42;157;237;660;279;817
312650;202205;2379;5484;1692;4260;60;197;1249;2913;1309;3110
312660;202205;1510;3377;1169;2826;102;250;808;1844;910;2094
312670;202205;6451;14588;5408;13021;146;593;4332;9746;4478;10339
312675;202205;1382;3342;1132;2989;44;153;925;2373;969;2526
312680;202205;1749;4133;1556;3855;46;180;1370;3277;1416;3457
312690;202205;3280;6583;2481;5595;121;237;1939;4342;2060;4579
312695;202205;1171;2799;994;2521;40;79;823;2059;863;2138
312700;202205;2323;5867;1687;4735;167;542;958;2540;1125;3082
312705;202205;1851;3692;1635;3394;12;41;1542;3165;1554;3206
312707;202205;1581;4187;1117;3355;49;212;755;2114;804;2326
312710;202205;8002;17594;5166;13338;1264;3178;1745;4686;3009;7864
312720;202205;1237;3040;945;2586;91;293;632;1623;723;1916
312730;202205;1773;4009;1272;3334;108;315;797;2016;905;2331
312733;202205;1495;3772;1126;3098;45;161;764;1953;809;2114
312735;202205;880;2154;700;1822;61;163;446;1074;507;1237
312737;202205;914;1896;664;1548;60;160;464;1036;524;1196
312738;202205;869;2066;628;1654;53;170;393;951;446;1121
312740;202205;488;1198;310;904;66;207;88;197;154;404
312750;202205;1703;4595;1256;3787;161;549;606;1698;767;2247
312760;202205;2043;5681;1487;4573;233;733;593;1748;826;2481
312770;202205;50976;117156;33287;87498;5618;16142;13238;32861;18856;49003
312780;202205;2890;7737;2445;7015;266;805;1586;4452;1852;5257
312790;202205;267;622;141;416;6;25;33;64;39;89
312800;202205;6171;15871;4865;13495;609;1980;2696;6972;3305;8952
312810;202205;1780;4587;1203;3620;304;972;422;1170;726;2142
312820;202205;1956;4877;1585;4257;90;254;1151;3025;1241;3279
312825;202205;1682;3423;1439;3118;28;72;1251;2642;1279;2714
312830;202205;3127;8313;2022;6157;442;1440;570;1615;1012;3055
312840;202205;1647;4055;1293;3487;114;377;741;1866;855;2243
312850;202205;1186;2507;862;2054;25;99;601;1298;626;1397
312860;202205;1223;2997;842;2412;207;630;257;658;464;1288
312870;202205;6862;17498;4426;12976;716;2231;1293;3412;2009;5643
312880;202205;1638;3892;1287;3326;75;188;759;1930;834;2118
312890;202205;2624;6022;1958;4967;129;299;1134;2803;1263;3102
312900;202205;1472;3524;1213;3181;117;362;732;1931;849;2293
312910;202205;1676;2988;973;2087;148;297;490;1011;638;1308
312920;202205;1079;2772;774;2292;129;443;286;747;415;1190
312930;202205;2714;6200;2043;5216;366;953;1010;2624;1376;3577
312940;202205;1152;2901;922;2586;80;292;533;1385;613;1677
312950;202205;3617;8304;2523;6620;408;1197;1277;3142;1685;4339
312960;202205;2023;4933;1683;4425;106;239;1230;3341;1336;3580
312965;202205;1889;4687;1559;4182;139;368;1039;2776;1178;3144
312970;202205;1733;4572;1416;4088;144;515;882;2387;1026;2902
312980;202205;28913;74652;23622;65404;4046;12168;11762;30593;15808;42761
312990;202205;600;1393;420;1099;61;188;220;518;281;706
313000;202205;527;1420;399;1196;25;108;254;713;279;821
313005;202205;2816;7560;2364;6826;128;386;1736;4861;1864;5247
313010;202205;6357;16097;5124;14137;733;2247;3146;8381;3879;10628
313020;202205;1234;3577;928;2935;158;561;211;586;369;1147
313030;202205;1330;2800;934;2257;57;177;675;1538;732;1715
313040;202205;957;2786;802;2490;39;170;512;1516;551;1686
313050;202205;2060;5333;1444;4406;238;851;427;1152;665;2003
313055;202205;2166;5360;1903;4985;419;1126;1228;3167;1647;4293
313060;202205;1180;2722;888;2232;195;570;218;504;413;1074
313065;202205;1865;5035;1643;4674;48;206;1346;3705;1394;3911
313070;202205;1030;2595;807;2235;79;232;448;1189;527;1421
313080;202205;432;1145;324;953;58;195;126;307;184;502
313090;202205;6083;14666;5088;13112;315;875;3543;8972;3858;9847
313100;202205;1502;3671;1187;3217;43;159;885;2306;928;2465
313110;202205;1700;4244;1221;3415;111;366;641;1600;752;1966
313115;202205;3267;8607;2635;7467;269;930;1523;3921;1792;4851
313120;202205;4272;9659;3139;8163;206;551;2122;5519;2328;6070
313130;202205;36854;88804;28267;73808;2710;8201;16621;40337;19331;48538
313140;202205;844;1712;576;1361;35;89;445;1039;480;1128
313150;202205;1574;4240;1190;3574;367;1219;222;579;589;1798
313160;202205;1493;3502;1159;3016;26;95;891;2215;917;2310
313170;202205;13082;34779;9845;28815;1623;5224;3840;10098;5463;15322
313180;202205;2761;6770;2059;5350;198;519;1349;3357;1547;3876
313190;202205;5024;13559;3717;11027;649;2088;1406;3797;2055;5885
313200;202205;1308;3207;1115;2879;22;78;925;2295;947;2373
313210;202205;4494;11560;3726;10326;409;1290;2369;6247;2778;7537
313220;202205;2067;5176;1411;3922;166;510;663;1628;829;2138
313230;202205;3169;8267;2582;7530;69;222;2089;6183;2158;6405
313240;202205;12270;28518;8559;22808;935;2975;4677;11493;5612;14468
313250;202205;7054;19519;5454;16154;978;2941;2562;7227;3540;10168
313260;202205;888;2097;639;1699;77;280;346;784;423;1064
313270;202205;7314;15715;6076;14088;498;1088;4741;11067;5239;12155
313280;202205;519;1337;351;1013;46;156;162;438;208;594
313290;202205;1148;3442;884;2971;203;777;335;1075;538;1852
313300;202205;2052;5236;1583;4449;344;1049;554;1384;898;2433
313310;202205;1547;4338;1251;3731;206;735;450;1094;656;1829
313320;202205;2261;5694;1612;4664;314;972;617;1833;931;2805
313330;202205;4694;11403;3583;9772;228;708;2387;6402;2615;7110
313340;202205;1745;3667;1298;3059;80;221;951;2146;1031;2367
313350;202205;3390;8905;2325;6648;233;796;1016;2478;1249;3274
313360;202205;1818;4205;1262;3336;191;609;653;1558;844;2167
313370;202205;1812;4683;1440;3974;266;780;583;1455;849;2235
313375;202205;2136;5344;1406;4040;244;811;397;1003;641;1814
313380;202205;7670;18178;5706;14651;797;2392;3051;6899;3848;9291
313390;202205;894;2636;772;2420;55;237;517;1534;572;1771
313400;202205;4254;9674;3279;8287;154;447;2514;6200;2668;6647
313410;202205;1581;3824;1169;3126;261;713;606;1553;867;2266
313420;202205;17810;38244;10029;25681;2412;6700;1895;4628;4307;11328
313430;202205;1287;3188;1066;2790;85;319;724;1699;809;2018
313440;202205;7592;15180;5413;12464;220;580;4107;9216;4327;9796
313450;202205;840;2114;607;1694;109;323;215;503;324;826
313460;202205;2540;6753;2029;5943;358;1179;1008;2845;1366;4024
313470;202205;3173;7515;2538;6591;136;417;1954;4982;2090;5399
313480;202205;1218;3299;762;2347;74;259;291;812;365;1071
313490;202205;3492;8425;1947;5626;348;1101;591;1593;939;2694
313500;202205;648;1638;464;1273;45;123;210;530;255;653
313505;202205;11409;27907;9697;25585;381;1163;7753;20289;8134;21452
313507;202205;1586;3774;1269;3299;47;172;993;2486;1040;2658
313510;202205;16893;42872;13231;35945;1310;3843;7253;18396;8563;22239
313520;202205;17473;43377;14121;37913;655;2122;10927;28328;11582;30450
313530;202205;652;1841;494;1510;62;226;210;551;272;777
313535;202205;2633;6869;2134;5936;244;638;1315;3628;1559;4266
313540;202205;950;2588;759;2156;108;330;372;944;480;1274
313545;202205;1266;3920;1075;3556;123;478;601;1909;724;2387
313550;202205;2329;6311;1947;5444;206;635;1297;3514;1503;4149
313560;202205;3293;5716;2473;4751;37;73;2194;4162;2231;4235
313570;202205;1130;3048;936;2715;177;522;452;1275;629;1797
313580;202205;6836;15648;5400;13387;411;1150;3693;8810;4104;9960
313590;202205;1284;3214;1042;2877;207;566;551;1607;758;2173
313600;202205;4927;11323;4158;10197;83;318;3685;8774;3768;9092
313610;202205;1166;2735;956;2381;78;221;631;1458;709;1679
313620;202205;6315;15736;5111;13637;460;1467;3303;8427;3763;9894
313630;202205;10174;23254;7335;19056;696;2143;4547;11295;5243;13438
313640;202205;1463;2862;967;2238;81;211;676;1529;757;1740
313650;202205;1859;5287;1469;4641;112;408;918;2935;1030;3343
313652;202205;964;2587;864;2419;57;203;651;1721;708;1924
313655;202205;1322;3011;1028;2649;74;191;743;1900;817;2091
313657;202205;1306;3220;1024;2770;39;150;758;1893;797;2043
313660;202205;1250;3118;1042;2774;72;262;758;1890;830;2152
313665;202205;6263;15258;5018;13125;383;1187;3416;8344;3799;9531
313670;202205;61058;142339;41647;110495;5209;15394;20939;51928;26148;67322
313680;202205;1233;2945;1011;2595;53;138;682;1651;735;1789
313690;202205;1087;3082;790;2502;158;555;235;683;393;1238
313695;202205;2044;5068;1525;4216;107;293;1025;2896;1132;3189
313700;202205;3195;9271;2744;8693;222;749;2179;6923;2401;7672
313710;202205;1668;3546;1201;2946;96;264;806;1936;902;2200
313720;202205;6968;18023;5097;14290;688;2099;2307;5842;2995;7941
313730;202205;1623;3241;1218;2723;89;166;803;1785;892;1951
313740;202205;1862;6375;1580;5686;354;1459;392;1250;746;2709
313750;202205;2503;6084;2012;5287;301;910;1159;2778;1460;3688
313753;202205;2438;5689;1643;4410;231;710;729;1833;960;2543
313760;202205;6648;17262;5275;14741;821;2540;2665;6827;3486;9367
313770;202205;4636;12162;3673;10675;203;567;2777;8182;2980;8749
313780;202205;4618;11373;3440;9554;424;1142;1147;3301;1571;4443
313790;202205;639;1739;554;1583;73;221;332;911;405;1132
313800;202205;1553;3288;1137;2726;94;266;653;1448;747;1714
313810;202205;1943;4462;1571;3949;52;183;1267;3083;1319;3266
313820;202205;20076;48993;13319;35145;2208;5989;3905;9575;6113;15564
313830;202205;458;1267;337;1012;59;204;143;391;202;595
313835;202205;1024;2744;846;2449;85;310;455;1196;540;1506
313840;202205;9037;22257;7169;19306;1585;4504;2036;5455;3621;9959
313850;202205;1124;2563;893;2249;140;402;469;1081;609;1483
313860;202205;3126;7703;2398;6437;314;1002;1196;2876;1510;3878
313862;202205;1354;2810;700;1873;41;121;336;911;377;1032
313865;202205;2945;7158;2424;6349;80;245;1851;4647;1931;4892
313867;202205;1600;4535;1269;3904;242;745;662;2124;904;2869
313868;202205;1933;5385;1571;4733;53;206;1195;3448;1248;3654
313870;202205;1189;2870;802;2197;92;270;358;872;450;1142
313880;202205;2260;5524;1690;4561;168;546;951;2321;1119;2867
313890;202205;2610;4949;1966;4129;49;138;1554;3125;1603;3263
313900;202205;5807;15383;4139;12031;948;3017;1240;3105;2188;6122
313910;202205;839;2337;640;1943;119;380;153;463;272;843
313920;202205;3231;9005;2667;7893;439;1368;1424;4180;1863;5548
313925;202205;1897;4414;1517;3767;159;372;1002;2454;1161;2826
313930;202205;5621;14758;4533;12924;292;959;3121;8658;3413;9617
313940;202205;11135;30343;8648;26236;1564;5092;2279;7481;3843;12573
313950;202205;6421;12861;4999;11122;246;634;3642;7971;3888;8605
313960;202205;6600;14985;4440;11434;727;2165;1699;3824;2426;5989
313970;202205;1775;4379;1514;3965;52;156;1034;2598;1086;2754
313980;202205;1539;3835;1070;3133;184;613;476;1318;660;1931
313990;202205;2267;6563;1744;5472;265;1037;925;2549;1190;3586
314000;202205;11934;27962;9704;24280;659;2043;6430;15620;7089;17663
314010;202205;1592;3564;1259;3110;38;139;973;2288;1011;2427
314015;202205;2474;6325;1960;5452;195;651;1174;3044;1369;3695
314020;202205;585;1490;398;1174;120;427;53;155;173;582
314030;202205;925;2469;722;2092;102;298;336;951;438;1249
314040;202205;699;1817;589;1623;76;259;323;846;399;1105
314050;202205;2187;5382;1632;4404;102;349;999;2456;1101;2805
314053;202205;2358;6318;1913;5466;310;812;1123;3331;1433;4143
314055;202205;2627;6106;2217;5529;75;220;1812;4526;1887;4746
314060;202205;1486;3685;1123;3114;36;130;801;2158;837;2288
314070;202205;5614;14098;4520;12247;666;1850;2430;6382;3096;8232
314080;202205;2266;5595;1641;4589;151;499;753;1879;904;2378
314085;202205;2667;6695;2145;5949;221;614;1352;3714;1573;4328
314090;202205;5806;13954;5020;12842;404;1044;3353;8768;3757;9812
314100;202205;3382;7762;2626;6734;59;169;1942;5000;2001;5169
314110;202205;5682;14938;4671;13109;485;1515;2639;6774;3124;8289
314120;202205;797;1766;374;1018;72;223;125;301;197;524
314130;202205;756;1900;516;1464;29;103;328;887;357;990
314140;202205;5267;13389;4199;11496;411;1239;2427;6354;2838;7593
314150;202205;1652;3924;1190;3141;83;230;797;2056;880;2286
314160;202205;2699;6377;1957;5144;208;563;929;2360;1137;2923
314170;202205;1054;2712;842;2300;41;163;574;1431;615;1594
314180;202205;6328;15993;5057;14033;453;1276;2962;8156;3415;9432
314190;202205;711;1667;537;1422;58;189;332;815;390;1004
314200;202205;3348;8832;2774;7908;214;621;1858;5195;2072;5816
314210;202205;2311;5675;1823;4834;282;779;725;1838;1007;2617
314220;202205;1814;4679;1442;4093;216;724;695;1803;911;2527
314225;202205;1209;3279;988;2880;97;275;657;1867;754;2142
314230;202205;1003;2437;807;2168;83;228;535;1433;618;1661
314240;202205;1236;3162;968;2777;203;614;437;1235;640;1849
314250;202205;498;1383;327;1015;41;142;131;358;172;500
314260;202205;1272;3077;1015;2735;225;594;477;1243;702;1837
314270;202205;3809;9824;3132;8784;105;372;2344;6449;2449;6821
314280;202205;4067;8943;2834;7146;273;775;1726;4064;1999;4839
314290;202205;5144;12277;4319;10888;278;737;3087;7529;3365;8266
314300;202205;2312;6191;1496;4487;291;934;507;1362;798;2296
314310;202205;4372;11055;3032;8829;885;2883;463;1196;1348;4079
314315;202205;1093;3170;914;2812;51;197;643;1913;694;2110
314320;202205;3665;9322;2484;7162;392;1299;1023;2693;1415;3992
314330;202205;60556;161342;46954;137795;10929;33067;13301;39045;24230;72112
314340;202205;2905;6974;1926;5275;372;1169;629;1460;1001;2629
314345;202205;1694;4473;1395;3963;107;320;992;2725;1099;3045
314350;202205;950;2475;643;1924;133;430;149;330;282;760
314360;202205;613;1697;408;1262;59;192;123;335;182;527
314370;202205;844;2063;681;1819;45;144;471;1196;516;1340
314380;202205;1318;3420;921;2761;216;727;283;815;499;1542
314390;202205;17067;40285;12032;31774;1680;4993;5037;11634;6717;16627
314400;202205;4531;12854;3514;10902;988;3187;1299;4199;2287;7386
314410;202205;3364;9001;2356;7061;430;1481;595;1753;1025;3234
314420;202205;900;2098;669;1741;28;91;443;1095;471;1186
314430;202205;9140;20462;6577;16456;908;2360;3316;7892;4224;10252
314435;202205;2122;5353;1660;4633;249;729;924;2505;1173;3234
314437;202205;1013;2406;740;1969;65;183;451;1172;516;1355
314440;202205;679;1861;488;1493;139;478;111;276;250;754
314450;202205;1669;4117;1384;3662;168;487;780;1943;948;2430
314460;202205;3809;10788;2881;8960;710;2367;969;2737;1679;5104
314465;202205;2642;6857;2157;5970;56;219;1684;4438;1740;4657
314467;202205;1091;2646;909;2351;64;187;648;1617;712;1804
314470;202205;2545;6850;2115;6041;313;969;1080;2904;1393;3873
314480;202205;8995;23578;6958;19512;1021;3160;3075;7680;4096;10840
314490;202205;1209;2970;887;2358;70;214;593;1509;663;1723
314500;202205;2024;4592;1475;3891;345;896;560;1486;905;2382
314505;202205;2483;5361;2039;4762;117;262;1561;3547;1678;3809
314510;202205;2314;5776;1686;4848;422;1345;685;1898;1107;3243
314520;202205;6779;19289;5424;16701;1200;4004;1289;3597;2489;7601
314530;202205;6181;17760;5529;16603;291;1147;4200;12141;4491;13288
314535;202205;3075;7105;2475;6246;125;373;1939;4846;2064;5219
314537;202205;1378;3582;1059;3083;72;197;743;2121;815;2318
314540;202205;488;1148;356;942;15;40;209;510;224;550
314545;202205;2231;4797;2000;4531;52;138;1720;3938;1772;4076
314550;202205;854;1927;578;1497;43;140;333;765;376;905
314560;202205;5417;14903;4118;12209;522;1873;1813;4645;2335;6518
314570;202205;352;934;252;754;25;86;127;380;152;466
314580;202205;540;1526;433;1313;95;285;163;483;258;768
314585;202205;756;2162;586;1809;49;173;280;808;329;981
314587;202205;2539;6332;1975;5436;501;1275;1013;2840;1514;4115
314590;202205;4880;12332;3767;10375;435;1376;1895;4784;2330;6160
314600;202205;2112;5530;1370;4181;328;1060;184;508;512;1568
314610;202205;10674;25239;8245;21557;984;3110;4103;10935;5087;14045
314620;202205;2735;5761;2222;5119;111;234;1837;4241;1948;4475
314625;202205;1769;4315;1509;3960;35;162;1281;3257;1316;3419
314630;202205;5933;13868;4798;12311;176;532;3898;9870;4074;10402
314640;202205;860;1848;657;1535;47;136;458;986;505;1122
314650;202205;949;2118;632;1627;60;188;377;870;437;1058
314655;202205;1712;4430;1218;3596;168;481;620;1835;788;2316
314660;202205;395;822;289;647;15;34;206;438;221;472
314670;202205;1872;3912;1302;3137;25;71;921;2130;946;2201
314675;202205;1884;4518;1597;4060;94;250;1251;3115;1345;3365
314690;202205;2322;6000;1769;5181;430;1278;729;2112;1159;3390
314700;202205;13012;33729;9034;26567;1458;4700;3988;11066;5446;15766
314710;202205;9443;25027;7063;20171;995;3177;2876;7166;3871;10343
314720;202205;2582;7277;1835;5769;348;1180;411;1132;759;2312
314730;202205;2803;6954;1993;5521;341;1043;740;1838;1081;2881
314740;202205;3614;9465;2867;8187;433;1324;1525;4144;1958;5468
314750;202205;328;826;254;675;30;96;152;358;182;454
314760;202205;2118;5948;1384;4334;221;811;403;994;624;1805
314770;202205;1164;3218;700;2140;101;313;211;596;312;909
314780;202205;403;970;290;791;30;104;167;413;197;517
314790;202205;13699;34492;10053;28019;1530;4830;4519;11848;6049;16678
314795;202205;1706;4140;1453;3734;46;179;1151;2800;1197;2979
314800;202205;12764;31182;8540;23715;1443;4384;2926;7198;4369;11582
314810;202205;11299;28083;8549;23555;2055;5963;3235;8514;5290;14477
314820;202205;1489;3338;1168;2870;75;231;752;1752;827;1983
314830;202205;1949;5187;1605;4603;164;495;948;2611;1112;3106
314840;202205;982;2848;770;2472;53;243;546;1662;599;1905
314850;202205;2778;5341;2270;4724;38;106;2059;4225;2097;4331
314860;202205;3740;9889;3126;8820;159;595;2270;6135;2429;6730
314870;202205;7705;16296;5937;14146;289;683;4550;10981;4839;11664
314875;202205;2124;5858;1876;5530;233;560;1392;4209;1625;4769
314880;202205;921;2134;708;1807;43;124;446;1093;489;1217
314890;202205;510;1449;397;1234;56;193;190;535;246;728
314900;202205;972;2310;753;1950;87;265;389;960;476;1225
314910;202205;1912;5104;1425;4312;219;777;709;1990;928;2767
314915;202205;2426;6588;1992;5836;155;465;1304;3785;1459;4250
314920;202205;605;1452;423;1194;18;57;296;840;314;897
314930;202205;6775;17949;5279;15203;834;2709;2377;6218;3211;8927
314940;202205;468;1052;388;925;29;66;278;629;307;695
314950;202205;699;1665;490;1353;46;167;276;690;322;857
314960;202205;1041;2279;819;1934;54;140;594;1340;648;1480
314970;202205;1227;3465;954;2929;152;506;436;1239;588;1745
314980;202205;2061;4953;1613;4305;181;548;1050;2712;1231;3260
314990;202205;3073;8440;2256;6689;377;1173;607;1593;984;2766
314995;202205;1904;4937;1503;4238;50;190;998;2632;1048;2822
315000;202205;1276;3038;928;2501;90;268;591;1545;681;1813
315010;202205;449;1156;360;1016;41;146;217;574;258;720
315015;202205;2762;7101;2409;6529;221;717;1684;4409;1905;5126
315020;202205;897;2461;644;1963;67;256;316;888;383;1144
315030;202205;727;1802;503;1414;162;437;115;292;277;729
315040;202205;1079;2700;903;2424;155;431;553;1396;708;1827
315050;202205;1356;3275;1012;2759;84;274;530;1361;614;1635
315053;202205;1365;3281;1020;2697;83;271;618;1527;701;1798
315057;202205;2054;5537;1632;4834;152;372;1052;3313;1204;3685
315060;202205;768;2152;570;1766;114;379;157;449;271;828
315070;202205;803;1816;623;1532;101;294;344;725;445;1019
315080;202205;3673;9249;2839;7799;140;463;2040;5305;2180;5768
315090;202205;915;2586;706;2229;91;315;313;906;404;1221
315100;202205;1590;4408;1078;3304;134;495;500;1337;634;1832
315110;202205;2443;5431;1802;4500;153;356;1044;2573;1197;2929
315120;202205;14464;31617;10803;26246;1145;2612;6508;15852;7653;18464
315130;202205;1938;5007;1654;4536;171;553;795;1991;966;2544
315140;202205;3445;8996;2765;7843;534;1679;1451;3829;1985;5508
315150;202205;5022;11922;3641;9739;525;1612;1760;4556;2285;6168
315160;202205;2165;4961;1509;3952;247;686;774;1963;1021;2649
315170;202205;1547;4680;1121;3685;223;772;328;1035;551;1807
315180;202205;20052;46884;12012;32652;1581;4932;4556;10852;6137;15784
315190;202205;2452;5122;1926;4450;181;411;1450;3371;1631;3782
315200;202205;5001;13020;3764;10977;1032;3178;1224;3412;2256;6590
315210;202205;10111;24783;7202;19081;678;1994;3688;8688;4366;10682
315213;202205;1200;3018;1043;2801;22;87;860;2247;882;2334
315217;202205;3097;8286;2360;7067;112;474;1647;4695;1759;5169
315220;202205;9858;25076;7817;21675;640;1648;4363;12209;5003;13857
315230;202205;3366;7106;2747;6289;191;360;1820;4340;2011;4700
315240;202205;2793;7522;2321;6721;483;1459;1141;3290;1624;4749
315250;202205;16546;42031;12401;34507;1840;5606;5687;14622;7527;20228
315260;202205;1031;2652;611;1819;137;404;65;173;202;577
315270;202205;1076;2904;809;2409;132;440;322;835;454;1275
315280;202205;3414;8182;2272;6213;595;1700;509;1380;1104;3080
315290;202205;1343;3160;837;2378;195;600;319;872;514;1472
315300;202205;763;1757;563;1458;31;94;399;1015;430;1109
315310;202205;1447;3498;1118;2949;98;298;743;1793;841;2091
315320;202205;736;2059;521;1635;69;258;205;603;274;861
315330;202205;852;2612;513;1778;60;243;206;617;266;860
315340;202205;3322;7723;2306;6188;454;1260;1010;2646;1464;3906
315350;202205;2102;4995;1758;4480;155;447;1274;3124;1429;3571
315360;202205;1973;5400;1563;4626;214;655;717;1981;931;2636
315370;202205;633;1661;510;1435;68;191;252;679;320;870
315380;202205;289;770;199;591;39;114;23;47;62;161
315390;202205;1373;3649;1113;3205;101;373;644;1669;745;2042
315400;202205;4672;11723;3737;10117;425;1282;2284;5817;2709;7099
315410;202205;2732;5880;2007;4832;381;1015;482;1156;863;2171
315415;202205;1674;4307;1361;3809;342;1111;378;987;720;2098
315420;202205;1696;4521;1213;3653;253;817;324;858;577;1675
315430;202205;4104;9540;2900;7774;462;1404;1436;3691;1898;5095
315440;202205;1177;2859;927;2473;77;250;564;1378;641;1628
315445;202205;2372;5046;1772;4221;66;214;1454;3351;1520;3565
315450;202205;2542;6510;2080;5777;223;608;1349;3680;1572;4288
315460;202205;49250;124731;41533;111690;4319;13955;26678;66568;30997;80523
315470;202205;761;2017;543;1512;46;146;277;701;323;847
315480;202205;1445;3879;1063;3095;154;470;466;1261;620;1731
315490;202205;3298;7818;2322;6270;308;874;956;2420;1264;3294
315500;202205;596;1525;382;1100;31;106;211;537;242;643
315510;202205;1545;3566;1293;3220;12;56;1129;2711;1141;2767
315520;202205;1234;2974;1033;2670;43;126;846;2117;889;2243
315530;202205;818;1955;681;1729;65;200;498;1179;563;1379
315540;202205;1873;4696;1289;3620;115;401;571;1467;686;1868
315550;202205;2054;5275;1423;4129;261;893;449;1299;710;2192
315560;202205;7428;20289;6386;18491;373;1066;4621;13285;4994;14351
315570;202205;2811;6799;2024;5417;266;848;1036;2459;1302;3307
315580;202205;3682;8010;2901;6822;435;1079;1217;2686;1652;3765
315590;202205;1269;2699;1025;2345;44;170;784;1620;828;1790
315600;202205;2816;8059;1999;6494;407;1193;925;3218;1332;4411
315610;202205;1098;2610;831;2163;109;367;419;938;528;1305
315620;202205;594;1492;450;1270;50;154;233;651;283;805
315630;202205;1207;3055;918;2542;129;422;471;1167;600;1589
315640;202205;426;997;325;875;27;95;214;541;241;636
315645;202205;1116;2735;784;2216;146;444;224;613;370;1057
315650;202205;1974;4262;1601;3748;69;157;1272;2913;1341;3070
315660;202205;2388;5823;1797;4775;169;454;1120;2904;1289;3358
315670;202205;17439;43992;13659;37359;2203;6494;6978;17847;9181;24341
315680;202205;3555;9438;2665;7832;333;1065;1422;3975;1755;5040
315690;202205;4313;10065;2616;7186;504;1351;778;2235;1282;3586
315700;202205;9800;24854;7533;20571;783;2426;4084;10291;4867;12717
315710;202205;2062;4721;1479;3880;71;218;1004;2533;1075;2751
315720;202205;4924;12731;4061;11247;195;792;2891;7572;3086;8364
315725;202205;2601;6194;2057;5352;206;513;1349;3651;1555;4164
315727;202205;650;1586;479;1299;58;180;242;615;300;795
315730;202205;695;1966;600;1790;132;426;223;589;355;1015
315733;202205;1596;3795;1229;3228;180;529;558;1333;738;1862
315737;202205;1344;3463;996;2807;32;116;700;1882;732;1998
315740;202205;923;2458;748;2111;72;255;502;1318;574;1573
315750;202205;1462;3500;1148;3031;81;220;764;2016;845;2236
315760;202205;1360;2903;1146;2623;31;103;980;2153;1011;2256
315765;202205;2255;5246;1857;4742;29;100;1661;4213;1690;4313
315770;202205;1279;3345;1022;2991;341;1075;257;726;598;1801
315780;202205;35403;90508;29808;80833;1904;6414;20414;52121;22318;58535
315790;202205;4031;11566;3444;10477;334;1017;2074;6599;2408;7616
315800;202205;1469;4588;1126;3827;145;588;453;1341;598;1929
315810;202205;1533;3496;1285;3095;61;178;1014;2335;1075;2513
315820;202205;3296;7581;2678;6768;232;596;1968;4901;2200;5497
315830;202205;1392;3910;955;2960;105;362;288;735;393;1097
315840;202205;1002;2270;716;1791;49;143;394;883;443;1026
315850;202205;1350;3648;1072;3196;155;494;583;1653;738;2147
315860;202205;605;1581;440;1302;86;273;143;353;229;626
315870;202205;516;1335;411;1165;28;91;288;777;316;868
315880;202205;1293;3045;935;2437;118;356;384;857;502;1213
315890;202205;2058;5352;1689;4866;424;1274;806;2379;1230;3653
315895;202205;7224;18519;5447;15177;565;1832;2792;7075;3357;8907
315900;202205;910;2281;766;2062;73;247;520;1328;593;1575
315910;202205;635;1582;541;1447;53;156;414;1088;467;1244
315920;202205;1572;3825;927;2645;155;528;329;811;484;1339
315930;202205;1304;2712;900;2156;101;252;487;1104;588;1356
315935;202205;1162;3257;942;2843;185;570;391;1177;576;1747
315940;202205;698;1745;553;1542;83;254;297;773;380;1027
315950;202205;1350;3487;1135;3156;96;297;896;2440;992;2737
315960;202205;6390;17011;4516;13349;1045;3442;1031;2283;2076;5725
315970;202205;648;1652;523;1487;68;209;352;1011;420;1220
315980;202205;4894;10073;2860;6880;491;1256;1351;2922;1842;4178
315990;202205;3945;9668;3117;8279;326;927;1763;4457;2089;5384
316000;202205;846;1860;674;1616;60;168;436;987;496;1155
316010;202205;847;2256;628;1864;67;223;280;695;347;918
316020;202205;1043;2817;843;2444;103;342;497;1350;600;1692
316030;202205;3085;7935;2369;6674;338;929;1461;4172;1799;5101
316040;202205;3019;8273;2202;6741;385;1356;611;1589;996;2945
316045;202205;2552;5537;2344;5284;137;198;2059;4748;2196;4946
316050;202205;441;1155;344;997;36;101;201;538;237;639
316060;202205;808;1818;595;1538;27;86;434;1082;461;1168
316070;202205;6448;16591;5254;14390;749;2107;2735;7146;3484;9253
316080;202205;874;2570;687;2197;167;573;125;349;292;922
316090;202205;525;1350;436;1186;42;146;272;656;314;802
316095;202205;1460;4253;1136;3470;261;865;467;1320;728;2185
316100;202205;2750;7465;2056;6070;312;1057;865;2277;1177;3334
316105;202205;854;2099;677;1817;40;110;442;1216;482;1326
316110;202205;16021;41201;13338;36874;925;3013;9549;25518;10474;28531
316120;202205;1412;3608;928;2616;158;483;338;749;496;1232
316130;202205;1456;3106;980;2350;69;204;613;1373;682;1577
316140;202205;1340;3423;855;2491;136;410;315;891;451;1301
316150;202205;2468;5254;1964;4522;138;401;1101;2350;1239;2751
316160;202205;1128;2822;908;2434;41;145;665;1734;706;1879
316165;202205;1027;2279;815;1975;84;220;539;1237;623;1457
316170;202205;1470;3234;1137;2764;67;224;825;1854;892;2078
316180;202205;1734;4623;1241;3688;229;745;335;883;564;1628
316190;202205;3004;8149;1798;5360;242;762;742;1940;984;2702
316200;202205;4023;10639;3167;9210;554;1833;1350;3731;1904;5564
316210;202205;5977;16699;4277;12758;1429;4664;497;1264;1926;5928
316220;202205;763;2201;529;1745;101;341;93;324;194;665
316225;202205;1825;3844;1393;3198;45;172;1088;2270;1133;2442
316230;202205;545;1368;420;1160;82;242;211;568;293;810
316240;202205;6352;17044;5528;15608;418;1292;4093;11313;4511;12605
316245;202205;3644;10516;3287;9949;166;758;2583;7433;2749;8191
316250;202205;12534;28578;9526;23778;1803;4743;3812;9449;5615;14192
316255;202205;3418;8887;2966;8172;141;383;2206;6123;2347;6506
316257;202205;1632;3582;1213;2915;75;196;848;1925;923;2121
316260;202205;2834;6080;2233;5170;216;483;1437;3249;1653;3732
316265;202205;1247;3194;982;2750;26;94;728;1952;754;2046
316270;202205;4211;12032;3599;10771;411;1311;2053;5816;2464;7127
316280;202205;3384;8725;2858;7779;352;1077;1665;4326;2017;5403
316290;202205;4263;11017;3423;9449;422;1296;1433;3701;1855;4997
316292;202205;6586;16194;5321;14231;593;1744;3514;9015;4107;10759
316294;202205;1010;2849;771;2454;123;477;236;665;359;1142
316295;202205;3870;10233;3188;9105;212;756;2134;5765;2346;6521
316300;202205;1149;3026;905;2655;53;172;632;1822;685;1994
316310;202205;894;2294;617;1813;139;464;184;487;323;951
316320;202205;764;2018;592;1751;118;383;150;393;268;776
316330;202205;1205;2946;920;2473;59;172;685;1796;744;1968
316340;202205;1112;2859;843;2398;74;276;516;1369;590;1645
316350;202205;1538;3944;1291;3533;160;445;863;2303;1023;2748
316360;202205;740;1809;626;1631;51;131;490;1293;541;1424
316370;202205;6620;15776;5140;13322;591;1833;2784;6330;3375;8163
316380;202205;1966;4363;1564;3802;87;190;1117;2682;1204;2872
316390;202205;847;2199;627;1829;252;827;121;309;373;1136
316400;202205;1348;3614;899;2756;108;351;338;918;446;1269
316410;202205;1335;3291;1123;2979;32;113;946;2425;978;2538
316420;202205;2215;5610;1896;5183;39;178;1562;4124;1601;4302
316430;202205;1010;2516;700;1999;104;341;296;780;400;1121
316440;202205;973;2839;796;2526;139;509;236;664;375;1173
316443;202205;639;1682;461;1353;105;353;128;346;233;699
316447;202205;2435;5749;2091;5245;30;101;1851;4538;1881;4639
316450;202205;2381;6597;1835;5508;208;684;1128;3261;1336;3945
316460;202205;1438;3569;1180;3155;111;330;783;1976;894;2306
316470;202205;8300;22269;6259;18273;858;2906;2880;7472;3738;10378
316480;202205;230;577;197;536;40;110;115;301;155;411
316490;202205;370;985;272;804;48;165;94;233;142;398
316500;202205;1454;4223;1012;3207;211;715;252;718;463;1433
316510;202205;910;2775;736;2442;117;386;375;1238;492;1624
316520;202205;1563;3611;1216;3024;175;498;571;1254;746;1752
316530;202205;1225;3030;898;2460;104;358;444;1103;548;1461
316540;202205;1160;2745;946;2446;131;395;494;1150;625;1545
316550;202205;1593;4167;1342;3740;50;176;1083;2969;1133;3145
316553;202205;5315;14578;3973;11569;489;1616;1805;4571;2294;6187
316555;202205;3064;8412;2691;7927;80;309;2285;6628;2365;6937
316556;202205;592;1349;453;1112;37;115;277;565;314;680
316557;202205;1317;3718;1139;3451;385;1269;428;1240;813;2509
316560;202205;392;1055;291;908;48;175;130;376;178;551
316570;202205;1601;4225;1342;3789;311;804;460;1398;771;2202
316580;202205;434;877;289;652;32;79;159;335;191;414
316590;202205;1482;3549;1031;2717;146;348;578;1461;724;1809
316600;202205;1092;3016;951;2759;139;427;571;1601;710;2028
316610;202205;702;1990;570;1781;59;232;335;1002;394;1234
316620;202205;2537;5950;2223;5499;119;293;1793;4369;1912;4662
316630;202205;1777;4942;1492;4422;380;1081;582;1978;962;3059
316640;202205;179;468;146;416;30;101;58;137;88;238
316650;202205;1249;3400;1012;3038;69;244;694;2000;763;2244
316660;202205;208;488;96;262;13;39;28;59;41;98
316670;202205;1906;4558;1439;3839;371;1015;484;1223;855;2238
316680;202205;2626;6411;1979;5230;152;455;1381;3529;1533;3984
316690;202205;1565;4227;1181;3538;195;658;418;1147;613;1805
316695;202205;1106;3067;914;2738;20;82;615;1785;635;1867
316700;202205;537;1015;454;927;15;38;396;779;411;817
316710;202205;3809;11234;3035;9719;449;1624;1607;4878;2056;6502
316720;202205;23668;61025;18263;51193;2711;8283;8942;23454;11653;31737
316730;202205;597;1365;484;1181;53;141;272;587;325;728
316740;202205;936;2456;818;2276;107;337;566;1547;673;1884
316750;202205;454;1229;345;1046;65;207;150;425;215;632
316760;202205;4313;12506;3717;11430;1261;4264;1425;4288;2686;8552
316770;202205;1819;3810;1377;3233;35;83;1110;2650;1145;2733
316780;202205;652;1792;530;1585;192;624;130;341;322;965
316790;202205;842;2132;625;1716;85;255;201;511;286;766
316800;202205;7448;19527;5985;16982;723;2228;3041;8299;3764;10527
316805;202205;1285;2470;1042;2197;37;94;888;1836;925;1930
316810;202205;795;2016;589;1649;70;217;394;1072;464;1289
316820;202205;396;866;234;600;18;60;137;322;155;382
316830;202205;968;2367;756;2032;80;218;475;1262;555;1480
316840;202205;3276;7711;2636;6719;140;458;2021;4913;2161;5371
316850;202205;2446;5714;1860;4749;171;531;1151;2681;1322;3212
316860;202205;24654;58221;18685;49395;2422;7446;9838;24653;12260;32099
316870;202205;9701;24416;7484;20400;883;2760;3948;9796;4831;12556
316880;202205;1188;2918;1003;2663;110;350;634;1549;744;1899
316890;202205;1322;2868;825;2216;99;326;526;1336;625;1662
316900;202205;2792;6997;2241;6013;416;1143;910;2271;1326;3414
316905;202205;562;1592;461;1403;117;356;193;618;310;974
316910;202205;1144;2785;792;2196;221;643;204;536;425;1179
316920;202205;2135;4730;1580;3929;198;572;998;2284;1196;2856
316930;202205;10116;26729;7930;23038;1595;5097;3214;8446;4809;13543
316935;202205;4897;12295;3673;10099;600;1825;1662;4176;2262;6001
316940;202205;7276;20113;5792;17264;805;2701;2697;7397;3502;10098
316950;202205;2229;4760;1722;4092;46;135;1461;3401;1507;3536
316960;202205;5939;12446;4344;10350;343;887;3098;7166;3441;8053
316970;202205;4578;11766;3896;10607;536;1524;1837;4669;2373;6193
316980;202205;828;2340;643;1993;202;700;171;510;373;1210
316990;202205;14591;36936;11154;30384;2444;7105;2413;5927;4857;13032
317000;202205;2914;7698;2553;7217;209;504;1909;5503;2118;6007
317005;202205;2953;7719;2323;6485;326;971;1309;3504;1635;4475
317010;202205;29949;67635;20267;53131;3332;9408;9837;25384;13169;34792
317020;202205;78161;179550;49439;130712;8645;24780;18290;44081;26935;68861
317030;202205;774;1923;621;1711;18;63;469;1265;487;1328
317040;202205;12950;31039;9108;24652;2035;5862;3090;8589;5125;14451
317043;202205;1035;2127;761;1765;40;102;595;1335;635;1437
317047;202205;1311;2939;918;2321;52;167;655;1574;707;1741
317050;202205;1370;4065;1007;3256;148;549;389;1054;537;1603
317052;202205;2797;6986;2240;6125;198;570;1539;4122;1737;4692
317057;202205;2351;4865;1774;4036;38;116;1358;2933;1396;3049
317060;202205;564;1460;342;1005;45;138;134;347;179;485
317065;202205;1248;3485;1026;3061;73;269;655;1808;728;2077
317070;202205;8716;23394;6726;19649;1059;3484;2847;7677;3906;11161
317075;202205;1155;2815;876;2351;98;295;494;1215;592;1510
317080;202205;7436;16356;5670;13620;1104;2810;2679;6231;3783;9041
317090;202205;5398;14364;4745;13347;280;772;3570;10006;3850;10778
317100;202205;2948;6753;1977;5195;391;1052;837;2127;1228;3179
317103;202205;2633;6126;2240;5590;88;359;1813;4294;1901;4653
317107;202205;1720;4119;1303;3354;51;170;850;1899;901;2069
317110;202205;765;1736;423;1199;77;254;155;430;232;684
317115;202205;1243;3361;1027;2969;103;315;651;1869;754;2184
317120;202205;20660;50958;17157;45466;1109;3742;11723;29039;12832;32781
317130;202205;13076;29170;9083;22710;1246;3371;3568;8822;4814;12193
317140;202205;1089;2450;849;2078;66;151;588;1439;654;1590
317150;202205;1104;2478;855;2162;36;121;691;1690;727;1811
317160;202205;3972;9042;2640;6944;246;606;1410;3863;1656;4469
317170;202205;2244;5281;1719;4363;103;324;1106;2523;1209;2847
317180;202205;2160;6370;1609;5093;320;1072;454;1317;774;2389
317190;202205;1279;3303;965;2798;137;411;530;1515;667;1926
317200;202205;7204;18088;5408;14630;1077;3095;1547;3737;2624;6832
317210;202205;1380;3108;1070;2695;41;146;780;1962;821;2108
317220;202205;351;964;302;880;57;171;169;475;226;646
320010;202205;5319;14846;4146;12501;465;1559;2413;7023;2878;8582
320013;202205;2406;6153;1727;4880;271;789;815;2377;1086;3166
320016;202205;3260;7943;2549;6860;210;570;1743;4662;1953;5232
320020;202205;5153;12474;3945;10423;603;1815;1916;4939;2519;6754
320030;202205;2034;5368;1337;3986;202;645;529;1486;731;2131
320035;202205;2228;5593;1846;4982;335;1015;1038;2691;1373;3706
320040;202205;5006;13379;4195;11987;542;1672;2350;6396;2892;8068
320050;202205;2124;4574;1834;4166;213;585;1169;2468;1382;3053
320060;202205;16147;41823;12202;34156;1860;5665;5756;14788;7616;20453
320070;202205;2105;5295;1576;4316;232;751;786;1882;1018;2633
320080;202205;6459;15746;4627;12239;827;2335;1971;4835;2798;7170
320090;202205;9757;24812;6614;18583;1365;4101;2543;6528;3908;10629
320100;202205;3771;9371;3074;8193;416;1219;1775;4583;2191;5802
320110;202205;2608;5644;1920;4598;195;580;1185;2570;1380;3150
320115;202205;2517;7356;2163;6803;699;2254;913;2993;1612;5247
320120;202205;29694;71430;21620;57498;2753;8110;11069;27236;13822;35346
320130;202205;62497;158491;51927;140302;5965;17779;32153;82961;38118;100740
320140;202205;4451;11569;3166;9077;391;1329;1530;4110;1921;5439
320150;202205;16748;41097;12192;32905;2862;8561;2125;4969;4987;13530
320160;202205;7336;19088;5495;15776;671;2144;2706;7486;3377;9630
320170;202205;2077;5577;1504;4478;390;1172;581;1784;971;2956
320180;202205;859;2534;687;2193;231;809;182;539;413;1348
320190;202205;3437;10309;2652;8631;623;2262;640;1867;1263;4129
320200;202205;1519;3954;1056;3129;221;709;329;978;550;1687
320210;202205;5287;12707;4091;10706;635;1810;2216;5430;2851;7240
320220;202205;3998;9686;3091;8226;538;1482;1542;3875;2080;5357
320225;202205;1696;4919;1182;3782;346;1210;298;925;644;2135
320230;202205;6289;16035;4796;13562;1045;3095;1637;4668;2682;7763
320240;202205;20041;48150;15097;40456;3701;10591;4822;12643;8523;23234
320245;202205;3717;10391;2776;8405;842;2713;508;1471;1350;4184
320250;202205;3211;8068;2178;5840;384;1150;932;2160;1316;3310
320255;202205;2392;6759;2087;6229;419;1320;1224;3671;1643;4991
320260;202205;1687;4522;1079;3254;231;742;273;676;504;1418
320265;202205;2719;8029;2144;6875;874;3026;345;1052;1219;4078
320270;202205;2564;6946;1997;5834;485;1573;700;2015;1185;3588
320280;202205;9288;22740;7624;20052;1137;3393;4588;11390;5725;14783
320290;202205;1544;4398;1005;3158;249;847;266;793;515;1640
320300;202205;4922;13608;4006;11854;1037;3400;1449;4060;2486;7460
320305;202205;6157;16141;4741;13505;860;2699;2307;6254;3167;8953
320310;202205;2581;6631;1829;5118;325;987;801;2052;1126;3039
320313;202205;2891;6788;1992;5199;367;1059;681;1539;1048;2598
320316;202205;1849;4915;1424;4220;225;664;783;2322;1008;2986
320320;202205;26033;64729;18923;52847;4158;12120;7270;20093;11428;32213
320330;202205;3348;8517;2634;7284;413;1176;1488;4113;1901;5289
320332;202205;9762;24545;7814;21114;1481;4322;3889;10118;5370;14440
320334;202205;2145;5740;1492;4431;279;1011;392;891;671;1902
320335;202205;1886;5259;1323;3986;240;852;430;1185;670;2037
320340;202205;6336;14136;5304;12678;446;1189;3544;8326;3990;9515
320350;202205;6260;14306;4448;11214;459;1342;2498;5789;2957;7131
320360;202205;1617;3932;1202;3187;139;369;594;1498;733;1867
320370;202205;3190;9081;2456;7555;679;2306;882;2554;1561;4860
320380;202205;3333;7919;2757;6990;260;800;1822;4321;2082;5121
320390;202205;9066;22662;6748;18235;1336;3844;2868;7260;4204;11104
320400;202205;3789;10145;2844;8186;735;2278;1083;2939;1818;5217
320405;202205;6237;15096;4755;12627;602;1706;2628;6679;3230;8385
320410;202205;5661;13786;4335;11698;724;1952;2170;5931;2894;7883
320420;202205;4449;10455;3452;8908;763;2132;1272;3078;2035;5210
320425;202205;2519;5656;1949;4741;165;418;1255;2924;1420;3342
320430;202205;3690;8879;2946;7625;396;1079;1789;4465;2185;5544
320435;202205;2653;7762;2081;6589;568;1924;815;2621;1383;4545
320440;202205;1803;4708;1355;3870;230;713;603;1587;833;2300
320450;202205;2284;5981;1820;5158;301;1019;982;2529;1283;3548
320455;202205;5126;14831;3545;11245;840;2971;914;2548;1754;5519
320460;202205;2425;6823;1782;5525;458;1581;519;1476;977;3057
320465;202205;1736;4601;1260;3682;256;789;581;1688;837;2477
320470;202205;4624;11662;3494;9437;675;2061;1280;3056;1955;5117
320480;202205;2604;6063;2134;5288;281;689;1357;3278;1638;3967
320490;202205;28963;68884;22104;57472;3686;9822;10357;26431;14043;36253
320495;202205;1621;4207;1185;3369;288;940;265;652;553;1592
320500;202205;71433;176424;58077;154288;6658;19878;36118;90485;42776;110363
320501;202205;5679;15535;4325;13103;1196;4025;1303;3858;2499;7883
320503;202205;2858;7766;1922;5869;533;1763;521;1498;1054;3261
320506;202205;3111;8925;2368;7358;699;2351;319;958;1018;3309
320510;202205;13539;33876;11099;29847;1046;3224;7064;18033;8110;21257
320515;202205;2078;5465;1588;4461;420;1275;537;1424;957;2699
320517;202205;2535;7066;2038;6058;585;1854;744;2166;1329;4020
320520;202205;48988;118709;37880;100523;5565;16399;18277;45886;23842;62285
320530;202205;40810;99792;32689;86114;2518;8046;21293;52167;23811;60213
330010;202205;30375;72008;25607;64613;2107;6118;18921;45774;21028;51892
330015;202205;1778;3984;1421;3472;186;552;910;2064;1096;2616
330020;202205;23990;55687;20303;50522;2157;5892;14921;36316;17078;42208
330022;202205;2286;5826;1788;5030;291;842;865;2424;1156;3266
330023;202205;7617;16901;5979;14485;783;2090;3899;9055;4682;11145
330025;202205;8360;18175;5483;13566;1016;2802;2028;4642;3044;7444
330030;202205;12800;30964;10133;26874;683;2371;7111;17595;7794;19966
330040;202205;19576;46988;16228;41687;845;2777;12140;29446;12985;32223
330045;202205;117348;243146;99705;221532;4819;11643;84858;184855;89677;196498
330050;202205;3474;8453;2724;7289;422;1311;1564;3871;1986;5182
330060;202205;6819;16176;5402;13790;974;2881;2471;5736;3445;8617
330070;202205;32347;73498;26958;66125;3188;8504;18230;43741;21418;52245
330080;202205;11964;26491;10206;24100;1113;2804;7170;16716;8283;19520
330090;202205;4013;7818;2944;6392;185;381;2151;4675;2336;5056
330093;202205;3359;7389;2586;6375;128;362;2074;4980;2202;5342
330095;202205;1744;4431;1366;3753;141;423;806;2079;947;2502
330100;202205;88393;210154;76957;194118;3095;10000;62372;153217;65467;163217
330110;202205;2666;6685;2166;5912;255;797;1395;3593;1650;4390
330115;202205;3355;7445;2414;6006;412;1086;1310;3049;1722;4135
330120;202205;4366;8623;3393;7436;163;446;2696;5615;2859;6061
330130;202205;5894;14452;4899;13023;600;1674;3258;8453;3858;10127
330140;202205;4914;10980;4062;9856;246;785;3224;7492;3470;8277
330150;202205;3015;7238;2423;6318;375;1068;1451;3562;1826;4630
330160;202205;1773;4400;1370;3736;278;813;742;1877;1020;2690
330170;202205;163306;352397;137261;318491;15369;35471;101406;233321;116775;268792
330180;202205;2511;5398;2015;4740;92;285;1557;3493;1649;3778
330185;202205;13397;29282;11348;26593;424;1301;9678;21952;10102;23253
330187;202205;6306;14205;5037;12218;619;1589;3270;7566;3889;9155
330190;202205;52413;109469;45494;100337;1982;5188;38383;82257;40365;87445
330200;202205;21229;48414;17587;43991;2460;5933;12494;31331;14954;37264
330205;202205;2681;6143;2057;5156;139;407;1419;3345;1558;3752
330210;202205;4016;9157;3030;7573;369;958;1713;3998;2082;4956
330220;202205;16471;37547;12311;30862;1943;5415;5836;13386;7779;18801
330225;202205;4683;11006;3654;9518;190;625;2734;6899;2924;7524
330227;202205;22256;48367;19089;44628;544;1549;16971;38890;17515;40439
330230;202205;2357;5015;1586;4014;145;392;799;1999;944;2391
330240;202205;30182;71413;25614;64731;1909;5580;19280;47099;21189;52679
330245;202205;2079;4823;1330;3556;264;729;556;1383;820;2112
330250;202205;52081;118427;44064;107120;5143;13437;31015;73782;36158;87219
330260;202205;5987;13205;4616;11404;268;826;3630;8648;3898;9474
330270;202205;39449;86772;25249;63809;3436;9455;11883;28214;15319;37669
330280;202205;3180;7303;2508;6238;169;552;1744;4000;1913;4552
330285;202205;34270;72495;28096;63947;1355;3773;22709;49596;24064;53369
330290;202205;5477;11539;4495;10290;280;837;3585;7767;3865;8604
330300;202205;6999;14991;5296;12666;382;1021;3912;8948;4294;9969
330310;202205;3370;7409;2533;6104;149;380;1849;4275;1998;4655
330320;202205;21633;46341;17033;40684;1765;3661;12822;30683;14587;34344
330330;202205;56369;114779;45318;100350;3103;7631;34933;74840;38036;82471
330340;202205;22263;49368;16606;40949;2194;6307;9355;21225;11549;27532
330350;202205;194037;398975;164072;363431;6716;16227;142751;311199;149467;327426
330360;202205;9222;20144;7917;18570;290;700;6803;15766;7093;16466
330370;202205;6322;16416;5064;14373;889;2735;2665;7344;3554;10079
330380;202205;7617;18051;6016;15332;639;2007;4004;9542;4643;11549
330385;202205;5015;12833;4136;11593;674;2156;2346;6256;3020;8412
330390;202205;38740;92747;30000;78226;3024;9433;19689;47735;22713;57168
330395;202205;4082;9091;3365;8206;136;442;2669;6285;2805;6727
330400;202205;4324;10318;3677;9338;164;578;2862;6772;3026;7350
330410;202205;4154;9788;3100;8078;458;1415;1822;4366;2280;5781
330411;202205;3349;8537;2670;7367;164;567;1891;4935;2055;5502
330412;202205;2045;5170;1684;4596;118;393;1172;3001;1290;3394
330414;202205;28923;67123;23920;60471;1347;3954;18852;46584;20199;50538
330415;202205;5739;14274;4307;11842;397;1216;2558;6711;2955;7927
330420;202205;15467;35980;11550;29829;1151;3502;6859;16359;8010;19861
330430;202205;13649;27434;11787;25048;233;786;10281;21015;10514;21801
330440;202205;3528;8436;2745;7141;275;885;1863;4508;2138;5393
330450;202205;1797;4580;1452;4021;121;370;917;2411;1038;2781
330452;202205;23023;53627;18845;47495;1854;5419;13245;31945;15099;37364
330455;202205;777717;1652510;636090;1458838;63487;156375;463718;1032489;527205;1188864
330460;202205;1447;3638;1122;3171;191;576;615;1704;806;2280
330470;202205;6936;15565;5116;12879;1138;3092;2073;5036;3211;8128
330475;202205;11839;27483;9710;24812;1169;3518;6744;16582;7913;20100
330480;202205;7074;16836;6019;15347;449;1232;4318;10581;4767;11813
330490;202205;136126;291354;112073;259887;9593;23573;84702;192663;94295;216236
330500;202205;10060;22315;8540;20320;526;1432;6671;15471;7197;16903
330510;202205;53499;120928;41465;104622;4558;12428;29086;71614;33644;84042
330513;202205;1580;3709;1278;3298;170;477;772;1958;942;2435
330515;202205;3259;7908;2691;7141;344;1079;1738;4350;2082;5429
330520;202205;15440;36766;12966;33130;1086;3271;9254;22697;10340;25968
330530;202205;2016;4568;1483;3799;261;722;741;1855;1002;2577
330540;202205;3588;8731;2799;7442;641;1813;1214;3139;1855;4952
330550;202205;14507;31799;11541;27992;1966;5169;6946;16344;8912;21513
330555;202205;24463;45972;20691;41632;727;1614;17765;35646;18492;37260
330560;202205;4905;11678;3989;10256;527;1412;2633;6509;3160;7921
330570;202205;3559;8656;3102;8014;434;1221;2170;5499;2604;6720
330575;202205;7491;17097;6534;15554;308;877;5435;12377;5743;13254
330580;202205;25532;61007;21065;53412;2879;7866;12459;29530;15338;37396
330590;202205;1784;4350;1499;3988;205;515;1002;2739;1207;3254
330600;202205;15595;37137;12925;33004;804;2508;9140;22185;9944;24693
330610;202205;12102;28841;9984;25611;905;2591;6856;16903;7761;19494
330615;202205;2643;6425;2155;5781;358;886;1427;3913;1785;4799
330620;202205;5125;13279;4116;11628;826;2555;1941;5207;2767;7762
330630;202205;34257;77748;27364;67244;1263;4066;20608;47951;21871;52017
350010;202205;2622;6617;1637;4613;313;953;441;975;754;1928
350020;202205;845;2087;512;1462;65;199;177;467;242;666
350030;202205;4194;10900;3275;9372;644;2127;1730;4573;2374;6700
350040;202205;893;2437;548;1732;76;291;180;428;256;719
350050;202205;1699;3963;1177;3111;207;637;476;1047;683;1684
350055;202205;1094;2657;885;2344;115;312;536;1330;651;1642
350060;202205;309;740;171;456;27;86;68;168;95;254
350070;202205;3931;9864;2684;7671;431;1411;1108;2792;1539;4203
350075;202205;724;1987;559;1680;194;592;111;346;305;938
350080;202205;762;1910;536;1531;56;185;246;629;302;814
350090;202205;683;1516;437;1116;69;202;234;540;303;742
350100;202205;2917;7160;2105;5828;128;460;1379;3513;1507;3973
350110;202205;569;1348;425;1100;15;50;289;712;304;762
350115;202205;1401;3886;1152;3402;176;584;609;1639;785;2223
350120;202205;755;1726;447;1201;36;122;248;610;284;732
350130;202205;3823;9563;3033;8158;462;1327;1614;3963;2076;5290
350140;202205;855;2239;621;1823;45;165;356;952;401;1117
350150;202205;587;1677;487;1501;94;314;163;435;257;749
350160;202205;13926;34106;9832;26592;1236;3787;5863;14806;7099;18593
350170;202205;2929;7759;2469;6811;328;1025;1414;3554;1742;4579
350180;202205;1168;2711;696;1882;103;297;328;812;431;1109
350190;202205;3727;10173;2664;7833;377;1326;1304;3262;1681;4588
350200;202205;543;1436;427;1222;22;82;291;772;313;854
350210;202205;7170;15794;5077;12574;418;1238;3418;7939;3836;9177
350220;202205;3476;9121;2483;7233;449;1391;1011;2646;1460;4037
350230;202205;1180;2822;962;2522;152;449;580;1454;732;1903
350240;202205;704;1918;469;1396;90;276;121;320;211;596
350250;202205;3986;10310;3023;8765;735;2233;1068;2986;1803;5219
350260;202205;994;2186;643;1613;64;181;384;881;448;1062
350270;202205;5249;13119;4219;11294;542;1657;2467;6089;3009;7746
350275;202205;3090;7708;2523;6880;249;840;1766;4519;2015;5359
350280;202205;21645;47730;14036;35709;2114;5659;6675;15961;8789;21620
350290;202205;3827;10085;2750;7935;467;1466;1266;3367;1733;4833
350300;202205;784;1936;607;1626;71;210;365;905;436;1115
350310;202205;1096;2916;852;2459;103;342;402;1061;505;1403
350315;202205;710;1660;507;1344;30;109;300;690;330;799
350320;202205;18931;46464;14467;38824;2473;7385;6878;16888;9351;24273
350330;202205;16206;37884;12051;30374;1048;3024;8099;19068;9147;22092
350335;202205;424;1154;334;989;40;128;153;433;193;561
350340;202205;1493;3688;926;2641;115;375;430;1104;545;1479
350350;202205;850;2035;668;1839;88;267;420;1136;508;1403
350360;202205;1256;3501;992;2989;170;538;447;1309;617;1847
350370;202205;806;1905;582;1500;180;437;210;515;390;952
350380;202205;5447;14328;4024;11405;959;2822;1426;3799;2385;6621
350390;202205;13096;32146;10438;27889;1440;4130;6130;15431;7570;19561
350395;202205;500;1231;265;785;35;109;90;244;125;353
350400;202205;9817;23115;7050;18701;1749;4866;2183;5661;3932;10527
350410;202205;12405;32874;9391;27307;1708;5483;4136;11142;5844;16625
350420;202205;1211;3019;871;2359;151;413;283;652;434;1065
350430;202205;767;1895;596;1630;69;220;353;873;422;1093
350440;202205;2439;5660;1985;4999;117;351;1365;3252;1482;3603
350450;202205;7900;20817;6243;18014;1216;3943;2931;7792;4147;11735
350460;202205;2420;6000;1496;4225;216;638;641;1637;857;2275
350470;202205;289;683;233;597;9;26;174;426;183;452
350480;202205;1151;2731;783;2125;175;529;214;502;389;1031
350490;202205;2258;5535;1640;4570;292;917;677;1662;969;2579
350500;202205;739;1873;535;1526;64;198;223;597;287;795
350510;202205;1411;3367;1074;2792;86;254;695;1684;781;1938
350520;202205;2715;7634;2164;6638;320;1111;1005;2770;1325;3881
350530;202205;3527;8490;2708;6972;242;723;1649;3906;1891;4629
350535;202205;1739;4420;1481;4057;209;648;937;2461;1146;3109
350540;202205;2350;4968;1775;4166;148;372;1284;2842;1432;3214
350550;202205;9733;23043;6876;18387;642;2104;4132;10096;4774;12200
350560;202205;4787;12144;3949;10800;243;826;2853;7406;3096;8232
350570;202205;33173;86336;27468;76084;4148;12684;15204;39896;19352;52580
350580;202205;2465;6227;1606;4583;400;1291;491;1114;891;2405
350590;202205;5683;14678;4278;11708;497;1549;2641;6662;3138;8211
350600;202205;39263;88421;25449;65283;3518;10259;12569;29512;16087;39771
350610;202205;8349;21490;6110;17230;783;2555;3323;8656;4106;11211
350620;202205;487;1183;307;900;33;106;174;472;207;578
350630;202205;1887;4323;1404;3542;94;295;977;2258;1071;2553
350635;202205;11909;27198;9130;22969;985;2787;6079;14590;7064;17377
350640;202205;1057;2745;592;1749;101;310;183;447;284;757
350650;202205;10267;26094;7366;20634;1205;3741;3214;8260;4419;12001
350660;202205;5524;13402;4341;11543;516;1393;2694;6983;3210;8376
350670;202205;2011;5177;1627;4609;219;649;1007;2849;1226;3498
350680;202205;1287;3327;893;2602;139;411;389;1071;528;1482
350690;202205;1572;3892;1139;3156;161;495;627;1662;788;2157
350700;202205;5714;13612;4398;11658;773;2316;2382;5907;3155;8223
350710;202205;3488;8830;2964;7971;540;1659;1622;4010;2162;5669
350715;202205;879;2381;750;2177;135;470;382;974;517;1444
350720;202205;185;450;135;375;20;53;58;145;78;198
350730;202205;710;1920;571;1649;42;143;352;925;394;1068
350740;202205;1994;4965;1390;3809;232;677;531;1306;763;1983
350745;202205;713;1741;413;1171;30;114;204;516;234;630
350750;202205;12264;30717;9831;26676;1628;5192;5087;12542;6715;17734
350760;202205;19111;44258;14443;36598;2230;6621;7847;17669;10077;24290
350770;202205;1217;2857;751;2075;62;186;434;1141;496;1327
350775;202205;810;1805;575;1471;71;178;306;767;377;945
350780;202205;2782;6409;2046;5413;548;1331;809;2421;1357;3752
350790;202205;2466;6341;1622;4786;326;977;479;1214;805;2191
350800;202205;4200;11174;3592;10178;231;791;2553;6918;2784;7709
350810;202205;3385;7727;2580;6562;499;1257;1256;3112;1755;4369
350820;202205;1082;2443;660;1695;70;212;356;830;426;1042
350830;202205;989;2605;589;1768;101;325;173;423;274;748
350840;202205;4023;11251;3127;9647;574;1969;1455;4118;2029;6087
350850;202205;9518;24657;7611;21354;1196;3676;4273;11234;5469;14910
350860;202205;4203;10384;3645;9648;133;492;2887;7481;3020;7973
350870;202205;3125;8130;2366;6934;284;914;1322;3727;1606;4641
350880;202205;1676;4449;1360;3849;354;1036;427;1122;781;2158
350890;202205;575;1466;381;1072;49;151;138;336;187;487
350900;202205;10533;26458;7556;20570;1152;3488;3911;9580;5063;13068
350910;202205;1083;2440;924;2214;80;209;725;1686;805;1895
350920;202205;14531;33849;12401;30569;435;1426;10295;24329;10730;25755
350925;202205;4739;12190;3472;10054;555;1833;1817;4813;2372;6646
350930;202205;1690;4249;1189;3286;85;258;683;1823;768;2081
350940;202205;2816;6863;2229;5941;204;635;1526;3828;1730;4463
350945;202205;1053;2788;815;2350;127;377;390;1037;517;1414
350950;202205;109656;266390;85985;223700;9762;27988;55176;136087;64938;164075
350960;202205;7619;19597;5956;16545;760;2395;3435;8975;4195;11370
350970;202205;4234;11195;3123;9170;865;2797;964;2378;1829;5175
350980;202205;806;2030;665;1788;136;387;340;870;476;1257
350990;202205;2285;5830;1749;4982;390;1242;720;1946;1110;3188
350995;202205;985;2851;890;2674;79;283;595;1705;674;1988
351000;202205;3485;8809;2387;6740;530;1542;813;2208;1343;3750
351010;202205;440;1066;289;804;40;129;141;372;181;501
351015;202205;1091;3080;910;2728;147;485;419;1118;566;1603
351020;202205;9877;25256;7571;21413;1492;4417;3748;10095;5240;14512
351030;202205;3428;9513;2767;8230;401;1359;1534;4316;1935;5675
351040;202205;6149;14098;5194;12700;195;616;4323;10161;4518;10777
351050;202205;20232;47016;15417;39925;2429;6745;8433;21044;10862;27789
351060;202205;57698;137387;44807;116110;3770;11036;31276;77771;35046;88807
351070;202205;1635;3844;949;2729;272;805;176;469;448;1274
351080;202205;3273;7496;2436;6507;250;785;1679;4228;1929;5013
351090;202205;380;1021;293;871;57;183;111;309;168;492
351100;202205;3250;8289;2187;6229;451;1411;730;1994;1181;3405
351110;202205;7255;17980;5093;14120;737;2317;2558;6631;3295;8948
351120;202205;838;2098;586;1663;102;287;219;579;321;866
351130;202205;1321;3425;629;1879;103;349;170;427;273;776
351140;202205;2644;6931;2024;5823;421;1358;942;2405;1363;3763
351150;202205;3366;9117;2364;7053;316;1078;917;2394;1233;3472
351160;202205;1309;3875;976;3137;191;667;243;653;434;1320
351170;202205;1722;4390;1496;4000;124;385;1064;2688;1188;3073
351190;202205;1154;3076;812;2408;182;537;285;798;467;1335
351200;202205;1891;4326;1444;3699;99;290;1041;2512;1140;2802
351210;202205;1739;4072;1144;3030;71;257;690;1637;761;1894
351220;202205;4181;10547;3622;9684;297;826;2572;6631;2869;7457
351230;202205;2445;6067;1905;5164;329;1006;969;2338;1298;3344
351240;202205;2771;6841;1775;4858;442;1220;545;1338;987;2558
351250;202205;1215;3140;740;2172;75;247;285;809;360;1056
351260;202205;1024;2433;741;1934;147;396;289;692;436;1088
351270;202205;605;1555;420;1191;49;163;206;482;255;645
351280;202205;4463;11244;3460;9472;682;1913;1499;3890;2181;5803
351290;202205;1720;3882;1129;2890;122;351;749;1824;871;2175
351300;202205;23603;60209;17216;48571;2888;8886;8486;22481;11374;31367
351310;202205;4174;9638;3199;8144;158;550;2386;5700;2544;6250
351320;202205;1012;2831;749;2318;142;480;243;652;385;1132
351330;202205;554;1328;430;1081;27;97;305;677;332;774
351340;202205;8226;20687;6859;18385;1256;3697;3906;9778;5162;13475
351350;202205;14542;34306;12157;30569;809;2344;9458;22780;10267;25124
351360;202205;4617;11326;3808;10175;739;2232;1975;4783;2714;7015
351370;202205;2378;6335;1644;4874;386;1259;492;1265;878;2524
351380;202205;53639;123638;38991;99325;4069;11445;24588;59428;28657;70873
351385;202205;452;1110;196;569;24;67;80;208;104;275
351390;202205;1578;3635;1044;2882;92;289;736;1954;828;2243
351400;202205;1212;3137;1001;2733;107;287;633;1653;740;1940
351410;202205;3005;7938;2248;6532;376;1120;991;2741;1367;3861
351420;202205;573;1313;340;919;35;98;211;522;246;620
351430;202205;1138;2806;932;2485;53;158;700;1793;753;1951
351440;202205;4034;10153;2772;7675;550;1603;853;2012;1403;3615
351450;202205;1982;5010;1389;3977;275;920;355;768;630;1688
351460;202205;1097;2709;893;2397;119;356;566;1451;685;1807
351470;202205;1413;3392;1124;2935;70;234;773;1888;843;2122
351480;202205;2790;7631;2214;6728;357;1276;1091;3017;1448;4293
351490;202205;2469;6480;2130;5893;75;307;1715;4558;1790;4865
351492;202205;398;1020;344;911;4;14;270;696;274;710
351495;202205;248;612;198;525;19;43;117;296;136;339
351500;202205;48196;110192;37547;93455;4698;12344;24518;58139;29216;70483
351510;202205;15287;35087;11429;28810;1194;3437;7566;18070;8760;21507
351512;202205;559;1423;417;1126;82;222;162;409;244;631
351515;202205;3821;8412;2487;6269;478;1272;656;1744;1134;3016
351518;202205;2818;6861;1889;5255;263;851;909;2188;1172;3039
351519;202205;701;1856;450;1390;87;274;92;246;179;520
351520;202205;1435;3451;683;1989;70;245;335;863;405;1108
351530;202205;401;1016;245;704;39;118;114;274;153;392
351535;202205;1986;4705;1436;3781;228;645;710;1768;938;2413
351540;202205;3109;7268;2143;5621;228;713;1114;2551;1342;3264
351550;202205;8509;20232;5978;15807;601;1818;3442;8349;4043;10167
351560;202205;573;1564;458;1348;109;356;147;396;256;752
351565;202205;283;757;229;663;49;169;72;174;121;343
351570;202205;26020;64997;20494;54623;1835;5486;13588;34423;15423;39909
351580;202205;255;625;147;444;13;38;70;208;83;246
351590;202205;547;1212;286;759;27;77;162;397;189;474
351600;202205;1516;3933;1174;3290;179;523;609;1570;788;2093
351610;202205;816;1851;533;1368;39;109;302;716;341;825
351620;202205;27941;70437;20976;59075;3038;9974;10457;26890;13495;36864
351630;202205;33258;81264;27167;71468;2501;7682;19122;47764;21623;55446
351640;202205;21696;52566;17416;45378;1197;3847;12608;30971;13805;34818
351650;202205;427;1122;221;676;30;106;60;160;90;266
351660;202205;788;2122;533;1602;93;291;124;308;217;599
351670;202205;7129;18330;4778;13357;992;2711;1985;5103;2977;7814
351680;202205;499;1312;339;980;58;170;96;224;154;394
351685;202205;498;1346;405;1198;90;264;163;433;253;697
351690;202205;1360;3334;798;2281;86;289;380;1004;466;1293
351700;202205;1546;3666;1141;3003;200;589;603;1449;803;2038
351710;202205;930;2300;710;1914;64;214;421;1017;485;1231
351720;202205;1743;4259;1219;3374;192;566;566;1440;758;2006
351730;202205;1144;2753;943;2440;76;240;596;1412;672;1652
351740;202205;3890;9331;3169;8043;457;1278;1795;4172;2252;5450
351750;202205;1875;4660;1148;3388;167;520;539;1513;706;2033
351760;202205;3826;10034;2917;8338;543;1744;1398;3599;1941;5343
351770;202205;2240;5948;1839;5236;318;936;1079;2957;1397;3893
351780;202205;1351;3289;822;2327;110;355;338;887;448;1242
351790;202205;1718;3889;1335;3366;167;442;866;2103;1033;2545
351800;202205;570;1255;299;777;37;104;120;266;157;370
351810;202205;1266;3178;1059;2872;175;472;622;1585;797;2057
351820;202205;3353;8726;2484;7111;555;1746;812;2090;1367;3836
351830;202205;5483;13511;4234;11449;353;1131;2749;6969;3102;8100
351840;202205;10528;27138;8167;23002;910;2911;4878;12691;5788;15602
351850;202205;1722;4565;1141;3429;185;617;409;1004;594;1621
351860;202205;3051;8281;2353;7056;275;925;1411;4184;1686;5109
351870;202205;29563;71114;22707;60139;4856;13179;10546;27805;15402;40984
351880;202205;177471;420386;138448;356475;21487;62923;82678;198543;104165;261466
351885;202205;1105;2727;888;2394;49;181;628;1603;677;1784
351890;202205;967;2429;635;1886;119;409;154;392;273;801
351900;202205;1408;3514;1080;3034;103;277;691;1902;794;2179
351905;202205;596;1600;445;1318;46;160;224;574;270;734
351907;202205;25617;63712;20305;54653;2004;6199;13610;34721;15614;40920
351910;202205;1926;4691;1399;3651;124;364;818;1889;942;2253
351920;202205;1003;2562;777;2141;109;334;336;831;445;1165
351925;202205;1083;2740;859;2363;96;325;522;1325;618;1650
351930;202205;4081;10391;3691;9714;305;918;2951;7562;3256;8480
351940;202205;1218;3031;886;2463;132;428;437;1198;569;1626
351950;202205;1942;4032;1498;3423;63;180;1106;2395;1169;2575
351960;202205;6016;14477;4543;12004;1023;2822;1990;4966;3013;7788
351970;202205;10089;26549;8202;23489;1128;3826;5079;13641;6207;17467
351980;202205;1203;2773;818;2154;96;317;483;1145;579;1462
351990;202205;1691;3790;1245;3154;55;184;668;1483;723;1667
352000;202205;3135;8273;2703;7434;244;794;1849;4759;2093;5553
352010;202205;2704;6713;2198;5928;617;1724;617;1691;1234;3415
352020;202205;1753;4495;1380;3868;234;731;726;1887;960;2618
352030;202205;6976;17029;5604;14877;715;2212;3502;8772;4217;10984
352040;202205;4862;11691;3507;9223;560;1612;1339;3146;1899;4758
352042;202205;3866;8791;2685;6989;343;1031;1584;3999;1927;5030
352044;202205;2489;6362;1544;4595;245;817;367;903;612;1720
352050;202205;15656;39914;10732;30448;2657;8201;2750;6630;5407;14831
352060;202205;866;2222;666;1872;114;348;292;750;406;1098
352070;202205;1058;2071;709;1616;42;116;434;901;476;1017
352080;202205;526;1321;335;963;42;114;109;289;151;403
352090;202205;1806;5038;1521;4517;168;585;765;2058;933;2643
352100;202205;4278;11329;3399;9679;583;1880;1617;4305;2200;6185
352110;202205;795;2173;601;1811;117;355;254;713;371;1068
352115;202205;636;1647;529;1491;125;377;270;718;395;1095
352120;202205;1009;2722;808;2335;86;259;492;1316;578;1575
352130;202205;2298;6185;1514;4330;214;613;654;1723;868;2336
352140;202205;1400;3647;1023;2907;187;523;449;1259;636;1782
352150;202205;1043;2576;781;2135;78;238;522;1362;600;1600
352160;202205;1101;2600;802;2117;82;254;419;1050;501;1304
352170;202205;3429;8703;2747;7438;328;1025;1646;4124;1974;5149
352180;202205;2914;7516;2250;6366;470;1412;916;2430;1386;3842
352190;202205;1655;4085;1329;3596;201;587;756;1986;957;2573
352200;202205;370;1088;276;915;40;135;108;346;148;481
352210;202205;24556;53673;19506;46986;955;2801;15668;36602;16623;39403
352215;202205;754;1858;613;1631;108;309;325;833;433;1142
352220;202205;29392;66830;22065;54815;3140;8758;13052;29639;16192;38397
352230;202205;18118;48478;14317;41666;3333;10590;5711;15129;9044;25719
352240;202205;12210;29713;9520;25382;1777;5154;4768;11755;6545;16909
352250;202205;26748;71013;22165;63478;2465;7776;15173;42272;17638;50048
352260;202205;5892;14051;4136;10735;555;1665;2469;5727;3024;7392
352265;202205;1027;2790;913;2628;141;432;537;1499;678;1931
352270;202205;2042;5680;1584;4717;300;1003;646;1737;946;2740
352280;202205;2717;6434;2078;5528;232;721;1226;3013;1458;3734
352290;202205;1639;4333;1319;3731;164;496;739;1880;903;2376
352300;202205;1080;2690;733;2015;74;226;398;1022;472;1248
352310;202205;46852;118613;35862;100626;6177;18145;19877;54781;26054;72926
352320;202205;7925;19027;6258;16102;777;2285;3749;8604;4526;10889
352330;202205;2835;6816;2225;5975;272;947;1466;3622;1738;4569
352340;202205;7938;19958;6095;16666;942;2894;3244;8091;4186;10985
352350;202205;2763;7252;2193;6071;132;449;1515;3984;1647;4433
352360;202205;1610;4044;1292;3477;97;317;926;2353;1023;2670
352370;202205;1205;3216;1037;2952;27;101;830;2309;857;2410
352380;202205;1012;2564;778;2170;164;459;314;830;478;1289
352390;202205;17326;40963;12122;31986;1777;5219;6903;16927;8680;22146
352400;202205;4113;11087;3338;9653;867;2720;1438;3882;2305;6602
352410;202205;4066;9869;3185;8459;266;801;2046;5164;2312;5965
352420;202205;952;2335;654;1859;144;430;207;583;351;1013
352430;202205;9948;22847;7480;18753;1028;2898;4230;9929;5258;12827
352440;202205;22093;57336;16991;47820;3701;11012;6818;18270;10519;29282
352450;202205;909;2137;502;1457;77;229;191;506;268;735
352460;202205;3504;9036;2511;7322;451;1395;1127;3062;1578;4457
352470;202205;3855;9536;2993;8164;252;792;1942;4972;2194;5764
352480;202205;4944;11235;3382;8572;433;1316;1746;3926;2179;5242
352490;202205;939;2528;748;2202;128;428;357;984;485;1412
352500;202205;12685;31331;8879;24518;3352;10684;1778;3121;5130;13805
352510;202205;4725;12230;3672;10395;534;1675;2136;5738;2670;7413
352520;202205;3314;8235;2577;7034;368;1175;1543;3790;1911;4965
352530;202205;13376;32577;9503;25577;1729;5244;3660;8376;5389;13620
352540;202205;633;1777;483;1479;77;240;196;541;273;781
352550;202205;1121;2918;783;2333;131;452;301;795;432;1247
352560;202205;733;1861;597;1624;52;185;404;1006;456;1191
352570;202205;2676;7254;1797;5493;412;1369;244;514;656;1883
352580;202205;763;1884;650;1691;91;246;363;923;454;1169
352585;202205;403;1066;296;883;30;117;163;439;193;556
352590;202205;15308;38643;11198;31193;2140;6618;6034;15537;8174;22155
352600;202205;2318;5877;1871;5109;143;471;1255;3170;1398;3641
352610;202205;3168;8210;2407;6961;385;1346;1183;3179;1568;4525
352620;202205;6647;15702;5098;13532;1155;3111;2498;6510;3653;9621
352630;202205;1003;2351;758;2016;108;316;386;985;494;1301
352640;202205;3592;8730;2656;7088;249;717;1574;3977;1823;4694
352650;202205;667;1793;464;1384;69;214;182;503;251;717
352660;202205;1248;3448;1057;3078;106;388;693;1860;799;2248
352670;202205;12076;30384;8696;24009;1585;4907;4000;9856;5585;14763
352680;202205;3706;10301;2696;8102;427;1483;1310;3421;1737;4904
352690;202205;30975;74386;24643;64257;1147;3738;18183;45247;19330;48985
352700;202205;819;1998;612;1688;114;325;281;764;395;1089
352710;202205;6342;15550;4661;12617;1061;3150;2045;5110;3106;8260
352720;202205;10551;26236;8538;22697;1626;4663;4237;10510;5863;15173
352725;202205;619;1409;359;962;23;69;202;496;225;565
352730;202205;5971;16988;5385;15705;666;2170;2645;6616;3311;8786
352740;202205;2745;6291;2100;5350;203;602;1276;3048;1479;3650
352750;202205;487;1188;316;886;38;123;152;373;190;496
352760;202205;1965;5142;1563;4401;181;487;843;2291;1024;2778
352770;202205;1058;2694;758;2146;114;338;365;958;479;1296
352780;202205;740;2006;537;1588;115;323;154;452;269;775
352790;202205;487;1225;376;1021;41;110;170;404;211;514
352800;202205;1599;4556;1129;3535;282;922;225;534;507;1456
352810;202205;1407;3189;938;2390;141;345;542;1340;683;1685
352820;202205;517;1403;385;1172;80;254;102;273;182;527
352830;202205;648;1567;323;920;24;75;112;262;136;337
352840;202205;4670;12430;3824;10959;941;2919;1722;4772;2663;7691
352850;202205;13662;31277;10007;25649;2036;5806;4849;11227;6885;17033
352860;202205;1262;3335;966;2820;158;505;386;1053;544;1558
352870;202205;981;2384;691;1811;62;191;440;1090;502;1281
352880;202205;1950;4511;1388;3541;210;587;603;1398;813;1985
352885;202205;386;1009;302;865;40;132;181;492;221;624
352890;202205;794;1819;559;1357;32;93;363;780;395;873
352900;202205;21649;53782;14812;40749;2271;6572;6547;16729;8818;23301
352910;202205;439;1116;246;727;18;54;96;242;114;296
352920;202205;3182;7696;2435;6468;113;358;1761;4457;1874;4815
352930;202205;6985;17786;5350;14701;877;2755;2644;6642;3521;9397
352940;202205;28434;72023;22050;59480;3452;10223;12513;31641;15965;41864
352950;202205;648;1663;412;1233;87;280;105;268;192;548
352960;202205;842;2136;511;1465;70;217;163;362;233;579
352965;202205;287;768;198;604;46;147;52;142;98;289
352970;202205;3622;7888;2852;6706;156;412;2196;4951;2352;5363
352980;202205;1564;3804;1237;3353;266;748;698;1862;964;2610
352990;202205;5116;12818;3880;10820;639;1940;2141;5741;2780;7681
353000;202205;539;1418;326;945;50;167;102;242;152;409
353010;202205;3106;7334;2150;5624;389;1169;1000;2360;1389;3529
353020;202205;3905;9708;2422;6778;367;1128;936;2408;1303;3536
353030;202205;5426;13145;3778;10367;861;2520;1132;2935;1993;5455
353040;202205;796;1742;582;1427;90;230;336;778;426;1008
353050;202205;6036;16268;4382;13014;710;2322;2248;6288;2958;8610
353060;202205;57069;137317;47427;122466;2917;9156;36275;89795;39192;98951
353070;202205;12161;32470;9047;25997;1400;4521;4381;11369;5781;15890
353080;202205;5494;14104;3813;10950;733;2353;1558;3874;2291;6227
353090;202205;697;1971;584;1762;42;149;380;1102;422;1251
353100;202205;341;859;159;472;30;97;46;107;76;204
353110;202205;8969;21984;7229;19588;1692;4471;3625;10300;5317;14771
353120;202205;498;1207;379;1012;48;166;199;457;247;623
353130;202205;3216;7280;2156;5490;509;1397;882;1971;1391;3368
353140;202205;3319;7640;2524;6379;136;432;1817;4338;1953;4770
353150;202205;1769;4234;1297;3483;249;724;602;1519;851;2243
353160;202205;748;1856;544;1527;73;230;251;627;324;857
353170;202205;641;1612;493;1403;86;251;247;703;333;954
353180;202205;12026;28186;9436;24030;1878;5126;5192;12600;7070;17726
353190;202205;3900;10010;3094;8446;378;1168;1868;4728;2246;5896
353200;202205;2011;5172;1262;3732;174;606;451;1187;625;1793
353205;202205;508;1444;427;1268;44;143;236;663;280;806
353210;202205;1055;2215;707;1664;24;67;531;1186;555;1253
353215;202205;451;1131;356;975;43;147;174;421;217;568
353220;202205;852;2249;609;1766;127;349;150;402;277;751
353230;202205;889;2341;692;2035;165;569;243;647;408;1216
353240;202205;2734;6966;2310;6314;286;905;1452;3763;1738;4668
353250;202205;1489;3272;991;2492;118;320;565;1369;683;1689
353260;202205;1316;2956;763;2071;114;342;359;885;473;1227
353270;202205;857;2063;716;1828;80;251;477;1122;557;1373
353280;202205;830;2123;610;1764;142;403;202;585;344;988
353282;202205;2036;5433;1718;4890;152;532;1089;2885;1241;3417
353284;202205;422;962;243;635;26;86;116;254;142;340
353286;202205;202;480;127;360;28;78;37;85;65;163
353290;202205;1650;4192;1026;2964;172;496;314;814;486;1310
353300;202205;2483;6319;1840;5118;304;956;861;2087;1165;3043
353310;202205;455;1067;342;878;23;78;222;517;245;595
353320;202205;804;1942;688;1782;20;68;534;1337;554;1405
353325;202205;824;2252;603;1790;103;293;250;703;353;996
353330;202205;710;1718;479;1301;75;225;240;586;315;811
353340;202205;3703;9612;2872;8038;478;1535;1515;3859;1993;5394
353350;202205;4603;10924;3417;8803;759;1987;1230;2862;1989;4849
353360;202205;761;2049;614;1774;63;230;371;1001;434;1231
353370;202205;658;1773;542;1590;42;135;374;1063;416;1198
353380;202205;354;977;284;854;37;124;138;369;175;493
353390;202205;7368;17521;5578;14649;454;1373;3520;8740;3974;10113
353400;202205;604;1535;459;1280;76;244;196;432;272;676
353410;202205;596;1508;450;1248;58;167;268;708;326;875
353420;202205;548;1362;370;1012;73;195;63;140;136;335
353430;202205;2703;6982;2156;6023;382;1113;1100;2909;1482;4022
353440;202205;81167;207139;61632;169965;8305;25405;36626;94672;44931;120077
353450;202205;440;1071;307;850;40;142;163;399;203;541
353460;202205;3829;9827;2873;8138;553;1688;701;1765;1254;3453
353470;202205;10186;25556;7564;20772;1209;3695;3579;8929;4788;12624
353475;202205;1935;4623;1341;3526;147;450;754;1780;901;2230
353480;202205;1803;4515;1483;4011;73;255;1089;2806;1162;3061
353490;202205;1217;3055;882;2455;124;367;403;1034;527;1401
353500;202205;1253;2884;918;2373;188;509;529;1310;717;1819
353510;202205;1063;2931;780;2308;180;588;263;664;443;1252
353520;202205;1196;2951;783;2249;84;267;376;953;460;1220
353530;202205;2867;7144;2322;6188;265;839;1328;3268;1593;4107
353540;202205;2379;6099;1939;5437;267;820;1171;3145;1438;3965
353550;202205;6995;16740;5703;14725;746;2104;3578;8677;4324;10781
353560;202205;2642;6665;2052;5811;537;1647;732;1882;1269;3529
353570;202205;774;1950;521;1488;93;305;230;586;323;891
353580;202205;2617;6539;2035;5451;384;1035;1035;2642;1419;3677
353590;202205;834;2003;605;1630;68;188;362;942;430;1130
353600;202205;1858;4483;1417;3736;151;446;788;1975;939;2421
353610;202205;847;2343;627;1897;108;366;266;721;374;1087
353620;202205;3339;8225;2427;6730;478;1391;886;2219;1364;3610
353625;202205;693;1650;427;1182;54;171;228;594;282;765
353630;202205;1727;4865;1488;4415;242;783;788;2152;1030;2935
353640;202205;1469;3666;1171;3201;159;446;711;1896;870;2342
353650;202205;8602;22133;6727;18814;767;2413;3953;10347;4720;12760
353657;202205;416;1065;317;916;26;91;153;407;179;498
353660;202205;1548;3120;1125;2566;171;411;697;1526;868;1937
353670;202205;4904;12801;3866;10881;703;2290;1918;4860;2621;7150
353680;202205;822;2025;611;1728;76;246;381;1000;457;1246
353690;202205;516;1343;247;743;30;91;65;178;95;269
353700;202205;2410;5913;1986;5250;141;444;1435;3642;1576;4086
353710;202205;6035;13284;3696;9192;437;1136;1950;4230;2387;5366
353715;202205;494;1264;294;863;17;68;118;309;135;377
353720;202205;2296;5724;1786;4968;290;860;964;2595;1254;3455
353730;202205;5262;13092;4130;11169;494;1603;2528;6267;3022;7870
353740;202205;2337;5879;1703;4788;348;1122;680;1716;1028;2838
353750;202205;1059;3016;790;2532;187;630;242;739;429;1369
353760;202205;15971;34044;12444;29489;2261;5543;7240;16823;9501;22366
353770;202205;688;1916;429;1366;71;249;70;184;141;433
353780;202205;7313;18100;6039;15908;928;2808;3679;9051;4607;11859
353790;202205;3272;9301;2469;7673;580;2016;604;1586;1184;3602
353800;202205;21718;53760;17507;47277;2552;6936;10233;26992;12785;33928
353810;202205;1430;3669;972;2731;148;461;443;1181;591;1642
353820;202205;2017;5189;1393;4010;299;963;435;1136;734;2099
353830;202205;715;1699;533;1422;81;242;250;614;331;856
353850;202205;1814;4726;1413;4012;271;775;611;1657;882;2432
353860;202205;3065;7838;2374;6749;532;1749;1162;2932;1694;4681
353870;202205;35002;87625;26012;71100;3267;9928;13951;34781;17218;44709
353880;202205;3548;9277;2849;8008;208;711;1827;4807;2035;5518
353890;202205;3509;7116;2568;5776;142;396;1855;3792;1997;4188
353900;202205;860;2300;651;1911;86;286;278;736;364;1022
353910;202205;3204;8157;2725;7441;215;689;1975;5239;2190;5928
353920;202205;2334;6033;1708;4918;436;1374;406;926;842;2300
353930;202205;5644;14243;4026;11213;703;2234;1836;4510;2539;6744
353940;202205;1429;3939;1034;3165;157;524;393;1062;550;1586
353950;202205;3892;9882;3032;8359;693;2049;1322;3371;2015;5420
353960;202205;907;2255;648;1790;159;420;192;500;351;920
353970;202205;729;1651;557;1401;45;140;404;968;449;1108
353980;202205;18701;44726;14798;38329;771;2439;11037;27168;11808;29607
353990;202205;1068;2497;689;1851;102;300;362;907;464;1207
354000;202205;2941;6831;1738;4599;410;1112;417;996;827;2108
354010;202205;366;917;263;755;44;138;151;419;195;557
354020;202205;4371;11124;3528;9511;634;1876;1783;4369;2417;6245
354025;202205;825;2180;556;1664;80;262;179;499;259;761
354030;202205;562;1181;315;799;63;150;146;354;209;504
354040;202205;903;1996;598;1537;31;98;446;1077;477;1175
354050;202205;1126;3066;800;2494;160;567;328;974;488;1541
354060;202205;4207;11225;3079;8895;534;1744;1458;3710;1992;5454
354070;202205;4582;11285;3153;8575;496;1515;1514;3663;2010;5178
354075;202205;3340;8802;2709;7729;330;1037;1706;4608;2036;5645
354080;202205;1669;4407;1181;3483;200;633;452;1178;652;1811
354085;202205;502;953;400;828;0;0;320;614;320;614
354090;202205;1902;5086;1625;4528;98;299;1246;3354;1344;3653
354100;202205;24559;62483;17778;51175;3656;11125;8258;22896;11914;34021
354105;202205;1594;3823;1168;3105;137;441;595;1437;732;1878
354110;202205;485;1322;364;1100;64;217;141;397;205;614
354120;202205;1557;4056;1107;3124;224;680;381;942;605;1622
354130;202205;6524;16358;4449;12431;1246;3609;647;1428;1893;5037
354140;202205;22944;54691;16421;43076;2389;6990;8067;19135;10456;26125
354150;202205;3205;7373;2524;6349;587;1508;1000;2471;1587;3979
354160;202205;3286;9009;2595;7699;621;2029;1002;2715;1623;4744
354165;202205;781;2202;615;1883;92;349;337;945;429;1294
354170;202205;2205;5795;1818;5097;133;433;1078;2816;1211;3249
354180;202205;465;1265;363;1065;44;122;195;541;239;663
354190;202205;1782;4836;1293;3834;83;295;691;1920;774;2215
354200;202205;1045;2420;803;2038;63;189;547;1279;610;1468
354210;202205;1109;2772;922;2490;52;179;664;1670;716;1849
354220;202205;3543;9038;2715;7494;407;1222;1453;3772;1860;4994
354230;202205;935;2167;763;1962;30;111;594;1455;624;1566
354240;202205;2028;5390;1392;4105;257;813;479;1243;736;2056
354250;202205;704;1660;461;1261;93;251;153;381;246;632
354260;202205;9661;23587;7530;20031;1130;3354;4086;10166;5216;13520
354270;202205;1164;3255;963;2889;155;503;451;1226;606;1729
354280;202205;965;2200;806;1963;51;147;593;1321;644;1468
354290;202205;1075;3219;909;2882;144;484;481;1505;625;1989
354300;202205;4037;11161;3419;10062;840;2465;1567;4547;2407;7012
354310;202205;850;2391;719;2161;151;474;338;974;489;1448
354320;202205;1106;2570;732;1967;93;281;346;814;439;1095
354323;202205;551;1255;352;901;41;101;171;400;212;501
354325;202205;1657;4759;1139;3600;215;709;252;729;467;1438
354330;202205;11344;27036;8111;20835;790;2337;5240;12397;6030;14734
354340;202205;41323;98832;29775;79523;3598;10978;17957;45405;21555;56383
354350;202205;1371;3313;1094;2870;154;463;651;1587;805;2050
354360;202205;712;1705;455;1302;115;339;128;342;243;681
354370;202205;1136;3047;927;2715;138;448;569;1591;707;2039
354380;202205;751;1919;564;1633;93;350;194;454;287;804
354390;202205;16758;38671;11583;29890;1738;4934;6142;14632;7880;19566
354400;202205;1834;5576;1460;4734;273;939;534;1684;807;2623
354410;202205;7689;18893;6020;15880;900;2667;3381;8212;4281;10879
354420;202205;1737;4279;1292;3486;155;477;746;1837;901;2314
354425;202205;3218;7508;2376;6097;467;1239;1114;2773;1581;4012
354430;202205;1784;4447;1426;3927;105;336;929;2423;1034;2759
354440;202205;696;1718;462;1266;56;168;229;562;285;730
354450;202205;543;1404;329;1004;49;163;106;267;155;430
354460;202205;942;2343;651;1843;119;366;291;769;410;1135
354470;202205;487;1204;340;941;15;56;175;417;190;473
354480;202205;1535;3346;1019;2536;84;244;650;1486;734;1730
354490;202205;927;2583;695;2090;128;401;325;890;453;1291
354500;202205;2517;6646;2026;5880;599;1791;616;1759;1215;3550
354510;202205;842;2238;683;1940;50;176;419;1068;469;1244
354515;202205;468;1277;329;1005;52;171;119;346;171;517
354520;202205;8697;22413;6338;17586;787;2563;3644;9259;4431;11822
354530;202205;5529;14559;4420;12526;1023;2887;1738;4944;2761;7831
354540;202205;1543;3859;1150;3184;225;653;484;1286;709;1939
354550;202205;676;1741;543;1507;72;232;294;745;366;977
354560;202205;2573;5984;1442;3898;164;452;784;1921;948;2373
354570;202205;1348;3292;577;1596;121;325;81;210;202;535
354580;202205;9764;24951;6694;19172;982;3125;3510;9466;4492;12591
354600;202205;2339;5788;1863;4981;272;735;1116;2831;1388;3566
354610;202205;527;1322;296;851;31;91;139;379;170;470
354620;202205;550;1440;346;1058;34;141;160;429;194;570
354625;202205;346;911;213;666;37;134;58;149;95;283
354630;202205;2720;7479;2245;6593;647;1954;636;1769;1283;3723
354640;202205;4122;11013;3188;9233;411;1388;1548;4047;1959;5435
354650;202205;985;2509;798;2208;107;290;466;1252;573;1542
354660;202205;3998;9070;2276;6332;238;799;1044;2627;1282;3426
354670;202205;1266;3382;911;2678;177;566;358;958;535;1524
354680;202205;6500;15853;5041;13553;909;2587;2834;7549;3743;10136
354690;202205;592;1732;433;1402;82;274;155;467;237;741
354700;202205;1029;2637;745;2101;78;254;411;1063;489;1317
354710;202205;560;1447;384;1105;45;131;178;451;223;582
354720;202205;344;793;166;463;62;157;40;119;102;276
354730;202205;12073;32602;9498;27849;1189;3894;5749;16026;6938;19920
354740;202205;358;948;162;503;26;90;24;56;50;146
354750;202205;3242;7968;2146;5932;314;981;936;2253;1250;3234
354760;202205;2487;6364;1817;5184;386;1214;684;1753;1070;2967
354765;202205;402;1046;179;542;19;72;56;141;75;213
354770;202205;2879;6831;2139;5540;405;1050;953;2344;1358;3394
354780;202205;67752;161369;53064;133789;3907;11836;37288;87324;41195;99160
354790;202205;1170;3070;925;2675;68;233;597;1654;665;1887
354800;202205;3044;7516;2335;6381;491;1415;1068;2697;1559;4112
354805;202205;1569;3457;1138;2845;109;262;734;1702;843;1964
354810;202205;712;2013;450;1470;68;257;147;427;215;684
354820;202205;1111;3009;807;2456;153;531;264;646;417;1177
354830;202205;583;1371;360;975;80;233;121;286;201;519
354840;202205;1013;2478;647;1744;53;161;364;883;417;1044
354850;202205;24880;60520;18113;49120;1760;5550;11755;29870;13515;35420
354860;202205;1951;5112;1278;3784;210;672;473;1293;683;1965
354870;202205;73261;175550;57806;148142;4754;14195;39493;94703;44247;108898
354880;202205;6838;16297;3576;9673;418;1329;1485;3233;1903;4562
354890;202205;19239;46042;15158;39268;2007;5862;8773;21764;10780;27626
354900;202205;441;1077;293;829;61;198;114;262;175;460
354910;202205;6816;17321;4401;13061;969;3088;1159;3086;2128;6174
354920;202205;572;1487;300;949;41;137;70;184;111;321
354925;202205;325;882;200;615;23;73;55;153;78;226
354930;202205;425;1013;294;780;38;102;145;362;183;464
354940;202205;2780;7819;2110;6439;632;2038;679;1832;1311;3870
354950;202205;1797;4257;1469;3842;94;323;1085;2670;1179;2993
354960;202205;998;2531;737;2132;91;312;321;848;412;1160
354970;202205;4824;12707;3837;11096;353;1257;2588;7172;2941;8429
354980;202205;39893;91133;28080;71282;2688;8185;18102;42592;20790;50777
354990;202205;86125;203488;63886;164742;4285;13452;43883;105168;48168;118620
354995;202205;3646;7394;2829;6375;135;382;2283;4937;2418;5319
355000;202205;1823;4294;1392;3668;208;659;731;1747;939;2406
355010;202205;4724;12172;3132;8870;1008;2777;681;1899;1689;4676
355020;202205;4068;10761;3066;9078;592;1963;1376;3764;1968;5727
355030;202205;1595364;3771896;1199671;3038139;157321;442203;672906;1570058;830227;2012261
355040;202205;3594;8265;2803;7263;193;559;2176;5571;2369;6130
355050;202205;1247;2653;937;2238;227;571;438;955;665;1526
355060;202205;7358;18779;5522;15511;855;2788;3038;7777;3893;10565
355070;202205;11678;28187;9687;25109;1047;3196;6454;15675;7501;18871
355080;202205;1092;2991;700;2286;154;558;122;330;276;888
355090;202205;1472;3884;1187;3420;198;629;626;1655;824;2284
355100;202205;26484;65566;20984;57588;2789;8227;13535;36329;16324;44556
355110;202205;1070;2813;796;2410;216;746;107;293;323;1039
355120;202205;841;2116;607;1777;70;224;284;797;354;1021
355130;202205;951;2060;528;1313;27;74;347;793;374;867
355140;202205;2439;4908;2067;4400;90;234;1808;3741;1898;3975
355150;202205;5263;13035;4288;11405;469;1372;2820;7155;3289;8527
355160;202205;2641;6859;1923;5639;415;1296;556;1504;971;2800
355170;202205;13526;32153;10793;27761;1736;4820;6109;15119;7845;19939
355180;202205;3256;8042;2386;6710;407;1318;1221;3126;1628;4444
355190;202205;2154;5438;1707;4734;557;1556;699;2083;1256;3639
355200;202205;938;2739;806;2540;217;745;358;1080;575;1825
355210;202205;3525;9128;2714;7464;505;1510;1322;3424;1827;4934
355220;202205;57682;143928;46937;124065;7338;21359;25442;61874;32780;83233
355230;202205;1369;3336;784;2219;134;384;258;650;392;1034
355240;202205;28861;73359;20972;58453;2184;6868;12586;32792;14770;39660
355250;202205;45178;114131;34661;94675;7335;20954;16414;42377;23749;63331
355255;202205;730;1769;401;1182;43;121;131;373;174;494
355260;202205;1816;4065;1344;3339;101;335;922;2109;1023;2444
355270;202205;1352;3783;1071;3236;226;717;481;1333;707;2050
355280;202205;36808;88604;27311;71791;3182;9334;15637;38271;18819;47605
355290;202205;1085;2758;840;2358;145;402;389;1040;534;1442
355300;202205;1581;4376;1314;3893;243;755;570;1543;813;2298
355310;202205;1033;2749;768;2294;98;321;434;1269;532;1590
355320;202205;608;1561;468;1307;98;322;198;449;296;771
355330;202205;3439;8295;2705;7056;109;370;2060;5093;2169;5463
355340;202205;4734;10134;3641;8722;586;1386;2093;5118;2679;6504
355350;202205;1590;4264;1217;3566;220;717;535;1466;755;2183
355360;202205;1422;3359;1111;2898;115;310;701;1750;816;2060
355365;202205;409;1013;218;688;50;148;42;136;92;284
355370;202205;6070;14914;4740;12822;1008;2463;2250;6529;3258;8992
355380;202205;3316;8411;2567;7071;481;1445;997;2379;1478;3824
355385;202205;1670;4079;1388;3693;90;325;931;2247;1021;2572
355390;202205;934;2471;679;1948;113;356;303;780;416;1136
355395;202205;2188;5837;1612;4723;256;827;655;1663;911;2490
355400;202205;10765;29315;8716;25431;1847;6146;3758;9855;5605;16001
355410;202205;27530;72364;18128;53484;3529;11389;6197;17371;9726;28760
355420;202205;719;2168;598;1938;145;517;199;607;344;1124
355430;202205;4249;10292;3284;8608;577;1620;1649;4191;2226;5811
355440;202205;855;2240;554;1627;92;257;126;328;218;585
355450;202205;3951;9749;2740;7476;384;1179;1319;3185;1703;4364
355460;202205;562;1340;361;998;34;113;168;425;202;538
355465;202205;528;1277;426;1118;59;164;267;680;326;844
355470;202205;1313;3207;775;2150;178;559;265;649;443;1208
355475;202205;399;881;335;802;10;26;270;629;280;655
355480;202205;4679;12230;3786;10899;470;1562;2516;7038;2986;8600
355490;202205;1033;2678;602;1820;62;222;284;781;346;1003
355495;202205;986;2589;737;2184;102;367;305;793;407;1160
355500;202205;7943;19453;5162;14285;726;2199;2146;5316;2872;7515
355510;202205;1616;3811;1069;2918;178;521;447;1089;625;1610
355520;202205;409;934;213;614;46;124;61;176;107;300
355530;202205;364;829;148;422;7;20;74;188;81;208
355535;202205;639;1651;508;1445;114;335;240;642;354;977
355540;202205;13449;31376;11239;28376;1096;3174;8229;19980;9325;23154
355550;202205;719;2035;608;1833;64;230;336;924;400;1154
355560;202205;1293;3233;766;2227;172;540;34;111;206;651
355570;202205;337;886;194;588;33;103;53;143;86;246
355580;202205;1381;3186;866;2333;153;479;302;736;455;1215
355590;202205;183;465;140;395;14;39;79;215;93;254
355600;202205;1742;4183;1157;3177;192;559;375;1001;567;1560
355610;202205;2158;5089;1482;3948;160;457;814;1990;974;2447
355620;202205;5840;14800;4445;12166;480;1601;2582;6410;3062;8011
355630;202205;2979;7580;2184;6170;284;851;1267;3355;1551;4206
355635;202205;1063;2940;784;2394;126;414;271;752;397;1166
355640;202205;3948;10370;2770;8107;643;1892;763;2208;1406;4100
355645;202205;4585;12216;3381;10135;482;1612;1889;5411;2371;7023
355650;202205;7730;19928;6150;17135;1339;3888;2787;7170;4126;11058
355660;202205;1620;4034;1119;3172;205;530;335;893;540;1423
355670;202205;4606;11809;3288;8957;413;1382;1713;4000;2126;5382
355680;202205;3283;8698;1644;4996;416;1381;144;429;560;1810
355690;202205;863;2425;589;1909;166;577;16;37;182;614
355695;202205;290;781;177;532;13;45;37;79;50;124
355700;202205;8827;23748;7421;20824;941;2982;4475;11794;5416;14776
355710;202205;10989;25026;7627;19042;1036;3027;4047;8762;5083;11789
355715;202205;529;1395;297;878;66;193;57;158;123;351
355720;202205;1657;4380;1332;3836;174;547;760;2023;934;2570
355730;202205;1154;2962;929;2582;110;362;526;1349;636;1711
410010;202205;1380;3716;1070;3099;236;738;251;673;487;1411
410020;202205;1216;3379;926;2781;253;740;256;717;509;1457
410030;202205;1821;4680;1545;4258;196;569;867;2399;1063;2968
410040;202205;15651;40995;11726;33888;2410;7530;4130;11005;6540;18535
410045;202205;885;2303;639;1816;126;383;223;561;349;944
410050;202205;2543;6200;1790;4928;264;814;720;1827;984;2641
410060;202205;2352;6356;1881;5494;445;1379;552;1534;997;2913
410070;202205;2210;5370;1645;4412;329;959;569;1337;898;2296
410080;202205;1508;3871;1084;3151;258;757;216;605;474;1362
410090;202205;1280;2955;1063;2655;110;260;588;1550;698;1810
410100;202205;2325;6338;1630;4790;302;958;172;461;474;1419
410105;202205;578;1412;347;975;35;105;138;361;173;466
410110;202205;3729;8879;2698;7083;364;1048;1338;3246;1702;4294
410115;202205;639;1590;468;1293;57;170;187;461;244;631
410120;202205;3396;8482;2961;7841;469;1217;1860;4879;2329;6096
410130;202205;1474;3717;1295;3396;182;531;754;1880;936;2411
410140;202205;19411;45602;13091;34693;2383;6858;4011;9678;6394;16536
410150;202205;18757;43043;10217;26905;1782;5035;2938;6832;4720;11867
410160;202205;3427;9120;2795;8060;614;1939;1053;2889;1667;4828
410165;202205;715;1844;567;1550;74;231;311;791;385;1022
410170;202205;3319;8256;2186;5931;442;1290;257;609;699;1899
410180;202205;18576;49331;14561;41588;2232;6986;7354;19112;9586;26098
410185;202205;513;1418;387;1116;55;187;144;349;199;536
410190;202205;2509;6039;1832;4858;390;1039;512;1230;902;2269
410200;202205;6625;14455;3739;9666;733;1978;569;1380;1302;3358
410210;202205;3630;8795;2343;6565;374;1194;798;1905;1172;3099
410220;202205;605;1518;408;1165;69;212;127;330;196;542
410230;202205;2084;5409;1594;4464;237;755;688;1687;925;2442
410240;202205;5905;14914;4140;11610;833;2655;664;1666;1497;4321
410250;202205;2666;6242;1970;5143;158;508;965;2394;1123;2902
410260;202205;2131;5106;1348;3663;187;530;681;1760;868;2290
410270;202205;556;1435;406;1165;52;181;161;410;213;591
410275;202205;682;1831;480;1401;79;267;192;501;271;768
410280;202205;2672;6758;1834;5203;232;754;795;2009;1027;2763
410290;202205;3726;10023;2605;7763;721;2120;706;2083;1427;4203
410300;202205;792;1865;622;1608;71;214;312;712;383;926
410302;202205;373;907;229;650;19;66;114;308;133;374
410304;202205;1574;3649;1361;3275;123;323;988;2252;1111;2575
410305;202205;1892;4337;1333;3549;96;289;897;2300;993;2589
410310;202205;3196;8192;2637;7220;258;887;1643;4245;1901;5132
410315;202205;756;1681;496;1272;167;443;145;361;312;804
410320;202205;1123;3039;755;2334;99;327;126;352;225;679
410322;202205;735;1892;389;1112;55;176;154;371;209;547
410330;202205;1705;4002;1191;3077;190;496;391;968;581;1464
410335;202205;957;2447;713;1999;114;356;284;715;398;1071
410337;202205;906;2171;634;1662;94;271;225;513;319;784
410340;202205;541;1476;371;1079;25;88;156;356;181;444
410345;202205;2914;7424;1726;4942;356;1086;587;1499;943;2585
410347;202205;872;2174;637;1767;67;194;202;560;269;754
410350;202205;1847;4367;1354;3589;149;460;690;1653;839;2113
410360;202205;4566;11090;3479;9246;604;1680;1361;3485;1965;5165
410370;202205;15998;41452;10549;29049;1239;3767;4473;10573;5712;14340
410380;202205;1967;4666;1433;3752;234;698;509;1157;743;1855
410390;202205;3169;7439;2162;5769;441;1363;862;1979;1303;3342
410395;202205;1049;2862;844;2463;150;449;337;992;487;1441
410400;202205;8422;20514;6395;16848;760;2231;3678;8972;4438;11203
410405;202205;987;2216;704;1799;89;250;369;862;458;1112
410410;202205;1668;4099;1513;3866;132;376;1038;2626;1170;3002
410420;202205;13275;34154;10159;28281;1521;4696;4605;11481;6126;16177
410425;202205;4000;10581;2790;8156;473;1475;1081;2844;1554;4319
410430;202205;14960;36069;10717;28616;1587;4685;4180;10229;5767;14914
410440;202205;2614;7261;2231;6580;364;1159;1170;3370;1534;4529
410442;202205;2764;7808;2235;6713;584;1834;652;1846;1236;3680
410445;202205;2515;6881;1822;5582;397;1341;287;941;684;2282
410450;202205;1685;3980;1273;3360;212;601;511;1226;723;1827
410460;202205;2632;6243;1925;5040;287;810;909;2170;1196;2980
410465;202205;3301;8996;2562;7655;469;1428;909;2473;1378;3901
410470;202205;2606;6789;1844;5461;493;1601;242;777;735;2378
410480;202205;44773;104231;25887;71888;3876;12054;7174;16935;11050;28989
410490;202205;13247;34648;9707;27658;1532;4654;4314;11258;5846;15912
410500;202205;2094;5209;1409;3950;257;747;337;791;594;1538
410510;202205;2043;4894;1422;3831;307;785;439;1180;746;1965
410520;202205;3391;10060;2985;9302;891;2917;1066;3369;1957;6286
410530;202205;1784;4216;863;2376;110;329;224;490;334;819
410540;202205;3159;8172;2190;6256;348;1118;939;2499;1287;3617
410550;202205;8772;22485;6015;16823;1022;3112;1772;4186;2794;7298
410560;202205;1782;4433;1311;3529;279;794;423;959;702;1753
410570;202205;3004;7660;2174;6273;692;2296;247;725;939;3021
410580;202205;31263;77351;23760;64090;3594;10874;12092;30030;15686;40904
410590;202205;1845;4953;1314;3760;190;577;415;982;605;1559
410600;202205;2028;5093;1592;4266;319;885;537;1436;856;2321
410610;202205;798;1968;608;1636;63;198;294;712;357;910
410620;202205;3032;7999;2152;6116;532;1553;483;1276;1015;2829
410630;202205;2898;7142;1951;5340;358;1154;499;1092;857;2246
410640;202205;5581;12605;3926;9769;868;2416;617;1552;1485;3968
410645;202205;1298;3384;1071;3107;193;598;687;1974;880;2572
410650;202205;2786;7276;1953;5622;345;1079;786;2029;1131;3108
410655;202205;990;2312;705;1832;54;141;349;845;403;986
410657;202205;681;1803;421;1258;67;218;140;348;207;566
410660;202205;4113;9918;2548;6714;404;1126;927;2143;1331;3269
410670;202205;1154;2793;693;1913;120;329;238;585;358;914
410680;202205;2723;7811;1841;5691;473;1519;369;1116;842;2635
410685;202205;581;1430;428;1173;85;258;171;435;256;693
410690;202205;158068;369244;110533;284922;16611;48206;48480;110195;65091;158401
410700;202205;2771;6761;2298;6047;463;1264;1028;2544;1491;3808
410710;202205;1021;2492;653;1816;116;350;289;734;405;1084
410712;202205;744;1959;621;1743;82;252;347;937;429;1189
410715;202205;978;2705;622;1926;69;234;259;739;328;973
410720;202205;4053;9799;3335;8591;525;1603;1182;2853;1707;4456
410725;202205;1298;3051;785;2146;183;543;156;355;339;898
410730;202205;886;2212;659;1820;117;362;153;425;270;787
410740;202205;963;2604;725;2165;67;245;342;1007;409;1252
410750;202205;2147;5009;1733;4299;288;744;881;2050;1169;2794
410752;202205;438;1036;241;667;42;113;110;273;152;386
410753;202205;372;1053;264;823;38;130;69;195;107;325
410754;202205;1221;2971;1018;2681;63;155;724;1966;787;2121
410755;202205;631;1572;467;1279;60;166;209;516;269;682
410760;202205;4095;10274;2876;8057;667;2168;797;2039;1464;4207
410765;202205;18531;48589;14724;41481;2972;9265;4529;11024;7501;20289
410770;202205;1171;2689;826;2123;81;183;423;1090;504;1273
410773;202205;1463;3632;1270;3337;115;347;851;2145;966;2492
410775;202205;1812;4033;1580;3708;49;127;1170;2621;1219;2748
410780;202205;712;1694;481;1268;87;246;152;363;239;609
410785;202205;830;2049;610;1689;74;251;228;596;302;847
410790;202205;1141;3164;941;2784;214;676;141;326;355;1002
410800;202205;3857;8169;3095;7111;80;243;2053;4500;2133;4743
410810;202205;501;1300;370;1056;41;145;152;384;193;529
410820;202205;1110;3027;614;1775;119;382;124;282;243;664
410830;202205;48746;111395;34844;88701;6119;17463;15385;36205;21504;53668
410832;202205;1197;3037;971;2652;94;318;608;1525;702;1843
410840;202205;10148;24465;6088;16962;1245;3724;1748;4250;2993;7974
410845;202205;1280;3021;993;2589;148;405;473;1177;621;1582
410850;202205;2428;6570;2127;6052;364;1163;1003;2728;1367;3891
410855;202205;828;1995;525;1415;59;170;258;613;317;783
410860;202205;5285;12075;4201;10367;226;715;2823;6486;3049;7201
410865;202205;1623;4426;1382;3988;138;441;809;2379;947;2820
410870;202205;1380;3531;1109;3063;132;390;637;1697;769;2087
410880;202205;5320;13533;3746;10776;706;2128;713;2047;1419;4175
410890;202205;1221;3217;971;2758;163;506;399;1048;562;1554
410895;202205;1130;3379;944;2999;296;1023;261;761;557;1784
410900;202205;943;2417;662;1910;105;341;167;384;272;725
410910;202205;485;1087;306;761;11;33;172;377;183;410
410920;202205;988;2288;745;1922;101;286;373;923;474;1209
410930;202205;1958;4807;1366;3810;355;1113;245;656;600;1769
410940;202205;27240;70261;20115;57885;3788;11917;7625;20832;11413;32749
410950;202205;2213;6025;1993;5689;115;357;1588;4464;1703;4821
410960;202205;9191;21378;6503;17070;1532;4466;2783;6984;4315;11450
410965;202205;1326;3178;916;2468;81;238;570;1460;651;1698
410970;202205;4733;12203;3379;9633;845;2766;550;1299;1395;4065
410975;202205;1614;3733;1216;3128;167;496;581;1422;748;1918
410980;202205;8551;20468;5676;15491;628;1899;2648;6507;3276;8406
410990;202205;1631;3730;1125;2966;187;554;512;1321;699;1875
411000;202205;767;2017;550;1630;99;321;169;440;268;761
411005;202205;525;1246;321;844;42;117;113;252;155;369
411007;202205;2835;7278;2123;6013;398;1261;820;2159;1218;3420
411010;202205;4897;13883;3865;11915;967;3159;549;1551;1516;4710
411020;202205;2660;7119;2207;6365;568;1723;721;2000;1289;3723
411030;202205;832;2021;581;1517;67;198;260;579;327;777
411040;202205;1153;2808;613;1678;96;264;171;387;267;651
411050;202205;2245;6671;1832;5836;407;1425;351;936;758;2361
411060;202205;2466;6307;1628;4612;345;1006;419;1113;764;2119
411065;202205;454;1105;282;773;24;77;120;305;144;382
411070;202205;8642;20690;6904;17956;796;2358;3818;9396;4614;11754
411080;202205;2214;5616;1786;4880;424;1304;484;1292;908;2596
411090;202205;906;2354;596;1745;85;262;135;341;220;603
411095;202205;2914;6644;1675;4487;246;685;336;801;582;1486
411100;202205;1380;3437;958;2700;114;370;353;919;467;1289
411110;202205;729;1838;351;1040;40;113;26;50;66;163
411120;202205;1655;4200;1358;3726;287;928;540;1301;827;2229
411125;202205;6090;16805;5418;15631;1185;3445;2554;7520;3739;10965
411130;202205;818;2077;580;1639;141;384;149;459;290;843
411140;202205;2532;7386;2095;6496;537;1754;659;2049;1196;3803
411150;202205;4611;11171;3135;8339;658;1869;327;681;985;2550
411155;202205;1169;2836;771;2120;119;347;344;838;463;1185
411160;202205;428;944;289;725;37;106;83;202;120;308
411170;202205;896;2445;684;2014;136;446;297;814;433;1260
411180;202205;6723;16715;5337;14447;749;2276;2800;6938;3549;9214
411190;202205;2226;5524;1684;4577;221;663;726;1733;947;2396
411200;202205;5574;14315;4188;11873;907;2942;1281;3105;2188;6047
411210;202205;3888;8404;2802;6688;394;1084;1303;2901;1697;3985
411220;202205;1033;2530;714;1954;153;436;227;588;380;1024
411230;202205;978;2501;728;2034;156;475;238;622;394;1097
411240;202205;1809;4111;1259;3204;211;563;536;1284;747;1847
411250;202205;2569;6500;1869;5279;375;1196;603;1575;978;2771
411260;202205;357;892;239;661;30;97;94;230;124;327
411270;202205;2229;5696;1652;4574;260;749;783;1986;1043;2735
411275;202205;1744;3793;1213;2967;133;396;651;1453;784;1849
411280;202205;1584;4096;1129;3247;286;874;249;643;535;1517
411290;202205;930;2336;599;1701;66;212;318;857;384;1069
411295;202205;1395;3396;1014;2714;126;369;457;1132;583;1501
411300;202205;1142;2793;754;2061;79;233;314;733;393;966
411310;202205;1025;2242;805;1951;125;314;387;891;512;1205
411320;202205;6250;15310;4662;12606;694;2027;2177;5258;2871;7285
411325;202205;1649;4371;1356;3833;269;758;664;1930;933;2688
411330;202205;3682;9462;2721;7777;576;1806;860;2426;1436;4232
411340;202205;931;2467;559;1649;87;264;162;428;249;692
411342;202205;1207;2820;656;1738;108;312;222;515;330;827
411345;202205;1342;3199;1003;2648;69;220;700;1801;769;2021
411350;202205;3304;8497;2211;6404;578;1766;426;1108;1004;2874
411360;202205;862;1932;647;1609;66;212;355;769;421;981
411370;202205;68099;162189;50407;132995;3941;12373;30149;73273;34090;85646
411373;202205;1639;3884;1308;3400;145;400;672;1774;817;2174
411375;202205;1267;3037;891;2346;109;291;358;885;467;1176
411380;202205;1282;2876;884;2143;50;130;566;1252;616;1382
411390;202205;1711;4506;1363;3798;202;635;538;1268;740;1903
411400;202205;2657;6227;2013;5105;184;545;1122;2653;1306;3198
411410;202205;3207;8615;2401;6987;519;1614;590;1562;1109;3176
411420;202205;4860;11432;2690;7491;395;1186;532;1112;927;2298
411430;202205;4371;11025;3315;9132;670;2047;1185;2875;1855;4922
411435;202205;493;1287;305;921;55;172;90;236;145;408
411440;202205;2897;7620;2316;6568;452;1418;777;2048;1229;3466
411450;202205;2838;7167;2158;6083;246;729;1262;3524;1508;4253
411460;202205;5024;12528;3206;9126;499;1599;723;1727;1222;3326
411470;202205;943;2296;701;1877;115;347;300;718;415;1065
411480;202205;6121;15342;4461;12334;726;2364;1612;3930;2338;6294
411490;202205;1877;4559;1427;3861;161;513;638;1531;799;2044
411500;202205;1529;3941;1057;2963;175;536;233;512;408;1048
411510;202205;2641;6213;2093;5364;308;911;662;1720;970;2631
411520;202205;39594;93999;24356;64869;2900;8932;10190;23837;13090;32769
411530;202205;1069;2662;623;1834;99;326;117;313;216;639
411535;202205;566;1584;384;1177;54;179;122;324;176;503
411540;202205;3015;7079;2116;5511;90;289;1275;3203;1365;3492
411545;202205;1009;2796;838;2487;64;216;548;1611;612;1827
411550;202205;795;1888;610;1564;92;248;190;436;282;684
411560;202205;2230;5948;1252;3867;190;630;96;227;286;857
411570;202205;8246;18500;5785;14863;1348;3730;1536;3761;2884;7491
411573;202205;873;2258;715;1981;150;453;302;764;452;1217
411575;202205;2252;5801;1681;4726;311;930;512;1326;823;2256
411580;202205;5464;12439;3390;9253;537;1650;637;1517;1174;3167
411585;202205;671;1924;337;1065;63;195;61;175;124;370
411590;202205;499;1307;375;1065;39;133;196;506;235;639
411600;202205;381;914;243;692;41;123;94;243;135;366
411605;202205;1758;3937;1136;2981;160;461;555;1462;715;1923
411610;202205;3186;6885;2293;5374;60;209;1683;3621;1743;3830
411620;202205;3261;8141;2739;7348;435;1219;1466;3907;1901;5126
411630;202205;941;2283;599;1689;75;260;231;558;306;818
411640;202205;532;1332;369;994;47;121;136;314;183;435
411650;202205;227;616;144;438;31;102;34;78;65;180
411660;202205;1026;2496;724;1935;73;227;292;687;365;914
411670;202205;1697;3841;1147;2857;106;280;646;1464;752;1744
411680;202205;1609;4121;1202;3348;237;721;456;1216;693;1937
411690;202205;4472;10887;3330;8935;669;1767;1015;2847;1684;4614
411695;202205;718;2061;504;1524;46;146;221;632;267;778
411700;202205;1887;4695;1273;3550;293;848;246;642;539;1490
411705;202205;2596;7184;2213;6540;366;1068;1343;4137;1709;5205
411710;202205;2292;5635;1590;4342;345;955;465;1158;810;2113
411720;202205;1210;2771;856;2167;125;326;339;814;464;1140
411721;202205;1120;2680;831;2165;126;331;280;690;406;1021
411722;202205;1046;2780;588;1744;101;331;178;401;279;732
411725;202205;1432;3836;932;2846;213;707;222;626;435;1333
411727;202205;1685;4473;1112;3284;244;742;131;333;375;1075
411729;202205;678;1631;385;1061;57;191;123;275;180;466
411730;202205;6140;15295;4823;12845;787;2288;2410;6128;3197;8416
411740;202205;573;1449;316;911;78;208;58;136;136;344
411745;202205;907;2501;644;1934;78;277;163;366;241;643
411750;202205;6771;16994;5073;13825;633;1904;2566;6498;3199;8402
411760;202205;8150;20425;6292;17443;1883;5325;1498;4480;3381;9805
411770;202205;3647;10016;2720;8068;591;1863;626;1655;1217;3518
411780;202205;2993;7996;2587;7303;643;1894;1013;2910;1656;4804
411790;202205;3308;7640;2011;5425;347;1064;643;1497;990;2561
411800;202205;1314;3609;951;2738;190;591;221;539;411;1130
411810;202205;1763;4362;1335;3564;226;631;531;1292;757;1923
411820;202205;15550;40477;12960;36204;2816;8278;6570;17736;9386;26014
411830;202205;580;1383;440;1143;140;325;65;181;205;506
411840;202205;14186;36108;9989;27762;1596;4827;3290;8096;4886;12923
411845;202205;712;1947;435;1333;71;247;106;283;177;530
411850;202205;8894;21506;6190;16939;1472;4266;1382;3466;2854;7732
411860;202205;797;2132;603;1750;88;275;148;387;236;662
411870;202205;667;1841;478;1432;125;404;99;270;224;674
411880;202205;2718;6276;1964;5097;233;705;888;2123;1121;2828
411885;202205;1242;3149;882;2467;119;391;243;541;362;932
411890;202205;1632;4192;1180;3418;215;691;142;382;357;1073
411900;202205;938;2451;589;1731;123;380;131;367;254;747
411910;202205;1242;3490;909;2838;163;607;312;873;475;1480
411915;202205;17707;42185;12534;33050;1793;5212;5545;13204;7338;18416
411920;202205;1352;3665;1122;3247;216;695;453;1228;669;1923
411925;202205;536;1359;382;1085;67;198;169;446;236;644
411930;202205;5718;16151;4817;14588;2069;6625;590;2017;2659;8642
411940;202205;3774;10335;2999;8802;700;2149;1090;2865;1790;5014
411950;202205;16758;42950;14005;38565;1521;4862;8869;23187;10390;28049
411960;202205;6908;17386;5491;14741;1019;2892;2234;5583;3253;8475
411965;202205;546;1442;392;1135;49;156;172;451;221;607
411970;202205;1315;2819;1028;2441;191;394;486;1322;677;1716
411980;202205;1755;3987;1285;3264;258;653;594;1423;852;2076
411990;202205;44561;111313;29877;85645;5219;16382;12167;32826;17386;49208
411995;202205;5037;11676;3933;10020;1038;2939;1285;3087;2323;6026
412000;202205;2073;4605;1471;3628;43;144;1051;2402;1094;2546
412010;202205;697;2018;504;1607;70;246;119;319;189;565
412015;202205;590;1573;473;1357;64;177;259;741;323;918
412020;202205;503;1393;322;1019;55;196;118;349;173;545
412030;202205;687;1881;511;1557;62;208;211;599;273;807
412033;202205;1048;2666;745;2083;71;210;285;670;356;880
412035;202205;790;2077;510;1563;68;220;259;756;327;976
412040;202205;789;2048;464;1392;57;164;78;210;135;374
412050;202205;1716;4138;1172;3173;266;811;273;708;539;1519
412060;202205;8305;22658;6850;19841;1729;5636;2019;5569;3748;11205
412065;202205;712;1869;521;1496;97;309;152;409;249;718
412070;202205;1445;3547;1115;2942;129;399;487;1108;616;1507
412080;202205;2773;7063;2010;5636;275;893;844;2006;1119;2899
412085;202205;363;860;136;401;14;53;36;81;50;134
412090;202205;7233;17487;5359;14227;1106;3104;2265;5995;3371;9099
412100;202205;2059;5165;1521;4231;465;1423;410;1157;875;2580
412110;202205;1043;2653;685;1950;86;262;223;562;309;824
412120;202205;2572;6770;1995;5763;437;1405;614;1538;1051;2943
412125;202205;801;2141;510;1546;91;282;114;328;205;610
412130;202205;912;2180;628;1667;123;323;162;412;285;735
412135;202205;665;1726;329;977;47;163;113;285;160;448
412140;202205;2144;5015;1532;3972;249;718;371;938;620;1656
412150;202205;3148;7745;2615;6803;472;1358;1325;3147;1797;4505
412160;202205;1005;3026;570;1858;61;226;50;115;111;341
412170;202205;5088;13089;4297;11856;762;2278;2020;5134;2782;7412
412175;202205;1478;4023;1233;3602;269;794;494;1427;763;2221
412180;202205;1904;5032;1417;4168;186;632;616;1654;802;2286
412190;202205;3760;9089;2724;7268;331;987;1126;2870;1457;3857
412200;202205;2166;5920;1447;4334;347;1124;290;781;637;1905
412210;202205;743;1705;460;1247;65;201;190;461;255;662
412215;202205;3744;9606;2742;7689;625;1762;1161;3337;1786;5099
412217;202205;1111;2756;921;2430;26;85;673;1663;699;1748
412220;202205;6828;18655;5494;16224;1261;3729;1805;5238;3066;8967
412230;202205;3045;8468;2401;7317;400;1397;536;1404;936;2801
412240;202205;8806;22035;5813;16348;995;3036;1804;4442;2799;7478
412250;202205;2239;5546;1640;4450;396;1151;352;854;748;2005
412260;202205;1507;3787;1150;3103;199;565;396;993;595;1558
412265;202205;1116;2781;898;2428;121;374;524;1290;645;1664
412270;202205;1134;3029;757;2248;107;348;287;774;394;1122
412280;202205;455;1172;349;992;83;245;94;243;177;488
412290;202205;1169;2830;841;2269;149;441;310;774;459;1215
412300;202205;1909;4757;1379;3863;248;741;350;928;598;1669
412310;202205;791;2195;606;1837;102;362;182;494;284;856
412320;202205;859;2115;542;1496;57;193;158;411;215;604
412330;202205;1778;4486;1232;3520;230;703;445;1273;675;1976
412340;202205;1331;3503;975;2787;146;481;130;329;276;810
412350;202205;3468;8793;2317;6591;460;1369;553;1391;1013;2760
412360;202205;313;812;240;669;6;24;163;432;169;456
412370;202205;994;2683;705;2103;142;439;150;427;292;866
412380;202205;1714;4551;1228;3610;322;1036;108;317;430;1353
412382;202205;550;1307;362;989;44;157;182;404;226;561
412385;202205;2592;6564;2103;5687;589;1544;838;2347;1427;3891
412390;202205;2821;6510;2215;5556;378;1013;801;1975;1179;2988
412395;202205;832;2220;604;1725;84;222;283;777;367;999
412400;202205;1026;2585;741;2064;136;389;233;587;369;976
412402;202205;2649;6274;1852;4992;402;1071;457;1245;859;2316
412405;202205;3466;8818;2306;6747;629;1877;272;767;901;2644
412410;202205;7141;17837;5302;14928;894;2928;1721;4524;2615;7452
412420;202205;612;1471;396;1054;37;107;181;425;218;532
412430;202205;624;1543;346;969;42;120;139;362;181;482
412440;202205;3304;8248;2312;6521;537;1540;695;1894;1232;3434
412450;202205;568;1602;385;1147;63;189;44;88;107;277
412460;202205;1266;3059;989;2609;156;449;477;1207;633;1656
412470;202205;1785;5250;1469;4576;350;1199;388;1154;738;2353
412480;202205;1340;3312;920;2492;156;462;359;840;515;1302
412490;202205;1537;3562;1177;2961;94;255;677;1557;771;1812
412500;202205;2296;5500;1751;4545;300;847;620;1415;920;2262
412510;202205;2211;6386;1599;4933;450;1469;290;734;740;2203
412520;202205;1509;3687;903;2490;194;531;162;406;356;937
412530;202205;762;1975;549;1561;77;215;103;275;180;490
412535;202205;882;2249;602;1721;122;379;95;198;217;577
412540;202205;1268;3113;916;2510;150;514;258;690;408;1204
412545;202205;771;1918;547;1487;96;277;177;453;273;730
412550;202205;40784;103303;30056;82902;4392;13350;13805;34178;18197;47528
412555;202205;336;840;232;623;26;89;78;161;104;250
412560;202205;5801;15653;4387;12607;912;2870;1156;3100;2068;5970
412570;202205;5073;12205;3085;8567;570;1788;546;1352;1116;3140
412575;202205;1189;2839;970;2491;163;428;513;1228;676;1656
412580;202205;1741;4248;1254;3395;105;314;699;1756;804;2070
412590;202205;462;1190;264;788;48;169;34;74;82;243
412600;202205;1883;4701;1448;3878;134;429;817;1973;951;2402
412610;202205;959;2482;691;1924;102;311;322;775;424;1086
412620;202205;1442;3565;1105;3046;223;653;411;1048;634;1701
412625;202205;10001;25607;6494;18879;1226;3790;570;1541;1796;5331
412627;202205;1265;3415;877;2646;166;549;256;752;422;1301
412630;202205;3126;8856;2231;6966;386;1298;613;1685;999;2983
412635;202205;483;1253;313;914;33;107;106;254;139;361
412640;202205;1128;2875;659;1916;81;230;161;402;242;632
412650;202205;1877;4903;1487;4128;245;765;591;1442;836;2207
412660;202205;3007;7378;2209;5921;268;793;849;2013;1117;2806
412665;202205;440;1057;337;879;57;171;148;356;205;527
412667;202205;1961;4970;1445;3970;207;618;640;1686;847;2304
412670;202205;965;2191;657;1711;134;365;191;452;325;817
412680;202205;2348;5981;1627;4665;195;661;552;1321;747;1982
412690;202205;1312;3296;914;2539;173;519;309;780;482;1299
412700;202205;2146;5373;1808;4848;262;789;963;2461;1225;3250
412710;202205;6506;18057;4874;14745;894;3011;1354;3482;2248;6493
412720;202205;1351;3734;1086;3191;166;542;314;742;480;1284
412730;202205;2980;7419;2151;5872;361;1080;839;2091;1200;3171
412740;202205;2226;5960;1557;4690;314;1049;242;697;556;1746
412750;202205;4502;11263;3695;10108;350;1099;2304;5956;2654;7055
412760;202205;3354;8643;2814;7769;506;1583;1589;4121;2095;5704
412770;202205;12572;31695;7148;21271;935;2973;1597;3965;2532;6938
412780;202205;1366;3441;1046;2879;239;725;390;982;629;1707
412785;202205;2480;5542;1747;4368;223;558;1133;2776;1356;3334
412788;202205;1598;4308;1310;3810;329;956;527;1469;856;2425
412790;202205;1524;3872;932;2737;143;461;315;781;458;1242
412795;202205;1381;3457;780;2279;133;409;161;446;294;855
412796;202205;2586;7032;2172;6311;484;1521;719;1907;1203;3428
412800;202205;4375;10062;3140;7857;350;1061;1584;3444;1934;4505
412810;202205;14142;34968;9611;26160;1127;3602;4150;9960;5277;13562
412820;202205;7128;18710;5104;14783;1157;3536;1626;4624;2783;8160
412830;202205;371;1027;283;850;35;104;70;199;105;303
412840;202205;2107;4930;1479;3767;142;414;819;1870;961;2284
412850;202205;3059;7663;2288;6423;280;873;1109;2884;1389;3757
412853;202205;1768;4213;1473;3728;208;595;800;1747;1008;2342
412855;202205;1525;3823;861;2456;111;371;208;479;319;850
412860;202205;839;2030;566;1580;93;286;250;612;343;898
412862;202205;736;1778;498;1390;99;279;189;505;288;784
412863;202205;1418;3986;1261;3706;302;970;525;1424;827;2394
412865;202205;770;2005;564;1609;142;405;157;446;299;851
412870;202205;1008;2482;741;2058;194;594;233;656;427;1250
412880;202205;1013;2651;725;2116;137;435;224;586;361;1021
420005;202205;474;1344;287;910;27;87;137;428;164;515
420010;202205;3674;8632;2447;6584;165;479;1829;4904;1994;5383
420020;202205;500;1487;331;1064;57;224;98;248;155;472
420030;202205;121;406;82;302;24;98;21;75;45;173
420040;202205;643;1866;388;1305;92;360;34;97;126;457
420050;202205;811;1801;551;1346;125;334;302;652;427;986
420055;202205;182;541;102;341;17;65;35;109;52;174
420060;202205;156;439;109;332;16;46;40;119;56;165
420070;202205;927;2616;711;2180;156;505;333;973;489;1478
420075;202205;86;225;50;151;8;24;12;20;20;44
420080;202205;464;1265;353;1000;73;233;137;352;210;585
420090;202205;471;1411;305;1035;76;283;69;195;145;478
420100;202205;1606;3817;1325;3375;70;196;1034;2581;1104;2777
420110;202205;302;921;259;829;39;143;145;455;184;598
420120;202205;692;1821;487;1385;65;211;254;643;319;854
420125;202205;415;1196;291;925;64;227;100;293;164;520
420127;202205;351;909;152;460;24;85;63;179;87;264
420130;202205;4798;12736;3703;10928;672;2234;1566;4144;2238;6378
420140;202205;4712;12148;3569;10219;997;3077;886;2429;1883;5506
420150;202205;755;1862;547;1524;51;167;322;868;373;1035
420160;202205;232;561;97;292;15;61;27;69;42;130
420165;202205;182;507;119;370;28;90;40;105;68;195
420170;202205;322;958;232;744;40;137;79;216;119;353
420180;202205;185;578;114;401;18;85;30;91;48;176
420190;202205;229;645;132;400;28;90;47;131;75;221
420195;202205;1993;4967;1539;4266;393;1288;598;1492;991;2780
420200;202205;6885;16163;4547;11926;601;1855;2163;4847;2764;6702
420205;202205;2317;5895;1597;4476;250;772;852;2293;1102;3065
420207;202205;2361;5826;1530;4292;252;803;636;1625;888;2428
420208;202205;375;1030;225;732;74;236;54;155;128;391
420209;202205;179;545;120;371;15;56;58;156;73;212
420210;202205;4247;10511;3056;8545;431;1446;1656;4328;2087;5774
420213;202205;916;2627;751;2300;149;497;301;894;450;1391
420215;202205;257;741;177;557;43;143;50;154;93;297
420220;202205;354;1020;236;778;36;142;93;276;129;418
420230;202205;6361;16333;4980;13838;604;1921;2809;7258;3413;9179
420240;202205;16889;45401;11200;32501;1316;4523;5496;13794;6812;18317
420243;202205;466;1192;387;1049;52;150;259;685;311;835
420245;202205;1851;4585;1416;3851;119;389;916;2336;1035;2725
420250;202205;584;1484;510;1373;40;134;373;953;413;1087
420253;202205;515;1202;373;1000;31;92;220;583;251;675
420257;202205;175;448;115;345;15;45;61;182;76;227
420260;202205;1346;3267;1013;2826;91;304;764;2088;855;2392
420270;202205;644;1623;340;948;40;121;141;349;181;470
420280;202205;1576;4371;1278;3784;180;631;600;1648;780;2279
420285;202205;128;327;92;256;14;52;33;56;47;108
420287;202205;511;1122;363;925;69;187;170;424;239;611
420290;202205;5951;16250;4691;13556;625;2083;2740;7292;3365;9375
420300;202205;8526;23197;5115;15353;914;3016;1718;4542;2632;7558
420310;202205;983;2132;563;1412;46;143;342;768;388;911
420315;202205;902;2335;627;1892;71;242;355;1028;426;1270
420320;202205;6507;16707;4827;14033;1381;4398;1560;4244;2941;8642
420325;202205;393;1083;278;866;38;121;106;308;144;429
420330;202205;1078;3032;716;2301;125;472;232;661;357;1133
420340;202205;1224;3172;945;2676;199;617;344;859;543;1476
420350;202205;1391;3355;1038;2763;93;293;710;1835;803;2128
420360;202205;3339;8834;1865;5724;373;1231;176;536;549;1767
420370;202205;1495;3702;1198;3202;90;313;831;2064;921;2377
420380;202205;5146;12900;3562;10077;662;2092;1541;4009;2203;6101
420390;202205;1183;2839;843;2184;152;444;327;618;479;1062
420395;202205;1371;3731;972;2951;163;556;178;389;341;945
420400;202205;1226;3228;864;2533;107;359;439;1211;546;1570
420410;202205;644;1613;507;1343;32;97;371;964;403;1061
420415;202205;389;1078;283;836;59;198;117;347;176;545
420417;202205;711;2012;560;1701;120;370;273;844;393;1214
420419;202205;172;589;123;458;48;190;13;53;61;243
420420;202205;14692;37222;10252;29123;2541;8072;3563;9214;6104;17286
420425;202205;717;1908;505;1458;46;151;254;695;300;846
420430;202205;3584;9315;2245;6496;412;1356;888;2275;1300;3631
420435;202205;325;817;185;561;31;102;90;260;121;362
420440;202205;853;2205;549;1562;127;364;198;536;325;900
420445;202205;278;653;179;479;27;83;72;156;99;239
420450;202205;908;2587;657;2031;112;429;236;606;348;1035
420455;202205;2381;5437;1779;4545;360;937;824;2084;1184;3021
420460;202205;10807;27523;8339;23109;1105;3543;4595;11964;5700;15507
420470;202205;704;1787;378;1097;61;192;104;259;165;451
420475;202205;78;205;35;110;7;29;5;8;12;37
420480;202205;6201;14796;4006;11148;635;1926;1734;4684;2369;6610
420490;202205;440;1184;309;906;48;157;143;393;191;550
420500;202205;1549;4018;1047;3143;164;573;508;1448;672;2021
420510;202205;178;487;98;316;19;62;27;77;46;139
420515;202205;116;315;78;234;11;42;27;80;38;122
420517;202205;809;2109;683;1883;77;218;406;1116;483;1334
420519;202205;350;855;254;703;26;80;133;367;159;447
420520;202205;310;820;170;550;27;85;11;32;38;117
420530;202205;914;2610;624;1965;99;366;238;634;337;1000
420535;202205;237;673;103;330;16;57;32;83;48;140
420540;202205;45606;106551;31903;83997;4284;12869;12996;29827;17280;42696
420543;202205;258;743;200;611;31;105;89;240;120;345
420545;202205;1486;4334;1125;3542;251;843;389;1124;640;1967
420550;202205;4383;11032;2916;8542;457;1501;1276;3652;1733;5153
420555;202205;390;1055;273;821;26;91;156;434;182;525
420560;202205;446;1051;310;854;47;119;190;534;237;653
420570;202205;3131;7822;2389;6489;386;1156;1226;3143;1612;4299
420580;202205;1984;5138;1402;4189;290;941;448;1246;738;2187
420590;202205;3205;8409;2040;5937;340;1141;593;1388;933;2529
420600;202205;1243;3365;992;2914;105;404;608;1673;713;2077
420610;202205;501;1381;349;1067;72;227;154;461;226;688
420620;202205;914;2206;640;1764;135;389;259;697;394;1086
420630;202205;1095;3208;812;2529;115;389;419;1205;534;1594
420640;202205;549;1463;296;960;97;328;61;183;158;511
420650;202205;4227;10769;2806;7940;417;1293;1225;2978;1642;4271
420660;202205;484;1205;314;851;71;211;73;169;144;380
420665;202205;790;1989;534;1561;86;290;242;632;328;922
420670;202205;1410;3837;894;2768;117;417;241;600;358;1017
420675;202205;210;553;132;405;12;43;79;237;91;280
420680;202205;325;714;176;509;25;95;94;243;119;338
420690;202205;994;2790;646;1988;87;298;205;529;292;827
420700;202205;3320;8455;2577;7162;191;621;1719;4591;1910;5212
420710;202205;1223;3347;992;2867;115;423;597;1534;712;1957
420720;202205;1466;3892;1088;3214;179;580;621;1699;800;2279
420730;202205;3740;9379;2868;7983;480;1493;1547;4055;2027;5548
420740;202205;533;1542;307;1047;75;269;26;88;101;357
420750;202205;2313;6461;1558;4776;262;973;604;1642;866;2615
420757;202205;111;275;52;161;6;19;25;79;31;98
420760;202205;391;1104;217;652;35;111;73;194;108;305
420765;202205;562;1541;298;917;37;128;169;495;206;623
420768;202205;1524;4041;1325;3714;131;370;1003;2783;1134;3153
420770;202205;431;1168;199;697;23;95;46;144;69;239
420775;202205;327;904;212;663;38;138;80;207;118;345
420780;202205;1076;2965;640;1968;104;316;92;250;196;566
420785;202205;238;606;173;475;20;70;79;166;99;236
420790;202205;1231;3472;944;2889;166;603;550;1564;716;2167
420800;202205;803;1880;486;1296;113;308;239;619;352;927
420810;202205;1667;4833;1399;4330;321;1188;677;1821;998;3009
420820;202205;15083;36708;11173;30550;1734;5282;5706;14521;7440;19803
420830;202205;5380;13568;4083;11317;667;2024;1850;4835;2517;6859
420840;202205;558;1664;291;1049;80;279;38;129;118;408
420845;202205;3165;7851;2140;6051;415;1411;915;2433;1330;3844
420850;202205;1262;3863;831;2761;161;581;218;656;379;1237
420860;202205;456;1194;271;845;61;194;76;214;137;408
420870;202205;903;2441;659;1942;140;448;233;626;373;1074
420880;202205;1280;3675;1020;3165;205;720;432;1230;637;1950
420890;202205;9066;24003;5846;17473;829;2748;2085;5479;2914;8227
420895;202205;203;557;135;391;22;61;54;153;76;214
420900;202205;1736;4172;1078;3046;142;516;501;1198;643;1714
420910;202205;37912;97101;25603;74296;3731;12532;11337;28891;15068;41423
420915;202205;579;1989;439;1610;63;260;243;884;306;1144
420917;202205;530;1325;247;650;34;83;122;313;156;396
420920;202205;98;251;48;145;4;15;13;36;17;51
420930;202205;19466;48281;14302;39447;2196;6723;7208;18601;9404;25324
420940;202205;3687;8756;2334;6522;503;1585;583;1326;1086;2911
420945;202205;213;630;128;390;20;74;52;139;72;213
420950;202205;411;1121;260;777;41;131;76;201;117;332
420960;202205;1231;2963;898;2423;136;418;439;1072;575;1490
420970;202205;2700;7107;1859;5579;409;1281;611;1796;1020;3077
420980;202205;297;995;252;893;97;354;75;271;172;625
420985;202205;384;1046;225;725;48;176;64;178;112;354
420990;202205;387;1148;233;778;32;111;53;160;85;271
421000;202205;629;1821;462;1474;98;340;112;280;210;620
421003;202205;510;1217;178;509;15;38;14;33;29;71
421005;202205;106;296;74;230;16;49;30;94;46;143
421010;202205;3935;10232;2890;8359;533;1754;1003;2468;1536;4222
421020;202205;432;1315;345;1149;49;190;181;573;230;763
421030;202205;1081;2963;833;2473;191;619;352;967;543;1586
421040;202205;727;1709;459;1294;44;131;276;753;320;884
421050;202205;1273;3314;872;2442;142;426;350;881;492;1307
421055;202205;182;477;105;308;17;58;60;160;77;218
421060;202205;797;2199;569;1724;93;342;276;734;369;1076
421070;202205;739;2119;462;1429;67;228;202;560;269;788
421080;202205;580;1637;465;1418;76;280;224;638;300;918
421085;202205;405;1131;187;620;21;68;36;92;57;160
421090;202205;303;768;175;486;15;53;65;152;80;205
421100;202205;941;2037;430;1214;86;268;127;303;213;571
421105;202205;1827;4736;1312;3789;197;634;624;1681;821;2315
421110;202205;1406;3474;1160;3120;112;359;717;1927;829;2286
421120;202205;1220;3577;868;2805;137;470;250;715;387;1185
421125;202205;379;943;277;751;80;236;118;301;198;537
421130;202205;6245;17266;5175;15184;943;3043;2807;7785;3750;10828
421140;202205;387;1011;262;761;46;144;112;291;158;435
421145;202205;483;1277;326;958;95;299;92;230;187;529
421150;202205;821;2224;559;1689;115;399;231;608;346;1007
421160;202205;630;1701;482;1409;70;263;294;787;364;1050
421165;202205;251;713;155;472;24;74;65;179;89;253
421170;202205;1258;3276;1062;2963;105;291;754;2119;859;2410
421175;202205;1159;2865;681;2050;105;374;316;878;421;1252
421180;202205;439;1116;245;739;32;128;114;291;146;419
421185;202205;358;892;251;686;28;87;134;335;162;422
421187;202205;298;907;190;628;36;117;70;223;106;340
421189;202205;458;1265;351;1049;54;187;150;405;204;592
421190;202205;14401;37205;10409;29804;1763;5745;4499;11553;6262;17298
421200;202205;845;2251;671;1932;91;321;383;1039;474;1360
421205;202205;246;636;181;521;37;108;75;212;112;320
421210;202205;1239;3019;712;2111;145;434;246;710;391;1144
421220;202205;1607;4532;1268;3842;325;1086;457;1253;782;2339
421223;202205;410;1043;275;812;44;149;170;480;214;629
421225;202205;1049;2870;899;2638;110;374;588;1709;698;2083
421227;202205;802;2178;527;1610;95;312;227;692;322;1004
421230;202205;653;1672;429;1255;87;281;161;455;248;736
421240;202205;303;873;139;480;22;95;23;56;45;151
421250;202205;2467;6046;1790;4977;256;738;1035;2781;1291;3519
421260;202205;246;754;63;212;15;54;7;22;22;76
421265;202205;888;2118;760;1953;45;116;646;1643;691;1759
421270;202205;407;1078;203;658;48;154;80;244;128;398
421280;202205;2508;6390;1896;5365;265;892;1064;2813;1329;3705
421290;202205;1193;3243;611;1827;102;318;141;373;243;691
421300;202205;338;882;171;545;29;105;27;85;56;190
421310;202205;236;647;165;509;38;117;84;258;122;375
421315;202205;297;740;203;553;54;139;70;194;124;333
421320;202205;686;2117;387;1278;45;144;44;80;89;224
421330;202205;694;1965;494;1536;99;337;147;407;246;744
421335;202205;422;1226;345;1090;56;202;159;476;215;678
421340;202205;1639;4319;1158;3467;170;577;558;1575;728;2152
421350;202205;1810;4455;1200;3444;207;674;492;1344;699;2018
421360;202205;2503;6408;1518;4482;345;1139;541;1340;886;2479
421370;202205;842;2582;557;1850;96;356;187;501;283;857
421380;202205;967;2388;841;2200;86;269;546;1369;632;1638
421390;202205;176;455;72;232;18;55;23;63;41;118
421400;202205;638;1683;421;1255;64;219;198;520;262;739
421410;202205;215;567;107;352;24;74;31;107;55;181
421415;202205;224;595;161;441;25;80;63;146;88;226
421420;202205;695;1843;521;1470;48;150;280;749;328;899
421430;202205;107;325;72;236;9;27;12;29;21;56
421440;202205;751;1932;457;1377;86;254;191;559;277;813
421450;202205;539;1559;325;1076;45;154;42;136;87;290
421460;202205;410;1233;227;819;15;53;18;52;33;105
421470;202205;357;956;242;731;38;120;85;262;123;382
421480;202205;3201;8292;2225;6367;326;1104;1008;2619;1334;3723
421490;202205;131;432;77;287;14;61;12;35;26;96
421500;202205;2473;6943;1726;5395;397;1446;479;1287;876;2733
421505;202205;353;910;299;832;28;97;199;531;227;628
421507;202205;491;1304;293;879;50;159;125;345;175;504
421510;202205;436;1158;302;859;40;139;153;359;193;498
421520;202205;526;1371;331;913;55;153;145;347;200;500
421530;202205;340;983;197;666;29;126;36;99;65;225
421535;202205;472;1190;282;812;41;125;143;389;184;514
421540;202205;379;860;211;598;31;102;74;196;105;298
421545;202205;709;2037;556;1776;101;380;284;842;385;1222
421550;202205;2530;6492;1945;5481;298;906;1089;2955;1387;3861
421555;202205;181;542;72;252;8;29;13;22;21;51
421560;202205;97;315;61;217;9;36;20;58;29;94
421565;202205;1052;2606;740;2121;169;540;281;756;450;1296
421567;202205;589;1725;431;1301;112;376;120;355;232;731
421568;202205;372;1053;228;701;36;135;85;232;121;367
421569;202205;174;496;83;265;8;30;48;147;56;177
421570;202205;1599;4295;1165;3401;226;727;448;1168;674;1895
421575;202205;359;981;268;743;36;110;147;381;183;491
421580;202205;5123;13393;3377;9871;467;1602;1347;3375;1814;4977
421590;202205;195;566;147;460;30;107;61;184;91;291
421600;202205;654;1674;446;1240;80;259;164;385;244;644
421605;202205;766;1966;561;1635;103;294;250;745;353;1039
421610;202205;1133;2911;765;2218;148;445;243;690;391;1135
421620;202205;4516;11491;2959;8748;574;1902;1117;3030;1691;4932
421625;202205;152;431;82;266;11;38;23;65;34;103
421630;202205;3085;7853;2068;5977;344;1126;793;1975;1137;3101
421635;202205;420;1103;267;797;23;99;152;391;175;490
421640;202205;761;1937;543;1605;118;365;254;714;372;1079
421650;202205;2820;7417;1951;5862;418;1494;681;1832;1099;3326
421660;202205;12674;33756;9243;27164;1275;4350;4526;12101;5801;16451
421670;202205;913;2504;662;1915;114;380;312;822;426;1202
421680;202205;1737;3739;1442;3288;83;291;1184;2472;1267;2763
421690;202205;1598;4411;1117;3431;232;767;346;996;578;1763
421700;202205;671;1903;479;1478;102;339;146;383;248;722
421710;202205;235;712;126;399;16;54;53;151;69;205
421715;202205;152;376;112;293;15;47;74;187;89;234
421720;202205;2390;6275;1439;4256;308;1013;455;1147;763;2160
421725;202205;316;768;169;494;28;95;70;170;98;265
421730;202205;542;1544;338;983;52;165;168;429;220;594
421740;202205;918;2492;627;1893;103;343;240;624;343;967
421750;202205;994;2281;499;1391;101;308;191;481;292;789
421755;202205;193;521;109;329;18;64;41;108;59;172
421760;202205;1175;2958;788;2260;153;504;291;718;444;1222
421770;202205;2834;7156;2058;5859;423;1206;879;2463;1302;3669
421775;202205;238;605;146;424;18;61;63;159;81;220
421780;202205;998;2794;664;2093;130;460;298;854;428;1314
421790;202205;993;2605;568;1770;114;378;204;581;318;959
421795;202205;201;567;142;429;28;89;46;127;74;216
421800;202205;3505;8890;2648;7362;371;1156;1576;4120;1947;5276
421810;202205;676;1781;471;1417;52;172;259;760;311;932
421820;202205;1157;3277;772;2372;135;466;279;732;414;1198
421825;202205;1692;4142;1470;3815;103;315;1116;2812;1219;3127
421830;202205;2108;5844;1629;4898;341;1127;455;1245;796;2372
421835;202205;280;671;193;531;31;106;98;253;129;359
421840;202205;233;716;172;585;27;104;50;157;77;261
421850;202205;435;1213;251;843;45;167;62;163;107;330
421860;202205;339;926;199;634;33;121;67;182;100;303
421870;202205;5374;13012;4063;10626;463;1478;2390;5574;2853;7052
421875;202205;343;991;153;474;23;75;37;97;60;172
421880;202205;766;2108;509;1547;103;322;145;422;248;744
421885;202205;291;781;185;548;34;107;81;213;115;320
421890;202205;1020;2849;769;2358;113;440;466;1336;579;1776
421895;202205;463;1145;402;1055;44;97;281;772;325;869
421900;202205;1219;3180;911;2498;109;375;450;1074;559;1449
421910;202205;362;1056;220;696;31;124;58;148;89;272
421915;202205;463;1287;280;853;61;185;62;165;123;350
421917;202205;680;1497;389;1107;108;327;102;300;210;627
421920;202205;447;1316;314;1040;109;365;110;375;219;740
421930;202205;3301;8122;1897;5490;371;1187;720;1810;1091;2997
421935;202205;450;1321;365;1149;65;209;224;701;289;910
421940;202205;408;1141;197;597;28;97;58;141;86;238
421950;202205;3529;8667;2088;5951;407;1263;590;1478;997;2741
421960;202205;186;440;101;287;11;34;36;83;47;117
421970;202205;2221;5528;1461;4014;252;810;653;1589;905;2399
421985;202205;367;988;245;739;31;95;112;321;143;416
422000;202205;2233;5403;1826;4796;128;424;1311;3378;1439;3802
430003;202205;638;1632;431;1269;79;239;204;595;283;834
430005;202205;320;841;225;680;17;56;135;391;152;447
430010;202205;2037;4514;1575;3823;306;713;886;2174;1192;2887
430020;202205;646;1436;474;1191;51;147;295;686;346;833
430030;202205;1165;2585;684;1725;128;326;319;749;447;1075
430040;202205;11528;25982;7355;19066;1921;5166;1815;4515;3736;9681
430045;202205;582;1362;427;1093;30;89;319;788;349;877
430047;202205;271;577;111;284;22;58;35;83;57;141
430050;202205;895;2170;539;1488;103;302;231;603;334;905
430055;202205;311;736;152;420;16;50;74;176;90;226
430057;202205;96;213;42;121;13;42;8;19;21;61
430060;202205;21280;53543;16936;46917;2793;8389;9121;24576;11914;32965
430063;202205;857;2287;713;2014;138;388;412;1154;550;1542
430064;202205;1281;3252;954;2633;146;429;521;1381;667;1810
430066;202205;114;246;82;194;8;23;66;148;74;171
430070;202205;769;1954;161;501;34;106;23;55;57;161
430080;202205;1018;2440;614;1655;98;311;313;740;411;1051
430085;202205;1022;2127;633;1525;91;237;304;702;395;939
430087;202205;975;2229;812;2016;76;223;565;1361;641;1584
430090;202205;509;1285;197;619;29;104;46;125;75;229
430100;202205;1114;2595;678;1793;129;380;213;497;342;877
430105;202205;1472;3670;1018;2901;144;475;495;1351;639;1826
430107;202205;187;526;95;282;12;30;32;79;44;109
430110;202205;2517;5984;1895;5065;313;900;962;2474;1275;3374
430120;202205;1427;3888;971;2818;171;484;448;1261;619;1745
430130;202205;3984;8576;2957;7176;969;2306;684;1955;1653;4261
430140;202205;1149;2849;821;2268;127;386;440;1152;567;1538
430150;202205;624;1574;354;1041;72;226;102;287;174;513
430155;202205;253;637;128;374;23;68;27;67;50;135
430160;202205;23715;51286;18832;44654;1800;4565;12401;28562;14201;33127
430163;202205;3673;7993;2631;6454;83;292;2017;4781;2100;5073
430165;202205;343;830;122;373;15;41;22;57;37;98
430170;202205;1049;2687;390;1262;72;264;65;168;137;432
430175;202205;840;2157;733;1954;147;364;391;1056;538;1420
430180;202205;731;1739;554;1443;84;211;292;765;376;976
430185;202205;736;1843;379;1079;103;265;70;197;173;462
430187;202205;910;1840;667;1544;84;181;446;1022;530;1203
430190;202205;1601;3838;1264;3332;230;639;630;1582;860;2221
430192;202205;135;355;57;164;11;30;15;37;26;67
430195;202205;484;1351;81;268;7;21;14;38;21;59
430200;202205;1236;3399;970;2918;294;911;268;853;562;1764
430205;202205;529;1220;481;1132;11;41;444;1020;455;1061
430210;202205;7247;18226;4794;13113;748;2271;1412;3002;2160;5273
430215;202205;390;920;244;639;37;104;104;270;141;374
430220;202205;703;1701;231;728;25;80;70;189;95;269
430222;202205;258;672;178;524;23;73;62;180;85;253
430223;202205;291;725;220;608;19;55;132;356;151;411
430225;202205;19;38;13;29;0;0;10;21;10;21
430230;202205;2227;5660;1853;5118;109;343;1452;3936;1561;4279
430235;202205;452;1213;296;888;49;162;83;200;132;362
430237;202205;576;1275;445;1072;24;71;352;822;376;893
430240;202205;1512;3389;847;2236;99;315;428;991;527;1306
430245;202205;800;2088;633;1782;116;321;369;1054;485;1375
430250;202205;1112;2535;810;2071;296;791;147;332;443;1123
430258;202205;151;390;112;315;8;21;58;162;66;183
430260;202205;791;1932;543;1490;62;189;310;838;372;1027
430265;202205;240;675;163;533;23;78;64;210;87;288
430270;202205;3478;7818;2787;6809;322;906;1923;4484;2245;5390
430280;202205;5799;12738;4189;10116;722;1774;2045;4755;2767;6529
430290;202205;2504;5398;2048;4869;99;293;1653;3805;1752;4098
430300;202205;11842;27703;9065;23160;1233;3427;5215;12713;6448;16140
430310;202205;14721;34887;10517;27396;1280;3667;5700;13771;6980;17438
430320;202205;1157;2755;664;1810;55;169;408;1077;463;1246
430330;202205;761;1785;463;1210;64;174;187;441;251;615
430340;202205;712;1588;486;1242;66;166;312;763;378;929
430350;202205;9601;22151;7466;18656;783;2125;4781;11282;5564;13407
430355;202205;377;995;146;447;27;83;17;43;44;126
430360;202205;990;2260;634;1654;121;359;233;564;354;923
430367;202205;387;824;231;573;40;119;124;278;164;397
430370;202205;571;1486;236;689;45;132;58;129;103;261
430380;202205;745;1776;379;1127;74;230;101;284;175;514
430390;202205;3928;9098;2557;6703;562;1595;389;767;951;2362
430400;202205;1144;2334;845;1929;124;311;413;894;537;1205
430410;202205;618;1390;449;1130;39;113;321;775;360;888
430420;202205;3175;7761;2497;6440;360;1053;1526;3639;1886;4692
430430;202205;621;1519;285;843;57;194;55;142;112;336
430435;202205;1871;4415;1390;3614;225;625;719;1833;944;2458
430440;202205;4535;11568;3643;10148;344;1064;2298;6295;2642;7359
430450;202205;8137;18639;6644;16166;1093;2953;3732;8488;4825;11441
430460;202205;41800;99448;31329;82659;4120;12042;17593;44276;21713;56318
430461;202205;243;626;89;261;16;58;36;83;52;141
430462;202205;345;880;183;567;37;120;49;134;86;254
430463;202205;7504;18681;5604;15321;1033;3101;2649;6892;3682;9993
430465;202205;525;1260;419;1070;60;160;269;666;329;826
430466;202205;5239;12354;4231;10847;726;1917;2336;5701;3062;7618
430467;202205;546;1270;395;1048;50;163;229;548;279;711
430468;202205;1539;3564;1240;3141;102;319;920;2255;1022;2574
430469;202205;676;1827;107;329;13;37;25;49;38;86
430470;202205;6501;15965;4354;12253;1153;3594;1226;3207;2379;6801
430471;202205;706;1858;584;1644;93;274;352;946;445;1220
430480;202205;687;1850;449;1350;66;215;125;316;191;531
430485;202205;184;464;86;244;14;31;21;57;35;88
430490;202205;491;1198;264;763;28;89;123;305;151;394
430495;202205;425;1119;289;870;42;143;136;384;178;527
430500;202205;1105;2714;783;2193;242;739;254;641;496;1380
430510;202205;31734;78434;23139;62645;3756;11343;10825;26658;14581;38001
430511;202205;391;1049;153;490;21;57;17;46;38;103
430512;202205;1153;2432;901;2060;186;432;396;900;582;1332
430513;202205;888;2069;436;1157;69;194;221;530;290;724
430515;202205;425;1125;310;900;40;126;161;455;201;581
430517;202205;1373;3767;1058;3081;152;440;636;1838;788;2278
430520;202205;1538;3716;854;2309;139;399;233;551;372;950
430530;202205;1062;2569;456;1324;64;193;127;344;191;537
430535;202205;4065;9902;2993;8053;410;1122;1570;4024;1980;5146
430537;202205;467;1343;401;1214;30;80;307;934;337;1014
430540;202205;684;1599;408;1139;60;173;230;622;290;795
430543;202205;1156;1979;700;1454;139;255;254;587;393;842
430544;202205;824;2205;561;1645;141;429;201;557;342;986
430545;202205;2791;6643;2119;5670;302;825;1285;3402;1587;4227
430550;202205;392;1068;288;851;59;188;99;269;158;457
430558;202205;173;386;69;183;5;12;27;68;32;80
430560;202205;310;710;166;473;25;77;61;152;86;229
430570;202205;952;2225;674;1745;118;384;321;708;439;1092
430580;202205;925;2213;667;1826;149;399;303;884;452;1283
430583;202205;206;504;47;131;2;7;11;20;13;27
430585;202205;241;584;134;370;26;85;47;108;73;193
430587;202205;221;588;166;496;17;57;70;206;87;263
430590;202205;1536;3523;1233;3062;111;308;895;2163;1006;2471
430593;202205;25;72;17;45;2;4;7;18;9;22
430595;202205;475;1198;127;400;13;41;26;62;39;103
430597;202205;490;1187;261;738;22;69;79;174;101;243
430600;202205;2155;5449;933;2644;136;387;219;536;355;923
430605;202205;1521;3725;1119;3035;142;416;556;1458;698;1874
430607;202205;722;1548;494;1192;28;72;337;781;365;853
430610;202205;6805;15145;4699;12080;1242;3519;1244;3138;2486;6657
430613;202205;298;673;85;238;14;38;21;47;35;85
430620;202205;787;1839;605;1525;118;334;318;701;436;1035
430630;202205;466;1231;147;439;28;86;38;96;66;182
430632;202205;487;1238;222;631;37;95;87;244;124;339
430635;202205;657;1411;488;1130;34;75;366;844;400;919
430637;202205;490;1150;380;991;34;106;261;659;295;765
430640;202205;1233;3191;851;2435;129;391;354;900;483;1291
430642;202205;393;1055;279;806;44;144;119;320;163;464
430645;202205;174;396;80;201;12;30;28;56;40;86
430650;202205;1998;5136;1557;4436;450;1161;699;2194;1149;3355
430655;202205;341;803;210;553;32;96;109;248;141;344
430660;202205;5798;13906;4474;11851;783;2190;2310;5937;3093;8127
430670;202205;702;1614;526;1323;89;221;244;604;333;825
430673;202205;578;1268;263;710;41;118;104;253;145;371
430675;202205;274;785;73;242;11;36;13;38;24;74
430676;202205;6229;14603;5047;12859;611;1673;3248;8041;3859;9714
430680;202205;1241;3084;772;2175;273;734;197;508;470;1242
430690;202205;3429;8541;2741;7360;795;2171;1081;2860;1876;5031
430692;202205;228;672;181;590;9;34;140;462;149;496
430693;202205;1053;2677;657;1921;127;420;188;509;315;929
430695;202205;436;1040;267;710;34;102;138;340;172;442
430697;202205;510;1205;392;1038;70;191;223;613;293;804
430700;202205;9060;21157;5859;15498;1149;3321;1649;3824;2798;7145
430705;202205;421;947;211;580;22;65;94;230;116;295
430710;202205;1931;3808;1353;3052;117;316;932;1998;1049;2314
430720;202205;924;2133;485;1361;63;197;248;633;311;830
430730;202205;1087;2834;767;2234;104;303;373;1031;477;1334
430740;202205;772;2002;401;1227;74;247;114;339;188;586
430745;202205;478;1133;333;859;49;160;169;353;218;513
430750;202205;1728;4076;1177;3130;311;844;465;1186;776;2030
430755;202205;495;1186;340;887;31;93;187;438;218;531
430760;202205;2565;5995;1990;5140;399;1115;972;2360;1371;3475
430770;202205;8014;18846;6356;16384;690;2035;4222;10417;4912;12452
430780;202205;2211;5287;1440;4013;229;703;719;1921;948;2624
430781;202205;589;1480;378;1023;112;304;134;307;246;611
430783;202205;387;867;248;659;33;108;141;357;174;465
430786;202205;34;109;20;74;3;13;2;7;5;20
430790;202205;5288;12382;3878;10025;359;1141;2389;5691;2748;6832
430800;202205;920;1938;690;1629;47;119;490;1114;537;1233
430805;202205;400;969;269;716;15;54;189;475;204;529
430807;202205;641;1537;397;1073;54;174;207;492;261;666
430810;202205;841;1943;401;1103;57;192;158;371;215;563
430820;202205;1393;3727;852;2607;128;400;285;797;413;1197
430825;202205;299;703;117;291;17;35;42;105;59;140
430830;202205;2016;5146;1647;4478;184;434;1105;2986;1289;3420
430840;202205;1184;2695;815;2121;116;292;525;1351;641;1643
430843;202205;191;453;94;257;5;11;33;83;38;94
430845;202205;558;1222;368;910;30;87;234;528;264;615
430850;202205;2654;6669;1857;5231;449;1296;590;1723;1039;3019
430860;202205;1144;2662;574;1569;76;251;268;625;344;876
430865;202205;581;1422;381;1073;99;292;88;212;187;504
430870;202205;618;1598;276;840;50;147;64;168;114;315
430880;202205;1665;3598;1182;2864;141;388;762;1728;903;2116
430885;202205;179;470;99;305;12;37;59;176;71;213
430890;202205;1221;2906;805;2202;114;375;125;319;239;694
430900;202205;3517;7104;2511;5723;134;432;1814;3834;1948;4266
430905;202205;1020;2439;703;1868;125;352;294;715;419;1067
430910;202205;2499;6473;1939;5367;287;911;948;2308;1235;3219
430912;202205;554;1506;384;1166;37;107;235;719;272;826
430915;202205;557;1602;396;1256;118;400;116;363;234;763
430920;202205;28397;67980;22544;58624;2569;7513;14568;36403;17137;43916
430925;202205;89;191;40;108;4;13;20;50;24;63
430930;202205;12696;28235;8917;22661;1284;3361;4770;11878;6054;15239
430940;202205;1275;3133;838;2299;171;491;306;746;477;1237
430950;202205;963;1983;622;1437;49;153;440;926;489;1079
430955;202205;464;1178;129;363;22;65;42;94;64;159
430957;202205;191;595;172;556;35;109;99;325;134;434
430960;202205;1585;3605;924;2452;191;546;365;891;556;1437
430965;202205;1695;3814;1342;3292;63;143;1016;2524;1079;2667
430970;202205;430;990;242;651;35;102;128;313;163;415
430975;202205;568;1571;436;1278;75;237;186;518;261;755
430980;202205;437;952;256;655;20;64;139;315;159;379
430990;202205;663;1761;464;1335;72;239;209;571;281;810
430995;202205;623;1495;451;1223;61;177;248;632;309;809
431000;202205;1526;3523;680;1930;128;379;59;144;187;523
431010;202205;2768;6994;2006;5717;397;1228;662;1666;1059;2894
431020;202205;9140;19198;5582;13930;953;2730;2422;5294;3375;8024
431030;202205;374;1002;189;618;40;144;27;87;67;231
431033;202205;4499;10161;3024;7860;607;1624;1211;3055;1818;4679
431036;202205;343;732;77;219;5;13;25;57;30;70
431040;202205;995;2384;646;1807;65;235;342;878;407;1113
431041;202205;494;1094;348;865;55;133;178;409;233;542
431043;202205;404;979;240;675;31;101;126;331;157;432
431046;202205;115;289;47;137;6;18;9;24;15;42
431050;202205;1454;3363;1031;2702;176;448;530;1426;706;1874
431053;202205;756;1882;414;1224;68;214;132;332;200;546
431055;202205;675;1541;530;1309;45;115;390;950;435;1065
431057;202205;239;680;142;456;28;101;55;160;83;261
431060;202205;6438;15193;4421;11911;988;2872;1550;3945;2538;6817
431065;202205;456;1088;338;892;45;127;179;454;224;581
431070;202205;449;1167;275;799;65;213;65;175;130;388
431075;202205;266;723;150;464;32;114;49;144;81;258
431080;202205;637;1676;449;1293;74;232;171;455;245;687
431085;202205;850;2129;524;1427;54;156;277;725;331;881
431087;202205;461;1207;363;1010;46;126;210;567;256;693
431090;202205;457;1039;186;553;31;95;44;136;75;231
431100;202205;4263;8804;2999;7201;301;794;1886;4389;2187;5183
431110;202205;1584;3484;1117;2682;175;454;562;1222;737;1676
431112;202205;709;1755;594;1561;70;220;399;986;469;1206
431113;202205;472;1192;396;1050;68;189;227;570;295;759
431115;202205;1056;2852;825;2427;67;254;561;1562;628;1816
431120;202205;3034;7419;2116;5727;479;1426;741;1843;1220;3269
431123;202205;390;1007;262;748;52;140;136;385;188;525
431125;202205;1165;2996;897;2507;251;704;436;1250;687;1954
431127;202205;204;548;73;226;8;29;12;32;20;61
431130;202205;3591;8488;2760;7234;373;1081;1540;3886;1913;4967
431140;202205;6414;14848;4063;10559;497;1410;1757;3935;2254;5345
431142;202205;630;1504;481;1272;75;203;308;806;383;1009
431150;202205;1142;2879;836;2341;131;402;418;1135;549;1537
431160;202205;747;1943;505;1446;109;326;145;392;254;718
431162;202205;641;1542;410;1129;37;126;227;560;264;686
431164;202205;190;446;51;159;4;13;9;23;13;36
431170;202205;505;1312;370;1047;96;282;113;301;209;583
431171;202205;877;1873;739;1706;129;280;511;1165;640;1445
431173;202205;510;1260;373;1062;113;373;127;320;240;693
431175;202205;1451;3234;927;2353;136;347;398;971;534;1318
431177;202205;955;2377;743;2056;131;397;441;1185;572;1582
431179;202205;357;766;109;314;21;62;34;98;55;160
431180;202205;2571;6288;1593;4398;348;1013;420;1009;768;2022
431190;202205;677;1662;288;826;36;113;69;155;105;268
431198;202205;452;1254;369;1103;92;287;152;482;244;769
431200;202205;385;944;114;308;25;68;16;40;41;108
431205;202205;250;642;135;396;38;115;41;122;79;237
431210;202205;712;1592;571;1380;132;312;268;687;400;999
431213;202205;312;775;234;629;13;29;131;344;144;373
431215;202205;685;1600;352;993;32;107;180;467;212;574
431217;202205;182;456;125;344;23;84;59;138;82;222
431220;202205;633;1547;392;1100;43;139;212;532;255;671
431225;202205;1696;3719;1322;3140;113;290;928;2143;1041;2433
431230;202205;769;2052;609;1717;131;386;305;784;436;1170
431235;202205;188;509;25;86;1;1;5;19;6;20
431237;202205;396;1188;317;1021;54;198;151;461;205;659
431238;202205;38;112;32;99;7;21;15;40;22;61
431240;202205;5618;12965;4504;11230;480;1418;2924;6830;3404;8248
431242;202205;312;734;270;659;24;69;203;480;227;549
431244;202205;420;1009;216;590;28;85;83;200;111;285
431245;202205;1475;3305;980;2475;73;192;528;1243;601;1435
431247;202205;306;733;190;508;27;84;95;226;122;310
431250;202205;2025;4766;1545;4142;345;856;795;2260;1140;3116
431260;202205;321;832;195;589;23;81;75;212;98;293
431261;202205;301;878;247;782;23;102;145;428;168;530
431262;202205;332;906;174;550;20;70;97;310;117;380
431265;202205;1751;4025;728;2040;114;355;215;513;329;868
431267;202205;268;655;177;470;13;42;121;294;134;336
431270;202205;3132;6690;1700;4280;370;965;578;1437;948;2402
431275;202205;159;423;100;290;23;70;42;107;65;177
431280;202205;250;662;92;291;16;52;14;31;30;83
431290;202205;384;1109;247;774;47;164;44;117;91;281
431295;202205;81;196;30;84;7;23;7;15;14;38
431300;202205;332;866;80;248;8;28;30;78;38;106
431301;202205;298;830;75;241;12;41;9;25;21;66
431303;202205;723;1755;437;1202;30;104;198;467;228;571
431306;202205;2536;5840;1617;4323;179;528;718;1729;897;2257
431308;202205;34;95;30;86;10;30;15;43;25;73
431310;202205;599;1533;430;1180;65;178;209;535;274;713
431320;202205;780;2061;457;1387;79;248;145;389;224;637
431330;202205;1961;4508;1045;2899;139;457;463;1136;602;1593
431333;202205;233;597;129;375;14;50;49;120;63;170
431335;202205;38;114;23;82;8;31;2;4;10;35
431337;202205;3578;8390;2866;7336;246;812;2101;5095;2347;5907
431339;202205;486;1190;359;973;87;222;153;414;240;636
431340;202205;20775;48741;14908;39131;2073;6120;7750;18871;9823;24991
431342;202205;452;996;333;805;40;97;237;560;277;657
431344;202205;430;1049;253;728;34;104;120;336;154;440
431346;202205;235;570;91;279;14;46;16;41;30;87
431349;202205;964;2191;642;1550;98;258;352;785;450;1043
431350;202205;5177;12255;3997;10373;461;1383;2399;5870;2860;7253
431360;202205;631;1437;324;863;97;276;82;195;179;471
431365;202205;2427;5212;1935;4553;106;301;1557;3570;1663;3871
431370;202205;5493;12395;4078;10228;754;2021;2166;5327;2920;7348
431380;202205;1006;2555;812;2240;125;355;486;1333;611;1688
431390;202205;3070;7268;1990;5394;211;703;1072;2524;1283;3227
431395;202205;1745;3838;1328;3238;173;425;851;2032;1024;2457
431400;202205;334;919;195;608;35;112;38;98;73;210
431402;202205;993;2093;742;1721;98;232;509;1134;607;1366
431403;202205;216;591;168;503;36;122;75;203;111;325
431405;202205;5857;14520;4664;12590;748;2306;2362;5893;3110;8199
431406;202205;636;1663;431;1232;101;262;165;514;266;776
431407;202205;588;1484;440;1192;58;159;296;783;354;942
431410;202205;20695;48654;14695;38750;1854;5746;8468;20535;10322;26281
431413;202205;261;705;63;208;7;20;15;44;22;64
431415;202205;778;1824;505;1367;86;268;243;575;329;843
431417;202205;632;1340;418;1000;63;180;234;525;297;705
431420;202205;1876;3938;1443;3368;125;329;945;2109;1070;2438
431430;202205;639;1560;316;930;46;153;105;269;151;422
431440;202205;36847;81361;26782;66459;4407;11780;12576;28955;16983;40735
431442;202205;157;439;81;270;15;52;12;38;27;90
431445;202205;400;1105;119;381;10;27;17;39;27;66
431446;202205;309;846;234;698;29;89;125;365;154;454
431447;202205;850;2117;496;1420;87;244;155;450;242;694
431449;202205;876;2142;582;1585;104;266;248;657;352;923
431450;202205;2616;4960;2073;4210;58;137;1718;3348;1776;3485
431454;202205;41;129;32;107;8;29;15;45;23;74
431455;202205;641;1459;334;852;33;92;172;379;205;471
431460;202205;3256;7410;2274;5737;529;1358;792;1969;1321;3327
431470;202205;1577;4101;1168;3285;212;635;468;1260;680;1895
431475;202205;270;719;61;202;3;14;8;15;11;29
431477;202205;493;1213;291;820;59;159;106;278;165;437
431478;202205;241;640;55;171;11;30;6;15;17;45
431480;202205;3866;9244;3065;7996;711;1885;1464;3805;2175;5690
431490;202205;130069;290102;100425;245764;5977;18133;75135;175026;81112;193159
431500;202205;545;1332;414;1100;61;172;222;561;283;733
431505;202205;285;660;194;527;14;44;137;369;151;413
431507;202205;344;801;140;409;45;143;17;39;62;182
431510;202205;1881;4558;1301;3462;318;884;437;1164;755;2048
431513;202205;245;529;134;342;37;111;37;69;74;180
431514;202205;134;319;105;270;3;8;71;163;74;171
431515;202205;538;1249;409;1035;92;250;225;535;317;785
431517;202205;71;202;58;176;4;15;30;86;34;101
431520;202205;423;1015;184;524;27;89;79;180;106;269
431530;202205;5849;12296;3627;9017;650;1638;1665;4001;2315;5639
431531;202205;231;531;149;385;20;55;56;131;76;186
431532;202205;608;1368;386;980;76;215;167;410;243;625
431535;202205;312;785;141;414;26;80;28;77;54;157
431540;202205;1938;5751;1783;5547;77;279;1405;4412;1482;4691
431545;202205;378;936;75;216;9;24;26;72;35;96
431550;202205;2483;5978;1778;4681;255;740;963;2364;1218;3104
431555;202205;731;1594;443;1114;46;132;256;637;302;769
431560;202205;28605;65267;19722;51611;3999;10140;7515;20276;11514;30416
431570;202205;5386;11525;4561;10375;279;784;3725;8092;4004;8876
431575;202205;400;919;335;821;74;146;184;453;258;599
431580;202205;650;1640;419;1195;53;172;224;601;277;773
431590;202205;759;1993;548;1558;119;323;197;549;316;872
431595;202205;415;1059;266;756;49;146;103;259;152;405
431600;202205;1781;4081;1294;3357;235;658;611;1515;846;2173
431610;202205;1615;3802;1073;2858;152;391;502;1384;654;1775
431620;202205;521;1274;273;725;63;180;126;291;189;471
431630;202205;1476;3504;696;1958;132;395;226;584;358;979
431640;202205;7511;16240;6386;14823;679;1699;4521;10319;5200;12018
431642;202205;698;1535;438;1079;81;173;189;443;270;616
431643;202205;397;945;195;547;22;59;62;165;84;224
431645;202205;2318;4568;1865;3981;45;131;1612;3362;1657;3493
431647;202205;351;814;124;348;14;40;37;96;51;136
431650;202205;136;358;97;299;12;42;37;97;49;139
431660;202205;1010;2556;488;1482;86;301;121;321;207;622
431670;202205;1348;3095;801;2119;133;358;370;888;503;1246
431673;202205;246;629;104;325;15;50;29;75;44;125
431675;202205;412;1031;128;418;15;49;20;55;35;104
431680;202205;9999;23718;7552;19417;1462;4033;3702;8925;5164;12958
431690;202205;28750;66885;20557;52865;3118;8943;10887;26678;14005;35621
431695;202205;246;578;142;388;21;81;79;182;100;263
431697;202205;519;1157;405;989;61;137;236;584;297;721
431700;202205;1607;3774;1292;3238;206;459;701;1790;907;2249
431710;202205;15886;34910;11466;28845;1542;4087;6850;16884;8392;20971
431720;202205;7725;17919;4730;12629;1127;3084;1159;2791;2286;5875
431725;202205;42;101;31;82;8;27;16;36;24;63
431730;202205;4792;10790;3176;8372;589;1626;1474;3792;2063;5418
431740;202205;5983;13527;4081;10503;964;2780;1250;2889;2214;5669
431750;202205;9024;22075;6815;18643;1561;4437;2637;7074;4198;11511
431755;202205;344;917;91;291;10;36;21;54;31;90
431760;202205;5989;12975;4182;10162;441;1238;2644;6041;3085;7279
431770;202205;2234;4820;1715;4142;218;494;1186;2875;1404;3369
431775;202205;230;573;126;375;26;85;26;68;52;153
431780;202205;2425;5594;1587;4112;256;706;635;1581;891;2287
431790;202205;829;2096;550;1554;68;196;254;702;322;898
431795;202205;310;752;150;435;28;84;44;118;72;202
431800;202205;9423;21387;6018;16158;1565;4910;716;1882;2281;6792
431805;202205;311;783;73;259;4;12;3;5;7;17
431810;202205;3700;8120;2370;5809;355;908;1229;2835;1584;3743
431820;202205;2414;6058;1879;5227;486;1464;799;2187;1285;3651
431830;202205;9980;21091;7394;17644;2089;5620;1544;3888;3633;9508
431840;202205;3113;7384;2513;6475;316;853;1630;4171;1946;5024
431842;202205;523;1275;183;549;32;113;63;164;95;277
431843;202205;353;918;249;700;50;156;113;292;163;448
431844;202205;201;548;75;249;12;46;19;59;31;105
431845;202205;549;1379;377;1042;34;96;229;621;263;717
431846;202205;321;766;281;709;12;37;250;620;262;657
431848;202205;176;450;96;277;12;45;27;62;39;107
431849;202205;418;1001;91;255;10;30;17;29;27;59
431850;202205;4818;12180;3727;10191;861;2534;1340;3435;2201;5969
431860;202205;707;1612;405;1053;49;138;244;614;293;752
431861;202205;113;302;73;217;19;61;22;57;41;118
431862;202205;533;1617;435;1437;91;341;208;642;299;983
431870;202205;25408;59916;20477;52508;2047;6038;13204;32304;15251;38342
431880;202205;4454;10864;3247;8806;418;1307;1730;4429;2148;5736
431890;202205;5522;13161;3540;9483;1039;2776;872;2396;1911;5172
431900;202205;1136;2762;742;2064;116;350;362;928;478;1278
431910;202205;854;1948;352;932;50;134;115;237;165;371
431912;202205;572;1411;459;1226;66;191;302;794;368;985
431915;202205;1251;2756;988;2363;73;169;729;1705;802;1874
431920;202205;1434;3003;1185;2692;36;86;1032;2309;1068;2395
431930;202205;787;1943;539;1504;170;446;206;603;376;1049
431935;202205;95;247;68;196;12;38;19;47;31;85
431936;202205;342;901;203;561;40;108;98;263;138;371
431937;202205;165;420;109;317;19;55;44;119;63;174
431940;202205;3364;7516;2125;5379;165;483;1277;3032;1442;3515
431950;202205;2349;5682;1867;4929;443;1211;824;2127;1267;3338
431960;202205;3394;7818;2618;6503;736;1875;837;2013;1573;3888
431970;202205;421;1028;197;549;45;130;50;130;95;260
431971;202205;88;207;38;112;5;14;7;19;12;33
431973;202205;644;1871;439;1456;47;181;308;1012;355;1193
431975;202205;120;242;34;91;6;20;8;16;14;36
431980;202205;1248;2912;995;2533;120;376;646;1515;766;1891
431990;202205;6818;15620;5027;13117;442;1397;3090;7716;3532;9113
432000;202205;15207;33780;11322;28005;1629;4369;6730;15893;8359;20262
432010;202205;3083;6866;2071;5244;430;1123;808;1886;1238;3009
432020;202205;1875;4765;1170;3310;288;869;315;840;603;1709
432023;202205;594;1373;293;798;42;116;129;302;171;418
432026;202205;1156;2953;885;2443;247;684;342;980;589;1664
432030;202205;480;1071;276;715;19;50;164;384;183;434
432032;202205;367;896;244;644;23;76;136;322;159;398
432035;202205;748;1991;636;1809;170;438;312;957;482;1395
432040;202205;1208;2777;481;1419;56;183;208;552;264;735
432045;202205;185;494;122;368;19;61;54;151;73;212
432050;202205;624;1453;455;1171;65;196;240;598;305;794
432055;202205;769;1855;533;1435;174;450;150;415;324;865
432057;202205;181;473;151;402;7;19;87;208;94;227
432060;202205;472;1138;145;457;21;73;40;119;61;192
432065;202205;247;642;186;521;42;117;79;218;121;335
432067;202205;867;2314;738;2039;68;216;540;1429;608;1645
432070;202205;1897;4532;1351;3564;210;623;674;1620;884;2243
432080;202205;5650;12336;4261;10285;601;1689;2175;4926;2776;6615
432085;202205;441;1122;332;954;59;188;179;492;238;680
432090;202205;2990;7105;1798;4899;334;913;790;2002;1124;2915
432100;202205;1044;2526;526;1544;90;285;117;285;207;570
432110;202205;2408;5901;1765;4814;448;1294;339;849;787;2143
432120;202205;3973;9987;3198;8745;501;1515;1668;4309;2169;5824
432130;202205;3056;7157;2552;6429;434;1120;1443;3632;1877;4752
432132;202205;243;657;135;416;23;79;59;156;82;235
432135;202205;1128;2507;768;1911;77;195;528;1310;605;1505
432140;202205;1996;5378;1563;4566;178;607;1041;2911;1219;3518
432143;202205;1698;4225;1288;3585;84;264;822;2223;906;2487
432145;202205;1992;5074;1321;3771;200;604;448;1069;648;1673
432146;202205;119;323;96;294;36;132;28;75;64;207
432147;202205;585;1537;335;1014;116;360;65;194;181;554
432149;202205;517;1202;261;702;35;98;106;251;141;349
432150;202205;4144;9790;3126;8138;572;1611;1496;3661;2068;5272
432160;202205;6843;16366;5109;13763;1268;3496;1920;5249;3188;8745
432162;202205;241;526;38;110;7;19;11;21;18;40
432163;202205;171;400;33;87;3;9;6;8;9;17
432166;202205;711;1874;574;1619;107;338;205;515;312;853
432170;202205;1720;4446;1201;3522;210;668;515;1384;725;2052
432180;202205;3414;7755;1902;5038;285;837;842;1942;1127;2779
432183;202205;422;1158;307;912;62;225;127;337;189;562
432185;202205;927;2326;547;1599;102;295;236;685;338;980
432190;202205;2315;5342;1650;4336;138;437;1066;2610;1204;3047
432195;202205;1073;2636;708;1969;136;366;283;780;419;1146
432200;202205;4055;9413;3051;7905;250;715;2066;5183;2316;5898
432210;202205;454;1120;309;849;48;135;164;405;212;540
432215;202205;720;1874;641;1754;46;108;475;1305;521;1413
432218;202205;261;613;118;321;15;50;41;82;56;132
432220;202205;4059;9041;2955;7295;525;1319;1583;3781;2108;5100
432225;202205;132;346;97;280;13;41;53;149;66;190
432230;202205;860;1970;453;1229;60;183;206;505;266;688
432232;202205;551;1300;356;985;62;193;160;399;222;592
432234;202205;311;753;163;455;35;83;36;87;71;170
432235;202205;46;130;21;64;5;16;6;17;11;33
432237;202205;335;832;300;776;12;33;253;640;265;673
432240;202205;19183;43326;14120;36758;1296;3147;9571;25086;10867;28233
432250;202205;6800;18005;5080;14667;991;3050;2466;6926;3457;9976
432252;202205;526;1205;339;856;43;113;183;423;226;536
432253;202205;1003;2771;696;2039;180;562;109;290;289;852
432254;202205;718;1650;221;640;27;78;34;74;61;152
432255;202205;111;280;64;180;7;22;33;83;40;105
432260;202205;6120;14714;4610;11984;984;2719;2043;4962;3027;7681
432270;202205;2442;6100;1992;5305;556;1558;719;1846;1275;3404
432280;202205;1511;3656;818;2351;132;418;275;658;407;1076
432285;202205;150;446;29;86;2;4;7;19;9;23
432290;202205;392;1019;245;705;72;222;63;144;135;366
432300;202205;32504;76004;24771;64146;2524;7707;16397;40328;18921;48035
432310;202205;1072;2518;801;2044;60;175;632;1576;692;1751
432320;202205;213;480;94;269;12;40;33;78;45;118
432330;202205;209;470;69;216;11;32;13;42;24;74
432335;202205;177;513;64;230;7;23;10;30;17;53
432340;202205;353;867;156;494;23;74;47;146;70;220
432345;202205;874;1749;747;1600;12;31;647;1349;659;1380
432350;202205;377;900;199;568;32;98;69;173;101;271
432360;202205;244;710;49;161;4;12;13;34;17;46
432370;202205;380;854;225;591;22;70;130;327;152;397
432375;202205;585;1367;404;1015;101;259;168;416;269;675
432377;202205;172;510;40;136;1;3;10;21;11;24
432380;202205;2161;5641;1531;4520;228;703;793;2274;1021;2977
500020;202205;3676;8533;2596;6859;236;752;1702;4339;1938;5091
500025;202205;1307;3099;852;2255;108;281;451;1148;559;1429
500060;202205;9196;24592;6406;18909;801;2554;3706;10926;4507;13480
500070;202205;5554;13125;3993;10586;719;2031;1870;4931;2589;6962
500080;202205;1823;4248;1124;3001;188;551;445;1053;633;1604
500085;202205;2305;5489;1646;4356;429;1205;693;1737;1122;2942
500090;202205;2377;5906;1625;4679;265;835;543;1679;808;2514
500100;202205;4337;10401;3324;8823;492;1487;1605;3992;2097;5479
500110;202205;11329;26482;7872;21236;1583;4407;3535;9799;5118;14206
500124;202205;2470;6607;1977;5840;294;873;1170;3511;1464;4384
500150;202205;1690;3551;1176;2865;203;554;634;1408;837;1962
500190;202205;5821;14426;3826;10674;770;2209;1300;3361;2070;5570
500200;202205;3128;6887;2146;5293;203;521;1376;3241;1579;3762
500210;202205;5675;12453;4044;10370;1083;2780;2002;5110;3085;7890
500215;202205;1639;4218;1225;3488;116;354;710;1991;826;2345
500220;202205;3493;8935;2543;7347;406;1269;1263;3465;1669;4734
500230;202205;2347;5186;1817;4471;209;556;1240;2961;1449;3517
500240;202205;4712;13125;3468;10587;527;1723;1512;4657;2039;6380
500260;202205;3717;7569;2426;5833;243;691;1470;3299;1713;3990
500270;202205;165845;374660;107337;280293;14917;43642;47248;112405;62165;156047
500280;202205;1569;3773;1063;3007;168;493;559;1577;727;2070
500290;202205;4201;9759;2580;7013;382;1171;994;2396;1376;3567
500295;202205;4490;10356;2984;7797;507;1499;1309;3017;1816;4516
500310;202205;1159;2225;802;1793;132;258;442;984;574;1242
500315;202205;4715;11588;3796;10306;258;745;2896;7852;3154;8597
500320;202205;23379;58791;16239;47244;3944;11564;6227;19159;10171;30723
500325;202205;6534;13755;4620;11164;523;1324;2823;6699;3346;8023
500330;202205;7820;16870;5235;13223;499;1265;2875;7337;3374;8602
500345;202205;2444;5718;1661;4483;277;778;679;1765;956;2543
500348;202205;2658;6438;2000;5345;210;606;1288;3447;1498;4053
500350;202205;1393;3670;818;2478;98;314;300;845;398;1159
500370;202205;31272;77018;22911;63702;2789;8895;12193;32896;14982;41791
500375;202205;2950;7384;1977;5449;267;795;792;1952;1059;2747
500380;202205;4028;9618;2821;7637;767;2137;539;1491;1306;3628
500390;202205;741;1500;455;1144;63;174;260;654;323;828
500400;202205;1796;4440;1200;3293;219;685;447;1096;666;1781
500410;202205;2745;6216;1914;5020;213;516;1080;2970;1293;3486
500430;202205;3210;7485;2210;6028;332;905;920;2710;1252;3615
500440;202205;1830;4202;1012;2807;161;444;380;1108;541;1552
500450;202205;2047;4803;1302;3551;259;698;360;933;619;1631
500460;202205;4257;10759;2623;7617;460;1500;739;1974;1199;3474
500470;202205;2931;7570;1908;5557;477;1516;510;1306;987;2822
500480;202205;2279;6752;1893;6156;168;580;1388;4581;1556;5161
500490;202205;1301;2908;795;2140;150;485;213;582;363;1067
500500;202205;4698;11840;3113;9385;893;2968;412;1347;1305;4315
500510;202205;807;1945;537;1460;36;117;355;898;391;1015
500515;202205;1886;4648;1461;3992;204;614;836;2201;1040;2815
500520;202205;3911;10579;3017;9106;642;1924;1532;4802;2174;6726
500525;202205;1110;3062;885;2735;126;404;534;1619;660;2023
500540;202205;5909;14675;3641;10717;1054;3478;598;1523;1652;5001
500560;202205;6096;15478;4887;13984;227;706;4051;11685;4278;12391
500568;202205;5165;10811;3203;7896;645;1627;1325;3041;1970;4668
500570;202205;9429;20963;6486;16269;924;2698;3359;7668;4283;10366
500580;202205;3625;8933;2641;7253;630;1785;1153;3157;1783;4942
500600;202205;4221;10044;3113;8316;739;2037;1020;2751;1759;4788
500620;202205;8996;22577;6271;17541;950;2885;3038;8014;3988;10899
500625;202205;613;1577;419;1207;65;217;163;439;228;656
500627;202205;918;2348;567;1737;96;312;183;525;279;837
500630;202205;8660;18637;5030;12877;1002;2773;1635;3996;2637;6769
500635;202205;3155;9598;2415;8607;244;763;1694;6542;1938;7305
500640;202205;2071;4237;1378;3336;74;205;908;2088;982;2293
500660;202205;23152;54624;15976;44406;4853;13696;5084;14611;9937;28307
500690;202205;3078;7517;2105;5977;431;1426;990;2631;1421;4057
500710;202205;3672;9242;2729;7639;657;2028;899;2370;1556;4398
500720;202205;5944;14491;4002;11306;806;2445;1405;3869;2211;6314
500730;202205;1230;2894;693;1939;128;361;214;598;342;959
500740;202205;5463;12439;3563;9510;570;1656;1663;4236;2233;5892
500750;202205;1225;2903;853;2305;122;358;370;899;492;1257
500755;202205;1196;2987;759;2185;144;448;222;558;366;1006
500769;202205;5952;14109;3380;9425;666;2016;551;1354;1217;3370
500770;202205;1604;4140;1114;3341;212;663;380;1112;592;1775
500780;202205;1406;3299;919;2503;181;562;257;610;438;1172
500790;202205;8315;21194;6173;17403;1211;3685;2485;6939;3696;10624
500793;202205;2391;5732;1745;4668;348;991;722;1778;1070;2769
500795;202205;3267;7369;2576;6469;141;378;2081;5300;2222;5678
500797;202205;913;2260;615;1715;193;550;181;501;374;1051
500800;202205;4029;8806;2549;6622;707;2052;498;1370;1205;3422
500830;202205;22120;52510;15264;40390;3245;9002;5477;13768;8722;22770
500840;202205;1666;3869;1033;2672;118;316;480;1151;598;1467
510010;202205;2095;4412;1480;3633;215;488;953;2346;1168;2834
510020;202205;4719;11364;2609;7335;481;1442;747;1842;1228;3284
510025;202205;8097;18724;5277;14372;636;1911;2732;7075;3368;8986
510030;202205;3604;7526;2434;5783;257;647;1353;3090;1610;3737
510035;202205;1339;3364;878;2636;216;653;362;1201;578;1854
510040;202205;2756;5792;2067;4938;245;512;1299;3228;1544;3740
510050;202205;2526;4912;1734;3919;235;600;1154;2536;1389;3136
510060;202205;1633;3997;1078;3007;216;643;256;616;472;1259
510080;202205;1715;4253;1180;3400;211;661;551;1499;762;2160
510100;202205;783;1707;569;1387;64;175;335;758;399;933
510120;202205;308;525;173;369;9;21;138;284;147;305
510125;202205;2367;5712;1894;5022;224;698;1019;2507;1243;3205
510130;202205;1815;4334;1283;3503;295;821;559;1522;854;2343
510140;202205;3449;8565;2356;7198;820;2719;840;2675;1660;5394
510160;202205;2135;4809;1635;4179;59;172;1425;3626;1484;3798
510170;202205;5672;13973;4321;11850;842;2504;2032;5405;2874;7909
510180;202205;17099;36148;11555;28527;2052;5426;5394;13723;7446;19149
510185;202205;1992;4974;1291;3965;531;1641;299;1186;830;2827
510190;202205;2594;6944;1680;5481;411;1470;393;1381;804;2851
510250;202205;19951;47356;14908;39912;2359;6784;8260;22245;10619;29029
510260;202205;2009;8315;1691;7778;265;1232;1035;5332;1300;6564
510263;202205;3901;10601;2556;7937;482;1703;557;1507;1039;3210
510267;202205;6381;17633;3790;11859;691;2371;688;1831;1379;4202
510268;202205;1499;3735;1065;3004;303;866;292;706;595;1572
510269;202205;1164;3004;768;2289;158;511;314;879;472;1390
510270;202205;3434;9270;2418;7533;365;1269;1069;3275;1434;4544
510279;202205;2049;5115;1206;3602;164;560;395;1048;559;1608
510285;202205;1249;3139;837;2427;200;635;271;710;471;1345
510300;202205;4413;10366;3345;8992;324;885;2334;6403;2658;7288
510305;202205;1645;4355;1073;3300;215;668;292;955;507;1623
510310;202205;1127;2651;786;2110;181;490;297;821;478;1311
510320;202205;4420;10380;3106;8255;652;1847;977;2438;1629;4285
510325;202205;4879;13756;3453;11046;852;2865;990;3167;1842;6032
510330;202205;2914;8275;1970;6646;423;1474;735;2774;1158;4248
510335;202205;5647;15482;4322;13318;733;2482;2191;6764;2924;9246
510336;202205;537;1439;392;1224;55;155;217;749;272;904
510337;202205;1649;4564;1098;3620;398;1391;308;1030;706;2421
510340;202205;108900;234281;74507;186354;15474;42781;30570;72466;46044;115247
510343;202205;1365;3204;907;2437;109;337;485;1205;594;1542
510345;202205;1429;3822;1082;3176;171;499;530;1493;701;1992
510350;202205;3525;8455;2399;6684;669;1954;735;1960;1404;3914
510360;202205;2258;4352;1422;3388;60;117;1028;2583;1088;2700
510370;202205;1975;5323;1480;4535;195;650;914;2817;1109;3467
510380;202205;666;1545;393;1091;52;166;171;454;223;620
510385;202205;1345;4333;1007;3733;95;409;672;2571;767;2980
510390;202205;1546;3660;1063;3100;328;894;457;1478;785;2372
510395;202205;806;1676;536;1297;36;77;368;904;404;981
510410;202205;5667;14598;4144;12043;733;2152;2298;6887;3031;9039
510420;202205;2880;5579;1974;4405;81;179;1463;3237;1544;3416
510450;202205;623;1464;364;1028;74;219;111;293;185;512
510452;202205;969;2625;720;2165;106;354;420;1223;526;1577
510454;202205;1163;3013;905;2595;113;291;567;1726;680;2017
510455;202205;1078;2742;710;2063;137;446;277;726;414;1172
510460;202205;2240;5361;1651;4497;275;811;868;2184;1143;2995
510480;202205;5603;12987;3774;9739;690;1900;1569;3762;2259;5662
510490;202205;1980;4755;1489;4141;230;650;972;2703;1202;3353
510500;202205;1700;3988;1026;2937;219;658;301;840;520;1498
510510;202205;4436;11734;3159;9633;871;2874;1028;3174;1899;6048
510515;202205;6032;14643;4105;11382;825;2561;1469;3649;2294;6210
510517;202205;1713;4191;1174;3407;401;1239;275;753;676;1992
510520;202205;2629;5140;1456;3657;135;366;677;1792;812;2158
510523;202205;1411;3144;1009;2557;117;336;664;1618;781;1954
510525;202205;8779;22982;6600;18876;1029;3215;3066;8252;4095;11467
510530;202205;562;1416;411;1206;30;101;273;796;303;897
510550;202205;2899;7946;2197;6789;395;1324;1189;3576;1584;4900
510558;202205;2617;6721;1960;5755;247;644;1022;3230;1269;3874
510560;202205;1965;5381;1236;3945;283;942;282;943;565;1885
510562;202205;6808;15665;5031;12742;825;2072;2495;6355;3320;8427
510590;202205;3530;8307;2557;7076;226;638;1793;5083;2019;5721
510600;202205;1444;2965;969;2306;116;286;547;1239;663;1525
510610;202205;3087;7068;2116;5793;319;982;1191;3204;1510;4186
510615;202205;3243;7558;2265;6071;299;851;1416;3782;1715;4633
510617;202205;1136;3286;911;2948;94;353;665;2189;759;2542
510618;202205;1419;3552;1029;2951;205;649;516;1442;721;2091
510619;202205;855;2122;486;1441;82;247;93;225;175;472
510620;202205;1556;3401;779;2173;270;851;63;141;333;992
510621;202205;1767;4515;1056;3194;244;792;294;770;538;1562
510622;202205;5931;15669;4003;11784;1294;4106;669;1769;1963;5875
510623;202205;3176;7464;2305;6128;539;1508;850;2275;1389;3783
510624;202205;1805;4543;963;3015;118;414;215;590;333;1004
510625;202205;3762;8728;2275;6176;399;1199;757;1987;1156;3186
510626;202205;1640;3905;1083;3039;266;834;311;884;577;1718
510627;202205;723;1770;399;1166;99;302;112;347;211;649
510628;202205;1687;3601;1099;2865;302;883;445;1108;747;1991
510629;202205;1940;5137;1361;4107;282;899;401;1200;683;2099
510630;202205;3870;10238;2452;7695;561;1881;576;1957;1137;3838
510631;202205;686;1511;514;1271;21;40;404;1019;425;1059
510637;202205;4154;9284;2958;7629;646;1809;1090;2820;1736;4629
510642;202205;6649;17275;5153;15126;911;3017;3061;8849;3972;11866
510645;202205;1175;2211;730;1660;177;379;339;806;516;1185
510650;202205;7969;18886;6269;17047;905;1577;4425;13502;5330;15079
510665;202205;2013;4239;1289;3120;284;602;494;1332;778;1934
510670;202205;486;1014;288;748;37;96;150;395;187;491
510675;202205;7289;19126;4961;14879;1292;4283;941;2649;2233;6932
510677;202205;2605;6334;1849;5239;298;932;1040;2880;1338;3812
510680;202205;810;1980;469;1377;93;307;120;299;213;606
510682;202205;1853;5001;1367;4251;425;1520;478;1390;903;2910
510685;202205;576;1565;415;1251;39;124;249;746;288;870
510700;202205;4848;10926;3363;8899;309;902;2412;6276;2721;7178
510704;202205;12580;28692;8547;22062;2095;5640;2386;5763;4481;11403
510706;202205;2606;7291;1813;5989;345;1175;771;2798;1116;3973
510710;202205;3361;7904;2167;5706;535;1388;657;1647;1192;3035
510715;202205;736;1478;498;1184;33;91;317;724;350;815
510718;202205;2603;5784;1582;4414;331;904;734;2337;1065;3241
510719;202205;520;1086;301;779;35;109;164;388;199;497
510720;202205;1057;2318;696;1816;174;470;276;687;450;1157
510724;202205;1000;2660;692;2085;104;359;344;954;448;1313
510726;202205;1088;1958;622;1403;64;152;336;763;400;915
510729;202205;688;1554;322;887;38;115;90;260;128;375
510730;202205;3393;7807;2323;6209;302;900;1261;3177;1563;4077
510735;202205;1362;3586;1088;3211;96;296;856;2523;952;2819
510740;202205;1117;2604;745;1959;80;246;452;1103;532;1349
510757;202205;522;1644;406;1464;138;565;141;468;279;1033
510760;202205;51357;108616;32129;80510;6387;17729;11623;26461;18010;44190
510770;202205;4745;10101;3321;8323;252;554;2296;5984;2548;6538
510774;202205;434;1068;314;883;51;136;186;531;237;667
510775;202205;756;1871;465;1412;107;341;124;347;231;688
510776;202205;767;1854;529;1414;98;313;245;624;343;937
510777;202205;1717;4328;1240;3719;177;618;827;2418;1004;3036
510779;202205;881;2247;662;1908;65;171;419;1266;484;1437
510780;202205;4710;11120;3474;9392;710;1830;1750;5144;2460;6974
510785;202205;2328;5879;1376;4177;346;1077;351;1126;697;2203
510787;202205;3623;9778;2391;7364;795;2531;230;669;1025;3200
510788;202205;640;1428;430;1118;66;159;205;601;271;760
510790;202205;22006;54309;14449;41296;3575;11071;2372;6302;5947;17373
510792;202205;11294;30098;7219;22337;1614;5446;1511;4257;3125;9703
510794;202205;1414;3719;1028;3103;325;1114;234;602;559;1716
510795;202205;11173;27394;7825;21706;1726;5256;2666;6894;4392;12150
510800;202205;1721;4378;1211;3566;368;1167;170;417;538;1584
510805;202205;1738;4607;1164;3575;244;835;463;1295;707;2130
510810;202205;788;1529;514;1184;167;327;233;591;400;918
510820;202205;900;1662;520;1203;28;59;326;746;354;805
510830;202205;1064;2379;812;2064;65;165;607;1589;672;1754
510835;202205;693;1553;459;1227;57;176;283;721;340;897
510840;202205;68612;138219;48797;114412;7913;17496;28387;68976;36300;86472
510850;202205;2146;5159;1378;3985;576;1858;109;214;685;2072
510860;202205;2934;7306;1921;5718;610;1943;387;1182;997;3125
510880;202205;866;2330;639;1932;157;481;192;587;349;1068
510885;202205;711;1665;466;1299;94;273;119;326;213;599
510890;202205;924;2457;694;2060;146;466;334;996;480;1462
510895;202205;1574;3856;1026;2931;148;489;468;1209;616;1698
520005;202205;3766;9195;2973;8177;867;2030;1320;4264;2187;6294
520010;202205;3125;8009;2303;6492;480;1490;902;2264;1382;3754
520013;202205;3917;9397;2610;7127;623;1696;786;2268;1409;3964
520015;202205;588;1423;430;1190;97;275;173;506;270;781
520017;202205;1385;3311;979;2675;188;565;422;1061;610;1626
520020;202205;564;1113;434;965;29;80;361;775;390;855
520025;202205;41811;107368;35661;98866;4748;13703;23687;65414;28435;79117
520030;202205;7361;16765;6063;15036;385;1022;4672;11383;5057;12405
520050;202205;455;1077;277;756;38;91;152;423;190;514
520055;202205;2066;4869;1305;3363;224;555;568;1398;792;1953
520060;202205;2075;5117;1447;4044;305;967;373;1050;678;2017
520080;202205;2132;5207;1630;4530;297;745;813;2430;1110;3175
520082;202205;1044;2491;747;1992;113;317;347;977;460;1294
520085;202205;1167;2735;935;2409;176;453;482;1232;658;1685
520090;202205;1001;1868;718;1565;42;74;594;1307;636;1381
520110;202205;46641;118267;32888;95619;9307;29889;4505;12288;13812;42177
520120;202205;273;618;143;385;21;66;57;140;78;206
520130;202205;4470;10179;3452;8625;676;1716;1485;3641;2161;5357
520140;202205;54691;137465;38525;110418;12782;38786;5724;17020;18506;55806
520145;202205;685;1511;452;1173;91;251;202;474;293;725
520150;202205;749;1722;551;1469;72;189;284;739;356;928
520160;202205;1005;2294;692;1757;131;290;258;696;389;986
520170;202205;5326;10594;3539;8529;237;652;2619;6214;2856;6866
520180;202205;3048;7456;2458;6628;309;976;1539;3987;1848;4963
520215;202205;2023;4619;1471;3806;253;678;780;1974;1033;2652
520235;202205;862;1824;582;1436;109;268;290;735;399;1003
520250;202205;1872;4472;1354;3660;440;1239;340;1054;780;2293
520260;202205;881;1990;546;1459;100;262;215;567;315;829
520280;202205;973;2089;765;1786;155;350;400;951;555;1301
520310;202205;1163;2378;752;1785;192;495;286;697;478;1192
520320;202205;2083;5223;1624;4502;173;489;949;2662;1122;3151
520330;202205;5563;13659;4254;11497;643;2011;2295;5818;2938;7829
520340;202205;2698;5666;1663;4254;181;396;935;2481;1116;2877
520350;202205;3499;8104;2452;6520;682;1847;895;2423;1577;4270
520355;202205;2155;5596;1556;4467;461;1407;268;676;729;2083
520357;202205;945;2110;682;1731;33;79;541;1375;574;1454
520360;202205;896;2171;703;1869;128;365;296;758;424;1123
520380;202205;1601;3824;973;2699;151;450;371;941;522;1391
520390;202205;1297;2867;823;2249;221;646;223;658;444;1304
520393;202205;743;1681;498;1297;66;182;203;502;269;684
520396;202205;997;2395;843;2171;50;125;588;1470;638;1595
520400;202205;1817;4159;1405;3618;105;291;1044;2682;1149;2973
520410;202205;2477;5128;1677;3979;258;699;941;2062;1199;2761
520420;202205;425;926;330;786;17;48;252;573;269;621
520425;202205;1749;4146;994;2725;275;794;180;451;455;1245
520430;202205;2732;6060;1668;4389;396;1128;259;609;655;1737
520440;202205;3381;7811;1919;5221;404;1215;463;1191;867;2406
520450;202205;15209;34530;10594;27714;3155;8391;2955;8029;6110;16420
520455;202205;847;2152;612;1794;173;513;174;541;347;1054
520460;202205;1200;2674;926;2323;138;303;661;1710;799;2013
520465;202205;1001;2329;826;2095;61;198;644;1573;705;1771
520470;202205;2595;6039;2023;5311;529;1358;984;2754;1513;4112
520480;202205;1035;2699;742;2202;174;548;279;789;453;1337
520485;202205;1726;4867;1369;4325;220;760;710;2131;930;2891
520490;202205;4818;12090;3679;10338;701;2044;1987;5574;2688;7618
520495;202205;1850;3743;1408;3159;102;229;1049;2375;1151;2604
520500;202205;1895;4509;1411;3682;204;592;757;1882;961;2474
520505;202205;1014;2024;778;1741;49;116;605;1311;654;1427
520510;202205;9610;22602;6945;18651;1253;3771;3060;7956;4313;11727
520520;202205;1372;3249;1054;2780;236;670;448;1171;684;1841
520530;202205;2881;7280;2107;5923;377;1039;1050;3119;1427;4158
520540;202205;3515;8774;2341;6546;440;1271;679;1759;1119;3030
520545;202205;1460;3408;1151;2957;243;628;566;1448;809;2076
520547;202205;1424;3486;1102;2932;228;619;581;1534;809;2153
520549;202205;17541;43225;14604;39114;1748;5105;9954;25951;11702;31056
520551;202205;5442;13480;4560;12234;449;1406;3275;8509;3724;9915
520552;202205;1076;2594;840;2250;171;454;430;1221;601;1675
520570;202205;616;1320;397;986;83;177;165;419;248;596
520580;202205;2523;5333;1890;4605;261;626;1174;2861;1435;3487
520590;202205;1563;3660;1064;2866;271;757;359;937;630;1694
520620;202205;10053;25087;8038;22197;1672;4826;4188;11490;5860;16316
520630;202205;1002;2332;711;1868;81;229;325;813;406;1042
520640;202205;2776;6343;2086;5186;476;1165;804;2068;1280;3233
520650;202205;1205;2496;856;2025;171;366;431;1074;602;1440
520660;202205;597;1425;327;949;57;186;91;264;148;450
520670;202205;1108;2781;928;2520;96;249;618;1673;714;1922
520680;202205;947;2130;750;1843;128;263;447;1128;575;1391
520690;202205;370;869;241;662;86;215;64;191;150;406
520710;202205;504;1142;337;865;21;55;222;540;243;595
520725;202205;1621;3699;1087;2808;159;462;586;1461;745;1923
520735;202205;1035;2321;703;1804;194;449;235;638;429;1087
520740;202205;2855;6068;2130;5168;473;1051;1024;2638;1497;3689
520750;202205;829;1812;590;1468;85;224;320;754;405;978
520753;202205;1500;3755;1121;3093;215;657;479;1239;694;1896
520760;202205;1621;3284;1372;2992;32;67;1253;2749;1285;2816
520780;202205;1733;3948;1254;3260;169;416;660;1692;829;2108
520790;202205;3787;8560;2619;6699;420;982;1379;3717;1799;4699
520800;202205;20265;48523;15917;42302;2291;6008;9733;26363;12024;32371
520810;202205;1448;2890;1089;2487;224;492;609;1521;833;2013
520815;202205;669;1976;505;1618;95;325;153;483;248;808
520830;202205;2093;4270;1499;3563;104;247;1167;2734;1271;2981
520840;202205;3243;8099;2614;7263;815;2471;940;2668;1755;5139
520850;202205;870;1916;670;1637;144;413;318;747;462;1160
520860;202205;10014;24921;7489;20777;1615;4673;3078;8282;4693;12955
520870;202205;153951;340170;110070;274856;20213;52774;49638;118694;69851;171468
520880;202205;10000;26934;7950;23287;1643;5004;3297;9477;4940;14481
520890;202205;5229;11349;3650;8972;549;1521;1847;4334;2396;5855
520910;202205;5341;12710;3500;9677;721;2151;955;2442;1676;4593
520915;202205;863;2206;565;1601;117;363;208;538;325;901
520920;202205;5218;10918;3745;9135;693;1460;1986;5155;2679;6615
520929;202205;766;1745;591;1494;95;192;282;764;377;956
520940;202205;1134;2842;878;2466;70;225;656;1798;726;2023
520945;202205;554;1186;396;976;30;83;249;589;279;672
520960;202205;1294;2799;998;2380;311;696;393;1046;704;1742
520970;202205;3671;9100;2772;7685;830;2429;582;1755;1412;4184
520980;202205;893;1978;652;1666;104;272;302;731;406;1003
520990;202205;3527;8290;2860;7463;455;1042;1908;5135;2363;6177
520993;202205;1396;3285;928;2459;135;396;452;1149;587;1545
520995;202205;2873;6788;2178;5811;377;963;800;2256;1177;3219
521000;202205;10726;26608;7171;20121;1165;3455;2122;5624;3287;9079
521010;202205;4306;10600;3163;8622;430;1211;1677;4460;2107;5671
521015;202205;905;2137;637;1670;50;144;404;1006;454;1150
521020;202205;4640;11138;2833;7777;705;2021;562;1556;1267;3577
521030;202205;848;1562;664;1305;25;56;564;1073;589;1129
521040;202205;9555;22246;7124;18575;1676;4358;2566;7102;4242;11460
521056;202205;1109;2773;820;2314;230;618;254;778;484;1396
521060;202205;1200;2988;848;2333;186;524;298;813;484;1337
521080;202205;1247;2558;656;1665;100;265;300;702;400;967
521090;202205;3592;9229;2430;6893;584;1776;291;822;875;2598
521100;202205;2249;4752;1684;3996;217;530;1097;2607;1314;3137
521120;202205;5693;12817;4291;11054;678;1442;1825;5570;2503;7012
521130;202205;1165;2583;585;1533;53;115;292;805;345;920
521140;202205;1716;4133;1264;3324;158;418;687;1747;845;2165
521150;202205;14804;31335;9531;23863;1903;5198;4331;10762;6234;15960
521160;202205;848;1689;582;1304;65;125;370;803;435;928
521170;202205;1242;2755;909;2261;108;299;487;1136;595;1435
521180;202205;9475;23717;7595;20615;1355;3966;3809;10008;5164;13974
521190;202205;12871;30417;8097;22754;1962;5816;2236;6192;4198;12008
521200;202205;824;1883;562;1471;61;162;312;789;373;951
521205;202205;725;1653;562;1404;23;62;440;1055;463;1117
521210;202205;873;2216;504;1447;91;280;132;295;223;575
521220;202205;4357;9781;3005;7775;622;1706;1296;3332;1918;5038
521225;202205;478;951;353;814;46;101;248;581;294;682
521230;202205;1641;3879;1389;3557;585;1498;483;1315;1068;2813
521250;202205;41356;98098;33429;87099;8650;23277;16790;43297;25440;66574
521260;202205;596;1318;451;1105;71;189;261;615;332;804
521270;202205;2333;5227;2022;4850;188;401;1488;3688;1676;4089
521280;202205;2087;5311;1577;4493;329;993;694;1984;1023;2977
521290;202205;645;1391;451;1150;45;122;285;701;330;823
521295;202205;1400;2920;1095;2546;153;289;742;1762;895;2051
521300;202205;2155;5057;1661;4340;325;799;932;2492;1257;3291
521305;202205;779;1742;537;1406;59;186;337;850;396;1036
521308;202205;5576;13828;3910;10849;348;1061;2430;6460;2778;7521
521310;202205;11572;27809;8009;21614;1430;4217;3589;9160;5019;13377
521340;202205;460;987;320;788;30;70;198;484;228;554
521350;202205;2262;5505;1725;4694;140;438;1232;3244;1372;3682
521370;202205;1434;3533;911;2670;291;917;149;463;440;1380
521375;202205;1595;3912;1089;3090;222;657;314;967;536;1624
521377;202205;1649;3308;1204;2760;136;245;885;2163;1021;2408
521380;202205;7072;18063;4563;13473;695;2069;991;3105;1686;5174
521385;202205;811;1822;613;1557;85;179;331;919;416;1098
521390;202205;783;1871;542;1486;139;418;96;272;235;690
521400;202205;3395;7490;2721;6658;279;675;1882;4572;2161;5247
521405;202205;1608;3963;1095;3016;132;374;603;1603;735;1977
521410;202205;1029;2385;812;2056;190;443;425;1112;615;1555
521440;202205;1635;3759;1254;3218;381;948;518;1379;899;2327
521450;202205;4662;12973;3459;10686;923;2883;828;2668;1751;5551
521460;202205;6857;16756;4986;13493;1334;3728;1795;4747;3129;8475
521470;202205;879;2144;609;1653;73;203;295;741;368;944
521480;202205;548;1230;376;940;79;181;152;352;231;533
521483;202205;2718;6224;1933;5069;392;1020;860;2288;1252;3308
521486;202205;2056;4692;1558;3982;142;270;1027;2651;1169;2921
521487;202205;461;1044;315;849;56;144;184;518;240;662
521490;202205;1007;2530;752;2115;39;131;529;1419;568;1550
521500;202205;2418;5800;1842;4993;176;648;1195;3033;1371;3681
521520;202205;907;2005;699;1716;110;232;378;957;488;1189
521523;202205;15483;43207;12775;39044;3620;11381;4583;14042;8203;25423
521525;202205;1255;2798;964;2391;74;221;662;1560;736;1781
521530;202205;2598;6444;1614;4501;329;915;417;1092;746;2007
521540;202205;939;2309;668;1871;135;420;279;765;414;1185
521550;202205;1887;4595;1050;2952;198;582;279;786;477;1368
521560;202205;6190;14756;4477;12457;1225;3169;1927;5871;3152;9040
521565;202205;789;1832;562;1467;86;234;264;684;350;918
521570;202205;4224;10921;2917;8493;589;1959;207;624;796;2583
521580;202205;573;1317;364;966;55;154;151;365;206;519
521590;202205;921;1948;667;1592;93;232;378;870;471;1102
521600;202205;499;1244;315;904;47;121;153;433;200;554
521630;202205;1935;4036;1234;3049;342;828;376;919;718;1747
521640;202205;2258;5052;1455;3863;325;908;468;1208;793;2116
521645;202205;603;1481;364;1049;145;402;33;78;178;480
521680;202205;1557;4107;1202;3519;345;1041;375;1084;720;2125
521690;202205;628;1473;522;1332;80;220;312;775;392;995
521710;202205;4003;9311;2615;7041;465;1377;810;1901;1275;3278
521720;202205;2764;5943;1809;4543;237;603;1031;2585;1268;3188
521730;202205;4412;11411;3396;9739;917;3043;937;2289;1854;5332
521740;202205;4816;11849;3724;10262;1188;3407;946;2637;2134;6044
521760;202205;18465;46118;14650;40655;3193;9115;6720;19617;9913;28732
521770;202205;3724;8374;2536;6562;616;1671;659;1729;1275;3400
521800;202205;7887;19670;5728;16141;1526;4269;2102;6513;3628;10782
521805;202205;1182;2346;822;1910;186;407;433;1066;619;1473
521810;202205;781;1765;568;1470;103;258;328;879;431;1137
521830;202205;6613;16844;5316;14871;338;1181;3912;10617;4250;11798
521839;202205;1034;2222;780;1833;74;211;547;1176;621;1387
521850;202205;7684;16779;4799;12464;1342;3374;735;1927;2077;5301
521860;202205;1847;4789;1263;3717;211;683;407;1085;618;1768
521870;202205;785;2066;569;1658;117;378;171;413;288;791
521878;202205;943;2295;637;1716;69;229;351;860;420;1089
521880;202205;23807;55913;16852;45324;3825;10725;7030;18437;10855;29162
521890;202205;3944;9495;2722;7414;719;1992;748;1891;1467;3883
521900;202205;1558;3544;803;2251;245;647;37;105;282;752
521910;202205;1643;3377;1175;2811;257;607;533;1278;790;1885
521920;202205;618;1552;465;1306;54;190;276;734;330;924
521925;202205;881;2184;650;1835;138;438;300;815;438;1253
521930;202205;6340;14499;4267;11419;1116;2487;1788;5291;2904;7778
521935;202205;1204;2743;828;2108;76;211;475;1144;551;1355
521940;202205;1505;3115;985;2401;170;459;501;1154;671;1613
521945;202205;765;1843;545;1466;86;231;284;769;370;1000
521950;202205;858;1945;594;1532;107;273;276;714;383;987
521960;202205;801;1975;551;1524;57;192;312;789;369;981
521970;202205;3278;7038;2456;6034;283;578;1720;4437;2003;5015
521971;202205;874;2023;613;1630;156;404;164;425;320;829
521973;202205;1710;4207;1402;3788;93;223;1092;2985;1185;3208
521975;202205;14818;36366;12054;32550;2046;5685;7126;19245;9172;24930
521980;202205;2774;6084;2119;5234;147;346;1613;4046;1760;4392
521990;202205;1426;3542;1178;3167;251;719;622;1676;873;2395
522000;202205;3167;7793;2484;6914;548;1559;1295;3803;1843;5362
522005;202205;397;896;281;727;42;121;132;340;174;461
522010;202205;5019;11821;3641;9615;737;2069;1428;3620;2165;5689
522015;202205;1220;3007;899;2516;257;715;352;998;609;1713
522020;202205;6228;14016;4136;10842;834;2137;1785;4831;2619;6968
522026;202205;886;2208;573;1690;97;337;175;441;272;778
522028;202205;581;1379;404;1081;89;267;167;405;256;672
522040;202205;4098;8408;2926;6862;322;777;2006;4573;2328;5350
522045;202205;22099;57035;16778;48266;3651;11175;5316;14629;8967;25804
522050;202205;1370;3315;960;2614;182;550;407;976;589;1526
522060;202205;3444;8609;2489;7096;385;1065;1297;3743;1682;4808
522068;202205;2156;4899;1729;4399;101;220;1409;3606;1510;3826
522070;202205;891;1881;724;1645;19;38;628;1396;647;1434
522100;202205;943;2280;646;1769;86;241;316;825;402;1066
522108;202205;1260;2737;993;2369;50;134;798;1864;848;1998
522119;202205;2123;4739;1683;4183;297;680;911;2404;1208;3084
522130;202205;573;1316;431;1131;39;89;324;868;363;957
522140;202205;26884;65422;19271;52233;4256;12201;6513;16530;10769;28731
522145;202205;919;2104;652;1715;137;377;325;847;462;1224
522150;202205;1231;2821;843;2224;207;540;245;648;452;1188
522155;202205;1184;2871;922;2486;153;357;549;1534;702;1891
522157;202205;829;1709;680;1535;34;73;547;1234;581;1307
522160;202205;6996;16959;4480;12571;1210;3609;532;1606;1742;5215
522170;202205;3122;7620;2408;6572;264;731;1525;4167;1789;4898
522180;202205;706;1615;467;1172;85;222;128;326;213;548
522185;202205;25780;59554;19041;50553;6952;19672;4558;13125;11510;32797
522190;202205;907;1982;636;1547;131;323;282;660;413;983
522200;202205;2187;5763;1596;4714;419;1232;431;1293;850;2525
522205;202205;1897;4383;1411;3703;333;864;617;1636;950;2500
522220;202205;1441;3268;1058;2742;126;314;674;1792;800;2106
522230;202205;1485;3433;1175;2990;205;578;652;1648;857;2226
530010;202205;229132;587687;191187;532651;24208;74080;121521;329374;145729;403454
110001;202204;4486;11947;3020;9268;668;2239;1128;3475;1796;5714
110002;202204;15309;37748;11308;31239;2832;8279;3529;9842;6361;18121
110003;202204;802;2230;578;1792;155;505;193;548;348;1053
110004;202204;14620;35971;10069;28244;1976;5941;3569;9812;5545;15753
110005;202204;2809;7007;2008;5721;393;1102;651;1997;1044;3099
110006;202204;1816;4942;1117;3462;210;692;240;698;450;1390
110007;202204;1465;3641;966;2808;279;809;314;1051;593;1860
110008;202204;3973;9711;2938;8274;397;956;1874;5828;2271;6784
110009;202204;5085;13476;3305;10314;667;2269;1304;3981;1971;6250
110010;202204;9119;26476;6951;22613;1355;4156;3630;13025;4985;17181
110011;202204;8330;21071;5770;16653;1747;5246;1246;3648;2993;8894
110012;202204;18135;43433;11626;32659;2935;8596;1942;5499;4877;14095
110013;202204;6369;17267;4495;13681;1753;5572;750;2476;2503;8048
110014;202204;4385;10987;3012;8430;424;1300;1549;4199;1973;5499
110015;202204;6593;16103;4215;11765;797;2485;1377;3438;2174;5923
110018;202204;4407;10728;2698;7844;538;1676;754;2177;1292;3853
110020;202204;92235;205784;69348;175542;15156;37107;33489;90215;48645;127322
110025;202204;5882;13612;4004;10460;636;1769;2074;5296;2710;7065
110026;202204;623;1568;462;1330;103;318;177;553;280;871
110028;202204;8188;19827;5191;14630;1274;3999;778;2192;2052;6191
110029;202204;1765;4175;1067;2992;199;550;446;1277;645;1827
110030;202204;15106;34346;9576;26213;2427;7205;1528;4967;3955;12172
110032;202204;3986;10579;2478;7514;726;2186;563;1809;1289;3995
110033;202204;4382;12838;3383;11018;1100;3674;1077;3795;2177;7469
110034;202204;3620;8198;2461;6619;795;2329;752;2317;1547;4646
110037;202204;1830;5189;1327;4276;298;969;567;1875;865;2844
110040;202204;3399;8940;2489;7326;587;1877;847;2425;1434;4302
110045;202204;5382;14775;3906;12159;987;3244;1458;4708;2445;7952
110050;202204;1967;5116;1347;4055;411;1421;232;634;643;2055
110060;202204;1005;2854;678;2099;170;554;179;543;349;1097
110070;202204;1771;5243;1286;4200;366;1318;322;960;688;2278
110080;202204;7281;16267;5538;14173;1011;2488;3234;8830;4245;11318
110090;202204;658;1743;459;1391;106;361;131;395;237;756
110092;202204;1460;3992;1021;3166;190;576;514;1682;704;2258
110094;202204;3250;9077;2442;7575;986;3199;365;1242;1351;4441
110100;202204;1976;5444;1560;4686;467;1468;618;1899;1085;3367
110110;202204;1996;5103;1428;4224;432;1347;355;1157;787;2504
110120;202204;1446;3919;1078;3235;257;810;375;1128;632;1938
110130;202204;3153;7513;1928;5334;283;766;215;526;498;1292
110140;202204;2537;6988;1833;5641;352;1167;738;2238;1090;3405
110143;202204;1580;4068;1145;3283;312;970;343;947;655;1917
110145;202204;1083;2691;649;1885;147;423;258;790;405;1213
110146;202204;565;1416;395;1138;82;194;185;592;267;786
110147;202204;867;2150;573;1603;82;254;270;673;352;927
110148;202204;1084;2844;553;1713;142;501;75;220;217;721
110149;202204;3770;9477;2561;7607;818;2530;657;2124;1475;4654
110150;202204;3051;7397;2017;5834;532;1668;571;1886;1103;3554
110155;202204;911;2525;638;1890;135;449;254;686;389;1135
110160;202204;1598;4586;1192;3736;352;1123;318;1047;670;2170
110170;202204;2347;5759;1526;4286;216;681;879;2332;1095;3013
110175;202204;2361;6421;1604;4809;290;896;638;1891;928;2787
110180;202204;1639;4176;1159;3261;139;403;622;1718;761;2121
120001;202204;3852;10410;3141;9347;455;1501;2064;6154;2519;7655
120005;202204;2181;7760;1981;7472;186;738;1565;6053;1751;6791
120010;202204;6265;16686;5403;15464;432;1195;4236;12318;4668;13513
120013;202204;2740;8388;2361;7898;546;1719;1336;4894;1882;6613
120017;202204;3093;8552;2664;7930;361;1064;1775;5578;2136;6642
120020;202204;16821;59027;15494;56632;971;4179;12696;46444;13667;50623
120025;202204;3925;9606;3217;8786;356;930;2401;6746;2757;7676
120030;202204;7035;26283;6512;25389;406;2060;5146;20283;5552;22343
120032;202204;1948;8062;1856;7893;97;600;1614;6739;1711;7339
120033;202204;4768;15942;4468;15411;95;540;3961;13520;4056;14060
120034;202204;3216;10344;2784;9644;115;624;2368;8042;2483;8666
120035;202204;4413;15419;4122;14927;237;1084;3512;12606;3749;13690
120038;202204;3261;9351;2812;8652;399;1310;1871;5765;2270;7075
120039;202204;2185;8913;2045;8650;123;706;1655;6996;1778;7702
120040;202204;58801;160469;50908;148655;6225;19483;34263;100076;40488;119559
120042;202204;3924;12960;3645;12479;146;712;3122;10546;3268;11258
120043;202204;1660;6215;1464;5942;37;229;1328;5397;1365;5626
120045;202204;6890;16502;5898;15364;365;1043;4929;12853;5294;13896
120050;202204;10989;35384;10126;34153;507;2004;8553;29008;9060;31012
120060;202204;11105;38965;10206;37685;478;2359;8941;32874;9419;35233
120070;202204;3862;11071;3344;10377;418;1156;2301;7559;2719;8715
120080;202204;5679;14853;5118;14066;622;1538;3869;10936;4491;12474
130002;202204;3705;12772;3308;12232;264;774;2805;10773;3069;11547
130006;202204;2864;9581;2389;8808;356;1252;1532;6199;1888;7451
130008;202204;3078;9828;2679;9258;148;530;2181;7728;2329;8258
130010;202204;4341;11958;3667;11191;129;329;3264;10114;3393;10443
130014;202204;4072;10988;3199;9641;476;1453;2034;6318;2510;7771
130020;202204;3246;11856;2877;11310;136;754;2374;9315;2510;10069
130030;202204;14846;37067;13696;35771;234;612;12799;33492;13033;34104
130040;202204;4631;12793;3848;11793;425;1131;2960;9408;3385;10539
130050;202204;8398;28669;7074;26979;258;993;6360;24694;6618;25687
130060;202204;8369;31487;7145;29919;378;2188;6044;25103;6422;27291
130063;202204;7235;22422;6440;21547;182;819;5907;19784;6089;20603
130068;202204;4354;13579;3670;12673;179;932;2943;10073;3122;11005
130070;202204;8461;22226;6943;20586;395;939;5742;17609;6137;18548
130080;202204;8525;27468;7449;26268;416;1336;6500;23383;6916;24719
130083;202204;3123;9539;2765;9097;267;825;2193;7499;2460;8324
130090;202204;4206;11767;3746;11229;70;180;3433;10440;3503;10620
130100;202204;8589;24923;7239;23516;157;318;6764;22471;6921;22789
130110;202204;9336;24851;7593;22701;1091;2868;5394;17273;6485;20141
130115;202204;5593;16834;4808;15941;141;418;4249;14359;4390;14777
130120;202204;15164;50555;13315;48147;1000;3975;10989;40211;11989;44186
130130;202204;6649;18475;5148;16557;509;1550;3818;12819;4327;14369
130140;202204;8041;26230;7028;25082;335;1470;6018;21698;6353;23168
130150;202204;4282;14224;4024;13934;76;427;3727;12903;3803;13330
130160;202204;6810;20038;5902;18926;322;893;5163;16895;5485;17788
130165;202204;3657;12832;3443;12593;134;552;3113;11498;3247;12050
130170;202204;13622;36091;11108;33261;546;1846;9586;28941;10132;30787
130180;202204;4822;14852;4590;14597;40;234;4442;14077;4482;14311
130185;202204;21924;49491;18095;45394;1348;1849;15492;41007;16840;42856
130190;202204;21575;66346;17432;60437;1452;5138;13387;47503;14839;52641
130195;202204;2738;9354;2265;8754;94;425;1922;7480;2016;7905
130200;202204;3269;8142;2702;7419;119;399;2311;6301;2430;6700
130210;202204;1530;5434;1380;5254;106;564;1142;4250;1248;4814
130220;202204;2625;8155;2199;7641;79;281;1953;6911;2032;7192
130230;202204;5551;20659;4834;19694;197;1115;4268;17411;4465;18526
130240;202204;15560;39152;12906;35831;172;868;12004;33006;12176;33874
130250;202204;29326;82166;25129;77396;1423;4029;20959;66541;22382;70570
130255;202204;5475;16257;4708;14945;187;691;3889;12309;4076;13000
130260;202204;309897;787466;255772;714888;59521;163081;143001;416564;202522;579645
130270;202204;10993;35775;9118;32965;1515;5040;5941;22683;7456;27723
130280;202204;3955;14756;3636;14397;107;450;3381;13543;3488;13993
130290;202204;15912;47157;14037;44895;723;2370;12401;40096;13124;42466
130300;202204;5548;17316;4968;16554;187;859;4329;14405;4516;15264
130310;202204;8430;23099;7420;21886;413;1225;6304;18906;6717;20131
130320;202204;3845;12035;3219;11218;378;1257;2423;8747;2801;10004
130330;202204;5282;15457;4267;14265;213;850;3611;12270;3824;13120
130340;202204;28011;77102;24184;72847;1074;3331;21080;64586;22154;67917
130350;202204;4403;14894;3939;14305;129;690;3469;12536;3598;13226
130353;202204;8792;21935;7104;19827;897;2318;5142;14927;6039;17245
130356;202204;6035;17842;5086;16418;804;2434;3265;11153;4069;13587
130360;202204;3412;10418;2796;9661;62;276;2551;8828;2613;9104
130370;202204;5909;23422;5040;22207;497;2646;3694;16391;4191;19037
130380;202204;8239;33876;7686;33070;591;3088;6381;27428;6972;30516
130390;202204;7303;27601;6530;26419;490;2132;5547;22659;6037;24791
130395;202204;2776;8301;2351;7650;186;612;1876;6100;2062;6712
130400;202204;3160;9099;2691;8483;99;310;2402;7663;2501;7973
130406;202204;12035;39496;10149;37233;1322;4779;7591;28875;8913;33654
130410;202204;4964;16190;4278;15129;1119;4063;2289;8449;3408;12512
130420;202204;16264;52112;13643;48891;1083;4533;10754;38813;11837;43346
130423;202204;4945;14603;4340;13908;173;713;3889;12411;4062;13124
130426;202204;3236;11584;2978;11277;74;264;2760;10644;2834;10908
130430;202204;5086;12815;4351;11895;161;482;3871;10533;4032;11015
130440;202204;5816;16535;4903;15463;94;378;4587;14530;4681;14908
140002;202204;2625;7381;2283;6972;114;361;1943;6039;2057;6400
140005;202204;3651;9810;3174;9256;506;1402;2323;7030;2829;8432
140010;202204;58658;152118;47441;136000;11016;33170;21795;64094;32811;97264
140015;202204;4717;12336;3979;11493;279;758;3397;10126;3676;10884
140017;202204;6184;14865;5477;13992;323;796;4687;12148;5010;12944
140020;202204;6034;16005;5231;15015;304;1059;4318;12367;4622;13426
140023;202204;2909;7942;2342;7158;234;704;1776;5588;2010;6292
140028;202204;2199;5387;1864;4975;89;260;1510;4047;1599;4307
140030;202204;6247;14611;5590;13862;216;376;5115;12945;5331;13321
140040;202204;2893;10754;2667;10468;89;506;2468;9601;2557;10107
140045;202204;3016;10625;2526;9968;469;1439;1631;7190;2100;8629
140047;202204;6925;18640;5800;17033;590;1840;4295;12794;4885;14634
140050;202204;1733;4873;1474;4504;218;613;1036;3285;1254;3898
140060;202204;2136;5099;1873;4743;138;338;1575;4030;1713;4368
140070;202204;2078;10375;2012;10268;121;803;1753;8866;1874;9669
150010;202204;53254;123393;48201;116979;1174;2620;43323;104918;44497;107538
150013;202204;2309;5291;1948;4899;94;208;1656;4278;1750;4486
150020;202204;15870;44710;14628;43087;1416;3389;11989;36591;13405;39980
150030;202204;9408;33711;8517;32662;397;1675;7612;29445;8009;31120
150034;202204;4959;11141;4040;10027;223;502;3431;8643;3654;9145
150040;202204;18072;43783;15865;41378;1289;1569;13940;38578;15229;40147
150050;202204;8526;25641;7815;24736;173;584;7221;23092;7394;23676
150060;202204;25028;64260;20307;57340;2436;7142;14231;40645;16667;47787
150070;202204;10253;29246;9203;28019;196;771;8649;26244;8845;27015
150080;202204;103167;223871;85319;200253;22334;52505;27252;76457;49586;128962
150085;202204;9806;24911;8881;23843;110;361;8389;22649;8499;23010
150090;202204;12614;38075;11878;36798;629;2063;10283;31688;10912;33751
150095;202204;7860;18391;6998;17364;567;792;6068;15679;6635;16471
150100;202204;3124;10293;2754;9690;218;725;2186;7884;2404;8609
150110;202204;4666;18081;4320;17692;149;658;4003;16588;4152;17246
150120;202204;8912;26024;8319;25320;323;645;7487;23319;7810;23964
150125;202204;974;2318;716;1973;95;293;463;1273;558;1566
150130;202204;25152;67982;21633;62760;3745;9519;13975;43425;17720;52944
150140;202204;313872;664080;267249;603599;34177;70733;173030;398061;207207;468794
150145;202204;4708;13933;3930;12735;1159;3557;1812;6697;2971;10254
150150;202204;20073;45999;17329;42606;1165;2711;13909;34453;15074;37164
150157;202204;4131;10523;3291;9430;379;1057;2245;6682;2624;7739
150160;202204;4322;10019;4039;9633;389;923;3203;7557;3592;8480
150170;202204;29813;84660;26525;79387;4000;10660;17750;56317;21750;66977
150172;202204;5978;14787;4851;13278;281;676;3769;10555;4050;11231
150175;202204;1929;5521;1596;4950;210;699;1045;3240;1255;3939
150178;202204;12305;29792;10064;27263;614;1050;8522;24212;9136;25262
150180;202204;29611;84959;26958;81995;1850;3904;22834;73515;24684;77419
150190;202204;7947;22835;7385;22165;172;714;6831;20403;7003;21117
150195;202204;5941;17187;5538;16606;230;727;4969;14934;5199;15661
150200;202204;6656;18025;6049;17350;34;135;5738;16507;5772;16642
150210;202204;32210;97671;30237;95252;1362;4017;26482;85100;27844;89117
150215;202204;10438;27858;9049;25734;1483;4190;5535;16110;7018;20300
150220;202204;14815;38158;12987;35687;915;2437;9755;26953;10670;29390
150230;202204;14747;38487;13109;36301;1287;2854;9459;27424;10746;30278
150240;202204;38773;99493;32689;89697;6811;19261;15399;41419;22210;60680
150250;202204;4683;16627;4367;16278;462;1722;3661;13921;4123;15643
150260;202204;2882;8657;2594;8243;99;349;2179;6948;2278;7297
150270;202204;10293;27478;7338;22269;2033;6482;2221;7054;4254;13536
150275;202204;7784;22440;7093;21513;169;705;6290;18873;6459;19578
150276;202204;2609;6567;2245;6119;287;645;1549;4704;1836;5349
150277;202204;5987;14040;4783;12667;585;1553;3369;9351;3954;10904
150280;202204;7905;28763;7617;28326;384;1374;6692;25316;7076;26690
150285;202204;3666;12025;3174;11241;218;836;2452;8810;2670;9646
150290;202204;12608;30791;11436;29550;499;720;10374;27558;10873;28278
150293;202204;10829;24777;8554;21861;1092;2624;5689;15001;6781;17625
150295;202204;8326;20961;5997;17757;1900;5666;2247;7738;4147;13404
150300;202204;2924;7530;2641;7194;32;109;2455;6707;2487;6816
150304;202204;4958;13457;4146;12233;598;1524;2828;8811;3426;10335
150307;202204;6567;19553;5979;18614;342;1038;4791;15079;5133;16117
150309;202204;7266;19759;5891;17546;769;2244;3809;11654;4578;13898
150310;202204;8201;30252;7715;29669;226;1116;6890;26819;7116;27935
150320;202204;10306;26211;9367;24893;510;1503;7403;19478;7913;20981
150330;202204;15386;45563;14243;43957;1414;3711;10714;34809;12128;38520
150340;202204;2745;7636;2413;7173;247;693;1808;5450;2055;6143
150345;202204;9868;25534;8799;24148;350;1057;7778;21292;8128;22349
150350;202204;10346;23904;9473;22803;500;1020;8270;19970;8770;20990
150360;202204;27226;70094;21765;63367;2319;4780;16166;49995;18485;54775
150370;202204;12892;35236;10526;32099;1203;3121;7728;25157;8931;28278
150375;202204;4188;16063;3788;15511;191;827;3363;13905;3554;14732
150380;202204;12304;28975;10071;26082;178;603;8906;22936;9084;23539
150390;202204;8003;30768;7133;29438;847;3100;5424;23405;6271;26505
150400;202204;7492;24606;7137;24019;133;547;6326;21491;6459;22038
150405;202204;10183;24853;8839;23274;554;1070;7260;19682;7814;20752
150410;202204;2202;6267;1883;5768;189;512;1331;4187;1520;4699
150420;202204;47949;122849;37235;107521;8596;24623;16594;53194;25190;77817
150430;202204;9217;25005;8379;23965;653;1496;7008;20506;7661;22002
150440;202204;6642;18564;6003;17731;676;1755;4569;13944;5245;15699
150442;202204;33290;71149;27941;64851;2253;4850;21371;49674;23624;54524
150445;202204;7922;21184;7010;19882;165;515;6288;17782;6453;18297
150450;202204;6058;22675;5615;22096;380;1844;4922;19231;5302;21075
150460;202204;9705;28941;8841;27873;397;1068;7554;24717;7951;25785
150470;202204;23911;58502;21513;55766;235;872;20499;52845;20734;53717
150475;202204;5928;17073;5037;15723;677;1830;3547;11619;4224;13449
150480;202204;15768;45523;14164;43261;2186;5281;10100;33229;12286;38510
150490;202204;9358;30438;8482;29318;501;1593;7162;25278;7663;26871
150495;202204;6142;18606;5816;18192;127;559;5345;16640;5472;17199
150497;202204;3069;9145;2472;8100;456;1516;1396;4860;1852;6376
150500;202204;3660;8817;3246;8238;222;536;2565;6453;2787;6989
150503;202204;5762;14143;4093;12014;1250;3440;1666;5430;2916;8870
150506;202204;13078;35381;11054;32645;1793;4681;7578;24080;9371;28761
150510;202204;11997;37654;10460;35069;1034;3359;7801;26677;8835;30036
150520;202204;8716;29956;8359;29521;183;1057;7768;27243;7951;28300
150530;202204;13477;43436;11654;40887;988;2892;9122;33219;10110;36111
150540;202204;5840;14222;5045;13078;296;687;4242;11032;4538;11719
150543;202204;8009;20713;6654;19039;467;1358;5257;15544;5724;16902
150548;202204;11337;33186;10153;31541;269;977;9099;28348;9368;29325
150549;202204;2249;6002;1898;5514;62;201;1575;4583;1637;4784
150550;202204;23572;64717;19474;58286;4478;13564;8875;27912;13353;41476
150553;202204;40719;105710;31722;90638;7295;21066;14440;42256;21735;63322
150555;202204;2231;5569;1745;4815;170;374;1142;3333;1312;3707
150560;202204;2157;5862;1927;5447;232;623;1263;3645;1495;4268
150563;202204;2952;8268;2431;7374;452;1428;1380;4241;1832;5669
150565;202204;4978;15059;4434;14225;114;474;3698;11929;3812;12403
150570;202204;7648;21272;7100;20571;318;972;6250;18084;6568;19056
150580;202204;12111;43481;10365;41554;1165;3781;8188;34940;9353;38721
150590;202204;8989;29118;7676;27563;167;923;7070;25307;7237;26230
150600;202204;11123;33289;10283;32272;189;785;9563;30024;9752;30809
150610;202204;3418;8705;3049;8156;104;370;2628;6905;2732;7275
150611;202204;3688;9411;3237;8801;93;323;2857;7693;2950;8016
150613;202204;16110;41473;12358;35415;2072;6355;6757;18990;8829;25345
150616;202204;4175;10995;3022;9018;599;1871;1387;4131;1986;6002
150618;202204;7865;21235;6418;19043;752;2234;4111;12603;4863;14837
150619;202204;7611;19736;6276;17939;359;868;5197;15154;5556;16022
150620;202204;7585;23560;6581;21942;720;2184;4542;15700;5262;17884
150630;202204;7521;18110;6856;17322;185;533;6189;15541;6374;16074
150635;202204;5963;15107;5031;13632;569;1438;3429;9390;3998;10828
150640;202204;2394;6837;2185;6575;36;109;2025;6139;2061;6248
150650;202204;13283;33692;11571;31124;2801;7046;5815;16787;8616;23833
150655;202204;6071;16546;5491;15715;133;485;4883;13882;5016;14367
150658;202204;5070;13810;3800;11704;804;2541;1892;6080;2696;8621
150660;202204;6534;17139;5756;16048;773;2048;3894;11020;4667;13068
150670;202204;10608;22177;8467;19748;611;1121;7061;17045;7672;18166
150680;202204;80639;218531;63846;193109;13346;38933;32600;107970;45946;146903
150690;202204;3058;7038;2626;6550;131;267;2285;5815;2416;6082
150700;202204;7446;19922;6676;18963;554;1236;5359;15751;5913;16987
150710;202204;4222;13105;3808;12473;266;857;2948;9855;3214;10712
150715;202204;6073;15429;5010;13910;262;680;4164;11623;4426;12303
150720;202204;8614;25179;7991;24315;421;1370;6875;21031;7296;22401
150730;202204;14609;40903;12447;37764;1408;4367;9125;28411;10533;32778
150740;202204;4531;11720;3968;10871;344;742;3016;8525;3360;9267
150745;202204;6103;15934;4975;14356;627;1789;3613;10694;4240;12483
150746;202204;1952;5271;1742;4968;62;191;1475;4186;1537;4377
150747;202204;5686;15869;5046;14946;426;1111;3901;11817;4327;12928
150750;202204;4113;11984;3368;10858;268;925;2493;8308;2761;9233
150760;202204;12989;35893;11760;34244;1602;4160;8503;25677;10105;29837
150770;202204;7818;24683;7232;24041;222;537;6644;22707;6866;23244
150775;202204;1279;3150;997;2789;112;343;710;1993;822;2336
150780;202204;4981;14422;4432;13780;174;457;3996;12754;4170;13211
150790;202204;6867;17400;5814;16260;481;1004;4021;13253;4502;14257
150795;202204;16996;47485;14731;44184;2742;7916;9369;29231;12111;37147
150796;202204;4319;9653;3747;9007;151;320;3275;7948;3426;8268
150797;202204;4783;13387;4106;12460;316;777;3328;10339;3644;11116
150800;202204;15032;43989;13452;41978;1394;4076;10431;33398;11825;37474
150803;202204;9075;24034;8398;23104;305;918;7526;20629;7831;21547
150805;202204;4016;11504;3428;10688;282;835;2656;8509;2938;9344
150808;202204;7340;20103;5460;17020;1899;6401;1068;3731;2967;10132
150810;202204;23533;56893;17781;50018;3642;9614;9414;29926;13056;39540
150812;202204;6686;16856;5916;15700;420;1259;4673;12093;5093;13352
150815;202204;10808;29603;9034;27528;876;2600;7290;22746;8166;25346
150820;202204;15743;35420;13702;32963;1859;3019;10177;26670;12036;29689
150830;202204;13422;44219;12402;42996;776;2053;10613;38540;11389;40593
150835;202204;3559;9995;3120;9366;324;1006;2315;6905;2639;7911
150840;202204;9006;23329;7283;20715;1042;3325;4471;12485;5513;15810
160005;202204;1397;3464;1236;3271;52;167;1079;2854;1131;3021
160010;202204;2522;6522;2342;6327;25;116;2266;6068;2291;6184
160015;202204;4005;9425;3614;8969;56;172;3423;8449;3479;8621
160020;202204;2607;7276;2263;6846;230;603;1754;5548;1984;6151
160021;202204;1400;4800;1275;4650;62;279;1013;3791;1075;4070
160023;202204;1522;4915;1363;4658;191;610;919;3317;1110;3927
160025;202204;2128;5921;2000;5780;26;56;1930;5597;1956;5653
160027;202204;11327;26908;10246;25572;594;1521;8819;21975;9413;23496
160030;202204;90365;232766;74766;212641;14094;36956;43772;134699;57866;171655
160040;202204;6501;20281;5895;19521;195;596;5409;18115;5604;18711
160050;202204;5892;15970;4735;14490;1443;3688;2364;8721;3807;12409
160053;202204;4794;13078;4307;12467;264;628;3562;10738;3826;11366
160055;202204;1299;3039;1262;3000;21;59;1200;2834;1221;2893
160060;202204;31814;73688;26742;67989;1862;4141;21768;57358;23630;61499
160070;202204;3190;10872;2793;10289;242;813;2184;8399;2426;9212
160080;202204;3923;10759;3452;10243;57;194;3212;9647;3269;9841
170025;202204;749;1854;494;1403;90;254;212;618;302;872
170030;202204;1332;3802;1039;3316;218;676;410;1369;628;2045
170035;202204;1685;4112;1238;3407;94;278;782;2077;876;2355
170040;202204;2160;5534;1715;4925;175;516;1069;3172;1244;3688
170070;202204;2161;4722;1542;3956;84;219;941;2474;1025;2693
170100;202204;2695;7184;2220;6411;218;629;1456;4248;1674;4877
170105;202204;764;2102;533;1638;127;383;169;482;296;865
170110;202204;1119;3088;860;2656;72;278;523;1537;595;1815
170130;202204;1543;4146;1168;3505;135;468;681;2015;816;2483
170190;202204;1765;4329;1364;3724;223;754;746;1924;969;2678
170200;202204;2332;5213;1547;3977;249;651;659;1673;908;2324
170210;202204;30170;77458;23012;65936;6688;20613;4719;14179;11407;34792
170215;202204;1482;3734;1188;3336;51;183;932;2593;983;2776
170220;202204;6565;19062;5456;17136;1684;5132;1913;6849;3597;11981
170230;202204;1383;3808;1032;3157;293;903;273;875;566;1778
170240;202204;3005;7676;2430;6781;146;499;1822;4946;1968;5445
170255;202204;4274;11708;3139;9784;580;1850;1471;4708;2051;6558
170270;202204;1001;2352;685;1897;89;232;384;1055;473;1287
170290;202204;3415;9090;2966;8509;223;508;2339;6921;2562;7429
170300;202204;2399;5769;1964;5137;160;404;1463;3811;1623;4215
170305;202204;746;1933;615;1710;75;207;335;943;410;1150
170307;202204;1150;3455;957;3116;104;362;608;1949;712;2311
170310;202204;1786;4234;1281;3451;158;454;686;1845;844;2299
170320;202204;1170;2944;885;2486;100;304;541;1530;641;1834
170330;202204;1043;2992;945;2852;34;140;808;2383;842;2523
170360;202204;630;1566;456;1298;23;90;313;839;336;929
170370;202204;1454;3549;1048;2895;190;519;474;1282;664;1801
170380;202204;2060;5529;1565;4775;114;374;934;2948;1048;3322
170382;202204;599;1654;494;1484;28;112;371;1075;399;1187
170384;202204;1853;5990;1534;5422;317;1085;816;2950;1133;4035
170386;202204;1085;2825;667;2026;74;259;250;707;324;966
170388;202204;809;2078;574;1683;76;237;280;796;356;1033
170389;202204;1061;3106;857;2754;99;327;551;1832;650;2159
170390;202204;2032;4239;1537;3659;37;96;1319;3165;1356;3261
170410;202204;692;1737;504;1430;32;113;353;957;385;1070
170460;202204;441;1139;360;1014;34;104;261;728;295;832
170510;202204;1020;2686;737;2209;39;167;475;1319;514;1486
170550;202204;7533;18893;5720;16113;1540;4676;1740;4907;3280;9583
170555;202204;1554;3917;1240;3445;121;271;618;1810;739;2081
170560;202204;1137;2998;875;2635;103;305;530;1676;633;1981
170600;202204;1505;3786;1186;3330;227;591;651;1924;878;2515
170610;202204;1824;4435;1370;3772;117;375;884;2364;1001;2739
170625;202204;482;1202;319;901;34;88;134;341;168;429
170650;202204;1506;4054;1236;3641;132;437;798;2320;930;2757
170700;202204;3903;10862;2997;9183;591;1833;1349;4093;1940;5926
170710;202204;1724;4094;1340;3533;162;427;884;2333;1046;2760
170720;202204;2017;4677;1542;3939;178;510;1010;2519;1188;3029
170730;202204;1224;3075;922;2618;105;257;559;1629;664;1886
170740;202204;2287;7047;1957;6469;159;581;1427;4665;1586;5246
170755;202204;972;2472;695;2019;118;369;296;834;414;1203
170765;202204;1284;3107;919;2554;180;479;462;1297;642;1776
170770;202204;2063;5520;1664;4924;150;494;1186;3465;1336;3959
170820;202204;4166;11447;3232;9849;597;1818;1623;5089;2220;6907
170825;202204;1150;2495;945;2230;75;169;734;1718;809;1887
170830;202204;1510;3741;1197;3257;319;889;532;1434;851;2323
170900;202204;3112;9019;2649;8363;187;615;2160;6890;2347;7505
170930;202204;4259;11087;3273;9320;751;2238;1086;3085;1837;5323
170950;202204;12677;33680;9060;27364;2552;8255;1301;4327;3853;12582
170980;202204;571;1373;414;1113;50;141;227;591;277;732
171050;202204;1830;5396;1584;4982;84;316;1287;4021;1371;4337
171070;202204;1489;3970;1272;3660;262;655;675;2243;937;2898
171090;202204;1139;2778;895;2434;130;358;505;1387;635;1745
171110;202204;645;1635;437;1266;75;220;200;535;275;755
171150;202204;1186;2788;745;2058;54;165;471;1286;525;1451
171180;202204;842;2172;562;1673;86;235;257;763;343;998
171190;202204;2220;6794;1923;6291;292;999;1204;4043;1496;5042
171195;202204;913;2700;725;2352;99;398;449;1385;548;1783
171200;202204;672;1793;504;1513;115;395;190;544;305;939
171215;202204;441;1104;349;957;40;121;208;551;248;672
171240;202204;862;2638;677;2317;26;161;466;1536;492;1697
171245;202204;874;2339;677;1951;60;196;432;1182;492;1378
171250;202204;1091;2820;800;2364;139;433;388;1169;527;1602
171270;202204;533;1774;410;1501;85;329;189;726;274;1055
171280;202204;987;2775;795;2456;69;221;514;1616;583;1837
171320;202204;4452;11809;3505;10219;637;1808;1554;4660;2191;6468
171330;202204;3102;8121;2421;6951;540;1593;1138;3298;1678;4891
171360;202204;1647;4343;1258;3779;118;317;840;2690;958;3007
171370;202204;812;1886;624;1624;51;133;450;1168;501;1301
171380;202204;1624;4264;1369;3929;150;378;985;2986;1135;3364
171395;202204;1129;2799;776;2195;66;210;520;1424;586;1634
171420;202204;2204;5871;1665;4899;290;910;836;2417;1126;3327
171430;202204;1197;3262;1003;2922;68;226;686;1888;754;2114
171488;202204;2741;7267;2183;6375;363;1041;1209;3569;1572;4610
171500;202204;1031;2482;745;2033;72;197;482;1292;554;1489
171510;202204;929;2759;799;2530;64;245;570;1779;634;2024
171515;202204;545;1287;400;1070;35;116;258;628;293;744
171525;202204;803;2068;602;1740;49;175;394;1075;443;1250
171550;202204;386;1039;305;920;39;162;181;502;220;664
171570;202204;1211;3389;1017;3059;127;388;622;1911;749;2299
171575;202204;1878;4805;1243;3724;137;400;589;1765;726;2165
171610;202204;6580;17545;4945;14815;1106;3611;1226;4034;2332;7645
171620;202204;3088;7770;2634;7138;127;417;2229;5981;2356;6398
171630;202204;1192;2893;927;2540;103;295;643;1787;746;2082
171650;202204;2447;6537;1915;5689;478;1523;593;1893;1071;3416
171660;202204;2602;6203;1825;4971;192;519;1149;3125;1341;3644
171665;202204;1394;3710;1108;3254;215;660;539;1617;754;2277
171670;202204;2110;5361;1578;4486;221;658;750;2124;971;2782
171700;202204;1306;3465;960;2860;114;344;556;1645;670;1989
171720;202204;864;2096;672;1814;41;118;500;1338;541;1456
171750;202204;1443;3880;985;3032;254;798;179;640;433;1438
171780;202204;1428;3371;1052;2806;90;268;737;1926;827;2194
171790;202204;1565;4757;1263;4152;194;660;650;2137;844;2797
171800;202204;818;2053;630;1787;71;224;356;970;427;1194
171820;202204;13055;34840;9783;29466;2335;7470;2778;8926;5113;16396
171830;202204;1727;5119;1473;4691;214;706;867;2848;1081;3554
171840;202204;820;2068;637;1793;31;114;389;1052;420;1166
171845;202204;733;1678;559;1415;47;156;394;944;441;1100
171850;202204;1041;3144;884;2817;66;275;651;2018;717;2293
171855;202204;1128;3252;957;2948;73;236;631;1902;704;2138
171865;202204;522;1427;450;1316;57;189;270;763;327;952
171870;202204;901;2326;632;1866;80;239;324;953;404;1192
171875;202204;1494;3960;1216;3547;37;172;949;2730;986;2902
171880;202204;1489;3919;1290;3657;40;127;1035;2952;1075;3079
171884;202204;1161;3020;883;2552;179;513;402;1193;581;1706
171886;202204;1665;4310;1219;3649;316;1042;319;1013;635;2055
171888;202204;686;1862;467;1451;26;103;282;840;308;943
171889;202204;438;1252;316;1033;68;228;118;371;186;599
171890;202204;1331;3613;978;3030;130;411;608;1859;738;2270
171900;202204;615;1972;480;1698;70;223;220;810;290;1033
172000;202204;650;1815;524;1603;84;261;254;763;338;1024
172010;202204;1260;3786;1091;3500;111;389;716;2285;827;2674
172015;202204;412;1326;315;1143;55;185;137;513;192;698
172020;202204;3150;8236;2751;7735;175;534;2067;5989;2242;6523
172025;202204;792;2064;571;1712;42;129;398;1190;440;1319
172030;202204;1378;3885;1124;3461;75;237;831;2564;906;2801
172049;202204;1404;3296;928;2635;130;350;486;1460;616;1810
172065;202204;1630;3843;1294;3414;137;265;967;2780;1104;3045
172080;202204;2655;7296;2129;6401;121;412;1431;4245;1552;4657
172085;202204;512;1316;321;914;58;169;123;325;181;494
172090;202204;4438;10279;3491;9060;148;382;2773;7228;2921;7610
172093;202204;491;1415;352;1181;25;116;204;649;229;765
172097;202204;778;1937;544;1552;78;245;234;650;312;895
172100;202204;55966;131717;41573;110034;7407;21140;17476;46402;24883;67542
172110;202204;1751;5946;1496;5570;99;439;1166;4409;1265;4848
172120;202204;5624;15554;4438;13679;495;1678;2662;8248;3157;9926
172125;202204;446;1149;339;987;29;100;201;546;230;646
172130;202204;689;1634;521;1358;20;82;363;876;383;958
172208;202204;2950;6650;2348;5890;200;428;1753;4462;1953;4890
172210;202204;2927;6949;2263;6131;267;708;1460;4154;1727;4862
210005;202204;20943;56655;15858;48590;3841;12273;7019;22343;10860;34616
210010;202204;2185;6133;1987;5903;51;225;1782;5260;1833;5485
210015;202204;3592;10157;3102;9508;175;560;2575;7930;2750;8490
210020;202204;8040;17859;6851;16478;108;321;6325;15201;6433;15522
210030;202204;4962;15655;4536;15010;496;1546;3554;12069;4050;13615
210040;202204;2335;4780;2052;4446;63;146;1793;3817;1856;3963
210043;202204;6520;17601;5501;16209;370;1139;4387;13045;4757;14184
210047;202204;7347;21179;5872;19239;180;791;5049;16579;5229;17370
210050;202204;2508;7672;2004;6784;181;749;1453;4852;1634;5601
210055;202204;2202;6321;1978;6013;52;186;1731;5290;1783;5476
210060;202204;8050;27944;7141;26348;663;2545;5051;19126;5714;21671
210070;202204;7702;19935;7138;19219;53;174;6732;18072;6785;18246
210080;202204;4768;14683;4493;14381;47;249;4168;13376;4215;13625
210083;202204;6445;16476;5402;15345;134;397;5037;14389;5171;14786
210087;202204;3145;8420;2677;7799;151;475;2165;6311;2316;6786
210090;202204;9960;29142;9294;28038;663;1610;7800;23884;8463;25494
210095;202204;7090;21867;6462;21069;422;1376;5324;18003;5746;19379
210100;202204;7240;21323;6276;19641;647;2055;4428;13969;5075;16024
210110;202204;3178;9286;2914;8961;64;304;2615;8005;2679;8309
210120;202204;28475;68307;24042;62754;1797;3729;18201;49036;19998;52765
210125;202204;4785;12319;4171;11622;607;1307;3110;9177;3717;10484
210130;202204;4612;11300;3765;10260;111;267;3280;8982;3391;9249
210135;202204;1826;4586;1509;4141;50;135;1292;3546;1342;3681
210140;202204;22333;55468;17399;49159;2814;7598;10725;31295;13539;38893
210150;202204;5164;11295;4573;10512;109;324;4042;9105;4151;9429
210160;202204;21260;53340;18158;49552;1438;3701;14133;39274;15571;42975
210170;202204;17107;48966;15772;47268;642;1983;14048;42135;14690;44118
210173;202204;2462;9000;2311;8759;104;556;2006;7546;2110;8102
210177;202204;3620;9529;3119;8893;399;984;2372;7041;2771;8025
210180;202204;1531;3886;1331;3648;24;74;1209;3307;1233;3381
210190;202204;5933;14582;4929;13241;98;358;4250;11278;4348;11636
210193;202204;1495;3982;1294;3672;49;148;986;2793;1035;2941
210197;202204;2231;6538;2021;6255;121;359;1692;5352;1813;5711
210200;202204;8623;25811;7609;24254;440;1621;6126;19510;6566;21131
210203;202204;7773;21578;6541;19972;421;1300;5273;16440;5694;17740
210207;202204;4275;9841;3339;8801;135;305;2804;7471;2939;7776
210210;202204;8246;25421;7481;24357;185;951;6425;20806;6610;21757
210215;202204;2672;8034;2309;7505;164;762;1786;5720;1950;6482
210220;202204;7196;22192;6773;21591;149;927;6106;19024;6255;19951
210230;202204;5926;16400;5365;15573;209;601;4793;13953;5002;14554
210232;202204;12825;37043;10504;33584;1624;5026;6883;23314;8507;28340
210235;202204;3676;10561;3224;9914;169;588;2697;8306;2866;8894
210237;202204;4028;10207;3384;9480;34;178;3190;8864;3224;9042
210240;202204;2786;8173;2542;7791;63;257;2098;6312;2161;6569
210250;202204;6392;17790;5770;17008;78;380;5273;15452;5351;15832
210255;202204;2864;8300;2445;7580;278;960;1590;4812;1868;5772
210260;202204;5840;16690;5123;15674;339;1139;4212;12907;4551;14046
210270;202204;5546;14081;4923;13307;81;375;4472;11955;4553;12330
210275;202204;3710;9011;3190;8380;170;429;2588;6858;2758;7287
210280;202204;6449;16572;5254;14836;201;835;4193;11518;4394;12353
210290;202204;8819;20653;7928;19573;164;412;7411;18308;7575;18720
210300;202204;35598;93008;28939;83556;4449;12161;17117;53325;21566;65486
210310;202204;3331;7994;2899;7396;63;174;2621;6668;2684;6842
210312;202204;3097;7047;2761;6686;16;79;2639;6334;2655;6413
210315;202204;3650;8848;3215;8366;114;270;2905;7664;3019;7934
210317;202204;4797;13902;4354;13385;96;451;3991;12191;4087;12642
210320;202204;25791;64709;23943;62381;329;1581;22230;57035;22559;58616
210325;202204;3936;10578;3324;9784;312;861;2648;7989;2960;8850
210330;202204;27646;70901;22261;64293;3764;8970;14370;45793;18134;54763
210340;202204;12127;30989;10866;29380;382;1252;9335;25132;9717;26384
210350;202204;9816;26508;8602;25031;164;577;7737;22505;7901;23082
210355;202204;4407;14033;3882;13221;129;574;3295;11238;3424;11812
210360;202204;13753;41565;12492;39561;581;2588;9665;29789;10246;32377
210370;202204;13160;26122;10097;22888;490;674;9014;21144;9504;21818
210375;202204;3572;9240;2681;7951;848;2611;866;2888;1714;5499
210380;202204;5975;14459;5151;13473;305;745;4346;11421;4651;12166
210390;202204;3295;9493;3058;9116;87;400;2752;8073;2839;8473
210400;202204;4917;13873;4337;13198;162;420;3866;11991;4028;12411
210405;202204;7932;19586;6479;17627;1165;2748;3822;11240;4987;13988
210407;202204;2252;6809;1882;6179;101;368;1473;4826;1574;5194
210408;202204;2891;9984;2674;9696;158;721;2154;7826;2312;8547
210409;202204;4197;13377;3783;12821;161;659;3135;10832;3296;11491
210410;202204;3910;10944;3297;9900;110;451;2695;7940;2805;8391
210420;202204;4137;12521;3677;11705;207;588;3065;9863;3272;10451
210430;202204;2402;6725;2091;6313;148;417;1696;5218;1844;5635
210440;202204;4667;11955;4039;11179;68;256;3707;10174;3775;10430
210450;202204;2510;7004;2156;6495;143;405;1751;5318;1894;5723
210455;202204;5055;12403;3895;10941;978;2706;1980;5830;2958;8536
210460;202204;3960;10931;3329;10110;88;348;2868;8676;2956;9024
210462;202204;1837;5215;1552;4786;61;179;1227;3822;1288;4001
210465;202204;2937;7995;2549;7465;127;520;2112;6042;2239;6562
210467;202204;6751;19219;5862;18085;305;1040;4956;15440;5261;16480
210470;202204;2087;5433;1552;4685;155;428;1125;3488;1280;3916
210480;202204;18527;51116;15398;47340;1695;3799;11255;37873;12950;41672
210490;202204;3775;9009;3023;8004;70;219;2590;6812;2660;7031
210500;202204;6825;24562;6277;23664;371;1742;5273;19756;5644;21498
210510;202204;6456;19974;5664;19141;116;520;5126;17545;5242;18065
210515;202204;4133;11322;3523;10597;185;610;2929;8958;3114;9568
210520;202204;2802;7730;2518;7353;98;351;2134;6174;2232;6525
210530;202204;57750;137375;45018;119080;8051;22674;16578;50890;24629;73564
210535;202204;3964;11651;3606;11137;129;492;3157;9739;3286;10231
210540;202204;16526;44901;13823;41111;1626;4397;9683;30250;11309;34647
210542;202204;7162;15993;5604;14248;517;1116;4438;11704;4955;12820
210545;202204;2427;7103;2251;6831;41;178;1989;5966;2030;6144
210547;202204;3997;13363;3524;12535;215;815;2764;10010;2979;10825
210550;202204;6310;18411;4872;16122;446;1633;3310;11256;3756;12889
210560;202204;4027;11660;3560;10928;102;391;3052;9262;3154;9653
210565;202204;1610;4737;1333;4344;81;365;1041;3386;1122;3751
210570;202204;11783;30449;10444;28814;320;910;9304;25882;9624;26792
210580;202204;3325;8212;2633;7364;208;511;1835;5461;2043;5972
210590;202204;4621;12917;3981;12120;68;339;3570;10835;3638;11174
210592;202204;2880;7928;2651;7573;26;126;2299;6475;2325;6601
210594;202204;2717;7087;2118;6175;136;379;1559;4703;1695;5082
210596;202204;3094;9879;2758;9300;279;963;2077;7184;2356;8147
210598;202204;2055;5467;1868;5211;93;265;1611;4498;1704;4763
210600;202204;3239;8473;2649;7647;255;678;1815;5296;2070;5974
210610;202204;3246;8066;2789;7521;60;253;2442;6524;2502;6777
210620;202204;3291;7604;2708;6894;139;278;2340;5995;2479;6273
210630;202204;3412;10496;3050;9873;137;572;2497;8000;2634;8572
210632;202204;5825;15214;5174;14348;193;780;4478;12163;4671;12943
210635;202204;1842;6240;1734;6042;131;426;1377;4919;1508;5345
210637;202204;2814;8649;2384;8042;170;657;1810;6213;1980;6870
210640;202204;5048;16577;4707;16175;65;335;4356;15002;4421;15337
210650;202204;7717;20986;6935;19990;120;410;6203;17916;6323;18326
210660;202204;8818;24326;7886;22847;238;1002;6759;19099;6997;20101
210663;202204;3238;7910;2882;7477;252;446;2202;6129;2454;6575
210667;202204;2169;6574;1933;6228;46;156;1681;5538;1727;5694
210670;202204;5383;16156;4849;15342;111;506;4320;13574;4431;14080
210675;202204;5812;14303;4991;13298;411;898;4003;11050;4414;11948
210680;202204;5202;11542;4390;10600;123;197;4023;9795;4146;9992
210690;202204;8549;23768;7121;22166;289;1003;6337;19794;6626;20797
210700;202204;3009;7968;2402;7096;166;460;1785;5413;1951;5873
210710;202204;5580;15881;4917;15002;106;501;4409;13318;4515;13819
210720;202204;3367;10088;2942;9570;82;414;2619;8455;2701;8869
210725;202204;1431;4400;1244;4119;57;207;879;3029;936;3236
210730;202204;1549;3394;1321;3093;58;127;1137;2662;1195;2789
210735;202204;5079;13759;4311;12799;224;561;3667;11242;3891;11803
210740;202204;5634;13836;4810;12899;109;286;4115;11010;4224;11296
210745;202204;4779;12273;4368;11765;64;235;3970;10621;4034;10856
210750;202204;26186;65456;22717;61089;2685;6471;15637;44178;18322;50649
210760;202204;6429;15551;5364;14426;110;212;5026;13720;5136;13932
210770;202204;6832;16140;5855;15033;65;262;5475;13947;5540;14209
210780;202204;8135;24018;7067;22266;505;1610;5587;17716;6092;19326
210790;202204;4890;14013;4364;13326;267;613;3634;11478;3901;12091
210800;202204;5261;13424;4496;12407;80;323;4038;11019;4118;11342
210805;202204;4430;14839;4138;14415;185;736;3574;12497;3759;13233
210810;202204;5264;14460;4774;13832;440;1039;3815;11500;4255;12539
210820;202204;7694;20917;6427;18926;767;2213;4070;12329;4837;14542
210825;202204;8119;22176;7310;21136;363;983;6360;18629;6723;19612
210830;202204;9054;23194;8176;22133;556;1177;6919;19331;7475;20508
210840;202204;3536;8730;3205;8305;38;176;2917;7431;2955;7607
210845;202204;6892;17533;6084;16648;46;162;5820;15975;5866;16137
210850;202204;6857;20619;5642;18838;345;1257;4467;15053;4812;16310
210860;202204;23062;54281;19093;49511;1126;2399;15496;41865;16622;44264
210870;202204;8215;19398;6573;17551;146;391;5932;15823;6078;16214
210880;202204;4532;13089;4053;12486;220;763;3209;9920;3429;10683
210890;202204;4653;11917;4230;11438;319;739;3534;9685;3853;10424
210900;202204;5259;14295;4121;12308;1549;4752;855;2969;2404;7721
210905;202204;2409;5648;2051;5205;55;87;1897;4885;1952;4972
210910;202204;7732;22673;6390;20567;738;2408;4347;14140;5085;16548
210920;202204;3413;10458;2975;9884;81;402;2668;8777;2749;9179
210923;202204;1805;4831;1541;4435;91;270;1195;3410;1286;3680
210927;202204;5223;16318;4534;15468;537;1749;3203;11457;3740;13206
210930;202204;2709;8421;2366;7785;123;470;1919;6233;2042;6703
210940;202204;4178;11373;3837;10978;106;508;3497;9792;3603;10300
210945;202204;8086;20697;7216;19692;350;823;6037;16986;6387;17809
210950;202204;5891;15089;4560;13269;541;1212;3200;9965;3741;11177
210955;202204;1665;4843;1412;4451;330;971;763;2542;1093;3513
210960;202204;10179;28252;8788;26190;2037;5712;4879;15654;6916;21366
210970;202204;1747;4461;1434;3937;107;311;1155;3075;1262;3386
210975;202204;1978;5609;1785;5319;159;469;1359;4075;1518;4544
210980;202204;10986;23676;9614;22251;105;239;9107;21122;9212;21361
210990;202204;18737;48610;14493;43219;1294;3292;10576;33104;11870;36396
211000;202204;15962;42927;13184;39511;1204;3381;10058;31398;11262;34779
211003;202204;6367;17171;5305;15915;134;494;4625;14109;4759;14603
211010;202204;6990;22640;6264;21746;102;456;5667;19909;5769;20365
211020;202204;9316;24541;8110;23206;235;800;7049;20664;7284;21464
211023;202204;2234;6772;2064;6555;104;367;1744;5512;1848;5879
211027;202204;4027;10560;3830;10268;137;441;3485;9235;3622;9676
211030;202204;4103;10862;3653;10302;322;788;2796;8121;3118;8909
211040;202204;4958;16688;4557;16013;117;625;4078;14254;4195;14879
211050;202204;10052;24078;9094;22873;142;455;8297;20800;8439;21255
211060;202204;7543;21350;6829;20400;165;712;6072;17987;6237;18699
211065;202204;2624;6420;2202;5900;88;222;1904;5149;1992;5371
211070;202204;8923;25537;7645;23696;353;1241;6448;19993;6801;21234
211080;202204;1427;3702;1146;3266;37;194;901;2418;938;2612
211085;202204;2366;6143;1984;5654;164;321;1606;4830;1770;5151
211090;202204;3407;8950;3079;8579;34;154;2848;7899;2882;8053
211100;202204;7905;17730;7374;17109;38;129;6979;16153;7017;16282
211102;202204;3610;10965;3267;10463;272;935;2636;8460;2908;9395
211105;202204;2570;7604;2155;6884;125;434;1636;5147;1761;5581
211107;202204;5239;15552;4464;14432;178;615;3554;11996;3732;12611
211110;202204;6822;17000;5419;14952;303;853;4273;11694;4576;12547
211120;202204;51021;118066;42007;107582;6682;15413;27123;73202;33805;88615
211125;202204;2162;6208;1816;5684;47;213;1547;4821;1594;5034
211130;202204;201100;457233;173499;421925;25479;54040;104582;271616;130061;325656
211140;202204;5315;14900;4622;14019;215;662;3903;11930;4118;12592
211150;202204;10338;26058;8674;23979;372;961;7292;20340;7664;21301
211153;202204;3084;7969;2192;6865;361;1080;1380;4581;1741;5661
211157;202204;1336;3878;1129;3494;82;258;816;2524;898;2782
211160;202204;5324;12983;4281;11550;134;515;3487;9052;3621;9567
211163;202204;1690;5189;1522;4951;46;173;1333;4361;1379;4534
211167;202204;1798;5033;1669;4851;30;100;1547;4480;1577;4580
211170;202204;7411;16490;6858;15857;49;137;6549;15037;6598;15174
211172;202204;2806;7346;2386;6727;94;340;1932;5260;2026;5600
211174;202204;3040;8294;2738;7955;32;172;2587;7467;2619;7639
211176;202204;4654;12413;3640;10945;204;712;2928;8759;3132;9471
211178;202204;5754;11687;4966;10855;27;105;4808;10419;4835;10524
211180;202204;4540;13988;4176;13478;175;701;3512;11268;3687;11969
211190;202204;3546;9331;3001;8548;34;181;2733;7696;2767;7877
211195;202204;1686;4200;1458;3868;68;177;1266;3346;1334;3523
211200;202204;2368;6501;1872;5761;191;583;1306;4009;1497;4592
211210;202204;6557;19203;5873;18271;344;1237;4873;15110;5217;16347
211220;202204;43397;101572;35910;92549;3197;7723;27169;71296;30366;79019
211223;202204;5840;14631;4798;13266;593;1596;3238;9098;3831;10694
211227;202204;1873;5699;1624;5347;82;336;1301;4308;1383;4644
211230;202204;9054;23628;7692;21687;368;803;6447;18460;6815;19263
211240;202204;8421;25426;7887;24733;232;871;7187;22494;7419;23365
211245;202204;7997;19841;6945;18735;135;351;6562;17728;6697;18079
211250;202204;15891;44132;14415;41998;1150;3444;11436;33305;12586;36749
211260;202204;8698;26403;7659;25096;191;868;6867;22606;7058;23474
211270;202204;11069;32998;9427;30856;390;1627;7712;25453;8102;27080
211280;202204;15525;36687;14029;34820;596;1332;12509;31250;13105;32582
211285;202204;2108;6264;1883;5970;137;474;1446;4633;1583;5107
211290;202204;7862;22520;7043;21423;302;1033;5878;17869;6180;18902
211300;202204;8046;22505;7038;20865;420;1361;5506;16084;5926;17445
211400;202204;12965;33847;10597;30644;1314;3613;7092;21620;8406;25233
220005;202204;2127;5051;1919;4766;33;103;1640;3983;1673;4086
220010;202204;1603;4358;1306;3844;39;130;1000;2908;1039;3038
220020;202204;4647;10956;4018;10124;129;400;3458;8554;3587;8954
220025;202204;2502;5245;2159;4750;56;109;1798;3846;1854;3955
220027;202204;1510;3428;1300;3149;29;97;1143;2709;1172;2806
220030;202204;3966;9120;3702;8785;122;304;3234;7593;3356;7897
220040;202204;8403;23907;7298;21875;1416;3915;4125;12899;5541;16814
220045;202204;1771;4778;1477;4317;27;140;1273;3615;1300;3755
220050;202204;5396;13174;4625;12211;63;260;4302;11218;4365;11478
220060;202204;3091;5571;2672;5093;24;48;2549;4820;2573;4868
220070;202204;2636;6332;2213;5732;71;164;1861;4783;1932;4947
220080;202204;824;2212;708;2050;20;79;609;1738;629;1817
220090;202204;1949;4394;1589;3867;84;120;1263;3193;1347;3313
220095;202204;996;1944;947;1895;37;69;860;1719;897;1788
220100;202204;1607;3995;1290;3522;33;127;1066;2788;1099;2915
220105;202204;2311;6543;2023;6049;135;432;1530;4537;1665;4969
220110;202204;3858;9891;3430;9195;36;169;3089;8157;3125;8326
220115;202204;3002;8092;2769;7796;82;240;2507;7036;2589;7276
220117;202204;1546;3467;1219;3029;7;28;1022;2465;1029;2493
220120;202204;16326;37141;15024;35555;73;303;14238;33383;14311;33686
220130;202204;1285;3138;1081;2866;15;71;978;2531;993;2602
220140;202204;2438;4707;2075;4297;55;136;1897;3873;1952;4009
220150;202204;7236;19427;6578;18326;166;599;5581;15220;5747;15819
220155;202204;1321;3537;1062;3075;25;80;774;2189;799;2269
220157;202204;1198;2685;1011;2413;27;73;822;1903;849;1976
220160;202204;3137;8080;2687;7291;54;190;2175;5749;2229;5939
220170;202204;1749;4367;1486;3983;27;109;1300;3441;1327;3550
220173;202204;2390;6233;1912;5406;54;205;1506;4150;1560;4355
220177;202204;2360;5903;2244;5774;7;26;2217;5697;2224;5723
220180;202204;1276;2807;1045;2441;6;30;853;1854;859;1884
220190;202204;8713;18913;7489;17321;477;972;5954;14022;6431;14994
220191;202204;1768;4902;1606;4637;109;358;1167;3286;1276;3644
220192;202204;2276;5621;1645;4527;35;122;1350;3628;1385;3750
220194;202204;1984;5114;1739;4741;64;233;1427;3760;1491;3993
220196;202204;2379;5653;2161;5339;24;112;1912;4621;1936;4733
220198;202204;1485;3513;1259;3237;10;22;1163;3001;1173;3023
220200;202204;5587;15408;4874;14483;81;358;4219;12497;4300;12855
220202;202204;2383;6183;2028;5625;39;157;1729;4693;1768;4850
220205;202204;2808;7431;2493;6880;69;260;2109;5683;2178;5943
220207;202204;843;2402;706;2171;63;198;466;1444;529;1642
220208;202204;1926;5503;1562;4835;177;552;966;2990;1143;3542
220209;202204;1738;4711;1487;4269;30;110;1209;3429;1239;3539
220210;202204;2097;4521;1833;4133;19;69;1632;3566;1651;3635
220211;202204;1982;4220;1821;4014;21;75;1617;3503;1638;3578
220213;202204;2032;4994;1720;4468;34;115;1379;3414;1413;3529
220217;202204;2619;6745;2449;6551;108;172;2208;6092;2316;6264
220220;202204;13086;29827;11184;27075;702;1482;8573;20882;9275;22364
220225;202204;1091;2660;873;2387;4;23;813;2205;817;2228
220230;202204;6308;14678;5401;13441;134;322;4754;11829;4888;12151
220240;202204;3454;9286;2909;8361;93;363;2371;6666;2464;7029
220245;202204;2131;4220;1605;3604;12;47;1478;3297;1490;3344
220250;202204;3374;8594;2956;8077;18;86;2772;7520;2790;7606
220253;202204;1826;4576;1557;4160;35;120;1334;3479;1369;3599
220255;202204;2216;4745;1896;4305;38;141;1648;3591;1686;3732
220260;202204;5465;14498;4758;13259;220;635;3823;10590;4043;11225
220265;202204;1591;4505;1449;4327;76;301;1210;3544;1286;3845
220270;202204;6478;20056;6070;19334;186;974;5111;15726;5297;16700
220271;202204;1628;3954;1422;3669;27;106;1231;3138;1258;3244
220272;202204;1910;5226;1684;4811;56;203;1277;3498;1333;3701
220273;202204;1426;3758;1195;3350;55;188;911;2521;966;2709
220275;202204;2795;5722;2264;5016;32;63;2072;4536;2104;4599
220277;202204;2588;5777;2199;5247;63;143;1852;4328;1915;4471
220280;202204;2060;4140;1729;3731;36;69;1527;3235;1563;3304
220285;202204;1680;3773;1441;3491;12;50;1362;3258;1374;3308
220290;202204;7734;19821;6181;17705;478;1291;4480;13276;4958;14567
220300;202204;2220;5948;1756;5357;34;176;1450;4367;1484;4543
220310;202204;3489;8640;2744;7777;46;191;2373;6667;2419;6858
220320;202204;3423;9218;2657;7872;81;371;2092;5979;2173;6350
220323;202204;1834;4909;1414;4248;49;194;1168;3422;1217;3616
220325;202204;1347;3838;1140;3475;31;140;924;2762;955;2902
220327;202204;1786;4570;1573;4242;50;186;1309;3431;1359;3617
220330;202204;5603;11656;4841;10767;43;137;4490;9875;4533;10012
220335;202204;1990;5298;1807;5052;59;148;1608;4489;1667;4637
220340;202204;2048;5165;1569;4369;68;209;1030;2769;1098;2978
220342;202204;1325;3593;1192;3401;69;178;940;2685;1009;2863
220345;202204;3380;7219;2568;6107;24;72;2276;5359;2300;5431
220350;202204;3716;8870;2983;7803;200;453;2124;5579;2324;6032
220360;202204;1408;3399;1083;2883;22;68;862;2240;884;2308
220370;202204;9625;25678;8730;24309;266;861;7484;20642;7750;21503
220375;202204;1848;4705;1630;4437;6;10;1565;4282;1571;4292
220380;202204;1762;3673;1435;3221;18;48;1284;2848;1302;2896
220385;202204;1014;2170;826;1856;7;13;739;1634;746;1647
220390;202204;12674;29576;10043;25774;1933;4848;4890;13015;6823;17863
220400;202204;1676;3734;1285;3143;19;65;992;2314;1011;2379
220410;202204;1328;3404;1089;3010;29;85;906;2471;935;2556
220415;202204;921;2225;761;1958;20;45;608;1531;628;1576
220420;202204;2142;5748;1720;4950;75;252;1272;3582;1347;3834
220430;202204;3186;7182;2861;6744;56;147;2567;5937;2623;6084
220435;202204;2174;4955;1883;4517;35;113;1624;3792;1659;3905
220440;202204;3464;8499;2960;7764;64;310;2626;6554;2690;6864
220450;202204;2947;6975;2438;6351;43;163;2166;5591;2209;5754
220455;202204;1461;4046;1400;3966;9;48;1279;3620;1288;3668
220460;202204;1210;2648;1125;2542;40;76;976;2175;1016;2251
220465;202204;2582;7457;2262;6977;154;475;1774;5551;1928;6026
220470;202204;4164;10504;3705;9774;160;389;2942;7638;3102;8027
220480;202204;3057;7416;2444;6478;229;451;1634;4377;1863;4828
220490;202204;2764;6403;2365;5915;27;121;2076;5088;2103;5209
220500;202204;3600;8147;3040;7314;111;212;2354;5571;2465;5783
220510;202204;2994;7543;2425;6562;122;274;1941;5299;2063;5573
220515;202204;1967;4265;1814;4056;56;76;1579;3504;1635;3580
220520;202204;5721;13620;5139;12812;106;267;4337;10957;4443;11224
220525;202204;1611;3622;1361;3321;11;39;1257;3053;1268;3092
220527;202204;1692;3915;1449;3569;41;84;1287;3189;1328;3273
220530;202204;1866;3968;1583;3616;170;348;1188;2863;1358;3211
220535;202204;931;2354;864;2253;41;120;693;1763;734;1883
220540;202204;3569;10568;3304;10064;196;586;2691;8214;2887;8800
220545;202204;1639;4486;1497;4274;61;251;1265;3536;1326;3787
220550;202204;9635;28212;8559;26283;450;1567;6531;19672;6981;21239
220551;202204;1636;4142;1436;3819;22;96;1211;3137;1233;3233
220552;202204;1845;4986;1491;4365;22;120;1212;3425;1234;3545
220553;202204;2284;4830;1925;4367;27;55;1736;3928;1763;3983
220554;202204;1074;2472;828;2101;76;149;575;1458;651;1607
220555;202204;3594;7669;3207;7193;35;126;2846;6350;2881;6476
220556;202204;1393;3720;1221;3413;40;174;921;2458;961;2632
220557;202204;1892;5355;1559;4659;115;387;1101;3197;1216;3584
220558;202204;1586;3859;1257;3398;26;113;1055;2762;1081;2875
220559;202204;2038;4611;1733;4145;50;89;1427;3404;1477;3493
220560;202204;2022;4137;1663;3704;32;60;1526;3382;1558;3442
220570;202204;8642;23412;7771;22144;465;1285;6270;17819;6735;19104
220580;202204;7551;19219;6835;18129;95;295;6159;16236;6254;16531
220585;202204;2283;6692;1879;5974;49;168;1528;4862;1577;5030
220590;202204;1628;3946;1339;3535;97;219;1017;2703;1114;2922
220595;202204;3051;7467;2747;7079;54;152;2430;6193;2484;6345
220600;202204;1922;3540;1673;3257;30;54;1541;2973;1571;3027
220605;202204;1690;4683;1450;4258;29;139;1177;3330;1206;3469
220610;202204;3016;8173;2814;7882;20;107;2638;7332;2658;7439
220620;202204;9078;25046;8308;24016;140;697;7640;21807;7780;22504
220630;202204;410;1140;322;988;26;79;208;618;234;697
220635;202204;2020;5574;1798;5135;55;218;1447;4012;1502;4230
220640;202204;2616;6889;2233;6358;77;280;1823;5142;1900;5422
220650;202204;2615;6235;2260;5715;147;265;1724;4477;1871;4742
220660;202204;2854;8383;2405;7636;80;359;1992;6225;2072;6584
220665;202204;1407;3909;1196;3574;31;150;1009;2928;1040;3078
220667;202204;1820;5126;1645;4821;67;248;1344;3863;1411;4111
220669;202204;1793;4998;1710;4877;42;170;1536;4289;1578;4459
220670;202204;2519;5831;2005;5110;36;105;1747;4442;1783;4547
220672;202204;3701;8449;3042;7659;95;328;2714;6701;2809;7029
220675;202204;1468;3737;1307;3460;67;177;1013;2669;1080;2846
220680;202204;3332;7722;3176;7525;196;305;2837;6885;3033;7190
220690;202204;1772;4342;1539;3988;117;300;1157;2986;1274;3286
220695;202204;1054;2683;974;2548;21;54;833;2164;854;2218
220700;202204;12967;27229;10654;24225;557;1166;8378;18670;8935;19836
220710;202204;998;2507;727;2032;22;70;558;1509;580;1579
220720;202204;2548;5344;2289;5014;19;61;2057;4413;2076;4474
220730;202204;1443;3774;1233;3452;19;91;1056;2879;1075;2970
220735;202204;1141;2416;878;2024;26;68;708;1587;734;1655
220740;202204;1523;3664;1219;3260;45;114;1004;2726;1049;2840
220750;202204;4694;10411;4137;9661;182;375;3714;8669;3896;9044
220755;202204;1671;3569;1400;3183;18;59;1190;2631;1208;2690
220760;202204;3925;8895;3471;8305;57;175;3257;7761;3314;7936
220770;202204;28311;76930;24300;70445;6322;18670;10465;31498;16787;50168
220775;202204;1497;3272;1350;3093;6;26;1310;2968;1316;2994
220777;202204;1762;4225;1368;3629;59;115;1002;2742;1061;2857
220779;202204;1364;3412;1180;3135;25;89;1018;2660;1043;2749
220780;202204;6491;14860;5781;13862;287;757;4659;11003;4946;11760
220785;202204;1648;3356;1450;3111;10;30;1377;2922;1387;2952
220790;202204;11458;29811;10270;28148;224;938;8778;23717;9002;24655
220793;202204;1097;2561;883;2209;12;24;750;1868;762;1892
220795;202204;1534;3686;1338;3412;21;79;1190;3012;1211;3091
220800;202204;23359;45901;20203;41855;1123;2052;16089;32856;17212;34908
220810;202204;3327;8693;2801;7818;69;174;2315;6431;2384;6605
220820;202204;6370;14267;5613;13204;239;507;4706;10938;4945;11445
220830;202204;8105;19826;7211;18584;310;881;5932;15040;6242;15921
220840;202204;14052;38828;11844;34719;2272;6125;6564;19594;8836;25719
220850;202204;3422;9817;3052;9356;66;301;2742;8414;2808;8715
220855;202204;924;1916;817;1783;17;55;747;1606;764;1661
220860;202204;1211;2687;1062;2473;18;68;987;2259;1005;2327
220865;202204;2573;6545;1997;5555;55;233;1520;4076;1575;4309
220870;202204;3661;8736;3058;7971;32;137;2817;7281;2849;7418
220880;202204;6944;13708;6083;12656;121;289;5610;11583;5731;11872
220885;202204;1631;4313;1360;3898;80;238;1068;3069;1148;3307
220887;202204;1761;3494;1470;3121;24;43;1360;2879;1384;2922
220890;202204;1558;4385;1359;4105;60;188;1113;3374;1173;3562
220900;202204;2433;5050;2048;4548;30;67;1827;3983;1857;4050
220910;202204;1920;4473;1646;4073;191;308;1253;3280;1444;3588
220915;202204;1049;2670;841;2310;14;51;627;1632;641;1683
220920;202204;1679;4716;1450;4423;76;280;1214;3705;1290;3985
220930;202204;2190;5003;1849;4549;18;75;1703;4184;1721;4259
220935;202204;1203;3274;961;2770;20;81;631;1715;651;1796
220937;202204;1667;4085;1415;3686;41;123;1123;2875;1164;2998
220940;202204;2000;4650;1652;4077;32;128;1374;3242;1406;3370
220945;202204;555;1730;440;1524;21;120;306;1028;327;1148
220950;202204;1554;3395;1051;2645;16;44;839;2016;855;2060
220955;202204;1753;4200;1452;3703;19;60;1244;3133;1263;3193
220960;202204;847;2088;625;1717;39;117;412;1068;451;1185
220965;202204;1968;4958;1713;4599;29;126;1479;3879;1508;4005
220970;202204;2407;4955;1829;4132;19;49;1615;3553;1634;3602
220975;202204;822;2013;703;1868;11;60;630;1615;641;1675
220980;202204;1340;3415;1193;3222;27;92;1022;2727;1049;2819
220985;202204;1584;3594;1380;3291;73;156;1097;2591;1170;2747
220987;202204;1658;4494;1463;4169;56;212;1221;3412;1277;3624
220990;202204;1845;4816;1611;4466;22;102;1356;3705;1378;3807
220995;202204;1450;3637;1197;3208;18;56;973;2565;991;2621
220997;202204;2641;7387;2421;7040;56;220;2152;6165;2208;6385
221000;202204;5085;12756;4459;11880;129;475;3829;10065;3958;10540
221005;202204;1707;4082;1545;3811;24;116;1333;3158;1357;3274
221010;202204;1463;2913;1151;2527;39;60;999;2178;1038;2238
221020;202204;1716;4929;1551;4656;23;91;1214;3615;1237;3706
221030;202204;1850;4101;1583;3782;28;83;1392;3354;1420;3437
221035;202204;1762;4104;1516;3768;25;40;1356;3408;1381;3448
221037;202204;806;2008;681;1799;18;46;505;1265;523;1311
221038;202204;582;1529;450;1305;24;78;314;895;338;973
221039;202204;942;2451;778;2184;26;113;624;1698;650;1811
221040;202204;4868;13066;4230;11995;204;571;3431;9720;3635;10291
221050;202204;4930;10735;4416;10091;98;253;3993;9125;4091;9378
221060;202204;10408;26499;8636;23642;427;1040;6879;18835;7306;19875
221062;202204;1323;3826;1137;3540;65;206;909;2802;974;3008
221063;202204;1294;3217;1125;2980;66;198;907;2349;973;2547
221065;202204;3038;7102;2649;6462;18;60;2356;5656;2374;5716
221070;202204;3726;10761;3027;9338;393;1134;1850;5845;2243;6979
221080;202204;3908;8981;3223;7976;56;195;2701;6512;2757;6707
221090;202204;1584;3686;1314;3281;15;55;1133;2766;1148;2821
221093;202204;1785;4328;1635;4069;156;318;1176;2905;1332;3223
221095;202204;1004;2429;828;2176;20;69;690;1787;710;1856
221097;202204;938;2256;707;1870;17;48;533;1330;550;1378
221100;202204;142150;347369;119984;312122;9160;26942;85398;213331;94558;240273
221110;202204;11225;30631;10267;29405;157;714;9287;26328;9444;27042
221120;202204;5322;14223;4739;13360;135;418;4148;11688;4283;12106
221130;202204;6433;14911;5022;12405;756;1762;3080;7381;3836;9143
221135;202204;2246;4858;1972;4512;66;135;1690;3972;1756;4107
221140;202204;1644;3355;1386;3039;29;64;1259;2716;1288;2780
221150;202204;1238;2892;971;2447;25;120;767;1805;792;1925
221160;202204;819;1927;721;1801;38;61;564;1428;602;1489
221170;202204;1133;2949;1043;2792;8;31;930;2432;938;2463
230010;202204;3435;8399;2834;7397;41;152;2354;5938;2395;6090
230015;202204;3684;10724;3246;9886;178;616;2309;6962;2487;7578
230020;202204;15314;43749;14358;42361;564;1923;12400;36408;12964;38331
230030;202204;13900;32794;11652;29885;346;939;9979;25535;10325;26474
230040;202204;4934;11830;4110;10523;51;219;3503;8795;3554;9014
230050;202204;2915;8605;2263;7174;296;985;1093;3218;1389;4203
230060;202204;2746;6887;2162;5904;38;160;1730;4595;1768;4755
230070;202204;4933;11545;3948;9850;570;1191;2465;6329;3035;7520
230075;202204;10355;30184;9447;28663;538;1894;7605;22740;8143;24634
230080;202204;3516;6727;2703;5739;11;23;2516;5317;2527;5340
230090;202204;5059;11345;4267;10144;164;398;3528;8219;3692;8617
230100;202204;22929;52657;20090;49006;1546;3822;14773;35764;16319;39586
230110;202204;14437;40375;12126;36018;1753;5342;6785;19981;8538;25323
230120;202204;9051;22065;7931;20357;470;1248;6113;15508;6583;16756
230125;202204;3557;8715;2890;7702;86;304;2307;5933;2393;6237
230130;202204;6480;18229;5314;15821;425;1230;3617;10655;4042;11885
230140;202204;3890;10823;3291;9654;98;429;2574;7285;2672;7714
230150;202204;1815;5005;1496;4357;178;494;937;2734;1115;3228
230160;202204;7839;17502;6794;16001;158;404;5848;13504;6006;13908
230170;202204;7070;18929;5760;16340;425;1159;4039;11316;4464;12475
230180;202204;1843;4724;1553;4192;19;81;1267;3284;1286;3365
230185;202204;5021;12997;4257;11774;333;946;3126;8719;3459;9665
230190;202204;16040;44344;13444;39645;1498;4550;8152;23672;9650;28222
230195;202204;6213;16766;5641;15792;354;966;4345;12115;4699;13081
230200;202204;5354;14062;4443;12433;226;661;3350;9194;3576;9855
230205;202204;4808;12663;4201;11822;247;761;3334;9220;3581;9981
230210;202204;12144;26019;10348;23702;468;1097;8337;18663;8805;19760
230220;202204;16689;38287;14675;35485;775;1865;12082;28842;12857;30707
230230;202204;7954;21314;7157;19803;436;1204;5541;15128;5977;16332
230240;202204;14939;36431;12823;32936;482;1366;10426;26267;10908;27633
230250;202204;9833;25691;9076;24574;272;889;7320;19155;7592;20044
230260;202204;16855;45390;14609;41653;2261;6196;8525;24642;10786;30838
230270;202204;8505;21080;6574;17646;797;1902;3977;11062;4774;12964
230280;202204;22278;55176;18354;48858;450;1885;14761;37483;15211;39368
230290;202204;5523;14168;4593;12491;178;506;3655;9740;3833;10246
230300;202204;5329;13254;4777;12516;88;268;4236;11054;4324;11322
230310;202204;5221;13967;4406;12531;181;622;3144;8724;3325;9346
230320;202204;8700;23507;7254;20995;257;1029;5659;15960;5916;16989
230330;202204;5326;13554;4181;11451;137;481;3178;8433;3315;8914
230340;202204;4277;12356;3700;11239;208;746;2698;7940;2906;8686
230350;202204;20778;51740;18188;48100;875;2762;13297;34517;14172;37279
230360;202204;3349;8220;2634;7013;154;380;1910;5026;2064;5406
230365;202204;3488;7802;2882;6931;86;267;2467;5874;2553;6141
230370;202204;73872;181653;63903;167855;5196;15157;46761;119706;51957;134863
230380;202204;7024;18172;5533;15483;133;535;4195;11297;4328;11832
230390;202204;3721;10221;3188;9393;89;386;2517;7270;2606;7656
230393;202204;3783;10153;3012;8641;96;505;2372;6477;2468;6982
230395;202204;6335;16450;5458;15001;498;1335;3688;10085;4186;11420
230400;202204;6185;15689;5424;14513;87;434;4397;11298;4484;11732
230410;202204;14414;40970;11886;36508;874;2912;8294;25494;9168;28406
230420;202204;33063;84413;27280;74963;2756;7970;16920;45345;19676;53315
230423;202204;5196;14431;4542;13209;305;939;3334;9561;3639;10500
230425;202204;6438;18412;5896;17404;538;1590;4241;12424;4779;14014
230426;202204;3060;7543;2254;6064;46;176;1706;4443;1752;4619
230427;202204;2052;5430;1478;4287;134;396;813;2196;947;2592
230428;202204;11170;28032;9610;25807;1444;3803;5677;15051;7121;18854
230430;202204;5490;14525;4361;12592;159;580;3310;9332;3469;9912
230435;202204;7071;16798;5861;14767;781;1826;3542;8924;4323;10750
230440;202204;506393;1139557;430566;1034308;29691;79179;314246;731474;343937;810653
230445;202204;4607;11824;3728;10328;248;684;2511;6744;2759;7428
230450;202204;4109;10858;3583;10116;214;831;2712;7348;2926;8179
230460;202204;2353;6085;2031;5578;57;227;1700;4587;1757;4814
230465;202204;4729;12157;3977;10764;136;445;3064;7947;3200;8392
230470;202204;12429;38164;11169;35929;799;3101;8157;25656;8956;28757
230480;202204;1664;4414;1392;3941;64;280;1064;2835;1128;3115
230490;202204;3076;7914;2602;7052;204;635;1726;4348;1930;4983
230495;202204;6650;17644;5855;16308;749;2028;3630;10147;4379;12175
230500;202204;10034;30520;8857;28428;320;1274;7165;22986;7485;24260
230510;202204;1910;5018;1505;4218;152;436;895;2418;1047;2854
230520;202204;5326;13551;4611;12367;429;991;3271;8747;3700;9738
230523;202204;17576;49054;14078;42020;3102;9083;4190;12901;7292;21984
230526;202204;4368;11147;3714;10097;271;625;2685;7468;2956;8093
230530;202204;6146;18074;5129;16196;822;2622;3231;10224;4053;12846
230533;202204;5316;11103;4233;9494;81;226;3583;7754;3664;7980
230535;202204;5638;15112;4769;13683;350;1102;3211;9184;3561;10286
230540;202204;17063;44632;14579;40962;338;1226;12049;33548;12387;34774
230550;202204;24552;59554;19997;52246;1539;4189;13878;35245;15417;39434
230560;202204;8860;20119;7208;17639;140;352;6148;15059;6288;15411
230565;202204;3441;8888;2870;7871;104;378;2266;6060;2370;6438
230570;202204;3717;8994;3158;8231;82;252;2613;6735;2695;6987
230580;202204;13382;30751;11537;28197;603;1210;9476;23249;10079;24459
230590;202204;10377;27366;8633;24355;532;1601;6427;17689;6959;19290
230600;202204;4209;9855;3275;8292;141;302;2259;5769;2400;6071
230610;202204;7507;19093;6657;17693;445;1218;5297;13994;5742;15212
230620;202204;2313;5875;1799;4919;101;317;1158;3010;1259;3327
230625;202204;9985;25669;8532;23180;1941;5418;3789;10139;5730;15557
230630;202204;13253;34171;11679;31357;1245;3048;7952;21444;9197;24492
230640;202204;30062;86187;27205;81652;1209;4795;22206;65257;23415;70052
230650;202204;5891;14763;4980;13272;134;568;4129;10603;4263;11171
230655;202204;10399;32298;9774;31287;640;2126;8071;25923;8711;28049
230660;202204;6612;18555;5355;16353;178;860;4311;12850;4489;13710
230670;202204;6846;15190;4989;12333;156;430;3982;9542;4138;9972
230680;202204;3093;7775;2588;6929;164;368;1821;4889;1985;5257
230690;202204;7743;21646;6595;19496;397;1369;4388;12712;4785;14081
230700;202204;11834;27491;9505;23384;520;1246;7160;17225;7680;18471
230710;202204;7531;22474;6612;20597;592;1846;4573;14112;5165;15958
230720;202204;2150;5935;1777;5262;124;350;1237;3602;1361;3952
230725;202204;5005;13503;4505;12678;378;1222;3089;8431;3467;9653
230730;202204;66281;164661;52347;144742;11756;32213;19407;57523;31163;89736
230740;202204;6773;17775;5717;16102;182;550;4569;12847;4751;13397
230750;202204;9299;23398;7696;20796;169;608;6191;16249;6360;16857
230760;202204;12794;31223;11092;28710;458;1484;8528;21368;8986;22852
230763;202204;5501;13891;4543;12282;104;459;3671;9572;3775;10031
230765;202204;47108;118816;39574;107314;4707;13635;23836;62546;28543;76181
230770;202204;31854;67852;27150;61932;2039;4653;20504;45919;22543;50572
230780;202204;7187;23486;6511;21952;835;2788;3956;13550;4791;16338
230790;202204;3416;8998;3050;8443;118;445;2376;6307;2494;6752
230800;202204;9543;27730;8379;25512;1087;3332;5001;14934;6088;18266
230810;202204;11927;34281;10627;32198;462;1669;8303;24678;8765;26347
230820;202204;3937;11867;3266;10489;284;1084;2070;6300;2354;7384
230830;202204;8585;21552;7301;19512;181;631;6049;15661;6230;16292
230835;202204;4616;10378;3596;8840;127;312;2891;6997;3018;7309
230837;202204;3773;9994;3376;9346;103;388;2827;7597;2930;7985
230840;202204;10707;29090;9234;26632;753;2152;6886;19688;7639;21840
230850;202204;11241;29365;9485;26166;472;1386;7145;19386;7617;20772
230860;202204;6678;14324;5597;12828;68;188;5019;11287;5087;11475
230870;202204;19359;42231;16712;37994;795;1652;13540;30396;14335;32048
230880;202204;2268;6464;2079;6168;61;279;1641;4715;1702;4994
230890;202204;4949;14739;4478;13895;271;951;3336;10142;3607;11093
230900;202204;3595;9475;3086;8542;152;519;2238;5916;2390;6435
230910;202204;3654;8886;2869;7727;66;259;2345;6264;2411;6523
230920;202204;5366;13881;4385;12293;110;429;3425;9293;3535;9722
230930;202204;7708;20081;6360;17736;311;902;4454;12197;4765;13099
230940;202204;9291;21446;8077;19676;165;425;6922;16666;7087;17091
230945;202204;7244;19408;6166;17477;308;1018;4467;12267;4775;13285
230950;202204;6942;16228;6133;15142;130;324;5297;13063;5427;13387
230960;202204;14895;40031;12987;36589;2045;5799;6775;18728;8820;24527
230970;202204;16796;41191;14351;37564;1350;3703;9694;24772;11044;28475
230980;202204;3405;8476;2974;7770;314;739;2040;5434;2354;6173
230990;202204;1862;4908;1543;4300;71;269;1125;2977;1196;3246
231000;202204;2910;7290;2335;6206;85;246;1765;4497;1850;4743
231010;202204;4421;8889;3528;7494;20;97;3187;6542;3207;6639
231020;202204;9479;26470;8425;24586;1113;2981;5445;16225;6558;19206
231025;202204;8759;21702;7698;20056;537;1350;5988;15449;6525;16799
231030;202204;8156;22806;6313;19124;870;2537;3575;10811;4445;13348
231040;202204;3415;8651;2951;7849;76;260;2454;6288;2530;6548
231050;202204;13464;31473;11071;27491;489;1300;8668;20811;9157;22111
231060;202204;3221;8337;2868;7797;80;282;2303;6306;2383;6588
231070;202204;8943;24190;7704;22054;616;1898;5356;15066;5972;16964
231080;202204;4341;11485;3620;10310;184;672;2675;7477;2859;8149
231085;202204;7994;17777;6440;15975;222;527;5227;12893;5449;13420
231090;202204;4930;12157;3652;9766;125;464;2554;6534;2679;6998
231095;202204;2451;6958;1950;5923;193;574;1291;3914;1484;4488
231100;202204;3470;9454;2871;8366;128;458;2171;6219;2299;6677
231110;202204;4116;11242;3789;10666;267;779;2756;7574;3023;8353
231120;202204;2677;7119;2249;6408;104;330;1670;4695;1774;5025
231123;202204;2130;5225;1736;4544;95;239;1242;3204;1337;3443
231126;202204;6146;15740;5047;13725;292;757;3697;9933;3989;10690
231130;202204;25840;58616;21581;53386;1288;3780;16600;39788;17888;43568
231135;202204;4689;12329;3890;10843;190;595;2791;7638;2981;8233
231140;202204;18543;49015;15005;43214;707;2706;11015;30692;11722;33398
231150;202204;6665;16957;4857;13547;698;1956;2065;5813;2763;7769
231160;202204;7477;20771;6664;19322;759;1964;4154;12284;4913;14248
231170;202204;5215;13818;4343;12237;272;846;3135;8488;3407;9334
231180;202204;16623;43673;13591;37743;2360;6568;6741;18445;9101;25013
231190;202204;4559;11906;3607;10215;87;337;2790;7703;2877;8040
231195;202204;5635;15754;4661;13854;295;982;3433;10079;3728;11061
231200;202204;9208;24856;8025;22657;177;835;6673;18042;6850;18877
231210;202204;5437;14737;4584;13315;169;661;3606;10161;3775;10822
231220;202204;14824;34090;11789;28780;526;1306;8891;20866;9417;22172
231230;202204;10364;31074;9149;28905;700;2417;6805;21391;7505;23808
231240;202204;13183;36107;11660;33418;1539;4354;7487;21415;9026;25769
231250;202204;2309;5525;1546;3942;97;237;956;2359;1053;2596
231260;202204;3597;9271;3129;8557;312;737;2174;6070;2486;6807
231270;202204;7120;17309;5786;15165;155;586;4428;11158;4583;11744
231280;202204;1937;5631;1728;5270;141;395;1221;3730;1362;4125
231290;202204;41490;116535;34925;104405;4872;14785;18545;54138;23417;68923
231300;202204;4611;11914;3629;10033;126;425;2546;6783;2672;7208
231310;202204;8629;20389;6925;17393;524;1353;4913;11955;5437;13308
231320;202204;8051;21321;6267;18199;121;463;4926;14168;5047;14631
231325;202204;2793;6663;2252;5841;178;329;1616;4231;1794;4560
231330;202204;11401;30997;9514;27442;1472;3872;5685;16825;7157;20697
231335;202204;6137;15388;5144;13845;114;432;4435;11806;4549;12238
231340;202204;20602;58487;18571;55088;1320;3972;14154;42257;15474;46229
231350;202204;17805;45095;16258;42914;290;989;14695;38405;14985;39394
231355;202204;4962;13510;4449;12598;197;668;3584;9940;3781;10608
231360;202204;8841;24624;7674;22704;345;1131;6123;17868;6468;18999
231370;202204;2356;6175;1895;5365;44;130;1449;4064;1493;4194
231375;202204;4543;13376;4081;12614;110;474;3409;10391;3519;10865
231380;202204;6537;16500;5858;15589;168;493;4887;13024;5055;13517
231390;202204;3800;10333;3402;9674;117;483;2576;7064;2693;7547
231395;202204;4715;12688;3949;11513;283;834;2744;7871;3027;8705
231400;202204;10831;29209;9062;26020;313;1329;6993;19480;7306;20809
231410;202204;16726;47339;15224;45033;724;2266;12448;36719;13172;38985
240010;202204;2896;7084;2272;6012;310;802;1192;3098;1502;3900
240020;202204;14936;37939;12548;33867;811;2481;8584;22544;9395;25025
240030;202204;4130;8159;3717;7585;116;290;3327;6578;3443;6868
240040;202204;899;2448;752;2183;23;89;512;1420;535;1509
240050;202204;3750;9466;2962;8059;56;180;2274;6025;2330;6205
240060;202204;1622;3986;1309;3425;37;120;1035;2632;1072;2752
240070;202204;2819;7328;2509;6707;189;541;1832;4707;2021;5248
240080;202204;3233;8223;2573;7088;102;342;1884;5094;1986;5436
240090;202204;2491;5750;2040;5017;20;54;1734;4183;1754;4237
240100;202204;12243;27122;9854;23155;240;723;7952;17825;8192;18548
240110;202204;5144;13663;4329;12210;174;652;3269;8903;3443;9555
240120;202204;3826;10067;3195;9271;237;777;2322;6682;2559;7459
240130;202204;4378;8177;3585;7166;47;98;3232;6381;3279;6479
240140;202204;1978;5670;1671;5114;201;671;1063;3210;1264;3881
240145;202204;7584;19848;6182;17499;728;2159;3931;10950;4659;13109
240150;202204;1127;2961;977;2668;52;174;755;1998;807;2172
240160;202204;1623;4516;1344;4005;33;139;1017;3003;1050;3142
240165;202204;1086;2743;909;2419;27;96;761;1971;788;2067
240170;202204;3113;7570;2620;6737;300;762;1710;4366;2010;5128
240180;202204;3400;9496;2731;8159;616;1745;1243;3872;1859;5617
240185;202204;1467;4205;1336;3977;39;153;1081;3126;1120;3279
240190;202204;1242;3224;1051;2935;25;101;871;2427;896;2528
240200;202204;13711;31231;11200;27165;1253;3002;6860;16130;8113;19132
240210;202204;3850;8449;3157;7368;39;178;2744;6131;2783;6309
240220;202204;8186;23262;7330;21951;458;1656;5753;17054;6211;18710
240230;202204;6569;15483;5214;13318;247;593;3981;10220;4228;10813
240240;202204;1958;5394;1329;4030;146;457;460;1237;606;1694
240250;202204;3492;8239;3030;7594;56;220;2628;6419;2684;6639
240260;202204;16035;44108;13874;40603;3933;10881;6540;20725;10473;31606
240270;202204;2658;7319;2285;6693;112;345;1693;5052;1805;5397
240280;202204;1879;4497;1562;3990;67;177;1235;3107;1302;3284
240290;202204;1300;3555;1056;3068;39;164;749;2027;788;2191
240300;202204;2535;6133;1856;4941;102;274;1159;3020;1261;3294
240310;202204;9367;23711;7473;20440;923;2524;3985;10734;4908;13258
240320;202204;2198;5685;1543;4409;74;255;1101;3019;1175;3274
240325;202204;37489;92497;30649;81347;4120;11837;17170;43853;21290;55690
240330;202204;2010;5130;1548;4290;60;216;1098;2906;1158;3122
240340;202204;2351;4807;1919;4188;44;111;1625;3413;1669;3524
240350;202204;2764;6072;2468;5739;33;106;2293;5289;2326;5395
240360;202204;12221;30707;10923;28766;1589;3711;7180;19306;8769;23017
240370;202204;2456;5557;1903;4565;97;255;1386;3143;1483;3398
240375;202204;1049;2471;874;2184;33;109;687;1633;720;1742
240380;202204;2549;6689;1969;5494;201;536;1115;3077;1316;3613
240390;202204;1128;2585;808;2010;33;68;523;1208;556;1276
240400;202204;1668;3797;1264;3140;44;149;901;2085;945;2234
240410;202204;638;1807;523;1590;49;172;325;949;374;1121
240420;202204;5311;16841;4727;15701;420;1741;3164;10124;3584;11865
240430;202204;3983;9415;3321;8314;124;423;2608;6257;2732;6680
240440;202204;3051;6355;2628;5771;225;423;2023;4461;2248;4884
240450;202204;4958;12797;3935;10971;356;1153;2388;6323;2744;7476
240460;202204;3735;9237;3349;8644;263;653;2729;7090;2992;7743
240470;202204;3889;11214;2970;9337;556;1627;1465;4808;2021;6435
240480;202204;650;1654;421;1172;26;66;212;555;238;621
240485;202204;2422;6376;1953;5570;146;436;1315;3735;1461;4171
240490;202204;1806;4244;1398;3542;83;166;995;2523;1078;2689
240500;202204;2327;6049;2009;5516;104;289;1607;4382;1711;4671
240510;202204;1826;4654;1565;4262;76;239;1261;3380;1337;3619
240520;202204;1790;3829;1363;3268;96;192;1053;2566;1149;2758
240530;202204;2646;6578;2352;6110;80;213;1995;5057;2075;5270
240540;202204;2617;5978;2326;5543;48;134;2072;4903;2120;5037
240550;202204;920;2184;824;2022;13;52;732;1746;745;1798
240560;202204;4030;9034;3456;8285;175;401;2833;6743;3008;7144
240570;202204;3052;7692;2081;5658;302;817;752;1918;1054;2735
240580;202204;9436;25382;8337;23491;594;1686;6700;18840;7294;20526
240590;202204;952;2056;827;1867;7;21;692;1516;699;1537
240600;202204;2000;5075;1467;4045;52;162;1007;2636;1059;2798
240610;202204;5112;12249;4394;11020;172;495;3397;8194;3569;8689
240615;202204;1418;3440;1137;2979;104;276;816;2062;920;2338
240620;202204;2090;5367;1791;4867;83;265;1476;3961;1559;4226
240630;202204;2414;6018;2166;5621;272;480;1522;4167;1794;4647
240640;202204;1048;2588;827;2224;27;95;633;1643;660;1738
240650;202204;4589;12292;3890;10926;293;810;2745;7686;3038;8496
240660;202204;3745;8325;3368;7836;55;152;3125;7204;3180;7356
240670;202204;2835;7259;2267;6149;163;471;1531;3991;1694;4462
240680;202204;1770;4288;1412;3687;52;166;1103;2774;1155;2940
240690;202204;1289;2917;1004;2441;28;106;825;1896;853;2002
240700;202204;2676;7406;2147;6453;100;321;1614;4810;1714;5131
240710;202204;19874;46030;16963;41409;1591;3899;12163;28925;13754;32824
240720;202204;5817;13629;4984;12474;523;1280;3450;8644;3973;9924
240725;202204;1253;3346;959;2812;42;126;636;1802;678;1928
240730;202204;2573;6605;2023;5594;71;224;1540;4153;1611;4377
240740;202204;2113;5429;1696;4612;68;221;1208;3099;1276;3320
240750;202204;2483;7624;2100;6813;257;902;1229;3997;1486;4899
240760;202204;1919;4036;1390;3258;92;132;1071;2565;1163;2697
240770;202204;3652;9343;3072;8550;126;451;2545;6958;2671;7409
240780;202204;5538;14338;4636;12879;644;1742;2981;8341;3625;10083
240790;202204;1005;2616;826;2309;24;109;629;1674;653;1783
240800;202204;60741;132066;48624;114585;5176;12486;30357;68619;35533;81105
240810;202204;107908;256336;93078;233327;8196;21987;66464;162017;74660;184004
240820;202204;6563;18225;5734;16776;697;2046;3737;11031;4434;13077
240830;202204;9667;25863;8483;24114;333;1183;6890;19340;7223;20523
240840;202204;1214;2867;977;2507;39;92;689;1718;728;1810
240850;202204;1595;4078;1119;3109;98;277;621;1632;719;1909
240860;202204;1567;3780;1193;3140;41;128;926;2352;967;2480
240870;202204;1199;2851;909;2372;143;364;496;1323;639;1687
240880;202204;1409;4237;1228;3885;106;411;898;2789;1004;3200
240890;202204;5386;13398;4225;11324;468;1383;2503;6260;2971;7643
240895;202204;3218;9175;2929;8713;291;815;2246;6857;2537;7672
240910;202204;3924;9868;3269;8717;62;220;2675;6931;2737;7151
240920;202204;1161;2707;931;2372;95;173;580;1520;675;1693
240930;202204;4083;8635;3354;7729;226;347;2382;5923;2608;6270
240933;202204;1795;4202;1502;3792;38;147;1305;3215;1343;3362
240940;202204;7664;16982;6116;14491;679;1544;3889;8878;4568;10422
240950;202204;1228;3401;1066;3101;41;167;856;2385;897;2552
240960;202204;752;2115;673;1959;17;58;531;1504;548;1562
240970;202204;2162;5049;1751;4391;72;253;1446;3500;1518;3753
240980;202204;4207;10530;3788;9849;85;364;3282;8235;3367;8599
240990;202204;3080;7689;2720;7058;230;706;2015;4960;2245;5666
241000;202204;1068;2585;828;2159;16;50;638;1584;654;1634
241010;202204;3319;9483;3006;8860;160;572;2351;6742;2511;7314
241020;202204;2380;5932;1799;4823;104;319;1274;3247;1378;3566
241025;202204;1910;5177;1544;4544;49;197;1127;3232;1176;3429
241030;202204;2740;8151;2215;7088;250;737;1436;4617;1686;5354
241040;202204;2361;7042;2051;6517;83;382;1564;4944;1647;5326
241050;202204;1571;4117;1262;3561;37;129;922;2524;959;2653
241060;202204;899;2323;776;2081;42;109;537;1389;579;1498
241070;202204;787;1957;653;1746;18;47;497;1282;515;1329
241080;202204;1257;3379;968;2789;43;137;674;1906;717;2043
241090;202204;2278;6107;1837;5358;81;337;1395;3931;1476;4268
241100;202204;1333;3460;1005;2810;42;108;684;1855;726;1963
241105;202204;1094;3077;886;2700;196;634;380;1157;576;1791
241110;202204;1068;2811;799;2253;51;142;512;1371;563;1513
241120;202204;8222;22177;6918;19991;827;2355;4354;12836;5181;15191
241140;202204;3743;9344;2878;7664;127;391;2128;5468;2255;5859
241142;202204;863;2211;646;1829;35;109;393;1045;428;1154
241150;202204;6543;15844;5758;14645;237;566;4563;11534;4800;12100
241160;202204;1319;3430;1028;2904;161;493;571;1523;732;2016
241170;202204;1499;3621;1260;3210;33;108;1036;2532;1069;2640
241180;202204;1161;2775;854;2222;82;221;461;1135;543;1356
241190;202204;1316;3189;1102;2792;15;55;804;1942;819;1997
241200;202204;25242;58913;22253;54282;2489;6278;15057;35553;17546;41831
241210;202204;1719;4227;1257;3383;105;315;743;1945;848;2260
241220;202204;10535;28076;9285;26087;1856;5149;4813;13818;6669;18967
241230;202204;3263;8010;2870;7419;112;313;2384;6085;2496;6398
241240;202204;1355;3586;846;2520;96;294;293;833;389;1127
241250;202204;6497;16767;5228;14543;172;749;4021;10661;4193;11410
241255;202204;2896;7952;2525;7270;140;495;1901;5313;2041;5808
241260;202204;5511;13418;4429;11685;138;484;3548;9081;3686;9565
241270;202204;1799;4982;1497;4415;124;381;1040;3047;1164;3428
241280;202204;2803;5945;2444;5330;84;186;2098;4489;2182;4675
241290;202204;3633;8374;2668;6857;77;232;2102;5247;2179;5479
241300;202204;1691;4268;1366;3723;35;126;918;2413;953;2539
241310;202204;2502;5570;2162;5101;70;117;1869;4429;1939;4546
241320;202204;1070;3242;918;2961;99;350;566;1806;665;2156
241330;202204;1972;4681;1561;4142;18;73;1375;3621;1393;3694
241335;202204;3959;10180;3482;9348;119;374;2884;7597;3003;7971
241340;202204;1831;4685;1458;3965;189;599;802;2008;991;2607
241350;202204;2432;6136;2109;5578;122;326;1633;4254;1755;4580
241355;202204;1553;3846;1261;3307;52;105;933;2426;985;2531
241360;202204;2288;5544;1696;4402;57;165;1250;3105;1307;3270
241370;202204;1525;3860;1196;3210;77;234;844;2138;921;2372
241380;202204;791;1968;623;1681;73;183;342;906;415;1089
241390;202204;2977;8201;2640;7708;168;509;2052;6006;2220;6515
241400;202204;4110;10603;3622;9888;206;660;2836;7623;3042;8283
241410;202204;2754;7668;2235;6649;244;774;1398;4108;1642;4882
241415;202204;2050;5219;1732;4632;52;197;1389;3558;1441;3755
241420;202204;3092;8462;2761;7923;447;1407;1780;5037;2227;6444
241430;202204;787;1874;501;1336;17;44;329;821;346;865
241440;202204;9147;25816;8202;24222;319;1080;6638;19383;6957;20463
241445;202204;1528;3307;1342;3059;52;92;1181;2720;1233;2812
241450;202204;3226;7219;2704;6409;273;557;1994;4761;2267;5318
241460;202204;4370;11050;3519;9372;242;667;2422;6209;2664;6876
241470;202204;1555;3906;1272;3482;37;122;1056;2860;1093;2982
241475;202204;1393;3561;1090;3019;24;95;816;2134;840;2229
241480;202204;3376;9791;2782;8558;754;2262;1046;3495;1800;5757
241490;202204;828;1745;606;1421;15;38;482;1095;497;1133
241500;202204;881;2264;801;2173;6;15;753;2059;759;2074
250010;202204;2903;8148;2409;7146;64;251;1780;5139;1844;5390
250020;202204;1808;4486;1338;3628;71;144;986;2657;1057;2801
250030;202204;7612;19827;6681;18430;716;2105;4862;13161;5578;15266
250040;202204;5152;13731;4520;12648;522;1440;3141;8701;3663;10141
250050;202204;4092;10145;3683;9629;153;448;3141;8202;3294;8650
250053;202204;1447;3727;1316;3537;116;280;956;2558;1072;2838
250057;202204;789;2387;719;2284;8;44;659;2095;667;2139
250060;202204;6374;15286;5719;14463;319;781;4775;12043;5094;12824
250070;202204;4462;11621;3738;10429;49;205;3023;8201;3072;8406
250073;202204;899;2175;734;1911;10;30;598;1519;608;1549
250077;202204;2911;6593;2276;5618;38;131;1898;4543;1936;4674
250080;202204;6144;13345;5172;12153;60;233;4669;10791;4729;11024
250090;202204;4094;8660;3589;8018;69;184;3169;6909;3238;7093
250100;202204;3843;11053;3457;10391;136;529;2752;8053;2888;8582
250110;202204;5396;14172;4891;13482;303;969;3798;10349;4101;11318
250115;202204;843;1893;639;1589;13;49;504;1213;517;1262
250120;202204;2097;5680;1774;5159;28;135;1439;4105;1467;4240
250130;202204;6645;15603;5655;14260;72;315;4958;12220;5030;12535
250135;202204;1501;3681;1305;3351;41;117;1112;2825;1153;2942
250140;202204;2470;6797;2286;6574;95;356;1989;5710;2084;6066
250150;202204;5231;15286;4705;14438;173;685;3817;11458;3990;12143
250153;202204;1550;3858;1275;3460;48;131;1011;2719;1059;2850
250157;202204;2266;5784;2007;5372;62;199;1651;4327;1713;4526
250160;202204;4341;10050;3479;8905;93;238;2979;7600;3072;7838
250170;202204;2117;5070;1903;4771;37;134;1643;4025;1680;4159
250180;202204;24800;53938;21305;49592;720;2206;17625;39631;18345;41837
250190;202204;4800;11651;4040;10586;366;927;2891;7472;3257;8399
250200;202204;2861;5822;2483;5342;49;133;2230;4661;2279;4794
250205;202204;942;2791;802;2569;13;56;641;2045;654;2101
250210;202204;1623;4640;1447;4370;54;255;1142;3351;1196;3606
250215;202204;1803;4630;1522;4246;100;312;883;2494;983;2806
250220;202204;723;1910;572;1677;33;119;387;1103;420;1222
250230;202204;1856;3965;1314;3185;20;69;1056;2486;1076;2555
250240;202204;3077;7710;2736;7149;37;165;2421;6184;2458;6349
250250;202204;5260;13311;4617;12436;225;502;3735;10375;3960;10877
250260;202204;1821;4867;1532;4356;58;162;1196;3407;1254;3569
250270;202204;1352;3810;1233;3664;83;268;916;2811;999;3079
250280;202204;4463;10136;4012;9538;241;443;3168;7619;3409;8062
250290;202204;1884;4437;1606;4028;24;72;1294;3152;1318;3224
250300;202204;6738;15455;6091;14693;149;591;5311;12343;5460;12934
250310;202204;1323;3477;1091;3101;45;134;813;2291;858;2425
250320;202204;14567;29723;12698;27631;184;519;11704;25055;11888;25574
250330;202204;2915;7125;2475;6533;87;282;2130;5491;2217;5773
250340;202204;1398;3101;1219;2867;14;45;1107;2568;1121;2613
250350;202204;4425;11772;3864;10816;293;633;3009;8648;3302;9281
250355;202204;2458;6323;2192;5991;24;110;2026;5513;2050;5623
250360;202204;2033;5056;1815;4767;45;158;1541;3947;1586;4105
250370;202204;16089;37327;13487;33504;252;843;11631;28234;11883;29077
250375;202204;1476;3292;1203;2976;6;22;1128;2798;1134;2820
250380;202204;1964;4407;1811;4222;31;117;1651;3735;1682;3852
250390;202204;2101;4973;1774;4472;94;216;1420;3559;1514;3775
250400;202204;79582;187368;60580;158822;17120;45798;18868;52931;35988;98729
250403;202204;2296;5408;2044;5129;52;284;1696;4009;1748;4293
250407;202204;1561;3431;1202;2900;137;253;775;2015;912;2268
250410;202204;790;1948;679;1767;10;35;566;1416;576;1451
250415;202204;2114;5467;1849;5074;42;156;1588;4308;1630;4464
250420;202204;1353;3430;1215;3244;17;43;1111;2960;1128;3003
250430;202204;7948;17213;6836;15755;369;732;5602;12682;5971;13414
250435;202204;1790;4715;1428;4114;20;88;1093;3055;1113;3143
250440;202204;5034;12715;4361;11854;82;222;3824;10331;3906;10553
250450;202204;2031;4937;1669;4444;73;162;1327;3624;1400;3786
250460;202204;8128;20708;7181;19394;456;1262;5706;15385;6162;16647
250470;202204;1846;4349;1521;3854;47;125;1228;3009;1275;3134
250480;202204;4294;11177;3625;10364;51;172;3186;9162;3237;9334
250485;202204;785;1695;595;1433;58;104;411;971;469;1075
250490;202204;5805;12721;5156;11991;110;359;4669;10638;4779;10997
250500;202204;2250;5834;1998;5412;56;168;1653;4416;1709;4584
250510;202204;6274;14304;5382;13108;106;211;4656;11431;4762;11642
250520;202204;2129;5312;1821;4907;86;268;1421;3748;1507;4016
250523;202204;2558;5678;2259;5282;194;462;1776;4079;1970;4541
250527;202204;1946;4464;1758;4255;15;46;1605;3853;1620;3899
250530;202204;734;1759;628;1606;19;46;518;1285;537;1331
250535;202204;1512;4127;1353;3852;29;132;1082;2972;1111;3104
250540;202204;3761;7347;3175;6708;302;357;2635;5845;2937;6202
250550;202204;849;2595;753;2417;49;169;523;1662;572;1831
250560;202204;1952;5077;1700;4720;39;148;1414;3823;1453;3971
250570;202204;3060;8373;2632;7627;116;376;2053;5862;2169;6238
250580;202204;1138;2862;1005;2681;48;204;852;2183;900;2387
250590;202204;1103;2486;994;2332;33;78;873;2000;906;2078
250600;202204;8725;22186;7241;20171;253;814;5704;15710;5957;16524
250610;202204;3255;8675;2906;8168;105;387;2425;6743;2530;7130
250620;202204;1008;2295;862;2059;43;111;655;1522;698;1633
250625;202204;2645;7175;2360;6729;49;230;2036;5674;2085;5904
250630;202204;12608;31036;10564;27724;1009;2800;7278;18469;8287;21269
250640;202204;4109;10073;3673;9515;92;334;3231;8267;3323;8601
250650;202204;1178;2548;960;2264;14;54;837;1923;851;1977
250660;202204;1773;4120;1413;3629;31;107;1163;2870;1194;2977
250670;202204;2642;7607;2385;7156;57;231;2070;6089;2127;6320
250680;202204;6611;14412;5957;13679;51;207;5596;12624;5647;12831
250690;202204;8277;16845;7035;15341;175;330;6160;13362;6335;13692
250700;202204;5090;13454;4450;12496;718;1908;2748;7875;3466;9783
250710;202204;4780;13135;4187;12307;281;919;3115;9092;3396;10011
250720;202204;3128;7882;2788;7416;48;198;2517;6615;2565;6813
250730;202204;5022;11885;4439;11111;156;528;3794;9204;3950;9732
250740;202204;2285;5277;1886;4751;121;281;1440;3644;1561;3925
250750;202204;126166;290125;108149;265439;7613;20426;81129;194282;88742;214708
250760;202204;3184;6595;2843;6080;39;141;2569;5308;2608;5449
250770;202204;4472;12613;4002;11992;460;1307;2866;8793;3326;10100
250780;202204;2032;5037;1716;4491;62;188;1388;3547;1450;3735
250790;202204;2863;7807;2494;7279;95;376;1946;5528;2041;5904
250800;202204;2727;6753;2369;6193;105;210;1910;5002;2015;5212
250810;202204;1577;3651;1327;3313;97;161;1069;2760;1166;2921
250820;202204;2182;5683;2006;5486;40;145;1812;4917;1852;5062
250830;202204;6862;19081;5656;16711;236;869;3979;11243;4215;12112
250840;202204;829;2506;722;2302;33;124;542;1743;575;1867
250850;202204;1959;5407;1742;5034;37;180;1452;4090;1489;4270
250855;202204;1187;3068;1040;2853;45;144;837;2255;882;2399
250860;202204;3895;10491;3252;9452;472;1367;1863;5399;2335;6766
250870;202204;1153;2949;978;2673;35;117;789;2116;824;2233
250880;202204;1856;4417;1535;3946;120;297;1143;2923;1263;3220
250890;202204;12587;28155;11142;26341;319;1296;9576;21474;9895;22770
250900;202204;3518;8514;3090;7806;74;222;2685;6615;2759;6837
250905;202204;2740;7171;2525;6886;43;145;2303;6275;2346;6420
250910;202204;7661;16520;6485;15221;80;263;5847;13617;5927;13880
250915;202204;2511;5275;1827;4539;25;55;1631;4082;1656;4137
250920;202204;4184;9639;3733;8987;235;485;3078;7326;3313;7811
250930;202204;2650;6565;2381;6227;74;240;2001;5144;2075;5384
250933;202204;1426;3815;1248;3507;42;162;993;2703;1035;2865
250937;202204;868;2159;724;1936;26;82;588;1565;614;1647
250939;202204;2224;5203;1944;4848;58;140;1591;3906;1649;4046
250940;202204;4517;11011;3950;10268;34;106;3563;9210;3597;9316
250950;202204;1927;4714;1549;4218;41;153;1246;3321;1287;3474
250960;202204;1246;3435;1096;3196;27;124;904;2554;931;2678
250970;202204;9477;22853;8334;21033;208;641;6974;17105;7182;17746
250980;202204;2713;6636;2465;6295;21;100;2174;5394;2195;5494
250990;202204;2402;6705;2036;6095;83;332;1572;4575;1655;4907
251000;202204;2249;5951;1819;5221;43;166;1473;4201;1516;4367
251010;202204;2875;7513;2583;7075;34;135;2280;6207;2314;6342
251020;202204;1751;4591;1575;4322;37;162;1367;3658;1404;3820
251030;202204;1145;2871;935;2505;56;144;627;1660;683;1804
251040;202204;2088;5333;1778;4833;31;132;1506;4030;1537;4162
251050;202204;1137;3045;950;2692;49;175;694;1880;743;2055
251060;202204;1236;2474;941;2104;26;61;715;1583;741;1644
251065;202204;531;1385;390;1116;11;44;283;767;294;811
251070;202204;837;1996;701;1806;16;57;597;1496;613;1553
251080;202204;22938;52886;18885;47026;3084;7387;10993;28109;14077;35496
251090;202204;3195;8579;2721;7774;71;219;2190;6194;2261;6413
251100;202204;902;2730;786;2503;30;125;613;1870;643;1995
251110;202204;2033;5003;1692;4392;117;262;1227;3151;1344;3413
251120;202204;8636;21969;7277;20327;452;1415;5548;15430;6000;16845
251130;202204;5227;9578;4570;8860;47;112;4264;8126;4311;8238
251140;202204;4628;12324;4096;11584;81;296;3351;9389;3432;9685
251150;202204;3014;8214;2764;7818;67;314;2386;6592;2453;6906
251160;202204;2570;6695;2228;6195;32;160;1970;5354;2002;5514
251170;202204;1945;4671;1710;4375;21;78;1562;3932;1583;4010
251180;202204;3066;7425;2534;6698;189;427;1821;4881;2010;5308
251190;202204;5190;12252;4685;11689;65;255;4259;10430;4324;10685
251200;202204;4914;13147;4321;12399;80;287;3785;10853;3865;11140
251203;202204;1101;3317;1004;3103;45;151;735;2234;780;2385
251207;202204;1272;3205;956;2682;21;87;667;1809;688;1896
251210;202204;9056;20966;7413;18734;474;972;5404;14071;5878;15043
251220;202204;1451;3187;1094;2721;91;190;810;2078;901;2268
251230;202204;5216;13716;4483;12432;125;428;3583;9637;3708;10065
251240;202204;4134;10916;3487;9815;231;588;2485;6981;2716;7569
251250;202204;12839;31300;11294;28729;627;1725;8763;21516;9390;23241
251260;202204;588;1420;527;1330;18;79;423;1014;441;1093
251270;202204;4855;13979;4323;13239;219;661;3391;10733;3610;11394
251272;202204;1459;3744;1341;3594;58;220;1139;2963;1197;3183
251274;202204;981;2603;782;2254;64;192;501;1414;565;1606
251275;202204;1578;3769;1329;3369;63;182;1056;2587;1119;2769
251276;202204;1505;3860;1312;3601;36;155;1049;2784;1085;2939
251278;202204;706;1772;632;1659;38;117;501;1296;539;1413
251280;202204;3089;6732;2826;6367;62;189;2519;5497;2581;5686
251290;202204;8057;15742;7403;14982;255;582;6613;13106;6868;13688
251300;202204;990;2697;883;2537;15;66;755;2156;770;2222
251310;202204;3153;8205;2718;7539;57;267;2277;6139;2334;6406
251315;202204;2063;5900;1857;5511;110;329;1457;4290;1567;4619
251320;202204;1834;4556;1370;3756;38;133;1044;2786;1082;2919
251330;202204;2397;5156;1957;4638;32;85;1727;4087;1759;4172
251335;202204;1227;3204;1101;3021;24;106;990;2658;1014;2764
251340;202204;4306;9434;3436;8310;152;360;2702;6485;2854;6845
251350;202204;1191;3189;1088;3029;30;101;907;2484;937;2585
251360;202204;2112;5324;1676;4705;27;81;1353;3746;1380;3827
251365;202204;881;2153;660;1746;16;43;519;1351;535;1394
251370;202204;27577;69017;23639;63592;3255;8307;14838;40676;18093;48983
251380;202204;1602;3828;1385;3492;24;103;1208;2943;1232;3046
251385;202204;874;2118;680;1778;31;67;468;1188;499;1255
251390;202204;7512;20006;6648;18681;583;1713;4703;13105;5286;14818
251392;202204;1149;2929;973;2650;38;114;762;2066;800;2180
251394;202204;753;1986;602;1725;58;171;404;1123;462;1294
251396;202204;743;1932;631;1744;26;75;431;1156;457;1231
251398;202204;1138;2766;805;2180;25;88;596;1549;621;1637
251400;202204;1579;3322;1262;2900;27;102;1052;2302;1079;2404
251410;202204;1792;3809;1441;3319;14;45;1233;2720;1247;2765
251420;202204;2289;5462;1891;5006;46;155;1512;3914;1558;4069
251430;202204;1713;4810;1545;4528;51;196;1333;3851;1384;4047
251440;202204;1206;3160;980;2751;60;137;732;2110;792;2247
251445;202204;1819;4648;1676;4457;33;138;1454;3767;1487;3905
251450;202204;4964;13591;4434;12782;87;363;3774;10785;3861;11148
251455;202204;982;2750;889;2589;24;91;723;2058;747;2149
251460;202204;1074;2772;880;2472;58;187;669;1848;727;2035
251465;202204;514;1404;435;1260;11;48;332;924;343;972
251470;202204;1327;3465;990;2803;126;374;514;1363;640;1737
251480;202204;1145;2794;903;2392;21;83;687;1727;708;1810
251490;202204;2225;5407;1806;4848;90;245;1364;3648;1454;3893
251500;202204;2283;5886;2080;5617;40;141;1824;4877;1864;5018
251510;202204;2979;8366;2469;7375;100;372;1734;4983;1834;5355
251520;202204;1187;2855;902;2364;84;174;578;1497;662;1671
251530;202204;16261;36154;13170;32361;138;679;11741;28223;11879;28902
251540;202204;3449;9068;3080;8427;64;260;2585;6875;2649;7135
251550;202204;4687;9659;3804;8605;141;239;3129;7155;3270;7394
251560;202204;621;1805;556;1710;41;164;407;1193;448;1357
251570;202204;1065;2828;877;2461;21;106;710;1922;731;2028
251580;202204;2338;5104;2087;4734;31;120;1812;3931;1843;4051
251590;202204;1876;4148;1593;3817;51;132;1373;3190;1424;3322
251593;202204;1057;2940;939;2737;83;268;638;1813;721;2081
251597;202204;2358;6063;2119;5747;15;71;1935;5184;1950;5255
251600;202204;7025;17924;6089;16515;261;760;4994;13374;5255;14134
251610;202204;3554;9418;3110;8650;237;639;2251;6243;2488;6882
251615;202204;1493;3409;1188;2955;24;74;973;2339;997;2413
251620;202204;22608;46396;17676;40452;159;417;15561;35529;15720;35946
251630;202204;5750;12187;4654;10676;241;515;3620;8052;3861;8567
251640;202204;2472;6214;2205;5812;25;116;1991;5152;2016;5268
251650;202204;4962;11342;4321;10542;156;390;3755;9089;3911;9479
251660;202204;4016;11087;3540;10274;71;321;2976;8455;3047;8776
251670;202204;4917;12191;4348;11436;69;249;3922;10191;3991;10440
251675;202204;954;2136;861;2019;63;146;703;1631;766;1777
251680;202204;2991;7119;2530;6523;69;156;2123;5478;2192;5634
251690;202204;3604;9427;3089;8565;109;315;2372;6524;2481;6839
251700;202204;2457;6450;2029;5868;50;191;1686;4763;1736;4954
251710;202204;889;2171;638;1695;46;134;382;940;428;1074
251720;202204;1467;3891;1173;3396;21;89;910;2541;931;2630
251740;202204;688;1823;557;1592;32;103;406;1125;438;1228
260005;202204;33888;67906;28360;61002;1758;3812;22417;46951;24175;50763
260010;202204;11576;28511;9564;25327;656;1769;5841;15351;6497;17120
260020;202204;7861;16546;6542;14719;83;350;5652;12365;5735;12715
260030;202204;8029;18501;6798;16769;108;408;5764;13872;5872;14280
260040;202204;8502;20029;7200;18269;558;1324;5289;13644;5847;14968
260050;202204;15420;37169;12973;34465;222;717;12042;31974;12264;32691
260060;202204;4837;10722;4170;9703;366;670;3137;7527;3503;8197
260070;202204;12944;28554;11239;26174;272;980;9523;21333;9795;22313
260080;202204;7579;15624;6595;14376;113;325;5700;12123;5813;12448
260090;202204;5706;13416;5062;12566;294;734;4045;10033;4339;10767
260100;202204;3306;8307;2793;7577;50;239;2393;6376;2443;6615
260105;202204;5529;14220;4966;13472;121;494;4280;11353;4401;11847
260110;202204;24945;64836;22243;60982;965;3131;18518;49846;19483;52977
260120;202204;16965;40843;14455;37313;1552;3770;10021;25977;11573;29747
260130;202204;3824;8477;3347;7830;131;304;2704;6169;2835;6473
260140;202204;14509;30043;12583;27802;381;991;11045;23950;11426;24941
260150;202204;4220;8739;3684;8090;95;207;3316;7228;3411;7435
260160;202204;7812;17536;6717;16226;88;284;6205;14940;6293;15224
260170;202204;24543;52400;21162;47966;1061;2412;17334;38689;18395;41101
260180;202204;3919;9644;3362;8880;95;331;2880;7463;2975;7794
260190;202204;22913;40680;19663;36946;175;470;17976;32969;18151;33439
260200;202204;12646;27842;10961;25699;500;1023;9530;22449;10030;23472
260210;202204;12606;33269;10640;30168;371;1244;8569;24113;8940;25357
260220;202204;13850;27509;12879;26340;491;789;11370;23185;11861;23974
260230;202204;13753;28691;12034;26517;305;695;10226;22298;10531;22993
260240;202204;3121;8692;2711;7925;87;364;2132;6095;2219;6459
260250;202204;2618;6135;2264;5613;98;241;1860;4543;1958;4784
260260;202204;15234;35532;13586;33156;804;1989;10721;26090;11525;28079
260270;202204;5540;11253;4934;10569;88;304;4403;9186;4491;9490
260280;202204;13883;38717;12546;36848;365;1643;10974;31510;11339;33153
260290;202204;46494;110020;40274;101471;3711;9460;28900;72138;32611;81598
260300;202204;11408;27486;9867;25374;267;866;8408;21385;8675;22251
260310;202204;7052;15261;6322;14374;443;736;5063;11776;5506;12512
260320;202204;8545;23153;7256;21048;179;639;6050;17402;6229;18041
260330;202204;2818;8061;2441;7300;73;262;1955;5683;2028;5945
260340;202204;2377;5827;2063;5371;29;122;1819;4603;1848;4725
260345;202204;30554;72405;25873;65953;3057;8257;16022;39441;19079;47698
260350;202204;6898;13949;6025;12978;39;126;5564;11808;5603;11934
260360;202204;2812;6799;2514;6269;83;236;1813;4449;1896;4685
260370;202204;6156;16282;5275;14818;206;678;4169;11431;4375;12109
260380;202204;5627;15255;4801;13941;191;609;3738;10721;3929;11330
260390;202204;5201;14659;4255;12806;219;677;2843;8359;3062;9036
260392;202204;4071;11435;3676;10941;80;473;3169;9317;3249;9790
260400;202204;23384;47816;20416;43982;425;1195;17113;35017;17538;36212
260410;202204;88011;198523;70729;175169;13006;32982;34617;87403;47623;120385
260415;202204;5065;12101;4381;11062;58;236;3770;9268;3828;9504
260420;202204;14620;27637;12569;25394;71;245;11906;23763;11977;24008
260430;202204;3066;8997;2597;8099;183;571;1738;5389;1921;5960
260440;202204;4690;10328;4183;9655;48;175;3763;8505;3811;8680
260450;202204;6288;14814;5628;13965;277;560;4790;12011;5067;12571
260460;202204;6056;16278;5170;14797;445;1428;3412;9482;3857;10910
260470;202204;5411;12976;4591;12043;76;222;4223;11136;4299;11358
260480;202204;4453;10795;3773;9867;308;843;2681;7040;2989;7883
260490;202204;6245;12969;5513;11973;39;146;5060;10792;5099;10938
260500;202204;6855;15872;5896;14533;446;1020;4288;10607;4734;11627
260510;202204;11745;25914;9956;23453;108;387;8940;20669;9048;21056
260515;202204;5073;12394;4021;10531;140;450;2950;7272;3090;7722
260520;202204;18198;39957;15886;37091;563;1466;13553;31107;14116;32573
260530;202204;11125;29028;9494;26612;126;618;8373;23009;8499;23627
260540;202204;8573;16643;7655;15522;97;249;7079;14147;7176;14396
260545;202204;103;291;68;213;10;39;25;68;35;107
260550;202204;3566;9035;2888;7930;171;565;2025;5338;2196;5903
260560;202204;6374;15547;5334;14032;133;480;4524;11681;4657;12161
260570;202204;9389;22036;8321;20649;259;765;7193;17526;7452;18291
260580;202204;5416;11370;4899;10705;25;84;4568;9881;4593;9965
260590;202204;8461;16448;7268;15151;137;320;6578;13594;6715;13914
260600;202204;37429;87953;31099;78732;1085;3270;24766;60686;25851;63956
260610;202204;8413;20466;7449;19206;427;1152;5647;14434;6074;15586
260620;202204;21437;48687;19085;45515;1223;3424;15059;34619;16282;38043
260630;202204;2662;6732;2179;5992;59;199;1802;4834;1861;5033
260640;202204;27300;54485;23313;49977;788;1706;19933;42072;20721;43778
260650;202204;7012;16716;5654;15063;518;921;4583;12574;5101;13495
260660;202204;8098;19092;7082;17822;292;851;6217;15397;6509;16248
260670;202204;2568;6249;2095;5505;65;162;1580;4015;1645;4177
260680;202204;33733;74611;28719;67817;2022;4945;21043;48393;23065;53338
260690;202204;3863;9473;3213;8483;80;283;2533;6576;2613;6859
260700;202204;7999;18279;7448;17672;34;165;7243;17128;7277;17293
260710;202204;1545;3741;1315;3410;60;194;1046;2671;1106;2865
260720;202204;31112;67791;26817;62556;1908;4478;20824;48501;22732;52979
260730;202204;8946;23684;7781;22088;205;778;6723;18758;6928;19536
260740;202204;1477;3915;1224;3524;23;81;978;2856;1001;2937
260750;202204;9011;20695;7181;18466;166;384;6288;16623;6454;17007
260760;202204;7182;14947;6289;13926;108;302;5597;12253;5705;12555
260765;202204;9695;24987;8529;23437;527;1745;6275;16809;6802;18554
260770;202204;4379;10358;3608;9120;100;319;2924;7221;3024;7540
260775;202204;6428;15299;5671;14219;167;584;4670;11191;4837;11775
260780;202204;4191;11495;3747;10801;351;1244;2464;6774;2815;8018
260790;202204;146567;304717;123618;276183;15332;33444;85351;188368;100683;221812
260795;202204;3695;8090;3209;7482;114;286;2724;6276;2838;6562
260800;202204;6887;13627;6271;12823;223;426;5517;11062;5740;11488
260805;202204;4166;10683;3558;9687;174;561;2749;7267;2923;7828
260810;202204;7630;18683;6714;17051;338;870;5324;13087;5662;13957
260820;202204;5020;10814;4457;10178;81;273;3819;8584;3900;8857
260825;202204;3352;9201;2952;8527;115;370;2295;6537;2410;6907
260830;202204;4953;13067;4158;11717;473;1124;2792;8066;3265;9190
260840;202204;5265;11664;4739;10969;244;514;4086;9395;4330;9909
260845;202204;5024;12304;4464;11409;215;616;3460;8576;3675;9192
260850;202204;5740;14406;4824;12762;364;1034;3258;8238;3622;9272
260860;202204;3815;10174;3278;9259;85;307;2689;7385;2774;7692
260870;202204;5190;11129;4462;10251;131;323;3959;9053;4090;9376
260875;202204;9371;19827;7764;17555;664;1370;5575;12759;6239;14129
260880;202204;11242;28836;9865;26623;295;944;8268;21922;8563;22866
260890;202204;15213;35332;13195;32406;850;2177;9528;22952;10378;25129
260900;202204;6305;16266;5240;14785;366;1115;3653;10182;4019;11297
260910;202204;3744;9217;3282;8552;111;338;2635;6753;2746;7091
260915;202204;5882;15058;5238;14327;55;245;4881;13282;4936;13527
260920;202204;3855;8369;3313;7797;69;161;2964;6960;3033;7121
260930;202204;4652;12586;4009;11496;169;652;3187;8780;3356;9432
260940;202204;17091;37340;14942;34430;1068;2511;11540;26048;12608;28559
260950;202204;8281;20264;6735;17775;332;1147;4685;11583;5017;12730
260960;202204;90066;180738;74971;162239;6706;14538;53974;113620;60680;128158
260970;202204;6407;15485;5675;14497;417;797;4252;11133;4669;11930
260980;202204;5221;13921;4579;13127;57;176;4194;12111;4251;12287
260990;202204;20093;50799;17000;46627;757;2397;13608;36700;14365;39097
261000;202204;19150;40709;16227;37101;508;1362;13443;29954;13951;31316
261010;202204;2542;6164;2205;5728;96;242;1882;4896;1978;5138
261020;202204;7664;18257;6726;16744;319;851;5549;13470;5868;14321
261030;202204;4605;12310;4056;11387;124;455;3274;8898;3398;9353
261040;202204;6103;16128;5006;14182;170;607;3938;10800;4108;11407
261050;202204;9058;21103;8213;19909;241;539;6924;16587;7165;17126
261060;202204;16453;37720;14343;35254;319;944;12176;29441;12495;30385
261070;202204;77620;159358;65125;143384;5083;10724;48493;104997;53576;115721
261080;202204;7818;17054;7096;16192;122;246;6637;15096;6759;15342
261090;202204;22163;48491;19744;45376;439;1267;17433;39300;17872;40567
261100;202204;9751;24340;8527;22596;628;1582;6456;17085;7084;18667
261110;202204;79421;205811;67237;184497;8174;23970;42464;114123;50638;138093
261120;202204;4242;9642;3706;8916;102;228;3203;7633;3305;7861
261130;202204;8226;18568;7234;17274;117;366;6424;15131;6541;15497
261140;202204;4280;9077;3825;8479;239;529;3030;6622;3269;7151
261150;202204;6212;14587;5494;13563;173;399;4730;11608;4903;12007
261153;202204;2149;6042;1795;5385;72;228;1237;3696;1309;3924
261160;202204;260097;558065;216425;500720;49401;112694;105541;248308;154942;361002
261170;202204;8446;17416;7442;16144;253;509;6460;13747;6713;14256
261180;202204;10528;24547;9205;22865;538;1164;6951;17397;7489;18561
261190;202204;5235;13877;4718;13084;163;710;3885;10417;4048;11127
261200;202204;3927;8197;3465;7602;132;323;2962;6347;3094;6670
261210;202204;2139;4849;1829;4418;68;157;1543;3671;1611;3828
261220;202204;16640;41580;14232;37533;1438;3911;9583;24533;11021;28444
261230;202204;4477;11798;3713;10810;52;198;3139;9176;3191;9374
261240;202204;6784;14507;6026;13409;290;619;5072;11146;5362;11765
261245;202204;4242;10934;3493;9656;73;339;2851;7566;2924;7905
261247;202204;3519;9541;2915;8490;287;756;1921;5703;2208;6459
261250;202204;30391;61204;26942;57268;4481;8547;18633;41161;23114;49708
261255;202204;4567;12493;3731;10918;160;610;2857;8124;3017;8734
261260;202204;17354;37156;15430;34741;265;974;14218;31241;14483;32215
261270;202204;5776;11754;5122;10986;154;342;4531;9527;4685;9869
261280;202204;2792;7285;2417;6694;90;314;1918;5162;2008;5476
261290;202204;3257;7813;2726;7216;84;282;2263;6004;2347;6286
261300;202204;15120;37238;13016;33938;424;1572;10445;26196;10869;27768
261310;202204;11063;24954;9574;23001;698;1762;7292;17144;7990;18906
261320;202204;6903;17872;5974;16417;68;315;5123;13833;5191;14148
261330;202204;7042;14950;6398;14145;129;391;5721;12330;5850;12721
261340;202204;5417;12941;4802;12175;118;413;4254;10587;4372;11000
261350;202204;9632;26687;8448;24712;189;670;6822;19740;7011;20410
261360;202204;9803;20932;8347;18923;298;754;6893;15091;7191;15845
261370;202204;27397;63813;23254;58402;2183;5407;16138;40308;18321;45715
261380;202204;4792;12701;4067;11479;405;1176;2781;7819;3186;8995
261390;202204;19010;50461;16052;45921;1163;3770;11140;31224;12303;34994
261400;202204;5524;15220;4848;13892;275;880;3718;10306;3993;11186
261410;202204;11133;25285;9217;22464;324;996;7682;18096;8006;19092
261420;202204;8449;23045;7619;22073;560;1998;5947;16999;6507;18997
261430;202204;4540;10506;3934;9623;56;254;3483;8209;3539;8463
261440;202204;1583;4476;1297;3933;51;232;939;2723;990;2955
261450;202204;16338;40890;14420;38068;456;1251;11660;30808;12116;32059
261460;202204;8909;21970;7734;20199;238;721;6423;16523;6661;17244
261470;202204;4454;10506;3839;9659;42;174;3305;8220;3347;8394
261480;202204;6134;16795;5282;15398;261;937;4194;11933;4455;12870
261485;202204;5823;15156;5124;14140;383;1227;3882;10523;4265;11750
261500;202204;7430;16977;6493;15737;613;1186;4529;11501;5142;12687
261510;202204;2054;5707;1773;5255;79;281;1369;4038;1448;4319
261520;202204;2611;7385;2347;6869;92;318;1776;5085;1868;5403
261530;202204;13908;36985;11425;32791;810;2966;6857;18278;7667;21244
261540;202204;10743;27170;9825;25920;2229;5254;5143;14993;7372;20247
261550;202204;4173;10290;3656;9512;227;692;2753;6935;2980;7627
261560;202204;10285;25242;9038;23466;412;1184;7338;18888;7750;20072
261570;202204;3934;9991;3105;8631;209;639;2132;5788;2341;6427
261580;202204;7711;18740;6690;17364;82;389;6131;15704;6213;16093
261590;202204;3133;7230;2560;6426;93;290;2015;4916;2108;5206
261600;202204;6599;14135;5652;12833;232;529;4554;10069;4786;10598
261610;202204;2403;6645;1935;5795;167;534;1266;3778;1433;4312
261618;202204;3171;6623;2817;6134;102;280;2414;5054;2516;5334
261620;202204;5107;12982;4686;12379;711;1655;3250;9004;3961;10659
261630;202204;6693;18025;5694;16160;450;1456;3779;10271;4229;11727
261640;202204;44013;89350;37835;81978;2047;3577;30178;66264;32225;69841
261650;202204;5053;10883;4334;10002;281;563;3367;7794;3648;8357
270010;202204;4804;15102;4136;13977;165;841;3323;10930;3488;11771
270020;202204;4622;10276;4050;9581;119;456;3563;8079;3682;8535
270030;202204;37063;96838;31172;87661;2421;7174;23081;64185;25502;71359
270040;202204;12012;29312;10315;27314;595;1620;8500;22518;9095;24138
270050;202204;5924;13117;5036;12127;235;480;4468;10838;4703;11318
270060;202204;2460;6008;2086;5565;139;371;1665;4431;1804;4802
270070;202204;5557;13741;4871;12804;108;471;4254;10817;4362;11288
270080;202204;1649;4174;1396;3777;74;192;1071;2837;1145;3029
270090;202204;1970;5588;1785;5251;45;197;1528;4384;1573;4581
270100;202204;7263;15428;6371;14206;178;454;5616;12229;5794;12683
270110;202204;3662;7997;2971;7199;185;324;2386;6055;2571;6379
270120;202204;2832;7401;2469;6920;70;270;2077;5701;2147;5971
270130;202204;5598;13652;4842;12747;200;600;4125;10798;4325;11398
270135;202204;2227;5027;1894;4661;29;125;1756;4272;1785;4397
270140;202204;10299;23350;8300;20644;345;1082;6528;15476;6873;16558
270150;202204;3227;8395;2958;8032;15;79;2821;7594;2836;7673
270160;202204;6186;16260;5302;15217;184;568;4785;13718;4969;14286
270170;202204;3622;10040;3055;9253;190;867;2295;6648;2485;7515
270180;202204;2501;7297;2291;7031;42;216;2061;6250;2103;6466
270190;202204;2419;5509;2202;5257;20;96;2067;4861;2087;4957
270200;202204;2898;8042;2525;7512;247;660;1782;5432;2029;6092
270210;202204;6425;14010;5478;12934;56;221;5097;11857;5153;12078
270220;202204;1872;4481;1518;3979;145;408;1070;2706;1215;3114
270230;202204;10842;27620;9120;25069;833;2314;6730;18377;7563;20691
270235;202204;6568;19141;5729;17834;195;722;4809;14840;5004;15562
270240;202204;13134;32627;10965;29749;942;2628;8285;22479;9227;25107
270250;202204;3316;7443;2958;6948;162;364;2538;5921;2700;6285
270255;202204;4991;13327;3972;11584;131;495;3112;8844;3243;9339
270260;202204;5844;16866;5292;15958;100;519;4641;13730;4741;14249
270270;202204;1165;2835;973;2605;110;261;730;1964;840;2225
270280;202204;4363;9747;3504;8701;235;541;2670;6772;2905;7313
270290;202204;8773;25699;7927;24397;143;704;7113;21618;7256;22322
270300;202204;4635;11354;3607;10234;157;417;2891;8329;3048;8746
270310;202204;7807;20372;6711;18756;131;538;5857;16054;5988;16592
270320;202204;6017;16939;5199;15433;276;958;3885;11106;4161;12064
270330;202204;4648;13706;4109;12924;210;931;3378;10476;3588;11407
270340;202204;1837;4527;1562;4161;78;150;1328;3540;1406;3690
270350;202204;2094;4523;1699;4069;124;308;1274;3044;1398;3352
270360;202204;3377;7240;3051;6878;45;139;2921;6536;2966;6675
270370;202204;1557;4479;1417;4229;34;164;1218;3573;1252;3737
270375;202204;3873;7937;3314;7330;15;49;3172;6981;3187;7030
270380;202204;6232;15634;5301;14496;579;1398;3927;11045;4506;12443
270390;202204;1363;3185;1090;2863;13;64;929;2432;942;2496
270400;202204;7493;17801;6327;16148;201;530;5208;13068;5409;13598
270410;202204;5198;14027;4519;13021;120;442;3888;11139;4008;11581
270420;202204;6810;18014;6164;17095;221;903;5383;14517;5604;15420
270430;202204;160639;356665;126631;314025;19827;50270;70432;175830;90259;226100
270440;202204;5169;13138;4512;12331;122;419;3996;10834;4118;11253
270450;202204;8497;20734;7518;19560;314;779;6428;16925;6742;17704
270460;202204;4214;8800;3598;8052;141;279;3265;7310;3406;7589
270470;202204;12808;32894;11193;30672;577;1798;9042;24593;9619;26391
270480;202204;3377;8217;2858;7503;165;492;2348;6047;2513;6539
270490;202204;1037;2649;903;2487;38;131;754;2033;792;2164
270500;202204;5493;15386;4897;14411;214;799;4055;11697;4269;12496
270510;202204;6737;15966;5669;14648;333;1038;4509;11262;4842;12300
270520;202204;4586;12034;3677;10601;721;2141;1735;5114;2456;7255
270530;202204;1454;3976;1243;3645;68;166;883;2636;951;2802
270540;202204;2495;6440;2111;5941;67;243;1819;5074;1886;5317
270550;202204;7496;18023;5970;16346;525;1380;4548;12668;5073;14048
270560;202204;3283;7951;2754;7240;150;467;2202;5648;2352;6115
270570;202204;5557;13148;4840;12136;409;967;3861;9632;4270;10599
270580;202204;2615;6754;2364;6412;114;306;2045;5534;2159;5840
270590;202204;1683;4845;1548;4660;14;78;1471;4406;1485;4484
270600;202204;3122;8889;2838;8464;62;272;2536;7468;2598;7740
270610;202204;4142;10080;3631;9420;73;219;3274;8386;3347;8605
270620;202204;1384;3890;1267;3684;31;121;1093;3087;1124;3208
270630;202204;19496;44727;16856;41189;712;2085;14361;34359;15073;36444
270640;202204;6087;16171;5310;14974;172;651;4485;12398;4657;13049
270642;202204;2772;8392;2439;7891;166;709;1880;5935;2046;6644
270644;202204;4291;9847;3580;8948;274;620;2851;7154;3125;7774
270650;202204;3831;9951;3363;9339;237;779;2754;7567;2991;8346
270660;202204;2165;5217;1866;4817;81;260;1476;3694;1557;3954
270670;202204;20503;42073;17416;38375;447;1149;15284;32807;15731;33956
270680;202204;6919;13974;6264;13268;419;498;5578;12259;5997;12757
270690;202204;11115;25359;9320;23088;346;952;7687;18753;8033;19705
270700;202204;602;1720;531;1615;49;169;394;1171;443;1340
270710;202204;6319;17487;5569;16355;352;1153;4442;12904;4794;14057
270720;202204;4241;10966;3784;10228;80;317;3406;9025;3486;9342
270730;202204;9159;18669;7984;17432;964;1156;6249;15108;7213;16264
270740;202204;2525;6429;2222;6079;91;279;1871;5077;1962;5356
270750;202204;6366;15425;5592;14465;100;387;5024;12833;5124;13220
270760;202204;3694;9652;3111;8862;60;273;2637;7402;2697;7675
270770;202204;24583;57596;20081;51990;3081;7440;12702;33909;15783;41349
270780;202204;2181;5193;2022;4989;46;156;1849;4493;1895;4649
270790;202204;1960;4804;1664;4408;126;332;1301;3423;1427;3755
270800;202204;12978;31612;11753;29914;499;1417;10032;25349;10531;26766
270810;202204;3791;9750;3028;8584;185;625;2236;6168;2421;6793
270820;202204;1763;4970;1503;4564;54;243;1221;3642;1275;3885
270830;202204;5911;13192;4832;11899;145;534;4078;9762;4223;10296
270840;202204;9268;25926;8134;24272;247;1076;6998;20419;7245;21495
270850;202204;9983;21759;8842;20442;517;1397;7640;17387;8157;18784
270860;202204;16327;33930;13103;30324;691;1564;10723;24580;11414;26144
270870;202204;2508;6645;2046;5885;217;567;1381;4078;1598;4645
270880;202204;8651;24631;7752;23308;219;946;6421;18854;6640;19800
270890;202204;3671;9338;3113;8562;300;820;2045;5626;2345;6446
270895;202204;4122;10503;3742;10028;67;330;3407;8904;3474;9234
270900;202204;1890;4622;1451;3935;28;103;1161;3085;1189;3188
270910;202204;4584;12335;3974;11434;143;429;3340;9502;3483;9931
270915;202204;10649;28254;8669;25148;755;2582;6036;16924;6791;19506
270920;202204;6876;17823;6180;16825;85;430;5463;14480;5548;14910
270930;202204;19965;42879;15669;37955;1969;3949;10999;28214;12968;32163
270940;202204;7004;17463;5906;16182;187;840;4808;12724;4995;13564
280010;202204;687;1881;545;1590;19;80;393;1071;412;1151
280020;202204;5619;13181;4749;11873;348;879;3579;8757;3927;9636
280030;202204;97088;207836;80045;184582;13543;30764;45287;104677;58830;135441
280040;202204;3442;8534;3017;7930;267;750;2209;5682;2476;6432
280050;202204;4691;12503;3961;11359;797;2276;2078;6003;2875;8279
280060;202204;7674;17933;6217;15853;978;2638;3536;9054;4514;11692
280067;202204;8190;18114;7015;16355;458;879;5231;12088;5689;12967
280070;202204;1966;5677;1821;5455;117;363;1527;4541;1644;4904
280100;202204;4723;11310;3992;10206;478;1111;2638;6926;3116;8037
280110;202204;1778;4015;1540;3677;23;76;1414;3301;1437;3377
280120;202204;8763;22638;7774;21096;903;2208;5661;15633;6564;17841
280130;202204;9998;21859;8734;20179;467;1183;7087;16248;7554;17431
280140;202204;6735;14175;5991;13164;544;1007;4652;10425;5196;11432
280150;202204;4599;10932;4005;10112;449;1037;2968;7535;3417;8572
280160;202204;1417;3679;1208;3352;125;386;828;2199;953;2585
280170;202204;6181;14309;5569;13548;235;611;4706;11314;4941;11925
280190;202204;1643;3144;1474;2931;39;102;1324;2568;1363;2670
280200;202204;1427;3553;1186;3217;80;235;865;2274;945;2509
280210;202204;19754;44425;17209;40903;1836;4307;11721;27478;13557;31785
280220;202204;1857;4634;1570;4263;74;213;1273;3454;1347;3667
280230;202204;4832;11336;3980;10067;284;610;2816;7113;3100;7723
280240;202204;3693;9143;3276;8531;44;223;2867;7271;2911;7494
280250;202204;1048;2279;880;2044;58;167;681;1518;739;1685
280260;202204;2702;5702;2379;5304;43;104;2196;4882;2239;4986
280270;202204;2708;6840;2384;6375;142;405;1995;5280;2137;5685
280280;202204;4352;12276;3866;11573;480;1240;2759;8552;3239;9792
280290;202204;22746;53180;19730;49041;1700;4337;13540;33662;15240;37999
280300;202204;14227;30176;12480;28296;1576;2092;9085;22825;10661;24917
280310;202204;1532;3747;1283;3354;42;127;994;2529;1036;2656
280320;202204;9794;24483;8486;22563;932;2472;5953;15574;6885;18046
280330;202204;5216;12096;4382;10931;316;742;3284;8145;3600;8887
280340;202204;6080;11949;5102;10875;244;392;4449;9630;4693;10022
280350;202204;32129;66547;28437;61763;1021;2573;23865;50316;24886;52889
280360;202204;6193;16324;5448;15173;605;1858;3520;9780;4125;11638
280370;202204;2629;5680;2145;4902;103;180;1679;3796;1782;3976
280380;202204;1164;2838;980;2598;88;200;687;1852;775;2052
280390;202204;4464;9638;3797;8647;203;431;3118;6999;3321;7430
280400;202204;4572;10257;4007;9534;501;987;2844;6956;3345;7943
280410;202204;3036;7531;2556;6810;232;646;1657;4259;1889;4905
280420;202204;4947;11924;4507;11380;80;257;4161;10427;4241;10684
280430;202204;2513;5491;2227;5123;71;207;1899;4233;1970;4440
280440;202204;4822;11792;4261;10973;147;520;3661;9146;3808;9666
280445;202204;2580;6284;2312;5846;50;163;1837;4468;1887;4631
280450;202204;11205;25512;9749;23552;2436;5710;4512;11591;6948;17301
280460;202204;8081;17308;7348;16335;419;872;6296;13845;6715;14717
280470;202204;1876;4951;1583;4404;115;309;1142;3142;1257;3451
280480;202204;53628;117612;46836;108391;4391;10437;33768;76181;38159;86618
280490;202204;4056;11056;3424;9975;137;543;2592;7250;2729;7793
280500;202204;1233;2584;1028;2329;25;73;861;1932;886;2005
280510;202204;3395;6973;2964;6401;89;233;2532;5271;2621;5504
280520;202204;2017;4535;1761;4183;111;226;1398;3281;1509;3507
280530;202204;2620;6256;2294;5816;145;359;1800;4537;1945;4896
280540;202204;9498;24089;8586;22806;327;982;7462;19628;7789;20610
280550;202204;7605;16282;6389;14595;129;463;5469;12001;5598;12464
280560;202204;8494;21072;7967;20319;133;476;7191;18003;7324;18479
280570;202204;7147;16214;5821;14615;315;810;4406;11032;4721;11842
280580;202204;6475;15399;5684;14293;447;990;4454;11190;4901;12180
280590;202204;3135;6868;2686;6336;148;425;2094;4705;2242;5130
280600;202204;4469;10519;3963;9806;191;472;3059;7456;3250;7928
280610;202204;3133;6686;2801;6265;125;285;2395;5222;2520;5507
280620;202204;6690;14562;5766;13386;491;892;4230;10193;4721;11085
280630;202204;4362;11031;4006;10562;207;579;3315;8716;3522;9295
280640;202204;2742;6585;2400;6203;95;229;2139;5569;2234;5798
280650;202204;1335;3339;1111;3014;100;286;796;2081;896;2367
280660;202204;4212;8528;3646;7881;165;282;3159;6855;3324;7137
280670;202204;22369;48519;19396;44695;1826;4161;14376;32950;16202;37111
280680;202204;3275;7167;2829;6535;299;535;1923;4640;2222;5175
280690;202204;1112;2492;941;2276;44;126;779;1816;823;1942
280700;202204;1330;2994;1135;2721;43;115;915;2143;958;2258
280710;202204;17414;35904;14830;32998;1063;1642;12505;28517;13568;30159
280720;202204;3004;6316;2483;5710;84;206;1930;4551;2014;4757
280730;202204;1168;2851;1008;2605;86;247;739;1839;825;2086
280740;202204;19041;37955;16573;34429;992;2216;13241;26459;14233;28675
280750;202204;3901;10239;3366;9323;229;651;2429;6627;2658;7278
280760;202204;7697;18150;6654;16702;733;1586;4505;11641;5238;13227
290010;202204;3524;6906;2341;5130;12;34;1986;4155;1998;4189
290020;202204;7048;15080;6499;14421;551;855;5453;12492;6004;13347
290030;202204;5280;10983;4323;9949;217;419;3646;8526;3863;8945
290035;202204;5967;11785;4897;10422;296;531;3796;8252;4092;8783
290040;202204;5735;11366;4914;10396;462;632;3891;8643;4353;9275
290050;202204;2292;6962;1946;6261;119;429;1349;4239;1468;4668
290060;202204;1614;3428;1195;2833;175;377;779;1837;954;2214
290070;202204;46230;91630;40187;84258;2334;4777;32182;66215;34516;70992
290080;202204;6689;17208;5863;16014;526;1497;4343;11812;4869;13309
290090;202204;2471;4376;1780;3635;18;49;1634;3297;1652;3346
290100;202204;11575;27158;9417;24115;1595;3695;5100;13789;6695;17484
290110;202204;6205;14833;5453;13692;650;1497;3556;8993;4206;10490
290115;202204;4482;12447;3822;11316;289;867;2976;8792;3265;9659
290120;202204;7284;16821;6085;15178;184;597;5139;12567;5323;13164
290130;202204;5198;11702;4061;10220;204;482;3069;7812;3273;8294
290135;202204;5091;10936;4170;9457;177;434;3349;7282;3526;7716
290140;202204;5074;12178;3955;10733;146;456;3321;8994;3467;9450
290150;202204;3296;7050;2845;6536;139;336;2352;5308;2491;5644
290160;202204;4027;8239;3584;7645;167;329;3049;6426;3216;6755
290170;202204;4055;8991;3623;8531;110;251;3304;7783;3414;8034
290180;202204;3395;8522;2824;7623;73;272;2386;6334;2459;6606
290190;202204;5450;12553;4866;11802;167;474;4043;9790;4210;10264
290195;202204;2822;6273;2250;5552;59;219;1954;4733;2013;4952
290200;202204;4650;12093;3687;10460;151;471;2768;7776;2919;8247
290205;202204;4005;9419;3568;8793;175;522;2901;6933;3076;7455
290210;202204;15027;37242;13340;34712;1039;2414;10575;27670;11614;30084
290220;202204;3533;7408;3116;6899;90;226;2706;5879;2796;6105
290225;202204;3712;7027;2864;6157;73;171;2593;5513;2666;5684
290230;202204;3226;7036;2966;6732;77;144;2645;6028;2722;6172
290240;202204;4698;10018;3825;8977;67;236;3379;7796;3446;8032
290250;202204;4436;11827;3663;10710;134;383;3032;8997;3166;9380
290260;202204;6190;13877;5254;12540;285;718;4385;10255;4670;10973
290265;202204;3854;10619;3128;9296;231;715;2167;6371;2398;7086
290270;202204;11797;37931;10884;36418;641;2564;8704;28955;9345;31519
290280;202204;6895;19478;5954;17627;422;1412;4242;12311;4664;13723
290290;202204;10944;30234;8832;26451;842;2730;5909;17386;6751;20116
290300;202204;4825;12034;3523;9649;226;668;2488;6650;2714;7318
290310;202204;2353;4513;1924;4021;29;101;1758;3581;1787;3682
290320;202204;30610;73098;24888;64832;4616;11414;13907;37299;18523;48713
290323;202204;4353;10842;3720;9858;108;304;2922;7718;3030;8022
290327;202204;4785;12616;4091;11368;372;931;2861;7890;3233;8821
290330;202204;2815;5031;2266;4446;27;43;2091;4116;2118;4159
290340;202204;6969;15444;5402;13601;535;1195;4078;10449;4613;11644
290350;202204;5262;13909;4369;12393;290;825;3092;8756;3382;9581
290360;202204;6198;13687;5471;12754;113;283;4842;11178;4955;11461
290370;202204;5635;12899;4144;10941;157;446;3022;7942;3179;8388
290380;202204;6539;15491;5445;14030;144;345;4725;12192;4869;12537
290390;202204;16998;44738;14102;40145;1438;4043;9613;27489;11051;31532
290395;202204;3350;8708;2670;7577;70;305;2074;5747;2144;6052
290400;202204;4320;10818;3482;9482;159;487;2674;7107;2833;7594
290405;202204;5148;13913;4360;12581;362;1043;3018;8811;3380;9854
290410;202204;6243;15822;4760;13526;166;620;3605;9984;3771;10604
290420;202204;3588;8912;2947;7930;97;290;2361;6276;2458;6566
290430;202204;3997;9329;3330;8337;162;511;2580;6167;2742;6678
290440;202204;3204;7420;2278;5982;160;356;1613;4321;1773;4677
290450;202204;4349;9371;3483;8139;126;303;2917;6621;3043;6924
290460;202204;14026;37181;11776;33110;2341;6638;5163;14544;7504;21182
290470;202204;5409;11734;4072;9928;459;1123;2549;6232;3008;7355
290475;202204;7423;19847;6226;17851;96;472;5260;14813;5356;15285
290480;202204;2099;4841;1728;4314;70;228;1306;3084;1376;3312
290485;202204;5135;13910;4504;13033;132;560;3806;10847;3938;11407
290490;202204;10324;22413;9347;21124;346;856;7802;17504;8148;18360
290500;202204;4698;13187;3718;11216;621;1947;1580;4663;2201;6610
290510;202204;4102;9131;3448;8297;81;240;3090;7366;3171;7606
290515;202204;3944;10344;3430;9631;40;117;3113;8832;3153;8949
290520;202204;13662;35798;10690;30247;665;2046;6912;18758;7577;20804
290530;202204;5390;14712;4540;13369;110;459;3823;11139;3933;11598
290540;202204;4111;9785;3734;9380;45;144;3506;8781;3551;8925
290550;202204;4712;11522;4103;10806;35;111;3770;10027;3805;10138
290560;202204;7107;17215;5456;14872;420;1367;3764;9882;4184;11249
290570;202204;50266;118014;44582;110999;2080;5574;36937;90749;39017;96323
290580;202204;9487;24406;8209;22620;862;2024;5960;17153;6822;19177
290590;202204;7611;22380;6406;20280;192;717;5223;16653;5415;17370
290600;202204;21129;55557;18302;51074;972;2674;14609;40716;15581;43390
290610;202204;2788;8205;2200;7044;112;394;1539;4898;1651;5292
290620;202204;6722;18297;5816;16826;338;909;4766;13848;5104;14757
290630;202204;10897;23592;8827;20992;735;1650;6821;16359;7556;18009
290640;202204;3075;7248;2367;6261;220;437;1634;4572;1854;5009
290650;202204;16377;36229;14703;34371;1485;3357;11900;27962;13385;31319
290660;202204;4199;10151;3383;8874;130;379;2492;6522;2622;6901
290670;202204;9033;20201;7851;18465;282;765;6676;15465;6958;16230
290680;202204;12482;31604;10341;28522;266;1116;8694;23478;8960;24594
290682;202204;6005;13258;5245;12278;370;577;4057;10105;4427;10682
290685;202204;3967;8366;2881;6849;450;881;1569;4062;2019;4943
290687;202204;7817;19009;6464;16877;783;1889;4306;11436;5089;13325
290689;202204;3154;8214;2407;6908;251;781;1579;4530;1830;5311
290690;202204;6194;15066;5061;13517;269;847;3852;10045;4121;10892
290700;202204;3473;7615;3120;7185;45;163;2868;6495;2913;6658
290710;202204;9717;24456;8258;22491;260;799;7089;19238;7349;20037
290720;202204;21806;54107;19701;50936;1074;2941;15948;40476;17022;43417
290730;202204;7775;17403;6638;16081;320;634;5255;12817;5575;13451
290740;202204;1212;2928;965;2552;14;50;844;2193;858;2243
290750;202204;14327;31453;12453;28585;505;1322;10057;22051;10562;23373
290755;202204;2248;6025;1801;5244;128;351;1234;3609;1362;3960
290760;202204;4180;11455;3443;10129;240;597;2389;7188;2629;7785
290770;202204;3069;8475;2813;8169;108;248;2390;7106;2498;7354
290780;202204;8703;20628;7484;19043;330;698;5829;15087;6159;15785
290790;202204;5767;14164;5014;13086;255;631;4162;10935;4417;11566
290800;202204;7986;14890;5735;12335;306;535;4400;9557;4706;10092
290810;202204;6146;14398;4984;12754;223;480;3787;9912;4010;10392
290820;202204;5991;14255;5350;13352;393;800;3829;9686;4222;10486
290830;202204;4866;10992;4287;10139;69;236;3614;8184;3683;8420
290840;202204;19827;48830;16917;44459;1888;4151;11705;31939;13593;36090
290850;202204;9180;18405;8121;17281;465;732;6857;14793;7322;15525
290860;202204;6987;18030;6064;16969;328;815;5085;14560;5413;15375
290870;202204;5359;13744;4071;11360;312;814;2723;7567;3035;8381
290880;202204;1595;3631;1284;3240;179;392;756;2077;935;2469
290890;202204;10099;19473;8951;18208;144;338;8315;16752;8459;17090
290900;202204;2668;6640;2071;5615;153;410;1290;3438;1443;3848
290910;202204;5784;12723;4415;10709;50;146;3815;9140;3865;9286
290920;202204;6211;13740;5477;12875;196;257;4834;11908;5030;12165
290930;202204;8172;21693;6565;18927;257;974;5048;14122;5305;15096
290940;202204;3885;10407;3267;9504;164;564;2634;7606;2798;8170
290950;202204;1612;3807;1309;3363;108;270;884;2291;992;2561
290960;202204;6633;15399;5920;14546;273;592;4986;12256;5259;12848
290970;202204;3466;9861;2823;8686;118;438;2210;6737;2328;7175
290980;202204;15175;33339;12996;30194;817;2003;9018;20013;9835;22016
290990;202204;10763;26633;9547;24760;301;1139;8129;20325;8430;21464
291000;202204;3736;8922;2855;7839;130;366;2323;6446;2453;6812
291005;202204;18262;41706;16181;39121;961;2296;13500;32311;14461;34607
291010;202204;3342;9739;2686;8342;166;563;1743;5259;1909;5822
291020;202204;1427;3294;1155;2843;32;96;841;1933;873;2029
291030;202204;2813;6365;2040;5110;144;332;1332;3221;1476;3553
291040;202204;6006;15301;4925;13784;219;703;3871;10838;4090;11541
291050;202204;10965;24095;9613;22306;1057;2347;7168;16461;8225;18808
291060;202204;9009;21660;7899;20235;644;1621;6134;15672;6778;17293
291070;202204;19596;46348;16564;41673;431;1411;14002;34447;14433;35858
291072;202204;31138;71105;23587;59167;3344;8768;13092;31732;16436;40500
291075;202204;6116;14046;5500;13103;96;257;4671;10797;4767;11054
291077;202204;1841;4623;1429;3915;67;138;999;2746;1066;2884
291080;202204;139899;315085;113061;279278;26020;60830;48781;125659;74801;186489
291085;202204;6140;14708;4997;12985;176;514;4169;10711;4345;11225
291090;202204;2418;4205;1799;3518;37;68;1560;2997;1597;3065
291100;202204;3740;7395;2637;6110;106;251;2079;4768;2185;5019
291110;202204;6640;18735;5580;16942;264;1028;4374;12875;4638;13903
291120;202204;9196;20071;7861;18427;368;926;6281;14572;6649;15498
291125;202204;2611;4244;1995;3562;69;110;1716;3040;1785;3150
291130;202204;3574;9598;2689;7937;73;344;2065;5839;2138;6183
291140;202204;5418;13521;3963;10995;549;1332;2412;6683;2961;8015
291150;202204;3041;5797;2390;5083;7;20;2283;4836;2290;4856
291160;202204;5639;14547;4712;13249;464;1338;3150;8763;3614;10101
291165;202204;2322;6105;1710;4919;35;147;1200;3306;1235;3453
291170;202204;24305;57616;20323;51054;1305;3402;13714;33254;15019;36656
291180;202204;8168;16010;6294;13592;186;477;5461;11504;5647;11981
291185;202204;3721;8696;3313;8090;181;431;2626;6393;2807;6824
291190;202204;8505;19496;7024;17659;222;636;5730;14395;5952;15031
291200;202204;3088;7974;2271;6451;78;291;1514;4067;1592;4358
291210;202204;8360;16245;6192;13799;316;640;4755;10576;5071;11216
291220;202204;5154;12937;4627;12183;356;936;3449;8989;3805;9925
291230;202204;5369;10193;4169;8886;69;110;3830;8179;3899;8289
291240;202204;4557;11126;3849;9970;76;232;3296;8417;3372;8649
291250;202204;3648;10213;2842;8773;198;606;1799;5587;1997;6193
291260;202204;1649;3559;1348;3172;32;71;1137;2673;1169;2744
291270;202204;6284;14606;4969;12795;411;948;3724;9774;4135;10722
291280;202204;3151;7071;2360;5942;184;431;1604;3920;1788;4351
291290;202204;6230;15618;4772;13399;420;1254;3219;8897;3639;10151
291300;202204;4339;10830;3457;9420;126;400;2678;7082;2804;7482
291310;202204;5691;14251;4867;12826;150;415;4140;10792;4290;11207
291320;202204;7433;18496;5852;15804;1168;2937;3130;8793;4298;11730
291330;202204;2127;5036;1766;4452;65;182;1368;3345;1433;3527
291340;202204;4809;11524;3859;9966;175;413;2751;7067;2926;7480
291345;202204;3226;8813;2900;8337;115;374;2429;6971;2544;7345
291350;202204;8001;17742;6263;15668;98;244;5495;13768;5593;14012
291360;202204;46226;94698;37119;84139;4135;8751;25180;58501;29315;67252
291370;202204;9072;23170;8013;21569;570;1682;6098;15987;6668;17669
291380;202204;4788;10512;4291;9854;166;417;3710;8426;3876;8843
291390;202204;14674;29200;11249;25459;458;1019;9512;21374;9970;22393
291400;202204;17873;39108;15064;35082;1546;3287;10480;24838;12026;28125
291410;202204;3333;8259;2613;7052;58;189;1963;5188;2021;5377
291420;202204;2127;4859;1653;4278;26;103;1467;3762;1493;3865
291430;202204;2976;7826;2554;7130;107;399;2022;5470;2129;5869
291440;202204;7183;19121;6194;17573;398;1158;4717;13530;5115;14688
291450;202204;12024;24388;9998;22084;238;329;8976;20142;9214;20471
291460;202204;18369;44106;16093;40840;759;2205;12585;31205;13344;33410
291465;202204;9895;23025;7801;20637;172;695;6765;17695;6937;18390
291470;202204;21893;43291;18629;39584;1109;2185;14507;31004;15616;33189
291480;202204;52447;105883;40396;90206;3636;8256;25951;55831;29587;64087
291490;202204;7193;15659;6347;14720;153;408;5842;13435;5995;13843
291500;202204;5984;12739;5046;11539;94;217;4669;10684;4763;10901
291510;202204;5059;11172;3784;9570;62;256;3269;8130;3331;8386
291520;202204;5085;10766;3890;9242;322;707;2983;7101;3305;7808
291530;202204;2686;5673;1968;4766;203;447;1370;3415;1573;3862
291535;202204;4030;10711;3434;9674;185;479;2710;7732;2895;8211
291540;202204;2446;5102;1719;4235;68;160;1444;3535;1512;3695
291550;202204;7034;14231;5449;12292;501;979;3862;8765;4363;9744
291560;202204;20122;45425;14863;38622;2172;5115;8479;22970;10651;28085
291570;202204;2661;5718;2039;5011;147;237;1671;4284;1818;4521
291580;202204;7299;17230;5759;15226;318;934;4332;11192;4650;12126
291590;202204;2693;5731;2379;5375;77;214;2140;4762;2217;4976
291600;202204;6261;13365;4864;11311;431;1061;3364;7571;3795;8632
291610;202204;6892;15596;6187;14828;165;380;5485;13255;5650;13635
291620;202204;3434;7170;2612;6281;185;390;2000;4924;2185;5314
291630;202204;4002;7797;3066;6652;267;490;2410;5254;2677;5744
291640;202204;19517;43046;15073;36881;1595;3911;8766;20864;10361;24775
291650;202204;10822;23729;9599;22300;722;1178;7977;19075;8699;20253
291660;202204;2215;5146;1622;4265;112;400;1107;2716;1219;3116
291670;202204;2188;5501;1817;4969;150;377;1319;3661;1469;4038
291680;202204;4637;10413;3778;9224;420;1010;2501;6213;2921;7223
291685;202204;5282;12163;4226;10730;209;441;3298;8486;3507;8927
291690;202204;4828;9434;3292;7355;298;540;2590;5772;2888;6312
291700;202204;10209;26435;9012;24464;327;1107;7605;20152;7932;21259
291710;202204;6115;13163;4666;11211;334;813;3474;8159;3808;8972
291720;202204;4883;13817;4056;12234;823;2453;2169;6602;2992;9055
291730;202204;7891;16961;6841;15619;401;882;5737;13080;6138;13962
291733;202204;3243;7664;2742;7004;132;260;2054;5485;2186;5745
291735;202204;3099;7980;2435;6831;76;195;1811;5059;1887;5254
291740;202204;4380;10746;3153;8492;124;262;2179;5833;2303;6095
291750;202204;23832;51914;19743;46004;2603;5237;12804;30703;15407;35940
291760;202204;12472;32588;9848;28621;2954;9690;2957;8375;5911;18065
291770;202204;8404;20896;7041;18588;340;1109;5432;13729;5772;14838
291780;202204;5700;14145;5125;13373;118;379;4471;11500;4589;11879
291790;202204;3314;7936;3023;7573;286;570;2362;6067;2648;6637
291800;202204;37483;84841;29368;73531;4321;10423;16742;41651;21063;52074
291810;202204;11935;26159;10136;24001;492;973;8421;20239;8913;21212
291820;202204;4312;10570;3745;9846;118;335;3040;7964;3158;8299
291830;202204;5243;11046;4283;9779;227;392;3449;7913;3676;8305
291835;202204;7249;20367;5828;17791;550;1705;3956;12209;4506;13914
291840;202204;54162;138449;47422;128349;4322;12425;35084;94196;39406;106621
291845;202204;3600;7532;2980;6787;136;280;2543;5877;2679;6157
291850;202204;4888;12336;4101;11103;134;338;3441;9335;3575;9673
291855;202204;2631;4577;2102;3997;29;61;1963;3706;1992;3767
291860;202204;2421;6093;1656;4652;36;108;1104;3003;1140;3111
291870;202204;1406;3358;961;2590;35;112;682;1793;717;1905
291875;202204;3265;9341;2804;8405;76;330;2086;6018;2162;6348
291880;202204;6127;16120;5274;14773;273;697;4002;11358;4275;12055
291890;202204;1886;3626;1252;2892;210;452;728;1702;938;2154
291900;202204;1484;3285;1134;2773;32;91;901;2138;933;2229
291905;202204;2653;6421;2185;5715;118;355;1671;4214;1789;4569
291910;202204;4054;8235;3511;7597;74;165;3173;6897;3247;7062
291915;202204;8163;21741;6638;19203;245;732;4991;14641;5236;15373
291920;202204;34377;80081;29783;74138;1818;5499;23327;56175;25145;61674
291930;202204;2882;6870;2482;6320;236;576;1854;4761;2090;5337
291940;202204;4305;10231;2916;7977;267;660;1747;4758;2014;5418
291950;202204;10178;29365;8543;26370;401;1378;5906;18073;6307;19451
291955;202204;19275;44273;17291;41780;1157;2947;14235;34153;15392;37100
291960;202204;4095;8884;3459;8076;234;410;2775;6637;3009;7047
291970;202204;5447;12117;4589;11072;167;502;3653;8641;3820;9143
291980;202204;11370;29611;9232;26124;904;2269;6295;18175;7199;20444
291990;202204;2623;6186;2163;5629;28;98;2000;5177;2028;5275
291992;202204;4749;10377;3963;9403;275;556;3208;7705;3483;8261
291995;202204;2503;6112;2058;5431;78;274;1663;4239;1741;4513
292000;202204;2939;6447;2414;5824;68;213;2007;4796;2075;5009
292010;202204;6486;13950;5292;12243;95;348;4519;10164;4614;10512
292020;202204;5389;13747;4559;12387;162;581;3697;9694;3859;10275
292030;202204;2284;6232;2007;5751;145;430;1304;3646;1449;4076
292040;202204;5249;11892;4164;10349;209;487;3343;8311;3552;8798
292045;202204;4999;10896;3884;9312;29;92;3588;8613;3617;8705
292050;202204;7305;18905;5940;16637;305;986;3990;10961;4295;11947
292060;202204;13593;28160;12618;26965;351;714;11363;23884;11714;24598
292070;202204;6646;15480;5810;14504;362;867;5000;12464;5362;13331
292080;202204;4136;8476;3435;7597;48;148;3189;6969;3237;7117
292090;202204;5031;10203;3598;8466;178;481;2890;6717;3068;7198
292100;202204;14455;31906;12424;29415;2013;4441;7497;18459;9510;22900
292105;202204;3907;9197;3399;8520;49;188;2893;7188;2942;7376
292110;202204;7139;15465;5186;12631;764;1884;3195;7628;3959;9512
292120;202204;8109;19008;6699;16680;554;1220;4838;12002;5392;13222
292130;202204;3853;8591;3192;7779;191;503;2450;5901;2641;6404
292140;202204;6480;13117;5533;11820;198;380;4871;10302;5069;10682
292145;202204;2921;7349;2449;6586;133;275;1903;5198;2036;5473
292150;202204;17152;41338;14800;37654;402;1295;12448;30982;12850;32277
292160;202204;3395;7490;2602;6495;36;106;2019;5392;2055;5498
292170;202204;10005;24489;8418;22007;429;1366;6552;16611;6981;17977
292180;202204;3275;8392;2436;6878;174;493;1544;4249;1718;4742
292190;202204;3312;8045;2799;7308;326;818;1874;5021;2200;5839
292200;202204;10445;23789;7947;20330;1522;3806;4026;10682;5548;14488
292205;202204;4311;10967;3740;10134;101;328;3210;8716;3311;9044
292210;202204;7537;15583;6179;13907;92;319;5678;12613;5770;12932
292220;202204;2542;5417;2202;4929;98;214;1730;3736;1828;3950
292225;202204;3589;9732;3150;9096;63;288;2779;7881;2842;8169
292230;202204;9847;21810;8777;20477;236;712;7550;17234;7786;17946
292240;202204;5390;14552;4707;13355;296;815;3383;9581;3679;10396
292250;202204;6735;15959;6031;14969;275;769;4852;11797;5127;12566
292260;202204;3633;9057;3211;8524;77;240;2812;7450;2889;7690
292265;202204;4075;9974;3350;8863;66;282;2805;7205;2871;7487
292270;202204;5189;10427;4175;9241;192;337;3450;7688;3642;8025
292273;202204;3219;6383;2578;5610;141;216;1857;4296;1998;4512
292275;202204;2006;4703;1631;4217;55;151;1312;3370;1367;3521
292280;202204;2996;6483;2431;5834;110;198;2066;5074;2176;5272
292285;202204;2934;6432;2334;5644;86;168;1927;4693;2013;4861
292290;202204;8481;20203;6713;17752;187;521;5612;14776;5799;15297
292300;202204;11815;27475;9369;24242;1088;2854;6279;16423;7367;19277
292303;202204;3534;8869;3064;8157;102;225;2639;7054;2741;7279
292305;202204;2543;6439;2323;6145;56;200;2080;5433;2136;5633
292310;202204;7884;17785;6858;16546;95;352;6156;14553;6251;14905
292320;202204;6592;16818;5253;14485;182;628;4044;10862;4226;11490
292330;202204;3356;6343;2777;5709;184;272;2179;4682;2363;4954
292335;202204;5534;13407;4904;12492;217;491;4168;10700;4385;11191
292340;202204;5984;16026;4940;14063;270;751;3585;10119;3855;10870
292350;202204;2988;7338;2516;6721;131;376;2069;5496;2200;5872
292360;202204;5593;13890;4658;12367;238;656;3398;8886;3636;9542
292370;202204;12106;25793;10401;23572;98;352;9774;21821;9872;22173
292380;202204;7603;19995;6787;18585;426;1205;5245;14211;5671;15416
292390;202204;5662;9422;4346;7934;70;126;4012;7231;4082;7357
292400;202204;25237;66662;21832;61513;2017;5667;15392;43531;17409;49198
292405;202204;5193;11517;4355;10256;139;339;3538;8307;3677;8646
292410;202204;2644;5488;2254;5003;92;178;1985;4426;2077;4604
292420;202204;5243;11403;4725;10694;71;263;4317;9478;4388;9741
292430;202204;5497;15366;4200;13022;315;1078;2838;8714;3153;9792
292440;202204;9748;28263;8944;27110;135;680;8057;24223;8192;24903
292450;202204;4571;12038;3513;10045;108;358;2711;7641;2819;7999
292460;202204;6600;15056;5555;13472;185;487;4660;11034;4845;11521
292465;202204;2946;6966;2501;6414;172;323;1651;4621;1823;4944
292467;202204;2322;5775;2056;5427;295;625;1420;4017;1715;4642
292470;202204;3240;7871;2471;6690;121;284;1813;4939;1934;5223
292480;202204;7410;15334;6105;13779;153;334;5530;12415;5683;12749
292490;202204;3046;6263;2580;5643;93;179;2181;4686;2274;4865
292500;202204;7993;19284;6407;16745;356;960;4615;11827;4971;12787
292510;202204;15584;37685;12195;32562;747;2156;8831;23339;9578;25495
292520;202204;8307;19281;7350;17895;335;943;6045;14399;6380;15342
292525;202204;7313;15413;6019;13951;116;278;5423;12619;5539;12897
292530;202204;35961;87714;28795;76438;5352;14768;15237;39942;20589;54710
292540;202204;5114;8619;4098;7547;112;178;3758;6938;3870;7116
292550;202204;9120;22452;7033;19976;531;1426;5072;15168;5603;16594
292560;202204;4970;11732;4174;10642;164;481;3160;7873;3324;8354
292570;202204;4180;10150;3494;8973;61;229;2971;7374;3032;7603
292575;202204;7645;20503;6999;19658;716;1873;5288;15099;6004;16972
292580;202204;8681;19803;7174;17647;180;441;6194;15024;6374;15465
292590;202204;8048;20383;6721;18061;354;1078;5389;14185;5743;15263
292593;202204;3155;7480;2576;6505;85;215;2138;5345;2223;5560
292595;202204;6114;15100;5277;14074;168;550;4559;12047;4727;12597
292600;202204;12855;31433;11137;28944;617;1455;8896;23204;9513;24659
292610;202204;5102;11731;4358;10528;151;340;3510;8375;3661;8715
292620;202204;7684;18440;6364;16856;140;332;5804;15497;5944;15829
292630;202204;10343;22924;8375;19898;980;2195;5471;12930;6451;15125
292640;202204;9002;24417;7662;22263;349;1093;5492;16003;5841;17096
292650;202204;4763;11278;4230;10586;63;230;3889;9593;3952;9823
292660;202204;12381;31879;10502;29135;654;1715;7891;22115;8545;23830
292665;202204;2308;6460;1969;6019;77;224;1589;4972;1666;5196
292670;202204;3884;10143;3033;8593;189;600;2050;5645;2239;6245
292680;202204;4495;10925;3568;9361;133;341;2748;7004;2881;7345
292690;202204;2883;7083;1986;5643;220;547;1238;3641;1458;4188
292700;202204;11463;28592;9979;26353;739;1684;7276;19466;8015;21150
292710;202204;3159;8312;2938;8038;53;171;2734;7472;2787;7643
292720;202204;10122;22006;8567;20223;426;868;6757;16376;7183;17244
292730;202204;5821;12144;5292;11378;394;617;4283;9479;4677;10096
292740;202204;394553;871492;346722;806707;39979;93272;240584;551901;280563;645173
292750;202204;7466;17395;6578;16202;210;550;5550;13619;5760;14169
292760;202204;4473;11665;3884;10671;182;577;3009;8091;3191;8668
292770;202204;7885;18456;6486;16582;841;2120;4524;11760;5365;13880
292780;202204;2390;4341;1767;3614;56;129;1473;2859;1529;2988
292790;202204;4339;8580;3282;7438;186;388;2716;6182;2902;6570
292800;202204;12496;29651;10679;26923;474;1241;8825;21989;9299;23230
292805;202204;4207;9119;3330;8029;126;302;2726;6495;2852;6797
292810;202204;14219;30512;11613;26617;656;1592;9326;20523;9982;22115
292820;202204;7885;20784;5773;17241;412;1424;4056;11865;4468;13289
292830;202204;3239;7165;2752;6594;106;239;2336;5666;2442;5905
292840;202204;10684;24498;9134;22461;198;608;8189;19796;8387;20404
292850;202204;2942;7056;2505;6454;241;566;1744;4499;1985;5065
292860;202204;19831;39441;17975;37304;601;1224;15752;32299;16353;33523
292870;202204;23464;51834;20444;47755;1331;2970;14961;34157;16292;37127
292880;202204;12882;32885;11044;30144;396;1392;8677;22840;9073;24232
292890;202204;8906;21450;7892;20050;164;570;7055;17663;7219;18233
292895;202204;3886;7225;2990;5934;233;369;2310;4639;2543;5008
292900;202204;3091;7532;2804;7126;51;210;2387;5872;2438;6082
292905;202204;5106;11853;4093;10368;116;348;3252;8014;3368;8362
292910;202204;5532;13844;5003;13133;170;450;4019;10368;4189;10818
292920;202204;11008;28124;10214;27087;272;996;8976;23389;9248;24385
292925;202204;5857;15849;4875;14037;320;895;3496;10014;3816;10909
292930;202204;7451;20213;6515;18565;726;2202;4050;11381;4776;13583
292935;202204;3016;6331;2418;5674;23;76;2201;5167;2224;5243
292937;202204;3100;7421;2656;6861;187;446;1985;5223;2172;5669
292940;202204;3327;7793;2666;6823;305;660;1781;4746;2086;5406
292950;202204;10499;25375;9180;23527;465;1150;7147;18080;7612;19230
292960;202204;5988;13485;5031;12160;160;342;4065;9768;4225;10110
292970;202204;4316;11302;3826;10613;97;332;3222;8989;3319;9321
292975;202204;4940;9954;4404;9369;127;254;4017;8540;4144;8794
292980;202204;4286;8768;3557;7761;69;195;3134;6681;3203;6876
292990;202204;13074;33424;10985;29947;446;1384;8556;22624;9002;24008
293000;202204;3085;6857;2650;6198;94;252;2106;4863;2200;5115
293010;202204;20927;49435;17009;43662;1920;4988;11220;28637;13140;33625
293015;202204;9741;27613;7700;23779;616;1883;5289;16583;5905;18466
293020;202204;11054;29527;9982;28030;166;619;9021;25292;9187;25911
293030;202204;5803;14351;4486;12345;260;571;3053;8698;3313;9269
293040;202204;4905;11707;4042;10520;77;256;3551;9168;3628;9424
293050;202204;27360;58875;24128;54258;1542;3276;18514;41105;20056;44381
293060;202204;4212;10389;3399;8897;210;585;2477;6271;2687;6856
293070;202204;30925;67554;27618;63521;1988;4653;21842;49678;23830;54331
293075;202204;4193;11757;3648;10883;91;443;3126;9240;3217;9683
293076;202204;3951;8875;3579;8438;88;170;3183;7586;3271;7756
293077;202204;7210;18457;5834;16353;691;1863;3538;10489;4229;12352
293080;202204;5220;14350;4412;12962;95;427;3622;10421;3717;10848
293090;202204;3502;9774;2716;8448;217;648;1873;5834;2090;6482
293100;202204;6507;16093;5354;14108;257;619;4239;11161;4496;11780
293105;202204;4263;12674;3674;11509;240;769;2572;8034;2812;8803
293110;202204;2748;6215;2304;5603;70;210;1914;4533;1984;4743
293120;202204;5694;13008;5171;12269;427;640;4180;10333;4607;10973
293130;202204;4057;10409;3502;9713;127;435;3026;8283;3153;8718
293135;202204;35537;78685;26424;66659;4670;12242;11670;29893;16340;42135
293140;202204;3071;5704;2716;5289;76;120;2424;4651;2500;4771
293150;202204;5740;16284;4736;14469;358;1188;3288;9938;3646;11126
293160;202204;5115;10399;4531;9756;659;852;3339;8104;3998;8956
293170;202204;6029;10757;5265;9858;91;214;4711;8677;4802;8891
293180;202204;5059;13076;4197;11550;94;365;3412;9137;3506;9502
293190;202204;17754;40749;15641;37832;135;579;14234;33838;14369;34417
293200;202204;10220;22363;8338;19482;234;611;7054;16201;7288;16812
293210;202204;5794;14073;4897;12766;382;928;3716;9733;4098;10661
293220;202204;6385;14367;4811;11881;752;1796;2877;7021;3629;8817
293230;202204;4928;10792;3687;9189;268;608;2752;6913;3020;7521
293240;202204;5207;12266;4222;10745;212;340;3139;8401;3351;8741
293245;202204;4392;10996;3978;10405;135;425;3431;8802;3566;9227
293250;202204;6613;14643;5373;13008;291;723;4262;10216;4553;10939
293260;202204;5422;12937;4459;11484;195;386;3182;8300;3377;8686
293270;202204;8578;16929;6861;15104;607;766;5437;12848;6044;13614
293280;202204;5027;12167;4385;11270;294;656;3402;8857;3696;9513
293290;202204;18602;47443;16525;44319;1532;4170;12042;32095;13574;36265
293300;202204;7215;15533;6265;14161;473;991;4753;10620;5226;11611
293305;202204;4960;10665;4236;9764;34;88;3911;8975;3945;9063
293310;202204;2437;5762;2065;5195;39;133;1697;4169;1736;4302
293315;202204;5140;10643;4283;9435;395;594;3402;7675;3797;8269
293317;202204;3279;6869;2925;6375;287;453;2208;4871;2495;5324
293320;202204;14434;31084;12883;29398;194;536;11844;26710;12038;27246
293325;202204;2070;4721;1642;4187;227;533;1068;2761;1295;3294
293330;202204;80848;199151;67302;177094;8929;25458;39132;97965;48061;123423
293340;202204;2414;6363;1962;5572;146;441;1331;3740;1477;4181
293345;202204;4177;10309;3347;9067;373;722;2241;6604;2614;7326
293350;202204;6925;18285;5941;17098;102;348;5335;15481;5437;15829
293360;202204;18241;40255;15788;37062;376;1089;14171;32863;14547;33952
310010;202204;1095;2338;738;1872;79;219;307;722;386;941
310020;202204;3257;8194;2512;6933;463;1323;948;2477;1411;3800
310030;202204;2154;5732;1672;4909;225;713;1091;3119;1316;3832
310040;202204;934;2296;738;1976;74;247;405;962;479;1209
310050;202204;1727;4711;1480;4329;97;367;1049;2962;1146;3329
310060;202204;3651;9348;3121;8650;136;448;2493;6933;2629;7381
310070;202204;373;839;274;700;10;30;205;517;215;547
310080;202204;827;2161;611;1772;77;241;314;867;391;1108
310090;202204;5563;12999;4625;11547;210;622;3686;8951;3896;9573
310100;202204;4159;10079;3520;9091;109;385;2986;7496;3095;7881
310110;202204;5353;13178;4184;11249;611;1870;2428;6197;3039;8067
310120;202204;722;1653;482;1290;69;214;256;600;325;814
310130;202204;431;1039;371;952;22;68;296;739;318;807
310140;202204;343;907;256;785;49;175;125;351;174;526
310150;202204;6873;16367;5248;13572;491;1518;2940;7008;3431;8526
310160;202204;10759;24969;8244;21086;1213;3404;3963;9694;5176;13098
310163;202204;1276;3567;1009;3054;209;698;332;902;541;1600
310170;202204;10870;25237;8833;22217;834;2038;6250;15692;7084;17730
310180;202204;2249;5084;1653;4169;151;464;1088;2601;1239;3065
310190;202204;3079;8334;2538;7418;619;1954;564;1580;1183;3534
310200;202204;2313;6238;1760;5276;260;912;864;2438;1124;3350
310205;202204;1284;3267;1033;2878;128;373;661;1865;789;2238
310210;202204;2740;7006;2234;6104;117;341;1594;4196;1711;4537
310220;202204;1334;3442;1022;2854;80;238;663;1776;743;2014
310230;202204;2518;6479;2048;5637;226;728;1332;3423;1558;4151
310240;202204;1145;3141;980;2866;61;215;678;1901;739;2116
310250;202204;1266;2988;1046;2657;36;104;835;2053;871;2157
310260;202204;3863;9492;2659;7354;666;2171;976;2206;1642;4377
310270;202204;3254;6980;2641;6180;92;246;2241;5224;2333;5470
310280;202204;2972;6292;2396;5508;156;428;1731;3754;1887;4182
310285;202204;2059;6118;1727;5521;159;587;1105;3475;1264;4062
310290;202204;1595;3950;1366;3572;154;495;888;2123;1042;2618
310300;202204;1840;4838;1539;4346;160;549;903;2355;1063;2904
310310;202204;364;828;246;637;40;110;135;328;175;438
310320;202204;569;1361;399;1090;15;60;240;617;255;677
310330;202204;556;1278;336;890;44;123;145;348;189;471
310340;202204;9278;22502;7380;19319;959;2426;4009;10443;4968;12869
310350;202204;14979;34677;10744;28040;1628;4618;5637;13998;7265;18616
310360;202204;662;1399;539;1246;23;65;364;810;387;875
310370;202204;1368;4050;1186;3736;218;749;381;1290;599;2039
310375;202204;969;2289;704;1909;144;403;333;893;477;1296
310380;202204;423;936;235;648;24;67;126;325;150;392
310390;202204;599;1679;478;1452;83;280;198;545;281;825
310400;202204;13388;31132;10120;26260;674;2154;6800;16816;7474;18970
310410;202204;1195;3337;692;2258;77;284;271;784;348;1068
310420;202204;5391;13246;4028;10873;505;1532;2094;5171;2599;6703
310430;202204;1946;4993;1352;3948;222;676;581;1499;803;2175
310440;202204;730;1811;517;1435;55;187;270;687;325;874
310445;202204;1515;4035;1131;3309;88;254;783;2231;871;2485
310450;202204;5096;11870;3929;10076;202;675;3035;7509;3237;8184
310460;202204;1971;5012;1532;4244;200;632;628;1548;828;2180
310470;202204;4067;8608;3170;7444;364;730;2118;5160;2482;5890
310480;202204;1124;2743;868;2329;92;303;533;1328;625;1631
310490;202204;3236;8305;2577;7254;315;1041;1482;3886;1797;4927
310500;202204;1613;4065;1248;3492;187;588;735;1959;922;2547
310510;202204;2538;6259;1821;4980;269;799;869;2262;1138;3061
310520;202204;1308;3216;947;2562;155;419;467;1263;622;1682
310530;202204;885;2157;635;1739;103;339;240;538;343;877
310540;202204;3418;9195;2813;8097;461;1472;1422;3773;1883;5245
310550;202204;1429;3339;1035;2699;68;244;662;1574;730;1818
310560;202204;18299;45350;13320;36525;1589;4878;6497;15928;8086;20806
310570;202204;1247;2969;978;2601;47;161;786;2039;833;2200
310590;202204;4858;11921;3898;10197;220;691;2445;5917;2665;6608
310600;202204;1542;4239;1281;3713;164;528;694;1870;858;2398
310610;202204;540;1421;353;1110;110;366;76;225;186;591
310620;202204;232486;555111;177587;459352;18911;58204;102087;239217;120998;297421
310630;202204;5253;13571;4107;11378;466;1370;2496;6682;2962;8052
310640;202204;1547;3961;1281;3482;135;453;804;1998;939;2451
310650;202204;2731;7025;2033;5755;146;501;1312;3509;1458;4010
310660;202204;1632;3924;1339;3525;34;95;1171;3046;1205;3141
310665;202204;1600;3717;1334;3369;25;76;1088;2756;1113;2832
310670;202204;70470;168536;59862;151347;4789;14104;42754;102284;47543;116388
310680;202204;884;1913;733;1709;28;99;611;1355;639;1454
310690;202204;2552;5898;1898;4917;142;451;1261;3035;1403;3486
310700;202204;559;1123;440;981;7;21;351;751;358;772
310710;202204;6956;18374;5088;15570;1048;3779;997;2743;2045;6522
310720;202204;1230;2707;978;2395;32;115;752;1764;784;1879
310730;202204;11625;28240;9964;25736;374;1248;7678;19111;8052;20359
310740;202204;7480;19339;5614;15752;711;2321;2566;6463;3277;8784
310750;202204;1482;3304;1145;2833;74;228;726;1638;800;1866
310760;202204;802;1894;582;1562;43;121;370;961;413;1082
310770;202204;1204;3115;844;2557;118;417;389;1050;507;1467
310780;202204;4889;10587;4048;9479;213;517;3109;7226;3322;7743
310790;202204;2033;6137;1756;5554;395;1405;371;989;766;2394
310800;202204;2618;7433;1934;6105;485;1752;144;397;629;2149
310810;202204;1524;3504;1279;3118;49;143;968;2243;1017;2386
310820;202204;1300;3188;818;2403;167;507;226;675;393;1182
310825;202204;3012;7937;2427;7027;60;309;2021;5627;2081;5936
310830;202204;2268;5912;1736;4953;311;1018;799;2114;1110;3132
310840;202204;2498;6416;1895;5421;387;1283;625;1552;1012;2835
310850;202204;1524;3988;1261;3604;45;218;966;2632;1011;2850
310855;202204;3537;8740;2773;7545;172;519;2027;5370;2199;5889
310860;202204;7675;20707;6283;18183;654;1789;3938;11489;4592;13278
310870;202204;1038;2379;829;2086;56;157;612;1498;668;1655
310880;202204;1049;2993;832;2564;101;316;473;1439;574;1755
310890;202204;2505;6882;1662;5203;323;1102;277;746;600;1848
310900;202204;4427;11832;3241;9409;492;1603;1482;3920;1974;5523
310910;202204;2463;5698;1746;4604;243;685;457;1100;700;1785
310920;202204;2146;5218;1653;4509;144;447;1099;2897;1243;3344
310925;202204;1202;2842;968;2499;49;161;750;1847;799;2008
310930;202204;6262;15278;4475;12502;836;2322;2176;6334;3012;8656
310940;202204;7910;16796;6486;14807;215;608;5270;11632;5485;12240
310945;202204;1481;3577;1167;3070;139;417;703;1749;842;2166
310950;202204;2104;5959;1418;4461;244;861;430;1141;674;2002
310960;202204;807;2067;486;1426;82;265;129;357;211;622
310970;202204;1294;3701;946;3002;232;765;194;588;426;1353
310980;202204;384;862;215;575;19;52;110;283;129;335
310990;202204;1564;3950;1259;3452;147;462;764;1968;911;2430
311000;202204;4482;11654;3369;9900;638;2042;1736;4832;2374;6874
311010;202204;1124;2827;928;2504;199;566;505;1331;704;1897
311020;202204;1308;3179;874;2440;52;173;485;1288;537;1461
311030;202204;2048;4838;1492;3943;313;960;674;1653;987;2613
311040;202204;329;966;273;856;78;268;81;241;159;509
311050;202204;3445;8194;2625;6989;376;1159;1369;3453;1745;4612
311060;202204;3818;9237;2883;7621;382;1135;1297;3140;1679;4275
311070;202204;2761;6352;1994;5206;226;748;1101;2607;1327;3355
311080;202204;1292;2752;1043;2378;47;148;824;1765;871;1913
311090;202204;2621;7677;2142;6822;441;1518;761;2378;1202;3896
311100;202204;2722;7341;1746;5457;343;1192;466;1272;809;2464
311110;202204;4273;8509;2386;5814;498;1209;684;1674;1182;2883
311115;202204;1572;3218;1318;2894;43;94;1112;2391;1155;2485
311120;202204;7856;19622;6066;16501;865;2668;2497;5964;3362;8632
311130;202204;2095;5268;1600;4605;128;445;965;2690;1093;3135
311140;202204;1746;4123;1361;3605;150;429;903;2345;1053;2774
311150;202204;1656;4967;1325;4356;172;648;729;2295;901;2943
311160;202204;4522;12197;3336;10090;623;2128;1370;3893;1993;6021
311170;202204;1033;2523;849;2284;48;144;534;1525;582;1669
311180;202204;1599;3396;1061;2624;178;441;566;1364;744;1805
311190;202204;963;2585;725;2126;114;378;295;738;409;1116
311200;202204;2513;6386;1860;5169;318;981;766;1877;1084;2858
311205;202204;1029;2757;857;2457;36;126;582;1566;618;1692
311210;202204;1182;3206;1046;3024;114;289;768;2302;882;2591
311220;202204;928;2298;797;2068;26;96;598;1439;624;1535
311230;202204;8962;25097;6859;20984;1154;3631;2782;8534;3936;12165
311240;202204;1210;2945;951;2588;161;478;477;1255;638;1733
311250;202204;1443;3806;1123;3252;202;642;452;1196;654;1838
311260;202204;3072;7134;2021;5371;263;807;987;2301;1250;3108
311265;202204;1500;3534;1122;2940;46;158;830;2093;876;2251
311270;202204;3331;9325;2893;8637;158;690;2117;6040;2275;6730
311280;202204;1263;3224;707;2145;142;482;155;423;297;905
311290;202204;2085;5929;1887;5544;112;365;1299;3771;1411;4136
311300;202204;5220;13362;4319;11888;212;725;3497;9402;3709;10127
311310;202204;640;1672;541;1497;30;88;365;972;395;1060
311320;202204;3627;10400;3162;9421;275;1049;1753;4721;2028;5770
311330;202204;6883;15733;5499;13651;475;1320;3391;8200;3866;9520
311340;202204;12160;31733;9753;27669;2120;6562;3472;9276;5592;15838
311350;202204;2706;6208;1999;4999;188;535;1127;2533;1315;3068
311360;202204;1234;2868;855;2345;228;670;326;926;554;1596
311370;202204;5363;12262;4001;10178;360;1113;2459;5815;2819;6928
311380;202204;435;1282;324;1058;56;183;160;523;216;706
311390;202204;1937;5610;1555;5104;655;2400;411;1204;1066;3604
311400;202204;1812;4669;1334;3802;228;679;395;946;623;1625
311410;202204;2137;5882;1722;5230;216;768;1003;2909;1219;3677
311420;202204;1763;4888;1328;4079;278;990;445;1146;723;2136
311430;202204;5001;12534;3408;9515;469;1384;1466;3860;1935;5244
311440;202204;3411;8912;2642;7673;678;2242;681;1882;1359;4124
311450;202204;2257;6350;1577;5008;410;1468;376;970;786;2438
311455;202204;1180;2548;829;2049;109;269;469;1146;578;1415
311460;202204;628;1801;427;1386;81;302;100;266;181;568
311470;202204;573;1664;401;1298;106;384;59;191;165;575
311480;202204;1271;2905;1049;2581;81;202;808;1972;889;2174
311490;202204;296;835;227;708;35;133;101;281;136;414
311500;202204;538;1261;422;1088;30;94;280;690;310;784
311510;202204;3826;9153;2748;7388;298;930;1371;3353;1669;4283
311520;202204;720;1874;634;1716;59;190;393;1043;452;1233
311530;202204;10092;22360;6888;17470;1360;3963;2553;6043;3913;10006
311535;202204;945;2432;679;1903;106;322;298;778;404;1100
311540;202204;562;1634;498;1521;58;211;367;1093;425;1304
311545;202204;2219;5973;1924;5528;98;333;1511;4277;1609;4610
311547;202204;1860;4043;1630;3717;49;99;1337;2975;1386;3074
311550;202204;3353;8583;2736;7533;392;1199;1266;3220;1658;4419
311560;202204;349;710;217;504;36;91;81;157;117;248
311570;202204;1701;3792;1203;3110;43;118;914;2409;957;2527
311580;202204;2501;4602;1749;3706;142;286;1246;2576;1388;2862
311590;202204;619;1564;508;1406;69;208;315;853;384;1061
311600;202204;1764;3967;1468;3576;137;383;1116;2643;1253;3026
311610;202204;2580;7389;2151;6589;139;510;1413;4155;1552;4665
311615;202204;3873;9728;3134;8549;129;445;2541;6756;2670;7201
311620;202204;609;1544;479;1360;61;194;280;752;341;946
311630;202204;1479;3858;1217;3339;135;357;752;2037;887;2394
311640;202204;845;2158;674;1885;88;287;361;934;449;1221
311650;202204;2167;5075;1746;4442;199;542;1080;2650;1279;3192
311660;202204;3347;9133;2508;7521;396;1307;694;1639;1090;2946
311670;202204;1821;4370;1356;3562;154;464;689;1748;843;2212
311680;202204;2521;6497;1950;5532;139;392;1381;3966;1520;4358
311690;202204;671;1345;515;1152;32;70;376;859;408;929
311700;202204;2334;5303;1807;4553;23;100;1517;3716;1540;3816
311710;202204;1764;4802;1302;4027;308;1015;483;1480;791;2495
311720;202204;472;1332;380;1165;48;161;201;616;249;777
311730;202204;4664;11238;3258;8622;803;2241;1282;3201;2085;5442
311740;202204;1093;2669;910;2418;75;161;726;1985;801;2146
311750;202204;4492;12373;3666;10973;325;1195;2431;6868;2756;8063
311760;202204;759;2009;593;1718;92;318;244;580;336;898
311770;202204;2495;6670;1967;5765;374;1190;814;2219;1188;3409
311780;202204;1598;4316;1201;3606;217;716;441;1174;658;1890
311783;202204;2578;6382;2113;5644;57;237;1736;4455;1793;4692
311787;202204;922;2511;729;2092;103;324;323;800;426;1124
311790;202204;1702;4497;1158;3494;231;790;381;1036;612;1826
311800;202204;5628;15945;4514;13638;927;2862;816;1988;1743;4850
311810;202204;1040;2894;833;2540;53;179;565;1696;618;1875
311820;202204;1006;2244;789;1929;49;166;552;1250;601;1416
311830;202204;9569;25824;7002;20554;2017;6156;1346;3863;3363;10019
311840;202204;4279;9979;3452;8833;238;631;2619;6677;2857;7308
311850;202204;399;977;315;832;14;54;219;549;233;603
311860;202204;77080;181369;61015;154826;6549;18882;38783;92380;45332;111262
311870;202204;2087;5297;1481;4275;266;930;634;1647;900;2577
311880;202204;7172;17308;6012;15713;349;855;4534;12013;4883;12868
311890;202204;2004;4410;1582;3846;57;198;1219;2780;1276;2978
311900;202204;806;1939;623;1697;101;252;352;994;453;1246
311910;202204;4713;11238;3635;9835;684;1863;1842;5036;2526;6899
311920;202204;2426;5862;1965;5215;118;285;1354;3608;1472;3893
311930;202204;4918;10633;3687;8998;765;2067;1788;4019;2553;6086
311940;202204;17943;44235;13288;35817;1717;5118;6308;15701;8025;20819
311950;202204;2640;6503;2003;5412;180;524;1253;3356;1433;3880
311960;202204;548;1296;438;1137;46;143;230;530;276;673
311970;202204;475;1456;354;1161;71;271;91;255;162;526
311980;202204;513;1310;281;861;35;124;107;290;142;414
311990;202204;590;1358;389;1057;60;197;172;415;232;612
311995;202204;1056;2860;563;1731;32;117;86;173;118;290
312000;202204;908;2031;684;1709;40;114;498;1223;538;1337
312010;202204;1202;2970;963;2604;37;141;708;1818;745;1959
312015;202204;1526;4075;1356;3805;64;265;1094;2973;1158;3238
312020;202204;1984;5770;1433;4541;265;913;334;923;599;1836
312030;202204;2387;5141;2057;4772;37;135;1902;4341;1939;4476
312040;202204;930;2611;670;2103;101;310;307;932;408;1242
312050;202204;1348;3892;1105;3467;235;927;415;1152;650;2079
312060;202204;1065;2491;708;2009;150;435;339;939;489;1374
312070;202204;1024;2730;746;2197;41;148;457;1246;498;1394
312080;202204;3160;7393;2458;6364;134;405;1703;4146;1837;4551
312083;202204;1089;2526;847;2168;50;174;662;1623;712;1797
312087;202204;2893;6707;2356;5907;77;202;1935;4822;2012;5024
312090;202204;12479;30654;9932;26681;1110;3487;5798;14645;6908;18132
312100;202204;1837;4802;1438;4135;95;371;947;2548;1042;2919
312110;202204;1106;3263;912;2873;166;636;410;1166;576;1802
312120;202204;1125;2980;796;2396;189;676;268;677;457;1353
312125;202204;2106;4947;1797;4534;90;271;1445;3527;1535;3798
312130;202204;1266;2885;940;2351;86;252;479;1072;565;1324
312140;202204;783;2195;651;1932;106;345;321;893;427;1238
312150;202204;536;1381;459;1242;25;77;311;784;336;861
312160;202204;10455;26289;8212;22508;914;2919;4357;11208;5271;14127
312170;202204;1009;2471;777;2057;46;144;520;1327;566;1471
312180;202204;1559;3905;1280;3428;133;386;755;1925;888;2311
312190;202204;857;2210;663;1877;65;216;355;940;420;1156
312200;202204;5344;13406;4250;11678;607;1642;2446;6628;3053;8270
312210;202204;1558;3199;1178;2683;50;153;937;2060;987;2213
312220;202204;1827;5220;1572;4773;126;420;1058;3200;1184;3620
312230;202204;19121;46256;13839;37214;2794;8519;4549;10418;7343;18937
312235;202204;2338;5373;1875;4736;192;463;1294;3198;1486;3661
312240;202204;869;2611;672;2206;145;495;223;719;368;1214
312245;202204;3313;7199;2800;6468;36;102;2508;5677;2544;5779
312247;202204;1218;2602;875;2111;101;257;566;1311;667;1568
312250;202204;1020;2607;653;1911;98;310;223;624;321;934
312260;202204;1119;2731;897;2396;44;168;718;1822;762;1990
312270;202204;803;2126;622;1776;35;139;349;892;384;1031
312280;202204;473;1320;376;1147;80;270;118;326;198;596
312290;202204;1000;2713;835;2447;151;496;297;793;448;1289
312300;202204;1194;3422;856;2631;189;638;191;476;380;1114
312310;202204;1090;3042;885;2650;111;381;481;1369;592;1750
312320;202204;2351;5650;1727;4618;352;949;467;1214;819;2163
312330;202204;1019;2706;845;2375;96;294;516;1385;612;1679
312340;202204;276;675;199;556;30;117;113;271;143;388
312350;202204;301;588;212;489;16;39;142;296;158;335
312352;202204;1699;4915;1497;4540;253;781;753;2470;1006;3251
312360;202204;3607;9750;2744;8203;503;1698;1142;3145;1645;4843
312370;202204;2252;5408;1855;4796;195;591;1197;2927;1392;3518
312380;202204;2457;5187;2039;4665;5;15;1807;4047;1812;4062
312385;202204;1408;3546;1103;3022;340;950;293;849;633;1799
312390;202204;2167;5813;1613;4789;250;835;477;1247;727;2082
312400;202204;3414;9145;2907;8334;827;2553;998;2902;1825;5455
312410;202204;15182;38200;12585;34128;1577;4643;8092;21170;9669;25813
312420;202204;4533;11230;3752;10002;713;2079;1981;5083;2694;7162
312430;202204;9522;22759;7825;19890;267;873;5954;14517;6221;15390
312440;202204;1113;3346;931;2984;427;1422;189;606;616;2028
312450;202204;1480;4053;1143;3458;249;800;501;1513;750;2313
312460;202204;534;1252;394;1047;36;116;250;645;286;761
312470;202204;528;1268;338;932;50;152;105;247;155;399
312480;202204;1165;2772;843;2302;70;243;491;1253;561;1496
312490;202204;2772;5865;2228;5133;165;419;1459;3232;1624;3651
312500;202204;1187;2672;996;2420;32;116;774;1850;806;1966
312510;202204;4930;12525;3615;10128;806;2207;1117;2970;1923;5177
312520;202204;366;872;289;754;49;165;169;411;218;576
312530;202204;763;1667;645;1527;33;76;485;1174;518;1250
312540;202204;1767;4564;1224;3557;132;389;702;1971;834;2360
312550;202204;911;2231;703;1839;50;156;460;1106;510;1262
312560;202204;2037;5130;1601;4447;100;308;1141;3145;1241;3453
312570;202204;2895;6370;2192;5503;408;948;1157;3005;1565;3953
312580;202204;687;1792;478;1365;50;179;230;597;280;776
312590;202204;1715;4649;1344;3924;129;451;800;2123;929;2574
312595;202204;2334;6267;1931;5639;252;653;1216;3753;1468;4406
312600;202204;1401;3233;926;2295;130;402;270;681;400;1083
312610;202204;8009;19426;5513;14932;794;2417;2127;5100;2921;7517
312620;202204;2775;6634;2103;5703;66;257;1687;4576;1753;4833
312630;202204;360;952;260;775;43;160;113;307;156;467
312640;202204;591;1566;439;1323;39;144;235;671;274;815
312650;202204;2349;5458;1682;4269;58;189;1245;2943;1303;3132
312660;202204;1498;3372;1161;2826;99;240;806;1864;905;2104
312670;202204;6298;14465;5291;12941;153;628;4238;9723;4391;10351
312675;202204;1378;3343;1128;2989;42;145;931;2406;973;2551
312680;202204;1723;4154;1530;3876;49;196;1340;3279;1389;3475
312690;202204;3251;6590;2476;5637;117;238;1979;4494;2096;4732
312695;202204;1163;2791;988;2516;39;80;817;2055;856;2135
312700;202204;2297;5817;1670;4697;159;521;948;2514;1107;3035
312705;202204;1805;3695;1590;3398;12;42;1496;3165;1508;3207
312707;202204;1588;4224;1133;3401;56;247;766;2149;822;2396
312710;202204;7824;17276;5050;13119;1232;3130;1734;4683;2966;7813
312720;202204;1220;3018;931;2569;92;297;623;1624;715;1921
312730;202204;1767;4000;1266;3326;105;306;799;2033;904;2339
312733;202204;1485;3750;1120;3083;44;153;765;1969;809;2122
312735;202204;865;2127;692;1806;59;163;441;1062;500;1225
312737;202204;905;1892;659;1553;58;157;465;1051;523;1208
312738;202204;854;2026;616;1617;54;162;386;937;440;1099
312740;202204;486;1208;307;913;64;209;88;198;152;407
312750;202204;1691;4582;1250;3782;164;569;605;1710;769;2279
312760;202204;2027;5633;1483;4550;234;744;598;1762;832;2506
312770;202204;50358;116074;32950;86942;5569;16005;13169;32988;18738;48993
312780;202204;2855;7692;2420;6978;258;797;1594;4500;1852;5297
312790;202204;265;617;141;415;6;25;33;63;39;88
312800;202204;6036;15635;4747;13292;619;2001;2593;6804;3212;8805
312810;202204;1759;4554;1193;3604;295;952;431;1212;726;2164
312820;202204;1946;4887;1580;4272;88;248;1152;3054;1240;3302
312825;202204;1651;3403;1419;3109;26;68;1246;2675;1272;2743
312830;202204;3099;8280;2007;6144;432;1422;568;1634;1000;3056
312840;202204;1633;4028;1292;3485;108;363;766;1942;874;2305
312850;202204;1168;2499;847;2052;28;111;583;1290;611;1401
312860;202204;1210;2982;834;2399;203;615;257;668;460;1283
312870;202204;6794;17384;4386;12920;716;2245;1281;3418;1997;5663
312880;202204;1634;3888;1285;3325;73;190;764;1949;837;2139
312890;202204;2588;5977;1939;4945;124;286;1120;2790;1244;3076
312900;202204;1457;3518;1203;3184;120;374;726;1944;846;2318
312910;202204;1656;2963;962;2074;149;300;483;999;632;1299
312920;202204;1071;2753;768;2277;121;422;294;767;415;1189
312930;202204;2689;6183;2041;5232;366;958;1028;2691;1394;3649
312940;202204;1136;2882;913;2578;76;287;540;1423;616;1710
312950;202204;3556;8207;2483;6555;399;1179;1251;3108;1650;4287
312960;202204;2022;4954;1691;4462;106;239;1241;3384;1347;3623
312965;202204;1850;4645;1536;4164;137;379;1033;2781;1170;3160
312970;202204;1704;4513;1395;4041;149;531;878;2399;1027;2930
312980;202204;28628;74242;23445;65224;4000;12116;11866;31087;15866;43203
312990;202204;595;1385;420;1102;61;190;225;534;286;724
313000;202204;521;1411;395;1190;25;109;256;722;281;831
313005;202204;2797;7560;2353;6837;127;385;1737;4912;1864;5297
313010;202204;6233;15903;5031;13989;715;2229;3117;8404;3832;10633
313020;202204;1232;3561;928;2923;160;573;221;606;381;1179
313030;202204;1312;2778;922;2246;54;177;667;1530;721;1707
313040;202204;945;2769;792;2476;39;170;506;1511;545;1681
313050;202204;2040;5309;1440;4409;236;852;435;1207;671;2059
313055;202204;2152;5355;1891;4980;356;943;1302;3404;1658;4347
313060;202204;1153;2689;862;2197;186;562;218;509;404;1071
313065;202204;1841;5039;1623;4682;48;210;1327;3707;1375;3917
313070;202204;1020;2584;799;2229;76;218;456;1235;532;1453
313080;202204;428;1142;323;953;58;195;125;307;183;502
313090;202204;6011;14594;5047;13103;333;914;3523;9050;3856;9964
313100;202204;1488;3657;1181;3220;42;154;887;2336;929;2490
313110;202204;1681;4209;1211;3399;111;374;648;1638;759;2012
313115;202204;3218;8540;2602;7420;269;944;1501;3901;1770;4845
313120;202204;4212;9566;3098;8096;206;553;2111;5548;2317;6101
313130;202204;36512;88406;28063;73647;2666;8128;16621;40704;19287;48832
313140;202204;811;1656;552;1317;27;65;436;1031;463;1096
313150;202204;1557;4196;1179;3539;370;1230;228;605;598;1835
313160;202204;1472;3480;1151;3012;24;89;885;2222;909;2311
313170;202204;12892;34451;9717;28624;1611;5216;3807;10144;5418;15360
313180;202204;2709;6714;2013;5305;211;558;1298;3293;1509;3851
313190;202204;4969;13552;3725;11153;645;2104;1419;3875;2064;5979
313200;202204;1298;3220;1111;2901;18;71;933;2345;951;2416
313210;202204;4441;11517;3685;10297;420;1352;2345;6262;2765;7614
313220;202204;2034;5104;1402;3898;167;520;658;1621;825;2141
313230;202204;3146;8282;2564;7555;69;225;2089;6270;2158;6495
313240;202204;12091;28224;8432;22603;940;3008;4610;11439;5550;14447
313250;202204;6986;19446;5407;16118;966;2912;2555;7287;3521;10199
313260;202204;869;2070;630;1689;80;292;345;792;425;1084
313270;202204;7121;15538;5903;13935;493;1096;4577;10905;5070;12001
313280;202204;517;1337;348;1010;45;153;160;437;205;590
313290;202204;1137;3418;873;2944;197;753;343;1113;540;1866
313300;202204;2011;5155;1556;4396;342;1048;546;1385;888;2433
313310;202204;1516;4267;1227;3677;206;736;444;1094;650;1830
313320;202204;2248;5685;1618;4691;305;945;636;1905;941;2850
313330;202204;4658;11377;3562;9768;227;705;2389;6467;2616;7172
313340;202204;1710;3639;1277;3046;84;240;952;2195;1036;2435
313350;202204;3362;8877;2313;6640;240;825;1011;2489;1251;3314
313360;202204;1788;4160;1248;3314;189;614;664;1595;853;2209
313370;202204;1790;4655;1433;3977;259;770;590;1480;849;2250
313375;202204;2110;5287;1390;4002;244;815;392;991;636;1806
313380;202204;7471;17746;5630;14501;790;2406;3045;6929;3835;9335
313390;202204;889;2659;774;2456;56;245;529;1603;585;1848
313400;202204;4208;9622;3255;8266;155;451;2496;6201;2651;6652
313410;202204;1554;3792;1154;3110;215;605;633;1630;848;2235
313420;202204;17607;37923;9917;25493;2409;6692;1786;4460;4195;11152
313430;202204;1256;3147;1035;2746;85;320;699;1661;784;1981
313440;202204;7429;15008;5303;12349;220;583;4018;9131;4238;9714
313450;202204;833;2097;603;1687;110;334;215;505;325;839
313460;202204;2501;6677;2006;5905;361;1195;1007;2866;1368;4061
313470;202204;3144;7522;2514;6603;140;439;1932;4976;2072;5415
313480;202204;1198;3259;748;2320;75;259;277;781;352;1040
313490;202204;3445;8305;1930;5585;340;1083;599;1626;939;2709
313500;202204;644;1640;469;1296;42;115;209;529;251;644
313505;202204;11300;27912;9626;25632;366;1123;7766;20568;8132;21691
313507;202204;1571;3792;1259;3323;44;162;1013;2593;1057;2755
313510;202204;16614;42582;13047;35784;1302;3859;7132;18370;8434;22229
313520;202204;17189;43162;13898;37778;668;2212;10776;28374;11444;30586
313530;202204;652;1841;495;1514;63;229;212;557;275;786
313535;202204;2610;6842;2128;5948;242;640;1323;3672;1565;4312
313540;202204;943;2582;753;2150;106;328;371;948;477;1276
313545;202204;1264;3922;1075;3563;117;459;608;1934;725;2393
313550;202204;2296;6243;1921;5389;198;618;1285;3491;1483;4109
313560;202204;3238;5701;2441;4757;40;76;2165;4173;2205;4249
313570;202204;1117;3022;929;2696;172;510;453;1282;625;1792
313580;202204;6722;15581;5307;13344;417;1163;3598;8752;4015;9915
313590;202204;1274;3189;1038;2861;201;554;559;1626;760;2180
313600;202204;4882;11363;4120;10238;80;299;3661;8872;3741;9171
313610;202204;1158;2740;947;2385;75;220;633;1493;708;1713
313620;202204;6250;15605;5060;13524;459;1461;3273;8389;3732;9850
313630;202204;10063;23113;7273;18981;686;2133;4537;11354;5223;13487
313640;202204;1439;2848;947;2226;83;220;654;1502;737;1722
313650;202204;1844;5269;1456;4627;112;411;921;2968;1033;3379
313652;202204;957;2599;861;2438;58;207;649;1739;707;1946
313655;202204;1302;3000;1015;2647;76;198;729;1893;805;2091
313657;202204;1297;3207;1020;2768;37;137;757;1905;794;2042
313660;202204;1227;3081;1025;2744;70;254;746;1883;816;2137
313665;202204;6171;15137;4961;13073;377;1175;3397;8398;3774;9573
313670;202204;60043;140565;41024;109362;5138;15332;20679;51666;25817;66998
313680;202204;1214;2930;999;2588;52;140;689;1697;741;1837
313690;202204;1068;3045;780;2479;160;564;239;693;399;1257
313695;202204;2037;5065;1530;4234;112;302;1028;2909;1140;3211
313700;202204;3143;9250;2714;8698;223;762;2157;6941;2380;7703
313710;202204;1653;3538;1192;2948;95;262;807;1966;902;2228
313720;202204;6888;17874;5042;14171;675;2058;2280;5789;2955;7847
313730;202204;1611;3227;1209;2714;90;172;804;1796;894;1968
313740;202204;1855;6357;1573;5666;352;1452;393;1256;745;2708
313750;202204;2457;6013;1974;5231;294;899;1137;2758;1431;3657
313753;202204;2429;5690;1635;4414;224;687;762;1948;986;2635
313760;202204;6563;17106;5220;14647;826;2563;2637;6798;3463;9361
313770;202204;4592;12097;3648;10644;201;566;2768;8192;2969;8758
313780;202204;4561;11290;3414;9509;438;1165;1137;3289;1575;4454
313790;202204;633;1733;550;1581;73;222;333;925;406;1147
313800;202204;1542;3273;1132;2717;94;267;660;1475;754;1742
313810;202204;1923;4444;1554;3936;51;183;1258;3088;1309;3271
313820;202204;19905;48728;13239;35018;2170;5926;3924;9684;6094;15610
313830;202204;457;1269;335;1012;59;204;142;394;201;598
313835;202204;1011;2743;837;2453;82;304;465;1246;547;1550
313840;202204;8918;22074;7081;19175;1557;4452;2048;5554;3605;10006
313850;202204;1106;2541;883;2239;134;392;469;1090;603;1482
313860;202204;3087;7651;2374;6411;314;1009;1198;2924;1512;3933
313862;202204;1345;2791;694;1859;43;127;339;934;382;1061
313865;202204;2918;7154;2412;6370;76;238;1865;4751;1941;4989
313867;202204;1586;4523;1263;3905;230;708;670;2164;900;2872
313868;202204;1917;5384;1563;4747;53;212;1203;3515;1256;3727
313870;202204;1176;2847;796;2187;86;249;362;894;448;1143
313880;202204;2226;5477;1682;4568;176;564;952;2336;1128;2900
313890;202204;2546;4882;1935;4101;48;135;1538;3130;1586;3265
313900;202204;5723;15260;4111;11998;922;2941;1246;3180;2168;6121
313910;202204;830;2323;633;1935;118;376;156;476;274;852
313920;202204;3200;8974;2655;7909;445;1404;1435;4229;1880;5633
313925;202204;1861;4338;1505;3745;154;367;1016;2504;1170;2871
313930;202204;5525;14706;4477;12927;282;970;3126;8799;3408;9769
313940;202204;10921;29874;8495;25873;1503;4909;2280;7551;3783;12460
313950;202204;6328;12781;4944;11096;256;664;3609;8000;3865;8664
313960;202204;6503;14839;4383;11356;748;2233;1632;3721;2380;5954
313970;202204;1756;4384;1502;3977;52;156;1026;2617;1078;2773
313980;202204;1509;3771;1047;3080;182;606;468;1303;650;1909
313990;202204;2243;6547;1728;5469;279;1085;893;2499;1172;3584
314000;202204;11756;27703;9615;24194;662;2054;6429;15787;7091;17841
314010;202204;1575;3565;1243;3113;39;136;966;2317;1005;2453
314015;202204;2423;6240;1927;5400;188;634;1156;3035;1344;3669
314020;202204;579;1474;393;1160;112;389;61;189;173;578
314030;202204;918;2461;717;2085;102;308;347;986;449;1294
314040;202204;691;1796;579;1595;74;254;323;843;397;1097
314050;202204;2166;5363;1622;4407;107;369;995;2475;1102;2844
314053;202204;2331;6284;1888;5432;294;776;1131;3367;1425;4143
314055;202204;2603;6120;2206;5556;71;222;1809;4563;1880;4785
314060;202204;1478;3682;1120;3124;36;124;800;2179;836;2303
314070;202204;5530;13991;4472;12201;670;1865;2404;6395;3074;8260
314080;202204;2260;5610;1646;4632;151;498;780;1988;931;2486
314085;202204;2632;6674;2123;5948;216;612;1344;3735;1560;4347
314090;202204;5734;13851;4973;12782;392;1013;3371;8900;3763;9913
314100;202204;3340;7725;2601;6711;58;176;1931;5016;1989;5192
314110;202204;5634;14888;4638;13080;480;1511;2660;6896;3140;8407
314120;202204;785;1750;365;1003;73;230;121;289;194;519
314130;202204;745;1880;505;1444;27;93;316;869;343;962
314140;202204;5150;13208;4123;11378;409;1236;2416;6407;2825;7643
314150;202204;1632;3896;1182;3130;78;215;803;2085;881;2300
314160;202204;2627;6295;1942;5133;211;593;949;2434;1160;3027
314170;202204;1044;2702;840;2308;40;165;574;1438;614;1603
314180;202204;6255;15903;5012;13985;449;1298;2975;8255;3424;9553
314190;202204;704;1670;533;1430;61;200;329;819;390;1019
314200;202204;3320;8792;2759;7883;208;613;1872;5252;2080;5865
314210;202204;2308;5664;1840;4862;291;808;766;1934;1057;2742
314220;202204;1789;4631;1422;4044;219;736;690;1808;909;2544
314225;202204;1201;3284;982;2888;93;264;663;1902;756;2166
314230;202204;988;2429;806;2181;84;235;542;1472;626;1707
314240;202204;1224;3143;960;2759;196;596;436;1231;632;1827
314250;202204;500;1387;328;1024;35;122;135;378;170;500
314260;202204;1262;3067;1007;2729;216;585;497;1308;713;1893
314270;202204;3753;9797;3092;8778;104;375;2314;6460;2418;6835
314280;202204;4032;8906;2817;7130;269;775;1735;4120;2004;4895
314290;202204;5089;12223;4276;10853;275;730;3066;7546;3341;8276
314300;202204;2288;6150;1484;4468;282;917;516;1399;798;2316
314310;202204;4337;10993;3009;8790;882;2887;465;1211;1347;4098
314315;202204;1077;3164;908;2830;53;219;652;1971;705;2190
314320;202204;3613;9233;2442;7094;390;1293;1012;2721;1402;4014
314330;202204;59603;159327;46306;136391;10750;32779;13229;39111;23979;71890
314340;202204;2881;6932;1908;5245;368;1154;621;1459;989;2613
314345;202204;1675;4463;1380;3960;101;309;987;2742;1088;3051
314350;202204;931;2438;632;1905;134;443;149;338;283;781
314360;202204;609;1690;410;1277;58;193;125;341;183;534
314370;202204;837;2070;678;1833;42;137;471;1213;513;1350
314380;202204;1305;3389;909;2731;218;728;276;802;494;1530
314390;202204;16747;39822;11845;31521;1648;4924;4951;11612;6599;16536
314400;202204;4443;12662;3455;10756;913;2971;1343;4348;2256;7319
314410;202204;3307;8886;2330;7007;413;1422;598;1785;1011;3207
314420;202204;898;2096;668;1740;27;89;450;1112;477;1201
314430;202204;9060;20372;6525;16405;896;2359;3303;7912;4199;10271
314435;202204;2103;5348;1645;4634;249;752;942;2578;1191;3330
314437;202204;1007;2402;734;1965;64;182;444;1170;508;1352
314440;202204;676;1863;486;1497;139;483;113;284;252;767
314450;202204;1654;4102;1373;3655;159;467;782;1968;941;2435
314460;202204;3744;10673;2844;8888;690;2310;953;2725;1643;5035
314465;202204;2601;6792;2131;5940;56;218;1675;4463;1731;4681
314467;202204;1075;2635;902;2352;55;158;652;1651;707;1809
314470;202204;2534;6842;2111;6046;308;961;1084;2921;1392;3882
314480;202204;8855;23322;6878;19379;1018;3174;3050;7703;4068;10877
314490;202204;1192;2953;874;2350;66;209;583;1498;649;1707
314500;202204;1983;4522;1449;3841;326;844;592;1587;918;2431
314505;202204;2453;5356;2014;4761;111;265;1551;3556;1662;3821
314510;202204;2270;5698;1652;4784;385;1227;699;1979;1084;3206
314520;202204;6544;18718;5220;16192;1151;3911;1212;3404;2363;7315
314530;202204;6101;17716;5467;16593;286;1154;4184;12257;4470;13411
314535;202204;3014;7059;2420;6205;118;355;1891;4823;2009;5178
314537;202204;1344;3531;1042;3054;64;179;748;2154;812;2333
314540;202204;486;1142;357;940;16;43;212;516;228;559
314545;202204;2209;4793;1989;4542;51;128;1721;3983;1772;4111
314550;202204;849;1932;581;1518;41;136;336;782;377;918
314560;202204;5366;14836;4082;12174;521;1866;1800;4676;2321;6542
314570;202204;346;924;249;749;24;82;128;392;152;474
314580;202204;532;1512;426;1303;95;290;160;481;255;771
314585;202204;741;2140;583;1811;52;192;284;826;336;1018
314587;202204;2517;6312;1962;5444;458;1164;1053;2979;1511;4143
314590;202204;4812;12227;3718;10301;431;1385;1869;4759;2300;6144
314600;202204;2089;5473;1355;4134;327;1059;182;500;509;1559
314610;202204;10504;24917;8122;21341;970;3072;4095;11049;5065;14121
314620;202204;2695;5720;2202;5105;104;225;1841;4271;1945;4496
314625;202204;1738;4311;1489;3966;33;162;1279;3315;1312;3477
314630;202204;5912;13891;4797;12374;168;516;3944;10089;4112;10605
314640;202204;852;1834;650;1523;48;139;453;979;501;1118
314650;202204;943;2100;631;1620;62;195;381;880;443;1075
314655;202204;1703;4427;1222;3612;170;496;627;1858;797;2354
314660;202204;392;821;284;640;14;33;204;437;218;470
314670;202204;1856;3892;1295;3130;26;73;922;2154;948;2227
314675;202204;1881;4548;1600;4099;87;234;1258;3153;1345;3387
314690;202204;2280;5937;1738;5136;424;1274;722;2122;1146;3396
314700;202204;12791;33307;8917;26324;1463;4726;3928;11009;5391;15735
314710;202204;9327;24860;6984;20063;997;3215;2876;7228;3873;10443
314720;202204;2546;7218;1818;5752;352;1205;412;1146;764;2351
314730;202204;2764;6870;1975;5478;334;1027;752;1889;1086;2916
314740;202204;3563;9383;2835;8134;425;1314;1524;4181;1949;5495
314750;202204;319;814;250;673;29;87;148;355;177;442
314760;202204;2111;5940;1401;4397;223;821;401;997;624;1818
314770;202204;1154;3208;699;2151;94;296;218;631;312;927
314780;202204;403;970;289;790;29;100;166;415;195;515
314790;202204;13517;34204;9942;27864;1481;4746;4565;12080;6046;16826
314795;202204;1697;4145;1450;3750;38;159;1164;2867;1202;3026
314800;202204;12613;30897;8448;23547;1438;4397;2868;7113;4306;11510
314810;202204;10989;27497;8318;23091;2031;5956;3182;8511;5213;14467
314820;202204;1480;3335;1166;2880;78;248;760;1787;838;2035
314830;202204;1932;5176;1598;4607;162;491;949;2637;1111;3128
314840;202204;966;2832;758;2463;48;222;548;1697;596;1919
314850;202204;2698;5288;2201;4683;43;125;1982;4156;2025;4281
314860;202204;3675;9825;3090;8811;162;612;2256;6192;2418;6804
314870;202204;7595;16316;5860;14196;278;670;4503;11076;4781;11746
314875;202204;2108;5856;1864;5534;212;530;1411;4313;1623;4843
314880;202204;911;2123;705;1809;43;121;448;1113;491;1234
314890;202204;509;1440;395;1224;55;190;190;533;245;723
314900;202204;950;2281;737;1928;88;265;381;960;469;1225
314910;202204;1890;5064;1419;4301;207;745;728;2055;935;2800
314915;202204;2379;6552;1961;5821;146;477;1309;3820;1455;4297
314920;202204;585;1425;410;1175;19;63;287;827;306;890
314930;202204;6672;17817;5220;15160;834;2742;2349;6224;3183;8966
314940;202204;463;1050;385;927;29;66;277;633;306;699
314950;202204;676;1620;478;1322;42;154;271;681;313;835
314960;202204;1026;2258;809;1922;51;136;587;1332;638;1468
314970;202204;1223;3447;952;2918;149;487;441;1255;590;1742
314980;202204;1996;4842;1560;4212;187;581;998;2615;1185;3196
314990;202204;3022;8315;2238;6637;370;1156;604;1600;974;2756
314995;202204;1881;4911;1501;4253;49;187;1006;2674;1055;2861
315000;202204;1271;3033;924;2496;90;270;595;1561;685;1831
315010;202204;428;1112;339;971;39;142;198;533;237;675
315015;202204;2731;7044;2384;6478;223;720;1670;4392;1893;5112
315020;202204;875;2433;641;1957;68;259;320;906;388;1165
315030;202204;711;1784;497;1409;155;429;117;296;272;725
315040;202204;1077;2700;900;2421;154;428;558;1419;712;1847
315050;202204;1342;3249;1008;2753;71;230;547;1425;618;1655
315053;202204;1352;3285;1016;2719;80;271;612;1537;692;1808
315057;202204;1998;5479;1610;4847;155;395;1054;3360;1209;3755
315060;202204;754;2126;561;1750;111;368;154;447;265;815
315070;202204;778;1777;601;1497;103;300;318;682;421;982
315080;202204;3631;9221;2827;7833;146;487;2032;5341;2178;5828
315090;202204;908;2579;701;2225;93;319;311;916;404;1235
315100;202204;1555;4317;1060;3245;135;493;495;1324;630;1817
315110;202204;2405;5361;1774;4439;156;371;1028;2553;1184;2924
315120;202204;14325;31468;10750;26242;1136;2614;6565;16144;7701;18758
315130;202204;1902;4943;1622;4479;168;555;775;1967;943;2522
315140;202204;3395;8905;2725;7764;526;1660;1448;3864;1974;5524
315150;202204;4954;11776;3607;9651;504;1534;1779;4654;2283;6188
315160;202204;2131;4917;1485;3924;249;698;759;1950;1008;2648
315170;202204;1529;4635;1115;3669;230;800;328;1043;558;1843
315180;202204;19777;46357;11897;32443;1569;4916;4542;10898;6111;15814
315190;202204;2432;5109;1916;4449;174;402;1453;3393;1627;3795
315200;202204;4862;12782;3683;10826;1014;3126;1213;3438;2227;6564
315210;202204;10046;24708;7186;19089;679;2021;3718;8816;4397;10837
315213;202204;1186;3009;1032;2796;21;85;854;2253;875;2338
315217;202204;3071;8282;2343;7074;115;492;1631;4701;1746;5193
315220;202204;9784;24969;7809;21687;676;1755;4439;12478;5115;14233
315230;202204;3305;7067;2702;6272;195;366;1825;4448;2020;4814
315240;202204;2741;7445;2284;6668;461;1409;1156;3371;1617;4780
315250;202204;16280;41598;12231;34259;1802;5558;5650;14705;7452;20263
315260;202204;1016;2626;599;1800;135;393;63;171;198;564
315270;202204;1052;2858;793;2372;136;449;310;815;446;1264
315280;202204;3358;8053;2228;6108;589;1698;502;1366;1091;3064
315290;202204;1334;3137;832;2360;191;590;322;878;513;1468
315300;202204;755;1754;555;1455;32;100;391;1007;423;1107
315310;202204;1428;3503;1115;2967;92;281;740;1806;832;2087
315320;202204;712;2008;508;1610;68;259;201;595;269;854
315330;202204;850;2616;514;1789;62;253;206;619;268;872
315340;202204;3308;7716;2304;6201;437;1231;1036;2714;1473;3945
315350;202204;2062;4952;1724;4443;149;440;1246;3092;1395;3532
315360;202204;1969;5421;1554;4634;212;644;718;2013;930;2657
315370;202204;628;1650;509;1433;69;194;257;693;326;887
315380;202204;287;761;198;581;38;108;25;54;63;162
315390;202204;1357;3638;1110;3211;101;380;645;1695;746;2075
315400;202204;4632;11676;3712;10097;417;1267;2290;5872;2707;7139
315410;202204;2707;5855;2007;4850;382;1019;475;1161;857;2180
315415;202204;1653;4270;1349;3787;315;1027;407;1091;722;2118
315420;202204;1681;4484;1204;3627;249;800;323;871;572;1671
315430;202204;4078;9493;2891;7747;456;1381;1443;3725;1899;5106
315440;202204;1163;2858;919;2479;76;251;557;1380;633;1631
315445;202204;2310;4977;1721;4164;69;235;1409;3305;1478;3540
315450;202204;2529;6483;2073;5759;218;592;1354;3704;1572;4296
315460;202204;48310;123244;40804;110560;4255;13889;26204;66039;30459;79928
315470;202204;757;2008;545;1517;43;133;286;736;329;869
315480;202204;1408;3801;1033;3032;152;474;449;1230;601;1704
315490;202204;3250;7762;2286;6229;294;857;947;2416;1241;3273
315500;202204;592;1522;378;1094;31;109;208;531;239;640
315510;202204;1517;3549;1280;3219;13;61;1127;2745;1140;2806
315520;202204;1216;2953;1019;2655;42;123;837;2115;879;2238
315530;202204;801;1943;667;1721;70;216;483;1164;553;1380
315540;202204;1849;4657;1274;3591;113;382;573;1506;686;1888
315550;202204;2039;5255;1415;4116;258;883;445;1298;703;2181
315560;202204;7341;20222;6326;18472;370;1072;4574;13289;4944;14361
315570;202204;2770;6739;2009;5413;267;866;1033;2499;1300;3365
315580;202204;3595;7902;2830;6731;429;1079;1190;2649;1619;3728
315590;202204;1233;2660;993;2312;45;175;751;1586;796;1761
315600;202204;2800;8040;1992;6495;394;1159;949;3326;1343;4485
315610;202204;1089;2600;825;2155;112;378;417;940;529;1318
315620;202204;588;1491;450;1279;51;158;237;675;288;833
315630;202204;1186;3020;900;2508;129;422;457;1144;586;1566
315640;202204;419;989;322;871;31;108;211;538;242;646
315645;202204;1106;2712;781;2209;148;456;230;626;378;1082
315650;202204;1928;4216;1562;3708;58;143;1257;2920;1315;3063
315660;202204;2395;5851;1807;4809;161;436;1143;2967;1304;3403
315670;202204;17091;43417;13422;36965;2167;6430;6879;17791;9046;24221
315680;202204;3517;9413;2645;7839;326;1062;1427;4039;1753;5101
315690;202204;4255;9974;2597;7191;505;1357;782;2281;1287;3638
315700;202204;9681;24723;7465;20528;786;2457;4052;10333;4838;12790
315710;202204;2063;4747;1489;3917;75;240;1023;2598;1098;2838
315720;202204;4893;12768;4042;11298;192;785;2911;7741;3103;8526
315725;202204;2566;6163;2029;5325;202;510;1335;3633;1537;4143
315727;202204;646;1575;476;1287;60;190;239;603;299;793
315730;202204;687;1951;598;1784;132;432;229;607;361;1039
315733;202204;1555;3717;1204;3173;174;514;542;1296;716;1810
315737;202204;1331;3447;992;2806;33;129;699;1888;732;2017
315740;202204;910;2438;738;2096;66;234;502;1333;568;1567
315750;202204;1443;3485;1147;3037;83;226;771;2049;854;2275
315760;202204;1335;2881;1134;2617;31;107;972;2159;1003;2266
315765;202204;2222;5237;1831;4739;31;111;1638;4217;1669;4328
315770;202204;1240;3257;992;2923;348;1114;261;741;609;1855
315780;202204;35062;90031;29601;80615;1848;6299;20431;52501;22279;58800
315790;202204;3985;11497;3412;10438;323;985;2089;6670;2412;7655
315800;202204;1452;4573;1119;3820;140;578;455;1357;595;1935
315810;202204;1527;3492;1283;3097;66;193;1023;2375;1089;2568
315820;202204;3257;7554;2643;6749;230;607;1949;4922;2179;5529
315830;202204;1374;3884;950;2961;106;372;296;773;402;1145
315840;202204;991;2263;711;1792;52;155;386;880;438;1035
315850;202204;1335;3620;1059;3171;155;491;571;1628;726;2119
315860;202204;582;1521;422;1250;86;274;138;343;224;617
315870;202204;515;1333;409;1162;25;80;293;794;318;874
315880;202204;1274;3022;920;2416;121;367;378;864;499;1231
315890;202204;2031;5316;1667;4833;412;1247;817;2428;1229;3675
315895;202204;7168;18433;5427;15160;554;1803;2824;7222;3378;9025
315900;202204;854;2154;724;1966;59;202;524;1351;583;1553
315910;202204;621;1550;528;1418;52;153;402;1061;454;1214
315920;202204;1568;3837;926;2663;153;519;329;837;482;1356
315930;202204;1280;2683;883;2139;97;240;469;1084;566;1324
315935;202204;1139;3206;922;2796;180;561;392;1184;572;1745
315940;202204;692;1745;552;1549;80;243;300;794;380;1037
315950;202204;1344;3486;1128;3154;97;301;890;2440;987;2741
315960;202204;6336;16917;4489;13313;1059;3516;1042;2347;2101;5863
315970;202204;640;1639;518;1478;63;195;353;1023;416;1218
315980;202204;4799;9915;2797;6772;475;1239;1323;2877;1798;4116
315990;202204;3899;9617;3088;8260;317;910;1770;4517;2087;5427
316000;202204;829;1830;659;1589;58;163;425;966;483;1129
316010;202204;843;2255;630;1877;71;241;286;722;357;963
316020;202204;1034;2824;835;2450;102;352;495;1354;597;1706
316030;202204;3079;7981;2373;6743;283;773;1527;4438;1810;5211
316040;202204;2979;8165;2191;6694;383;1350;621;1623;1004;2973
316045;202204;2499;5581;2299;5335;118;181;2035;4820;2153;5001
316050;202204;440;1154;344;997;38;110;200;537;238;647
316060;202204;800;1819;589;1544;26;83;428;1088;454;1171
316070;202204;6333;16405;5190;14297;736;2094;2733;7215;3469;9309
316080;202204;870;2559;684;2189;168;576;127;359;295;935
316090;202204;514;1326;426;1167;43;150;261;633;304;783
316095;202204;1452;4245;1134;3477;260;873;470;1331;730;2204
316100;202204;2727;7450;2049;6087;317;1081;863;2290;1180;3371
316105;202204;904;2199;709;1890;45;122;455;1253;500;1375
316110;202204;15763;41072;13160;36856;902;2974;9494;25840;10396;28814
316120;202204;1388;3573;917;2600;150;459;335;753;485;1212
316130;202204;1449;3106;975;2350;68;202;609;1379;677;1581
316140;202204;1329;3394;844;2466;132;396;316;903;448;1299
316150;202204;2438;5230;1941;4511;145;422;1074;2325;1219;2747
316160;202204;1114;2821;900;2443;42;150;657;1736;699;1886
316165;202204;1014;2265;810;1971;84;225;546;1264;630;1489
316170;202204;1451;3222;1128;2767;59;205;823;1874;882;2079
316180;202204;1696;4541;1213;3628;226;735;326;873;552;1608
316190;202204;2973;8097;1805;5393;248;790;752;1984;1000;2774
316200;202204;3943;10535;3103;9124;542;1812;1321;3700;1863;5512
316210;202204;5785;16235;4183;12549;1419;4692;467;1199;1886;5891
316220;202204;753;2180;523;1724;108;376;87;298;195;674
316225;202204;1793;3818;1366;3180;44;170;1063;2258;1107;2428
316230;202204;542;1361;418;1155;79;235;212;574;291;809
316240;202204;6263;16973;5465;15587;419;1312;4084;11434;4503;12746
316245;202204;3598;10492;3258;9947;175;800;2581;7519;2756;8319
316250;202204;12359;28271;9423;23594;1734;4589;3839;9585;5573;14174
316255;202204;3375;8802;2934;8101;147;393;2186;6111;2333;6504
316257;202204;1609;3570;1195;2908;72;192;837;1932;909;2124
316260;202204;2740;6014;2160;5128;210;486;1358;3164;1568;3650
316265;202204;1239;3190;977;2753;23;93;727;1966;750;2059
316270;202204;4160;11974;3569;10756;408;1317;2043;5835;2451;7152
316280;202204;3362;8728;2855;7824;343;1059;1677;4401;2020;5460
316290;202204;4167;10871;3368;9371;426;1324;1406;3685;1832;5009
316292;202204;6451;16000;5238;14112;559;1651;3513;9117;4072;10768
316294;202204;1001;2836;767;2447;121;479;236;666;357;1145
316295;202204;3807;10141;3147;9046;196;722;2154;5867;2350;6589
316300;202204;1130;3013;892;2650;49;169;626;1819;675;1988
316310;202204;881;2276;607;1802;135;453;175;474;310;927
316320;202204;759;2013;592;1755;123;406;158;422;281;828
316330;202204;1190;2931;909;2463;51;151;685;1816;736;1967
316340;202204;1085;2811;824;2358;73;281;502;1347;575;1628
316350;202204;1510;3907;1268;3503;162;450;846;2288;1008;2738
316360;202204;739;1814;624;1635;50;128;491;1303;541;1431
316370;202204;6510;15607;5066;13214;572;1784;2758;6383;3330;8167
316380;202204;1941;4342;1545;3791;89;194;1098;2669;1187;2863
316390;202204;841;2190;622;1821;253;831;119;307;372;1138
316400;202204;1335;3585;898;2758;106;346;347;951;453;1297
316410;202204;1309;3282;1103;2978;33;121;937;2442;970;2563
316420;202204;2188;5598;1883;5189;39;174;1561;4170;1600;4344
316430;202204;983;2462;689;1984;107;358;295;776;402;1134
316440;202204;965;2827;789;2516;142;526;235;670;377;1196
316443;202204;627;1650;453;1330;103;346;124;340;227;686
316447;202204;2409;5766;2075;5276;31;102;1840;4586;1871;4688
316450;202204;2350;6561;1819;5500;205;687;1126;3279;1331;3966
316460;202204;1420;3534;1169;3138;107;318;792;2020;899;2338
316470;202204;8191;22142;6190;18199;857;2906;2851;7496;3708;10402
316480;202204;228;575;195;534;39;112;116;302;155;414
316490;202204;365;966;271;799;48;164;94;233;142;397
316500;202204;1441;4200;1007;3204;205;709;259;743;464;1452
316510;202204;898;2766;728;2437;118;404;382;1276;500;1680
316520;202204;1546;3582;1208;3009;175;504;583;1300;758;1804
316530;202204;1229;3066;902;2496;105;385;448;1111;553;1496
316540;202204;1144;2728;933;2437;126;394;495;1170;621;1564
316550;202204;1559;4130;1319;3714;50;180;1067;2959;1117;3139
316553;202204;5238;14459;3937;11539;483;1615;1799;4598;2282;6213
316555;202204;3032;8400;2699;7964;83;324;2312;6717;2395;7041
316556;202204;587;1339;448;1102;38;121;276;571;314;692
316557;202204;1298;3679;1123;3418;370;1227;433;1265;803;2492
316560;202204;388;1042;287;892;45;166;133;386;178;552
316570;202204;1574;4183;1328;3771;313;828;466;1428;779;2256
316580;202204;431;877;286;651;34;86;156;332;190;418
316590;202204;1473;3547;1031;2731;139;334;588;1496;727;1830
316600;202204;1078;3007;936;2746;143;420;555;1606;698;2026
316610;202204;695;1976;566;1776;55;219;337;1017;392;1236
316620;202204;2481;5894;2189;5478;121;309;1774;4394;1895;4703
316630;202204;1765;4933;1484;4423;375;1073;590;2020;965;3093
316640;202204;177;461;144;409;31;103;56;130;87;233
316650;202204;1224;3388;992;3033;71;262;684;2003;755;2265
316660;202204;208;488;97;263;13;39;29;60;42;99
316670;202204;1899;4561;1442;3855;368;1005;495;1265;863;2270
316680;202204;2603;6393;1969;5235;152;456;1390;3583;1542;4039
316690;202204;1557;4203;1180;3527;192;633;454;1281;646;1914
316695;202204;1101;3058;915;2736;18;73;621;1805;639;1878
316700;202204;520;1016;440;931;9;26;388;793;397;819
316710;202204;3765;11177;3006;9697;443;1596;1604;4945;2047;6541
316720;202204;23298;60519;17984;50840;2654;8201;8798;23345;11452;31546
316730;202204;591;1374;483;1199;54;143;274;618;328;761
316740;202204;920;2438;804;2259;103;329;555;1531;658;1860
316750;202204;449;1233;342;1050;63;201;155;451;218;652
316760;202204;4229;12338;3665;11322;1235;4182;1408;4283;2643;8465
316770;202204;1802;3794;1375;3238;37;85;1111;2662;1148;2747
316780;202204;633;1761;515;1561;179;591;135;369;314;960
316790;202204;825;2103;615;1704;84;253;202;521;286;774
316800;202204;7341;19364;5912;16879;703;2201;3035;8364;3738;10565
316805;202204;1276;2493;1037;2225;39;99;888;1879;927;1978
316810;202204;754;1942;563;1596;65;207;374;1024;439;1231
316820;202204;386;859;227;594;18;60;127;311;145;371
316830;202204;957;2359;747;2028;81;229;471;1267;552;1496
316840;202204;3206;7630;2586;6665;134;445;1990;4906;2124;5351
316850;202204;2405;5658;1829;4707;169;526;1125;2652;1294;3178
316860;202204;24187;57563;18341;48924;2358;7328;9660;24523;12018;31851
316870;202204;9543;24119;7365;20169;874;2756;3882;9740;4756;12496
316880;202204;1171;2904;993;2657;113;356;622;1545;735;1901
316890;202204;1302;2820;812;2183;86;288;525;1336;611;1624
316900;202204;2745;6896;2209;5938;410;1124;894;2250;1304;3374
316905;202204;554;1581;455;1394;106;332;200;640;306;972
316910;202204;1128;2761;776;2169;219;648;195;513;414;1161
316920;202204;2107;4716;1562;3928;194;556;987;2312;1181;2868
316930;202204;9886;26312;7778;22732;1576;5040;3119;8297;4695;13337
316935;202204;4838;12244;3645;10118;599;1860;1665;4239;2264;6099
316940;202204;7207;20033;5748;17226;754;2576;2749;7608;3503;10184
316950;202204;2202;4741;1712;4094;39;114;1458;3434;1497;3548
316960;202204;5835;12326;4268;10270;321;846;3076;7204;3397;8050
316970;202204;4497;11672;3853;10574;515;1493;1843;4740;2358;6233
316980;202204;815;2327;643;2004;212;737;162;485;374;1222
316990;202204;14382;36640;10999;30152;2452;7153;2333;5824;4785;12977
317000;202204;2873;7705;2529;7241;217;535;1903;5552;2120;6087
317005;202204;2920;7652;2301;6436;321;968;1311;3523;1632;4491
317010;202204;29304;66465;19784;52188;3261;9296;9523;24839;12784;34135
317020;202204;76449;176286;48510;128811;8446;24397;18047;43900;26493;68297
317030;202204;769;1920;618;1710;14;50;467;1267;481;1317
317040;202204;12713;30613;9014;24454;2009;5772;3131;8772;5140;14544
317043;202204;1022;2110;754;1757;40;101;587;1328;627;1429
317047;202204;1309;2945;915;2322;52;165;652;1576;704;1741
317050;202204;1356;4029;999;3237;141;528;395;1081;536;1609
317052;202204;2763;6989;2221;6148;199;581;1549;4229;1748;4810
317057;202204;2310;4857;1741;4033;38;117;1326;2929;1364;3046
317060;202204;561;1452;346;1016;50;157;135;355;185;512
317065;202204;1231;3452;1013;3036;64;238;654;1824;718;2062
317070;202204;8581;23057;6606;19343;1030;3412;2794;7553;3824;10965
317075;202204;1132;2776;858;2324;95;293;486;1229;581;1522
317080;202204;7322;16199;5586;13505;1104;2845;2630;6153;3734;8998
317090;202204;5374;14365;4735;13370;278;764;3588;10114;3866;10878
317100;202204;2916;6705;1959;5165;388;1054;843;2155;1231;3209
317103;202204;2570;6069;2194;5556;72;303;1795;4356;1867;4659
317107;202204;1697;4107;1287;3357;58;204;844;1932;902;2136
317110;202204;726;1671;405;1163;77;257;149;416;226;673
317115;202204;1248;3374;1033;2984;105;321;654;1873;759;2194
317120;202204;20173;50155;16774;44830;1090;3711;11499;28872;12589;32583
317130;202204;12967;29010;9019;22611;1245;3395;3569;8873;4814;12268
317140;202204;1076;2439;845;2082;68;162;586;1451;654;1613
317150;202204;1043;2399;816;2111;36;118;665;1685;701;1803
317160;202204;3957;9025;2639;6956;242;601;1433;3934;1675;4535
317170;202204;2196;5206;1689;4319;106;332;1084;2511;1190;2843
317180;202204;2161;6389;1617;5122;323;1083;463;1347;786;2430
317190;202204;1269;3295;962;2800;140;431;530;1515;670;1946
317200;202204;7114;17956;5353;14544;1042;3029;1580;3846;2622;6875
317210;202204;1356;3092;1049;2682;40;140;761;1952;801;2092
317220;202204;339;947;294;869;56;165;159;460;215;625
320010;202204;5225;14606;4093;12345;437;1475;2445;7139;2882;8614
320013;202204;2388;6118;1719;4857;266;770;818;2394;1084;3164
320016;202204;3252;7939;2549;6869;207;568;1765;4734;1972;5302
320020;202204;5003;12224;3850;10257;593;1783;1851;4862;2444;6645
320030;202204;2001;5325;1326;3991;210;679;517;1473;727;2152
320035;202204;2198;5553;1820;4949;338;1024;1020;2676;1358;3700
320040;202204;4952;13317;4169;11972;531;1648;2381;6523;2912;8171
320050;202204;2089;4500;1812;4109;213;589;1156;2444;1369;3033
320060;202204;15944;41419;12091;33925;1809;5526;5740;14813;7549;20339
320070;202204;2066;5249;1541;4271;233;757;749;1820;982;2577
320080;202204;6393;15659;4603;12243;819;2323;1978;4893;2797;7216
320090;202204;9677;24651;6587;18533;1368;4127;2587;6710;3955;10837
320100;202204;3733;9352;3059;8209;403;1181;1784;4676;2187;5857
320110;202204;2555;5579;1879;4547;193;582;1158;2556;1351;3138
320115;202204;2487;7290;2143;6756;692;2245;902;2960;1594;5205
320120;202204;29233;70697;21335;57070;2721;8039;10939;27238;13660;35277
320130;202204;61449;156973;51168;139267;5822;17540;31812;82877;37634;100417
320140;202204;4394;11466;3115;8997;388;1322;1498;4075;1886;5397
320150;202204;16577;40847;12122;32834;2863;8611;2144;5091;5007;13702
320160;202204;7260;19003;5456;15745;673;2180;2685;7470;3358;9650
320170;202204;2048;5559;1488;4477;378;1144;593;1852;971;2996
320180;202204;838;2476;675;2162;226;794;182;542;408;1336
320190;202204;3410;10271;2658;8665;638;2296;641;1896;1279;4192
320200;202204;1490;3878;1050;3110;227;730;327;973;554;1703
320210;202204;5196;12551;4039;10622;626;1807;2210;5455;2836;7262
320220;202204;3901;9518;3040;8146;519;1446;1543;3930;2062;5376
320225;202204;1689;4916;1184;3797;351;1230;307;949;658;2179
320230;202204;6189;15912;4728;13492;1028;3089;1670;4788;2698;7877
320240;202204;19728;47585;14924;40131;3646;10460;4818;12750;8464;23210
320245;202204;3676;10297;2770;8397;852;2754;507;1472;1359;4226
320250;202204;3180;8041;2169;5856;374;1146;951;2234;1325;3380
320255;202204;2367;6732;2073;6218;419;1334;1210;3647;1629;4981
320260;202204;1666;4479;1073;3245;224;718;277;702;501;1420
320265;202204;2701;7986;2150;6890;884;3055;350;1070;1234;4125
320270;202204;2547;6929;1994;5849;479;1564;719;2081;1198;3645
320280;202204;9039;22324;7420;19692;1122;3366;4468;11261;5590;14627
320290;202204;1529;4357;1007;3157;250;856;266;795;516;1651
320300;202204;4834;13437;3944;11729;1016;3347;1436;4053;2452;7400
320305;202204;6070;16034;4704;13479;854;2685;2317;6348;3171;9033
320310;202204;2562;6607;1818;5105;324;989;806;2082;1130;3071
320313;202204;2863;6744;1988;5194;369;1074;683;1554;1052;2628
320316;202204;1844;4912;1424;4225;223;663;779;2309;1002;2972
320320;202204;25712;64164;18759;52530;4094;11983;7288;20250;11382;32233
320330;202204;3307;8456;2602;7235;403;1152;1477;4112;1880;5264
320332;202204;9632;24374;7722;20985;1455;4274;3818;10041;5273;14315
320334;202204;2120;5689;1480;4407;287;1037;380;856;667;1893
320335;202204;1815;5098;1286;3904;239;843;421;1179;660;2022
320340;202204;6207;13967;5201;12547;443;1193;3459;8230;3902;9423
320350;202204;6186;14229;4422;11206;436;1290;2527;5916;2963;7206
320360;202204;1609;3912;1200;3179;141;377;591;1497;732;1874
320370;202204;3164;9019;2433;7494;676;2291;873;2536;1549;4827
320380;202204;3284;7893;2722;6987;260;802;1808;4369;2068;5171
320390;202204;8903;22398;6658;18097;1303;3794;2873;7327;4176;11121
320400;202204;3760;10092;2836;8172;735;2277;1083;2951;1818;5228
320405;202204;6164;15030;4714;12604;597;1711;2614;6722;3211;8433
320410;202204;5600;13672;4304;11633;719;1947;2177;5978;2896;7925
320420;202204;4372;10329;3414;8835;747;2090;1266;3087;2013;5177
320425;202204;2484;5631;1923;4726;166;425;1231;2905;1397;3330
320430;202204;3666;8855;2935;7624;391;1066;1795;4515;2186;5581
320435;202204;2609;7685;2052;6536;553;1894;811;2616;1364;4510
320440;202204;1792;4703;1352;3887;224;702;612;1633;836;2335
320450;202204;2229;5913;1779;5107;296;1025;946;2471;1242;3496
320455;202204;5108;14801;3534;11232;841;2978;936;2629;1777;5607
320460;202204;2391;6749;1763;5479;444;1545;517;1486;961;3031
320465;202204;1695;4489;1229;3593;244;751;577;1687;821;2438
320470;202204;4531;11516;3450;9391;674;2073;1256;3037;1930;5110
320480;202204;2547;5985;2086;5221;283;696;1330;3270;1613;3966
320490;202204;28371;67883;21717;56791;3556;9588;10270;26409;13826;35997
320495;202204;1617;4186;1194;3376;276;911;291;722;567;1633
320500;202204;69638;173019;56741;151692;6507;19617;35467;89697;41974;109314
320501;202204;5596;15396;4279;13020;1167;3947;1321;3959;2488;7906
320503;202204;2803;7657;1889;5800;528;1761;510;1475;1038;3236
320506;202204;3093;8923;2352;7354;694;2347;305;932;999;3279
320510;202204;13259;33386;10885;29472;976;3074;7022;18088;7998;21162
320515;202204;2053;5409;1579;4442;416;1268;535;1423;951;2691
320517;202204;2512;7032;2024;6036;576;1827;741;2166;1317;3993
320520;202204;48061;117039;37241;99327;5510;16332;18005;45569;23515;61901
320530;202204;40194;98984;32265;85620;2502;8064;21090;52279;23592;60343
330010;202204;29723;71072;25121;63928;2089;6128;18612;45514;20701;51642
330015;202204;1729;3915;1385;3424;180;527;889;2070;1069;2597
330020;202204;23400;54877;19863;49907;2138;5868;14605;35987;16743;41855
330022;202204;2250;5750;1771;4980;291;836;886;2493;1177;3329
330023;202204;7397;16534;5788;14163;768;2084;3755;8841;4523;10925
330025;202204;8229;17991;5390;13445;1028;2843;1957;4543;2985;7386
330030;202204;12516;30606;9927;26645;678;2388;6981;17554;7659;19942
330040;202204;19068;46201;15811;41032;850;2795;11783;28964;12633;31759
330045;202204;113412;238529;96336;217630;4630;11418;82076;182049;86706;193467
330050;202204;3387;8299;2661;7165;412;1281;1524;3823;1936;5104
330060;202204;6697;16016;5316;13677;959;2855;2456;5753;3415;8608
330070;202204;31234;71588;26066;64513;3051;8251;17695;42904;20746;51155
330080;202204;11598;26025;9931;23755;1050;2700;7013;16582;8063;19282
330090;202204;3953;7755;2904;6351;180;379;2137;4686;2317;5065
330093;202204;3302;7307;2544;6314;119;335;2038;4944;2157;5279
330095;202204;1711;4390;1342;3727;130;405;798;2080;928;2485
330100;202204;86583;208398;75431;192743;3031;9982;61166;152493;64197;162475
330110;202204;2587;6571;2099;5817;251;795;1357;3568;1608;4363
330115;202204;3289;7303;2377;5911;389;1029;1319;3082;1708;4111
330120;202204;4280;8551;3328;7388;162;443;2654;5629;2816;6072
330130;202204;5615;13930;4689;12605;544;1567;3139;8256;3683;9823
330140;202204;4792;10914;3964;9819;259;838;3101;7368;3360;8206
330150;202204;2959;7155;2382;6254;373;1064;1425;3534;1798;4598
330160;202204;1709;4303;1317;3652;269;799;706;1828;975;2627
330170;202204;157021;344022;132105;311555;14621;34142;98069;229988;112690;264130
330180;202204;2418;5298;1923;4642;93;290;1466;3395;1559;3685
330185;202204;13083;28950;11123;26361;415;1282;9516;21888;9931;23170
330187;202204;6140;13944;4931;12063;605;1560;3222;7571;3827;9131
330190;202204;50786;107261;44193;98538;1929;5088;37344;81083;39273;86171
330200;202204;20478;47356;16992;43126;2363;5808;12147;30963;14510;36771
330205;202204;2633;6080;2024;5122;139;403;1393;3326;1532;3729
330210;202204;3968;9107;2997;7543;360;940;1697;4012;2057;4952
330220;202204;16054;36863;12038;30383;1942;5457;5641;13095;7583;18552
330225;202204;4658;10997;3644;9525;190;632;2734;6929;2924;7561
330227;202204;21156;46897;18029;43205;528;1522;15942;37543;16470;39065
330230;202204;2344;4991;1577;4006;143;390;818;2076;961;2466
330240;202204;29442;70305;25028;63850;1868;5533;18863;46612;20731;52145
330245;202204;2066;4800;1318;3527;262;717;556;1392;818;2109
330250;202204;50668;116479;42894;105469;5034;13271;30147;72690;35181;85961
330260;202204;5897;13146;4564;11387;270;844;3584;8627;3854;9471
330270;202204;38765;85476;24827;62943;3394;9347;11597;27685;14991;37032
330280;202204;3090;7193;2441;6160;170;559;1693;3959;1863;4518
330285;202204;33330;71384;27322;63059;1365;3835;22069;48999;23434;52834
330290;202204;5327;11375;4396;10192;285;866;3496;7677;3781;8543
330300;202204;6886;14874;5210;12575;375;1001;3854;8946;4229;9947
330310;202204;3289;7317;2474;6051;149;379;1805;4253;1954;4632
330320;202204;21067;45619;16655;40199;1715;3614;12570;30444;14285;34058
330330;202204;54850;112282;44090;98197;3014;7475;33935;73237;36949;80712
330340;202204;21831;48736;16280;40463;2139;6184;9181;21146;11320;27330
330350;202204;188131;392265;159150;357868;6499;15867;138517;307050;145016;322917
330360;202204;8980;19901;7728;18385;272;671;6665;15701;6937;16372
330370;202204;6160;16167;4929;14168;882;2744;2556;7171;3438;9915
330380;202204;7330;17647;5791;15011;653;2078;3795;9208;4448;11286
330385;202204;4901;12690;4055;11507;670;2168;2322;6293;2992;8461
330390;202204;37336;90402;28929;76457;2967;9367;18931;46734;21898;56101
330395;202204;3982;8965;3284;8105;134;440;2606;6222;2740;6662
330400;202204;4181;10092;3591;9204;166;592;2819;6778;2985;7370
330410;202204;4072;9682;3026;7985;454;1414;1766;4309;2220;5723
330411;202204;3334;8524;2656;7354;162;570;1898;4983;2060;5553
330412;202204;1968;5053;1623;4506;120;407;1122;2927;1242;3334
330414;202204;27726;65296;22931;58928;1247;3749;18194;45768;19441;49517
330415;202204;5693;14191;4280;11794;392;1208;2561;6744;2953;7952
330420;202204;15195;35610;11357;29586;1115;3436;6780;16385;7895;19821
330430;202204;13406;27124;11608;24823;222;748;10175;20978;10397;21726
330440;202204;3458;8347;2694;7089;272;880;1826;4497;2098;5377
330450;202204;1754;4514;1423;3982;125;392;896;2386;1021;2778
330452;202204;22554;52853;18455;46826;1823;5362;12950;31499;14773;36861
330455;202204;752994;1617785;616041;1430098;61738;153826;448867;1013940;510605;1167766
330460;202204;1406;3553;1092;3106;183;566;607;1695;790;2261
330470;202204;6754;15331;5010;12743;1122;3052;2004;4977;3126;8029
330475;202204;11625;27272;9542;24655;1131;3435;6665;16626;7796;20061
330480;202204;6991;16747;5966;15302;442;1235;4318;10672;4760;11907
330490;202204;133949;288222;110395;257432;9492;23431;83506;191267;92998;214698
330500;202204;9829;22006;8354;20075;528;1441;6497;15246;7025;16687
330510;202204;51635;117857;39946;101984;4447;12242;27895;69677;32342;81919
330513;202204;1560;3682;1272;3298;170;477;778;2002;948;2479
330515;202204;3136;7729;2595;6991;334;1055;1683;4291;2017;5346
330520;202204;15028;36105;12646;32604;1066;3223;9028;22406;10094;25629
330530;202204;1979;4518;1463;3771;256;714;741;1872;997;2586
330540;202204;3482;8549;2726;7309;625;1765;1181;3099;1806;4864
330550;202204;13778;30520;10951;26903;1921;5074;6515;15632;8436;20706
330555;202204;23908;45469;20278;41294;686;1560;17508;35665;18194;37225
330560;202204;4818;11596;3921;10217;523;1435;2596;6520;3119;7955
330570;202204;3466;8520;3029;7907;409;1158;2140;5501;2549;6659
330575;202204;7320;16891;6402;15413;299;852;5324;12297;5623;13149
330580;202204;24765;59702;20425;52328;2733;7640;12156;29183;14889;36823
330590;202204;1753;4324;1481;3984;201;519;998;2751;1199;3270
330600;202204;15291;36828;12673;32757;807;2560;8945;22082;9752;24642
330610;202204;11897;28601;9816;25440;895;2570;6771;16942;7666;19512
330615;202204;2604;6375;2132;5749;351;870;1428;3936;1779;4806
330620;202204;4973;13026;3996;11432;809;2524;1876;5110;2685;7634
330630;202204;33221;76254;26624;66204;1229;4021;20082;47452;21311;51473
350010;202204;2555;6461;1588;4483;318;967;422;941;740;1908
350020;202204;837;2072;507;1453;65;197;175;467;240;664
350030;202204;4114;10749;3213;9255;640;2137;1704;4536;2344;6673
350040;202204;880;2410;543;1721;77;308;181;434;258;742
350050;202204;1667;3913;1160;3083;201;629;472;1048;673;1677
350055;202204;1082;2650;877;2343;115;315;533;1335;648;1650
350060;202204;298;719;165;442;26;83;64;163;90;246
350070;202204;3825;9671;2619;7560;431;1421;1070;2756;1501;4177
350075;202204;702;1937;543;1641;194;600;108;333;302;933
350080;202204;759;1912;534;1536;56;189;245;635;301;824
350090;202204;673;1512;429;1113;66;194;225;535;291;729
350100;202204;2863;7096;2059;5767;128;466;1354;3514;1482;3980
350110;202204;560;1336;417;1093;18;61;283;710;301;771
350115;202204;1387;3852;1145;3388;175;586;612;1653;787;2239
350120;202204;746;1713;450;1207;38;132;249;613;287;745
350130;202204;3758;9471;2982;8078;465;1344;1585;3932;2050;5276
350140;202204;846;2218;613;1805;45;160;351;945;396;1105
350150;202204;578;1663;481;1494;96;322;162;437;258;759
350160;202204;13619;33532;9603;26162;1194;3714;5787;14788;6981;18502
350170;202204;2860;7616;2412;6693;324;1027;1381;3493;1705;4520
350180;202204;1161;2695;692;1872;106;307;317;783;423;1090
350190;202204;3625;9944;2583;7661;371;1309;1250;3182;1621;4491
350200;202204;527;1418;412;1206;21;81;283;779;304;860
350210;202204;6996;15522;4950;12379;412;1229;3324;7829;3736;9058
350220;202204;3416;8993;2439;7136;449;1394;986;2601;1435;3995
350230;202204;1180;2835;964;2537;155;457;582;1466;737;1923
350240;202204;701;1932;476;1436;95;292;124;338;219;630
350250;202204;3892;10157;2960;8667;714;2205;1055;2983;1769;5188
350260;202204;980;2169;637;1611;65;184;391;911;456;1095
350270;202204;5192;13027;4182;11243;535;1652;2449;6075;2984;7727
350275;202204;3026;7608;2467;6793;241;822;1736;4501;1977;5323
350280;202204;21332;47212;13908;35475;2119;5685;6572;15807;8691;21492
350290;202204;3750;9924;2686;7794;467;1474;1224;3285;1691;4759
350300;202204;774;1930;600;1622;72;215;362;915;434;1130
350310;202204;1089;2911;845;2455;103;347;402;1064;505;1411
350315;202204;704;1655;503;1343;30;108;297;693;327;801
350320;202204;18648;45923;14255;38397;2437;7305;6768;16765;9205;24070
350330;202204;15907;37452;11819;30056;1034;3017;7946;18951;8980;21968
350335;202204;423;1156;334;993;41;132;155;440;196;572
350340;202204;1461;3635;915;2625;113;381;430;1110;543;1491
350350;202204;844;2023;662;1827;83;255;415;1125;498;1380
350360;202204;1226;3447;973;2956;179;570;435;1295;614;1865
350370;202204;796;1889;574;1487;178;434;210;513;388;947
350380;202204;5323;14032;3937;11198;952;2776;1404;3808;2356;6584
350390;202204;12852;31737;10286;27641;1451;4176;6047;15366;7498;19542
350395;202204;502;1237;268;793;37;115;92;250;129;365
350400;202204;9711;22943;6998;18627;1724;4811;2208;5792;3932;10603
350410;202204;12177;32386;9256;27020;1693;5458;4113;11153;5806;16611
350420;202204;1177;2943;846;2299;150;411;272;629;422;1040
350430;202204;766;1898;601;1647;68;216;361;899;429;1115
350440;202204;2405;5620;1966;4980;115;346;1358;3266;1473;3612
350450;202204;7715;20444;6093;17696;1205;3924;2844;7685;4049;11609
350460;202204;2366;5909;1465;4165;217;653;618;1591;835;2244
350470;202204;289;689;235;607;10;30;175;435;185;465
350480;202204;1140;2711;781;2129;177;534;207;491;384;1025
350490;202204;2243;5537;1635;4587;287;904;676;1678;963;2582
350500;202204;735;1873;536;1533;63;193;226;606;289;799
350510;202204;1395;3352;1068;2793;87;260;693;1698;780;1958
350520;202204;2665;7547;2128;6565;317;1113;992;2769;1309;3882
350530;202204;3488;8448;2682;6958;238;720;1644;3938;1882;4658
350535;202204;1721;4394;1467;4035;204;627;934;2470;1138;3097
350540;202204;2318;4957;1759;4180;150;379;1268;2846;1418;3225
350550;202204;9524;22649;6718;18088;624;2074;4044;9955;4668;12029
350560;202204;4642;11942;3825;10630;241;816;2749;7288;2990;8104
350570;202204;32317;84774;26873;74984;4060;12492;15054;40026;19114;52518
350580;202204;2435;6201;1593;4584;389;1270;495;1150;884;2420
350590;202204;5609;14557;4237;11642;486;1516;2624;6647;3110;8163
350600;202204;38821;87656;25233;64911;3458;10134;12519;29510;15977;39644
350610;202204;8235;21323;6045;17163;783;2587;3284;8627;4067;11214
350620;202204;483;1183;305;901;32;105;172;472;204;577
350630;202204;1839;4268;1377;3518;88;277;954;2242;1042;2519
350635;202204;11543;26599;8840;22474;959;2741;5859;14231;6818;16972
350640;202204;1048;2726;597;1765;101;311;187;463;288;774
350650;202204;10100;25780;7240;20396;1193;3710;3177;8263;4370;11973
350660;202204;5393;13191;4268;11427;520;1413;2639;6925;3159;8338
350670;202204;1968;5112;1608;4580;209;634;1024;2902;1233;3536
350680;202204;1272;3301;881;2587;141;417;390;1094;531;1511
350690;202204;1538;3817;1118;3108;153;472;621;1657;774;2129
350700;202204;5628;13495;4351;11602;759;2276;2357;5907;3116;8183
350710;202204;3420;8726;2924;7906;527;1638;1610;4011;2137;5649
350715;202204;872;2377;744;2174;133;469;385;996;518;1465
350720;202204;186;456;135;380;19;55;60;146;79;201
350730;202204;699;1905;577;1671;41;143;371;994;412;1137
350740;202204;1955;4881;1380;3801;227;682;547;1350;774;2032
350745;202204;706;1731;410;1169;28;112;205;526;233;638
350750;202204;12028;30255;9652;26294;1585;5100;5030;12468;6615;17568
350760;202204;18638;43451;14112;36006;2211;6614;7639;17369;9850;23983
350770;202204;1213;2849;750;2071;66;199;440;1160;506;1359
350775;202204;798;1774;565;1444;73;181;306;771;379;952
350780;202204;2753;6360;2026;5372;557;1354;773;2352;1330;3706
350790;202204;2426;6234;1591;4696;318;949;479;1229;797;2178
350800;202204;4135;11082;3549;10119;234;803;2535;6947;2769;7750
350810;202204;3353;7673;2567;6540;483;1209;1265;3159;1748;4368
350820;202204;1070;2419;654;1686;66;203;354;830;420;1033
350830;202204;975;2576;587;1768;102;324;174;435;276;759
350840;202204;3947;11114;3079;9569;566;1952;1456;4178;2022;6130
350850;202204;9384;24422;7524;21209;1192;3671;4226;11206;5418;14877
350860;202204;4137;10320;3586;9591;132;486;2841;7465;2973;7951
350870;202204;3088;8086;2344;6918;264;861;1369;3910;1633;4771
350880;202204;1628;4361;1325;3786;361;1062;401;1078;762;2140
350890;202204;565;1439;376;1057;50;154;138;332;188;486
350900;202204;10279;25981;7361;20191;1163;3533;3761;9351;4924;12884
350910;202204;1076;2440;920;2217;81;211;722;1690;803;1901
350920;202204;14196;33326;12148;30185;408;1363;10146;24241;10554;25604
350925;202204;4674;12091;3435;9990;536;1781;1814;4848;2350;6629
350930;202204;1674;4226;1184;3282;90;284;684;1829;774;2113
350940;202204;2754;6768;2195;5892;202;641;1505;3796;1707;4437
350945;202204;1024;2740;797;2321;131;405;389;1042;520;1447
350950;202204;107727;263134;84762;221615;9487;27396;54807;136182;64294;163578
350960;202204;7458;19288;5865;16369;729;2320;3465;9151;4194;11471
350970;202204;4148;11011;3075;9074;862;2800;956;2394;1818;5194
350980;202204;797;2018;659;1781;135;388;337;868;472;1256
350990;202204;2232;5739;1727;4945;378;1218;718;1960;1096;3178
350995;202204;959;2797;873;2638;77;281;591;1708;668;1989
351000;202204;3438;8710;2360;6679;523;1519;817;2221;1340;3740
351010;202204;432;1041;281;779;42;132;133;350;175;482
351015;202204;1067;3017;888;2667;143;470;415;1119;558;1589
351020;202204;9780;25224;7509;21451;1484;4444;3746;10252;5230;14696
351030;202204;3348;9376;2712;8135;376;1286;1537;4408;1913;5694
351040;202204;6026;13950;5109;12616;180;580;4295;10238;4475;10818
351050;202204;19874;46315;15150;39378;2384;6612;8291;20873;10675;27485
351060;202204;57042;136472;44465;115658;3734;10976;31179;77940;34913;88916
351070;202204;1599;3778;932;2691;265;780;169;465;434;1245
351080;202204;3211;7379;2388;6414;240;763;1656;4207;1896;4970
351090;202204;365;999;284;860;54;169;105;312;159;481
351100;202204;3172;8139;2147;6158;451;1420;719;1983;1170;3403
351110;202204;7249;17974;5111;14171;734;2302;2558;6639;3292;8941
351120;202204;837;2101;588;1672;103;291;220;589;323;880
351130;202204;1296;3357;614;1839;99;333;169;435;268;768
351140;202204;2606;6886;1996;5795;406;1325;945;2437;1351;3762
351150;202204;3276;8940;2310;6944;314;1075;897;2377;1211;3452
351160;202204;1291;3823;966;3107;195;679;242;658;437;1337
351170;202204;1668;4293;1453;3926;126;396;1030;2635;1156;3031
351190;202204;1141;3062;808;2410;179;524;282;798;461;1322
351200;202204;1857;4271;1417;3659;95;286;1027;2506;1122;2792
351210;202204;1731;4068;1140;3036;71;261;688;1649;759;1910
351220;202204;4099;10452;3554;9609;290;819;2545;6678;2835;7497
351230;202204;2381;5943;1858;5075;321;972;971;2401;1292;3373
351240;202204;2738;6774;1756;4819;426;1184;567;1404;993;2588
351250;202204;1210;3125;733;2161;78;256;276;789;354;1045
351260;202204;1020;2438;749;1962;144;397;302;734;446;1131
351270;202204;596;1545;419;1199;48;167;207;494;255;661
351280;202204;4395;11091;3424;9379;675;1920;1509;3917;2184;5837
351290;202204;1650;3766;1104;2857;122;354;733;1805;855;2159
351300;202204;23149;59344;16931;48025;2816;8769;8384;22426;11200;31195
351310;202204;4068;9459;3139;8036;144;513;2369;5720;2513;6233
351320;202204;1004;2815;740;2293;140;478;241;644;381;1122
351330;202204;549;1321;432;1087;27;97;304;673;331;770
351340;202204;7988;20394;6674;18191;1251;3676;3747;9683;4998;13359
351350;202204;14273;33879;11943;30216;786;2275;9311;22636;10097;24911
351360;202204;4497;11173;3734;10087;741;2256;1933;4759;2674;7015
351370;202204;2350;6278;1625;4835;376;1227;502;1308;878;2535
351380;202204;52970;122706;38547;98734;4023;11391;24283;59095;28306;70486
351385;202204;444;1099;189;563;25;73;71;190;96;263
351390;202204;1545;3595;1017;2847;98;317;696;1865;794;2182
351400;202204;1188;3090;984;2700;102;277;630;1652;732;1929
351410;202204;2983;7905;2228;6497;375;1107;975;2727;1350;3834
351420;202204;555;1285;334;911;38;113;201;492;239;605
351430;202204;1118;2796;920;2492;54;166;697;1820;751;1986
351440;202204;3972;10058;2736;7620;546;1599;844;2015;1390;3614
351450;202204;1953;4979;1368;3952;271;902;344;766;615;1668
351460;202204;1072;2641;872;2339;118;355;560;1438;678;1793
351470;202204;1394;3358;1115;2915;71;238;771;1888;842;2126
351480;202204;2760;7641;2194;6748;355;1285;1080;3033;1435;4318
351490;202204;2407;6363;2086;5813;74;312;1699;4562;1773;4874
351492;202204;389;1009;336;901;4;14;264;692;268;706
351495;202204;241;604;192;519;18;42;115;302;133;344
351500;202204;47132;108661;36909;92571;4443;11711;24350;58416;28793;70127
351510;202204;15008;34686;11245;28553;1164;3390;7488;18075;8652;21465
351512;202204;545;1392;407;1102;78;214;160;404;238;618
351515;202204;3773;8318;2464;6231;479;1286;661;1754;1140;3040
351518;202204;2792;6800;1880;5226;256;822;942;2294;1198;3116
351519;202204;696;1842;445;1375;83;263;91;244;174;507
351520;202204;1418;3434;681;1993;75;261;329;852;404;1113
351530;202204;394;997;241;688;38;117;115;273;153;390
351535;202204;1962;4653;1428;3765;223;640;723;1805;946;2445
351540;202204;3077;7229;2115;5586;229;719;1096;2538;1325;3257
351550;202204;8405;20048;5913;15695;586;1779;3417;8335;4003;10114
351560;202204;562;1545;451;1334;111;365;143;389;254;754
351565;202204;283;759;228;662;49;170;72;174;121;344
351570;202204;25594;64235;20188;54072;1811;5437;13403;34183;15214;39620
351580;202204;252;622;149;450;14;42;70;206;84;248
351590;202204;545;1211;288;763;25;75;167;405;192;480
351600;202204;1502;3905;1164;3271;167;503;637;1655;804;2158
351610;202204;813;1855;532;1372;39;112;305;733;344;845
351620;202204;27466;69556;20615;58396;3009;9953;10263;26556;13272;36509
351630;202204;32849;80860;26853;71192;2484;7649;18897;47704;21381;55353
351640;202204;21228;51866;17063;44855;1182;3844;12355;30700;13537;34544
351650;202204;421;1115;220;678;30;106;61;165;91;271
351660;202204;786;2115;535;1609;94;287;125;314;219;601
351670;202204;7052;18206;4742;13325;973;2649;2007;5231;2980;7880
351680;202204;495;1302;334;968;62;184;93;212;155;396
351685;202204;494;1338;404;1199;89;257;165;447;254;704
351690;202204;1344;3300;790;2262;90;303;371;980;461;1283
351700;202204;1517;3609;1126;2972;195;570;599;1458;794;2028
351710;202204;919;2295;704;1917;66;221;418;1025;484;1246
351720;202204;1699;4184;1193;3333;186;569;556;1430;742;1999
351730;202204;1122;2720;928;2417;75;238;589;1412;664;1650
351740;202204;3841;9255;3142;7999;450;1258;1782;4156;2232;5414
351750;202204;1844;4578;1122;3315;166;518;528;1490;694;2008
351760;202204;3783;9966;2884;8293;548;1757;1366;3575;1914;5332
351770;202204;2178;5855;1786;5156;292;904;1066;2946;1358;3850
351780;202204;1343;3272;818;2324;106;345;337;883;443;1228
351790;202204;1686;3821;1318;3324;163;432;869;2117;1032;2549
351800;202204;562;1248;304;786;33;96;125;278;158;374
351810;202204;1247;3149;1045;2853;150;404;632;1634;782;2038
351820;202204;3267;8561;2419;6997;548;1758;804;2093;1352;3851
351830;202204;5389;13408;4167;11370;347;1125;2731;7010;3078;8135
351840;202204;10316;26761;8006;22725;893;2914;4795;12592;5688;15506
351850;202204;1700;4534;1134;3428;190;642;402;1005;592;1647
351860;202204;3001;8208;2329;7034;270;905;1415;4239;1685;5144
351870;202204;28818;69660;22166;59031;4764;13006;10311;27420;15075;40426
351880;202204;172733;412663;134959;350699;21128;62235;80280;195488;101408;257723
351885;202204;1073;2675;865;2351;47;174;619;1608;666;1782
351890;202204;951;2400;626;1871;119;410;152;386;271;796
351900;202204;1384;3477;1064;3006;107;293;679;1885;786;2178
351905;202204;574;1536;426;1260;40;136;217;560;257;696
351907;202204;25069;62721;19944;53995;1933;6040;13479;34693;15412;40733
351910;202204;1897;4662;1379;3634;113;339;809;1890;922;2229
351920;202204;999;2573;778;2157;114;353;343;865;457;1218
351925;202204;1063;2697;839;2319;98;332;505;1284;603;1616
351930;202204;3953;10181;3582;9533;308;938;2851;7385;3159;8323
351940;202204;1204;2994;874;2430;131;425;436;1197;567;1622
351950;202204;1922;4045;1483;3437;62;173;1091;2407;1153;2580
351960;202204;5921;14285;4477;11853;991;2789;2018;5045;3009;7834
351970;202204;9710;25869;7888;22913;1126;3821;4822;13253;5948;17074
351980;202204;1194;2753;813;2143;92;297;484;1163;576;1460
351990;202204;1670;3758;1228;3128;59;207;660;1478;719;1685
352000;202204;3106;8263;2687;7450;240;778;1854;4831;2094;5609
352010;202204;2660;6655;2176;5896;609;1730;601;1654;1210;3384
352020;202204;1707;4434;1346;3823;230;717;699;1858;929;2575
352030;202204;6845;16858;5509;14751;715;2214;3414;8637;4129;10851
352040;202204;4801;11561;3476;9143;550;1588;1332;3138;1882;4726
352042;202204;3777;8640;2628;6874;335;1021;1539;3893;1874;4914
352044;202204;2454;6288;1535;4573;246;813;367;923;613;1736
352050;202204;15356;39261;10565;30079;2632;8157;2719;6619;5351;14776
352060;202204;856;2209;662;1869;113;353;297;766;410;1119
352070;202204;1045;2049;705;1606;43;118;437;914;480;1032
352080;202204;522;1312;332;954;41;110;110;295;151;405
352090;202204;1790;5011;1515;4507;167;586;772;2094;939;2680
352100;202204;4194;11147;3353;9574;575;1846;1629;4380;2204;6226
352110;202204;782;2150;598;1806;114;350;262;751;376;1101
352115;202204;620;1614;514;1458;112;334;281;768;393;1102
352120;202204;996;2704;803;2336;80;243;494;1336;574;1579
352130;202204;2286;6154;1508;4308;217;617;647;1716;864;2333
352140;202204;1360;3581;999;2873;175;512;462;1311;637;1823
352150;202204;1033;2569;780;2147;78;241;527;1387;605;1628
352160;202204;1095;2602;798;2122;80;248;423;1070;503;1318
352170;202204;3402;8661;2731;7415;311;975;1683;4258;1994;5233
352180;202204;2844;7343;2203;6230;472;1427;902;2373;1374;3800
352190;202204;1621;4059;1306;3581;194;575;753;2021;947;2596
352200;202204;359;1058;265;881;36;116;106;346;142;462
352210;202204;24045;52883;19151;46426;924;2692;15450;36427;16374;39119
352215;202204;748;1849;608;1627;105;300;325;840;430;1140
352220;202204;28676;65728;21496;53946;3062;8614;12670;29197;15732;37811
352230;202204;17770;47813;14088;41245;3244;10408;5691;15224;8935;25632
352240;202204;11927;29230;9316;25027;1753;5127;4669;11643;6422;16770
352250;202204;26310;70172;21847;62809;2417;7653;15015;42078;17432;49731
352260;202204;5783;13847;4062;10610;529;1609;2447;5731;2976;7340
352265;202204;1026;2784;916;2630;138;428;550;1533;688;1961
352270;202204;1980;5551;1546;4650;305;1022;617;1696;922;2718
352280;202204;2658;6344;2039;5475;220;692;1219;3036;1439;3728
352290;202204;1604;4267;1304;3713;166;509;728;1874;894;2383
352300;202204;1062;2677;728;2023;77;242;398;1038;475;1280
352310;202204;46114;117450;35364;99790;6140;18144;19537;54247;25677;72391
352320;202204;7740;18775;6131;15956;781;2307;3658;8544;4439;10851
352330;202204;2771;6717;2172;5886;270;935;1423;3566;1693;4501
352340;202204;7769;19665;5973;16435;927;2865;3198;8065;4125;10930
352350;202204;2704;7166;2149;6004;137;479;1468;3892;1605;4371
352360;202204;1567;3965;1265;3426;92;299;922;2373;1014;2672
352370;202204;1195;3208;1036;2957;27;103;836;2345;863;2448
352380;202204;994;2536;765;2150;162;454;312;844;474;1298
352390;202204;17064;40564;11964;31752;1749;5182;6831;16922;8580;22104
352400;202204;4055;10950;3318;9599;862;2711;1488;4059;2350;6770
352410;202204;3944;9668;3094;8309;240;750;1999;5129;2239;5879
352420;202204;950;2330;650;1851;142;426;205;578;347;1004
352430;202204;9760;22631;7351;18620;1046;2993;4156;9882;5202;12875
352440;202204;21631;56493;16704;47318;3638;10906;6813;18442;10451;29348
352450;202204;897;2122;493;1444;77;231;189;502;266;733
352460;202204;3481;9009;2505;7325;450;1392;1141;3134;1591;4526
352470;202204;3783;9414;2940;8071;254;813;1913;4940;2167;5753
352480;202204;4900;11206;3373;8590;428;1306;1743;3963;2171;5269
352490;202204;926;2498;739;2182;124;415;358;999;482;1414
352500;202204;12396;30770;8695;24128;3313;10596;1755;3111;5068;13707
352510;202204;4649;12136;3617;10333;542;1698;2071;5643;2613;7341
352520;202204;3288;8195;2571;7034;369;1176;1567;3900;1936;5076
352530;202204;13196;32298;9424;25485;1726;5251;3701;8573;5427;13824
352540;202204;632;1775;483;1478;78;240;195;542;273;782
352550;202204;1111;2912;786;2350;128;437;308;830;436;1267
352560;202204;705;1820;573;1593;56;204;384;976;440;1180
352570;202204;2657;7212;1782;5449;414;1373;241;527;655;1900
352580;202204;742;1854;633;1662;75;208;371;953;446;1161
352585;202204;396;1055;294;877;31;116;170;468;201;584
352590;202204;15130;38343;11072;30979;2131;6600;5961;15476;8092;22076
352600;202204;2279;5826;1837;5073;141;462;1230;3157;1371;3619
352610;202204;3105;8133;2366;6913;380;1340;1162;3168;1542;4508
352620;202204;6524;15527;5016;13415;1141;3069;2467;6539;3608;9608
352630;202204;987;2326;745;1995;102;302;387;999;489;1301
352640;202204;3526;8611;2614;7015;251;733;1562;3994;1813;4727
352650;202204;659;1785;461;1383;67;213;185;514;252;727
352660;202204;1230;3423;1044;3065;106;383;689;1884;795;2267
352670;202204;11824;29964;8545;23767;1601;5001;3901;9742;5502;14743
352680;202204;3661;10222;2662;8042;415;1445;1292;3413;1707;4858
352690;202204;30596;73918;24406;63995;1152;3773;18038;45261;19190;49034
352700;202204;813;1987;611;1688;119;338;279;761;398;1099
352710;202204;6245;15384;4605;12528;1048;3120;2036;5133;3084;8253
352720;202204;10305;25871;8355;22440;1629;4711;4101;10321;5730;15032
352725;202204;619;1411;357;959;23;69;205;508;228;577
352730;202204;5922;16875;5365;15655;674;2207;2651;6662;3325;8869
352740;202204;2698;6227;2076;5319;192;568;1269;3065;1461;3633
352750;202204;488;1200;318;902;40;137;149;366;189;503
352760;202204;1927;5082;1538;4368;166;443;839;2326;1005;2769
352770;202204;1053;2685;758;2148;111;330;371;975;482;1305
352780;202204;739;2006;537;1592;110;308;157;465;267;773
352790;202204;482;1212;371;1007;42;110;166;396;208;506
352800;202204;1571;4500;1112;3503;291;946;236;581;527;1527
352810;202204;1392;3159;928;2370;134;331;546;1342;680;1673
352820;202204;510;1383;379;1154;81;256;99;268;180;524
352830;202204;639;1560;323;928;30;95;108;261;138;356
352840;202204;4582;12279;3767;10869;940;2959;1704;4744;2644;7703
352850;202204;13337;30787;9730;25217;2016;5802;4614;10849;6630;16651
352860;202204;1225;3265;958;2797;159;506;386;1057;545;1563
352870;202204;972;2372;690;1820;60;187;444;1110;504;1297
352880;202204;1928;4478;1377;3533;205;577;620;1478;825;2055
352885;202204;378;982;295;842;36;114;180;490;216;604
352890;202204;791;1814;557;1352;31;92;362;775;393;867
352900;202204;21297;53153;14619;40405;2242;6550;6531;16804;8773;23354
352910;202204;440;1117;249;733;20;62;96;235;116;297
352920;202204;3140;7634;2406;6432;110;348;1749;4466;1859;4814
352930;202204;6830;17530;5260;14571;876;2749;2630;6737;3506;9486
352940;202204;27790;70664;21527;58357;3409;10121;12110;30849;15519;40970
352950;202204;645;1664;409;1233;92;297;110;287;202;584
352960;202204;842;2131;513;1465;72;220;166;367;238;587
352965;202204;286;773;197;609;44;143;54;154;98;297
352970;202204;3519;7806;2778;6652;159;423;2138;4943;2297;5366
352980;202204;1562;3808;1238;3361;264;754;704;1875;968;2629
352990;202204;5038;12748;3838;10808;629;1937;2122;5774;2751;7711
353000;202204;538;1425;327;955;53;181;96;226;149;407
353010;202204;3058;7246;2121;5567;375;1137;1005;2384;1380;3521
353020;202204;3846;9618;2382;6715;358;1099;925;2421;1283;3520
353030;202204;5332;12959;3731;10263;845;2492;1138;2967;1983;5459
353040;202204;779;1703;567;1391;91;222;321;757;412;979
353050;202204;5966;16141;4366;12989;704;2297;2234;6286;2938;8583
353060;202204;55895;135609;46624;121329;2891;9157;35877;89761;38768;98918
353070;202204;11870;31899;8857;25625;1376;4470;4296;11291;5672;15761
353080;202204;5373;13845;3725;10756;710;2301;1542;3878;2252;6179
353090;202204;692;1961;582;1755;38;140;389;1124;427;1264
353100;202204;341;861;163;484;30;99;48;109;78;208
353110;202204;8804;21698;7118;19390;1658;4420;3618;10327;5276;14747
353120;202204;486;1184;376;1002;47;162;196;445;243;607
353130;202204;3137;7144;2091;5376;500;1379;847;1928;1347;3307
353140;202204;3263;7577;2487;6345;130;409;1799;4359;1929;4768
353150;202204;1753;4210;1284;3464;243;708;601;1525;844;2233
353160;202204;741;1850;541;1526;72;229;250;631;322;860
353170;202204;626;1586;481;1384;81;240;240;694;321;934
353180;202204;11886;28015;9403;24042;1799;4873;5336;13110;7135;17983
353190;202204;3799;9808;3024;8295;369;1135;1839;4712;2208;5847
353200;202204;2000;5155;1250;3713;177;622;449;1186;626;1808
353205;202204;502;1434;427;1270;46;148;238;671;284;819
353210;202204;1038;2207;692;1657;26;75;519;1184;545;1259
353215;202204;447;1129;357;982;46;156;177;439;223;595
353220;202204;847;2227;604;1747;128;354;147;392;275;746
353230;202204;885;2347;695;2053;166;574;261;698;427;1272
353240;202204;2673;6868;2260;6236;280;890;1432;3776;1712;4666
353250;202204;1437;3165;947;2397;110;298;540;1317;650;1615
353260;202204;1301;2935;755;2058;117;350;353;888;470;1238
353270;202204;858;2080;722;1852;74;230;492;1167;566;1397
353280;202204;810;2069;599;1725;140;401;198;572;338;973
353282;202204;2022;5432;1702;4884;156;543;1082;2908;1238;3451
353284;202204;422;965;243;638;26;86;115;254;141;340
353286;202204;197;467;123;349;27;76;35;79;62;155
353290;202204;1630;4129;1015;2921;174;509;319;823;493;1332
353300;202204;2434;6214;1808;5034;300;959;862;2111;1162;3070
353310;202204;452;1061;342;880;22;73;226;537;248;610
353320;202204;794;1926;683;1773;18;62;539;1361;557;1423
353325;202204;801;2208;590;1768;100;288;251;716;351;1004
353330;202204;702;1712;479;1310;75;231;245;607;320;838
353340;202204;3626;9462;2822;7942;481;1540;1494;3846;1975;5386
353350;202204;4443;10627;3317;8607;730;1912;1212;2848;1942;4760
353360;202204;756;2035;610;1763;62;228;375;1011;437;1239
353370;202204;657;1780;547;1609;44;152;383;1084;427;1236
353380;202204;346;965;277;841;36;121;129;348;165;469
353390;202204;7275;17340;5526;14543;443;1347;3513;8769;3956;10116
353400;202204;592;1516;450;1262;76;242;196;448;272;690
353410;202204;594;1508;454;1263;58;165;273;730;331;895
353420;202204;538;1340;362;993;70;185;61;139;131;324
353430;202204;2644;6894;2118;5963;384;1140;1108;2978;1492;4118
353440;202204;79639;203829;60609;167705;8173;25103;36111;93909;44284;119012
353450;202204;431;1066;303;852;40;146;162;407;202;553
353460;202204;3792;9785;2850;8115;543;1649;727;1886;1270;3535
353470;202204;10065;25396;7478;20664;1199;3713;3592;9086;4791;12799
353475;202204;1913;4602;1328;3520;147;450;741;1780;888;2230
353480;202204;1791;4512;1477;4016;68;240;1088;2836;1156;3076
353490;202204;1220;3070;886;2471;124;367;408;1051;532;1418
353500;202204;1228;2842;901;2340;174;473;536;1343;710;1816
353510;202204;1038;2885;764;2279;180;592;262;680;442;1272
353520;202204;1160;2881;773;2228;80;253;383;985;463;1238
353530;202204;2828;7098;2286;6148;268;857;1315;3277;1583;4134
353540;202204;2385;6121;1949;5462;263;799;1187;3200;1450;3999
353550;202204;6915;16646;5654;14669;725;2056;3573;8751;4298;10807
353560;202204;2601;6611;2024;5776;510;1587;753;1949;1263;3536
353570;202204;766;1929;520;1487;88;294;235;603;323;897
353580;202204;2576;6468;2007;5403;379;1025;1025;2636;1404;3661
353590;202204;819;1979;593;1607;63;181;360;939;423;1120
353600;202204;1839;4454;1418;3745;156;460;802;2033;958;2493
353610;202204;824;2295;612;1868;110;383;255;706;365;1089
353620;202204;3297;8172;2402;6708;474;1413;903;2296;1377;3709
353625;202204;678;1624;419;1165;51;170;227;593;278;763
353630;202204;1690;4772;1459;4339;246;802;767;2097;1013;2899
353640;202204;1450;3621;1161;3178;159;451;708;1890;867;2341
353650;202204;8561;22106;6711;18822;755;2375;3954;10404;4709;12779
353657;202204;414;1060;315;911;26;92;153;407;179;499
353660;202204;1518;3076;1095;2522;175;423;667;1480;842;1903
353670;202204;4806;12639;3789;10754;679;2208;1882;4840;2561;7048
353680;202204;816;2023;609;1733;73;243;380;1006;453;1249
353690;202204;509;1325;245;734;29;86;65;177;94;263
353700;202204;2359;5836;1962;5216;136;439;1433;3653;1569;4092
353710;202204;5966;13167;3686;9177;409;1058;1948;4252;2357;5310
353715;202204;488;1255;296;877;14;59;118;316;132;375
353720;202204;2278;5705;1779;4970;289;863;979;2645;1268;3508
353730;202204;5127;12856;4030;10999;479;1577;2452;6148;2931;7725
353740;202204;2298;5801;1671;4726;340;1115;673;1713;1013;2828
353750;202204;1045;2996;783;2517;187;629;243;747;430;1376
353760;202204;15654;33630;12240;29220;2241;5529;7154;16756;9395;22285
353770;202204;689;1938;441;1405;75;271;73;193;148;464
353780;202204;7138;17825;5912;15712;927;2835;3581;8897;4508;11732
353790;202204;3215;9205;2423;7583;577;2005;601;1624;1178;3629
353800;202204;21403;53328;17264;46937;2527;6886;10084;26898;12611;33784
353810;202204;1407;3622;959;2710;145;458;442;1188;587;1646
353820;202204;1996;5134;1379;3973;296;958;429;1120;725;2078
353830;202204;703;1685;524;1412;78;235;249;626;327;861
353850;202204;1790;4700;1402;4002;271;788;606;1653;877;2441
353860;202204;3045;7828;2368;6749;508;1682;1181;3008;1689;4690
353870;202204;34633;86972;25783;70725;3217;9864;13961;35063;17178;44927
353880;202204;3521;9241;2847;8017;212;731;1838;4875;2050;5606
353890;202204;3464;7063;2551;5783;142;392;1861;3857;2003;4249
353900;202204;853;2288;649;1909;87;289;284;759;371;1048
353910;202204;3115;8058;2665;7376;211;669;1954;5280;2165;5949
353920;202204;2303;5989;1692;4903;432;1368;404;948;836;2316
353930;202204;5478;13890;3910;10969;676;2192;1800;4455;2476;6647
353940;202204;1405;3890;1023;3150;155;524;389;1056;544;1580
353950;202204;3809;9755;2975;8274;664;1986;1360;3528;2024;5514
353960;202204;903;2254;648;1798;160;433;199;517;359;950
353970;202204;726;1653;557;1407;45;141;402;969;447;1110
353980;202204;18416;44329;14603;38071;754;2406;10906;27082;11660;29488
353990;202204;1048;2465;672;1819;104;307;348;890;452;1197
354000;202204;2907;6771;1722;4576;394;1068;416;1003;810;2071
354010;202204;362;914;261;757;45;141;147;414;192;555
354020;202204;4256;10972;3444;9413;607;1802;1762;4427;2369;6229
354025;202204;819;2165;555;1667;82;273;173;485;255;758
354030;202204;551;1148;306;768;58;141;146;344;204;485
354040;202204;901;1999;602;1550;29;90;451;1098;480;1188
354050;202204;1106;3027;798;2487;155;550;332;979;487;1529
354060;202204;4106;11009;3026;8791;536;1748;1410;3632;1946;5380
354070;202204;4523;11204;3129;8559;499;1539;1502;3648;2001;5187
354075;202204;3300;8723;2685;7679;314;990;1717;4672;2031;5662
354080;202204;1637;4321;1154;3405;205;644;429;1118;634;1762
354085;202204;498;952;397;828;0;0;318;614;318;614
354090;202204;1864;5016;1598;4480;94;283;1236;3351;1330;3634
354100;202204;23806;60837;17259;49955;3594;10992;7958;22318;11552;33310
354105;202204;1581;3811;1165;3108;140;454;590;1439;730;1893
354110;202204;480;1316;360;1096;64;221;138;392;202;613
354120;202204;1543;4023;1103;3114;220;668;391;972;611;1640
354130;202204;6417;16182;4391;12337;1232;3584;605;1357;1837;4941
354140;202204;22622;54072;16217;42667;2368;6987;7984;19053;10352;26040
354150;202204;3179;7329;2509;6321;578;1481;1013;2514;1591;3995
354160;202204;3251;8947;2564;7640;625;2050;987;2697;1612;4747
354165;202204;769;2168;605;1855;92;347;331;937;423;1284
354170;202204;2173;5715;1799;5044;128;421;1086;2863;1214;3284
354180;202204;457;1244;357;1050;43;123;193;531;236;654
354190;202204;1775;4826;1291;3837;80;287;696;1950;776;2237
354200;202204;1023;2370;790;2015;63;189;540;1277;603;1466
354210;202204;1097;2757;914;2484;53;179;668;1696;721;1875
354220;202204;3521;9023;2713;7518;402;1214;1476;3864;1878;5078
354230;202204;921;2160;755;1960;29;110;588;1457;617;1567
354240;202204;2004;5346;1383;4099;250;807;483;1260;733;2067
354250;202204;693;1631;453;1236;91;245;152;378;243;623
354260;202204;9428;23196;7406;19836;1114;3342;4056;10191;5170;13533
354270;202204;1146;3245;959;2906;159;525;453;1260;612;1785
354280;202204;951;2189;817;1993;57;169;597;1337;654;1506
354290;202204;1057;3193;896;2869;149;510;473;1507;622;2017
354300;202204;3985;11099;3386;10032;828;2468;1554;4537;2382;7005
354310;202204;824;2337;695;2104;152;488;315;904;467;1392
354320;202204;1097;2555;725;1957;91;279;348;830;439;1109
354323;202204;547;1257;351;906;42;102;168;401;210;503
354325;202204;1649;4762;1140;3624;215;708;276;823;491;1531
354330;202204;11122;26686;7970;20612;764;2281;5165;12343;5929;14624
354340;202204;40402;96997;29144;78184;3548;10861;17625;44910;21173;55771
354350;202204;1358;3302;1094;2890;148;457;665;1630;813;2087
354360;202204;701;1683;450;1292;112;328;133;362;245;690
354370;202204;1128;3053;923;2731;134;440;577;1636;711;2076
354380;202204;743;1896;560;1612;96;360;193;447;289;807
354390;202204;16459;38141;11402;29575;1687;4822;6078;14620;7765;19442
354400;202204;1790;5483;1441;4694;271;934;533;1688;804;2622
354410;202204;7538;18689;5911;15743;879;2629;3330;8200;4209;10829
354420;202204;1716;4238;1275;3452;158;480;744;1851;902;2331
354425;202204;3155;7428;2332;6044;466;1254;1094;2778;1560;4032
354430;202204;1738;4383;1389;3876;106;338;905;2402;1011;2740
354440;202204;689;1695;465;1274;56;170;234;580;290;750
354450;202204;534;1380;326;992;47;158;108;272;155;430
354460;202204;939;2331;649;1833;113;344;297;789;410;1133
354470;202204;486;1199;344;941;16;54;176;418;192;472
354480;202204;1506;3295;1002;2507;85;248;642;1488;727;1736
354490;202204;916;2570;687;2082;124;392;324;897;448;1289
354500;202204;2482;6586;2002;5839;590;1772;600;1735;1190;3507
354510;202204;827;2203;676;1925;46;161;427;1104;473;1265
354515;202204;454;1242;324;988;50;167;119;344;169;511
354520;202204;8546;22105;6254;17404;772;2517;3610;9222;4382;11739
354530;202204;5405;14356;4322;12358;958;2734;1741;5016;2699;7750
354540;202204;1522;3811;1136;3148;217;626;490;1314;707;1940
354550;202204;677;1754;545;1519;74;239;302;780;376;1019
354560;202204;2547;5946;1442;3909;168;469;782;1925;950;2394
354570;202204;1345;3285;575;1593;121;329;78;202;199;531
354580;202204;9662;24741;6639;19075;977;3110;3494;9480;4471;12590
354600;202204;2319;5751;1850;4961;271;725;1120;2862;1391;3587
354610;202204;521;1314;300;859;32;94;139;373;171;467
354620;202204;550;1452;346;1070;37;152;156;434;193;586
354625;202204;342;908;212;666;35;130;57;146;92;276
354630;202204;2654;7363;2205;6514;635;1914;613;1736;1248;3650
354640;202204;4061;10918;3150;9190;408;1393;1529;4036;1937;5429
354650;202204;978;2505;793;2207;104;286;465;1260;569;1546
354660;202204;3990;9077;2278;6348;236;800;1055;2658;1291;3458
354670;202204;1229;3284;889;2623;177;576;370;996;547;1572
354680;202204;6320;15531;4899;13290;887;2563;2771;7472;3658;10035
354690;202204;587;1733;430;1406;86;290;151;455;237;745
354700;202204;1024;2640;740;2105;80;264;406;1062;486;1326
354710;202204;558;1451;385;1116;46;135;172;437;218;572
354720;202204;336;779;162;456;61;155;39;119;100;274
354730;202204;11788;31941;9291;27331;1143;3755;5651;15853;6794;19608
354740;202204;356;948;162;511;25;92;25;62;50;154
354750;202204;3202;7880;2123;5882;295;923;928;2259;1223;3182
354760;202204;2449;6282;1803;5140;371;1176;700;1804;1071;2980
354765;202204;396;1036;175;537;17;67;57;154;74;221
354770;202204;2849;6784;2122;5526;388;1020;967;2392;1355;3412
354780;202204;67013;160327;52596;133211;3855;11720;37026;87280;40881;99000
354790;202204;1157;3041;913;2647;68;235;593;1647;661;1882
354800;202204;3004;7454;2322;6370;471;1369;1102;2809;1573;4178
354805;202204;1545;3433;1125;2834;109;270;729;1705;838;1975
354810;202204;701;2004;441;1462;70;271;144;435;214;706
354820;202204;1099;2983;802;2448;156;538;254;610;410;1148
354830;202204;571;1353;356;968;78;226;123;298;201;524
354840;202204;1007;2468;645;1742;57;170;365;898;422;1068
354850;202204;24366;59732;17740;48544;1744;5534;11495;29603;13239;35137
354860;202204;1931;5077;1266;3762;206;669;473;1304;679;1973
354870;202204;71816;173201;56802;146527;4702;14113;38863;94062;43565;108175
354880;202204;6729;16087;3552;9610;423;1354;1481;3233;1904;4587
354890;202204;18820;45279;14905;38815;1972;5801;8732;21894;10704;27695
354900;202204;444;1077;296;831;61;193;116;264;177;457
354910;202204;6705;17142;4332;12953;958;3078;1125;3037;2083;6115
354920;202204;566;1471;296;939;40;136;72;195;112;331
354925;202204;320;874;197;614;24;76;54;155;78;231
354930;202204;421;1005;294;783;37;102;145;361;182;463
354940;202204;2718;7692;2057;6327;636;2061;647;1774;1283;3835
354950;202204;1778;4240;1449;3824;81;272;1091;2734;1172;3006
354960;202204;981;2501;737;2135;83;285;359;964;442;1249
354970;202204;4762;12621;3794;11026;354;1268;2574;7191;2928;8459
354980;202204;39164;89831;27593;70459;2621;8012;17808;42277;20429;50289
354990;202204;84385;200607;62920;163177;4261;13433;43377;104918;47638;118351
354995;202204;3535;7270;2754;6289;132;385;2214;4852;2346;5237
355000;202204;1793;4244;1372;3639;203;648;725;1754;928;2402
355010;202204;4646;12016;3086;8784;989;2743;667;1875;1656;4618
355020;202204;4039;10715;3051;9052;583;1936;1381;3806;1964;5742
355030;202204;1575902;3741622;1187629;3020054;155291;438581;667814;1568109;823105;2006690
355040;202204;3526;8156;2754;7180;198;568;2138;5531;2336;6099
355050;202204;1220;2609;918;2205;222;567;427;937;649;1504
355060;202204;7247;18606;5445;15392;842;2739;2986;7718;3828;10457
355070;202204;11466;27791;9513;24782;1024;3148;6362;15569;7386;18717
355080;202204;1075;2954;699;2280;157;563;120;326;277;889
355090;202204;1437;3810;1160;3368;195;633;616;1647;811;2280
355100;202204;25578;63875;20266;56186;2642;7881;13135;35662;15777;43543
355110;202204;1048;2770;785;2380;215;744;111;308;326;1052
355120;202204;832;2089;602;1757;71;222;279;778;350;1000
355130;202204;933;2034;513;1294;27;79;340;793;367;872
355140;202204;2407;4895;2046;4406;89;230;1784;3735;1873;3965
355150;202204;5159;12860;4199;11250;453;1339;2767;7088;3220;8427
355160;202204;2598;6786;1898;5598;407;1294;558;1513;965;2807
355170;202204;13244;31676;10590;27418;1690;4715;6030;15069;7720;19784
355180;202204;3218;8021;2361;6707;403;1317;1186;3068;1589;4385
355190;202204;2129;5409;1692;4716;516;1439;739;2219;1255;3658
355200;202204;915;2679;785;2482;201;690;364;1101;565;1791
355210;202204;3458;9001;2679;7397;491;1474;1334;3480;1825;4954
355220;202204;56522;141764;46073;122446;7333;21446;24869;61009;32202;82455
355230;202204;1333;3278;761;2177;128;371;251;645;379;1016
355240;202204;28478;72661;20772;58044;2153;6781;12434;32508;14587;39289
355250;202204;44322;112601;34021;93474;7237;20794;15985;41640;23222;62434
355255;202204;719;1756;396;1174;40;115;136;391;176;506
355260;202204;1796;4046;1328;3325;101;338;912;2105;1013;2443
355270;202204;1325;3725;1052;3193;223;715;473;1324;696;2039
355280;202204;36152;87582;26840;71088;3113;9207;15382;38068;18495;47275
355290;202204;1065;2718;829;2334;138;384;390;1046;528;1430
355300;202204;1553;4337;1288;3854;237;740;557;1535;794;2275
355310;202204;1022;2727;765;2290;100;330;438;1287;538;1617
355320;202204;604;1558;467;1309;98;325;199;455;297;780
355330;202204;3389;8226;2675;7016;112;379;2046;5093;2158;5472
355340;202204;4647;9998;3585;8623;544;1295;2125;5222;2669;6517
355350;202204;1555;4202;1196;3528;218;712;525;1455;743;2167
355360;202204;1386;3319;1090;2875;107;300;700;1776;807;2076
355365;202204;404;1006;218;690;50;153;41;128;91;281
355370;202204;5965;14759;4684;12750;1002;2487;2254;6585;3256;9072
355380;202204;3260;8324;2533;7020;470;1447;1005;2424;1475;3871
355385;202204;1657;4076;1375;3687;95;348;923;2248;1018;2596
355390;202204;924;2451;672;1930;115;370;305;790;420;1160
355395;202204;2177;5814;1603;4707;259;835;647;1660;906;2495
355400;202204;10620;29044;8622;25246;1832;6118;3746;9913;5578;16031
355410;202204;27112;71620;17867;53006;3506;11387;6058;17155;9564;28542
355420;202204;714;2154;597;1937;150;546;196;600;346;1146
355430;202204;4196;10214;3251;8567;576;1626;1622;4144;2198;5770
355440;202204;849;2226;553;1624;91;258;133;350;224;608
355450;202204;3879;9613;2697;7389;378;1164;1309;3194;1687;4358
355460;202204;564;1358;364;1020;35;123;168;429;203;552
355465;202204;508;1248;413;1101;55;157;261;679;316;836
355470;202204;1269;3117;761;2131;173;558;264;658;437;1216
355475;202204;392;878;329;800;10;26;261;617;271;643
355480;202204;4583;12065;3719;10777;449;1509;2502;7074;2951;8583
355490;202204;1029;2679;599;1825;57;204;287;801;344;1005
355495;202204;970;2556;732;2175;99;353;304;792;403;1145
355500;202204;7868;19363;5119;14245;734;2218;2119;5328;2853;7546
355510;202204;1579;3740;1049;2868;180;524;442;1090;622;1614
355520;202204;410;936;214;616;46;117;62;181;108;298
355530;202204;364;833;149;429;7;20;72;189;79;209
355535;202204;630;1637;502;1438;122;354;227;622;349;976
355540;202204;13018;30651;10931;27818;1060;3103;8021;19638;9081;22741
355550;202204;699;1985;591;1791;63;226;325;899;388;1125
355560;202204;1279;3210;758;2217;177;570;38;122;215;692
355570;202204;331;872;190;576;32;97;51;139;83;236
355580;202204;1368;3170;857;2325;146;460;316;775;462;1235
355590;202204;182;466;139;398;13;37;82;226;95;263
355600;202204;1727;4161;1152;3178;188;548;388;1051;576;1599
355610;202204;2131;5044;1471;3931;156;445;815;2002;971;2447
355620;202204;5774;14717;4419;12147;483;1617;2569;6419;3052;8036
355630;202204;2929;7473;2159;6122;280;834;1263;3388;1543;4222
355635;202204;1030;2874;763;2354;129;426;252;721;381;1147
355640;202204;3948;10400;2789;8181;632;1857;789;2311;1421;4168
355645;202204;4555;12208;3374;10175;484;1628;1899;5484;2383;7112
355650;202204;7514;19536;5971;16802;1336;3912;2635;6875;3971;10787
355660;202204;1594;3978;1106;3134;203;520;339;907;542;1427
355670;202204;4501;11595;3213;8800;400;1357;1694;3998;2094;5355
355680;202204;3240;8622;1635;4971;416;1385;134;400;550;1785
355690;202204;853;2396;582;1888;165;576;17;42;182;618
355695;202204;289;780;178;537;14;52;36;77;50;129
355700;202204;8673;23524;7313;20689;930;2971;4423;11776;5353;14747
355710;202204;10836;24781;7519;18858;1022;3002;4027;8836;5049;11838
355715;202204;528;1393;298;883;66;193;58;160;124;353
355720;202204;1617;4319;1305;3800;173;554;751;2025;924;2579
355730;202204;1112;2897;905;2545;109;361;520;1359;629;1720
410010;202204;1365;3688;1063;3082;231;725;258;693;489;1418
410020;202204;1203;3371;921;2787;250;743;262;736;512;1479
410030;202204;1793;4638;1534;4240;199;590;871;2422;1070;3012
410040;202204;15268;40263;11488;33427;2366;7458;4085;11042;6451;18500
410045;202204;879;2295;640;1828;122;379;230;581;352;960
410050;202204;2518;6130;1775;4883;266;822;722;1841;988;2663
410060;202204;2335;6316;1868;5464;434;1348;566;1578;1000;2926
410070;202204;2187;5344;1645;4434;313;939;590;1395;903;2334
410080;202204;1496;3849;1075;3142;253;757;223;620;476;1377
410090;202204;1258;2950;1055;2666;103;247;595;1581;698;1828
410100;202204;2287;6272;1599;4737;295;940;172;473;467;1413
410105;202204;556;1368;333;941;33;101;130;348;163;449
410110;202204;3686;8829;2673;7056;351;1008;1337;3278;1688;4286
410115;202204;637;1584;468;1289;59;178;187;462;246;640
410120;202204;3295;8334;2873;7716;438;1179;1817;4822;2255;6001
410130;202204;1455;3685;1276;3365;177;513;745;1887;922;2400
410140;202204;19088;44952;12976;34435;2332;6728;4015;9747;6347;16475
410150;202204;18558;42685;10121;26735;1763;4980;2891;6794;4654;11774
410160;202204;3376;9013;2755;7965;608;1905;1038;2884;1646;4789
410165;202204;713;1842;570;1553;74;229;314;795;388;1024
410170;202204;3284;8179;2167;5884;444;1318;262;632;706;1950
410180;202204;18167;48474;14243;40903;2177;6847;7257;19072;9434;25919
410185;202204;508;1408;386;1113;50;167;149;367;199;534
410190;202204;2475;5988;1813;4837;383;1037;521;1271;904;2308
410200;202204;6571;14391;3732;9694;729;1995;561;1385;1290;3380
410210;202204;3591;8723;2330;6540;373;1203;802;1921;1175;3124
410220;202204;597;1501;402;1147;67;205;123;321;190;526
410230;202204;2056;5358;1579;4433;235;751;690;1711;925;2462
410240;202204;5837;14777;4107;11527;831;2633;670;1699;1501;4332
410250;202204;2651;6228;1966;5152;157;514;973;2432;1130;2946
410260;202204;2100;5075;1335;3663;185;533;672;1762;857;2295
410270;202204;547;1423;402;1164;53;185;162;429;215;614
410275;202204;682;1823;482;1397;79;266;190;489;269;755
410280;202204;2636;6700;1811;5164;229;752;792;2029;1021;2781
410290;202204;3695;9973;2587;7741;711;2093;712;2111;1423;4204
410300;202204;785;1849;617;1597;67;199;313;719;380;918
410302;202204;389;959;239;687;23;78;117;322;140;400
410304;202204;1539;3625;1327;3251;122;324;945;2199;1067;2523
410305;202204;1874;4323;1331;3560;99;310;893;2298;992;2608
410310;202204;3132;8081;2594;7145;251;872;1620;4231;1871;5103
410315;202204;746;1667;489;1268;162;429;146;382;308;811
410320;202204;1111;3019;759;2351;97;323;125;351;222;674
410322;202204;725;1864;383;1092;52;167;154;370;206;537
410330;202204;1695;3992;1188;3082;190;499;402;1012;592;1511
410335;202204;940;2414;705;1986;112;356;285;722;397;1078
410337;202204;903;2163;636;1663;95;263;226;519;321;782
410340;202204;541;1477;372;1084;25;90;155;349;180;439
410345;202204;2859;7303;1691;4875;345;1072;569;1453;914;2525
410347;202204;854;2146;619;1736;69;204;200;560;269;764
410350;202204;1829;4327;1345;3565;149;455;685;1652;834;2107
410360;202204;4535;11047;3469;9226;590;1658;1394;3581;1984;5239
410370;202204;15818;41094;10433;28815;1230;3757;4456;10627;5686;14384
410380;202204;1942;4633;1424;3749;238;714;502;1153;740;1867
410390;202204;3113;7388;2142;5762;446;1373;851;1995;1297;3368
410395;202204;1032;2829;830;2441;145;433;346;1027;491;1460
410400;202204;8220;20180;6279;16649;745;2219;3627;8927;4372;11146
410405;202204;962;2176;680;1760;79;226;356;846;435;1072
410410;202204;1625;4047;1483;3831;136;400;1026;2637;1162;3037
410420;202204;13022;33768;10012;28070;1453;4536;4582;11555;6035;16091
410425;202204;3927;10428;2756;8085;469;1491;1072;2830;1541;4321
410430;202204;14757;35708;10609;28411;1587;4699;4142;10177;5729;14876
410440;202204;2586;7240;2214;6574;352;1128;1175;3421;1527;4549
410442;202204;2743;7783;2221;6710;576;1823;646;1842;1222;3665
410445;202204;2489;6842;1815;5569;408;1391;292;957;700;2348
410450;202204;1671;3964;1277;3367;221;608;523;1271;744;1879
410460;202204;2589;6189;1904;5038;282;806;904;2198;1186;3004
410465;202204;3242;8889;2539;7619;470;1445;913;2520;1383;3965
410470;202204;2545;6695;1814;5419;476;1554;256;843;732;2397
410480;202204;44120;102996;25580;71323;3874;12071;7082;16875;10956;28946
410490;202204;13060;34368;9583;27504;1517;4646;4268;11293;5785;15939
410500;202204;2084;5217;1407;3965;259;775;352;834;611;1609
410510;202204;2021;4860;1413;3817;288;740;457;1230;745;1970
410520;202204;3348;9987;2961;9264;875;2880;1059;3363;1934;6243
410530;202204;1766;4183;857;2369;106;318;222;486;328;804
410540;202204;3140;8132;2189;6258;343;1096;954;2560;1297;3656
410550;202204;8662;22268;5959;16728;1023;3140;1769;4201;2792;7341
410560;202204;1762;4403;1301;3515;259;758;455;1038;714;1796
410570;202204;2957;7606;2160;6264;677;2264;259;778;936;3042
410580;202204;30715;76413;23419;63532;3536;10768;11925;29926;15461;40694
410590;202204;1817;4907;1309;3773;194;590;415;996;609;1586
410600;202204;2006;5062;1587;4269;313;877;544;1454;857;2331
410610;202204;797;1971;606;1635;64;201;294;717;358;918
410620;202204;2982;7916;2126;6072;526;1545;465;1251;991;2796
410630;202204;2873;7126;1931;5326;356;1167;496;1108;852;2275
410640;202204;5473;12425;3873;9693;857;2393;616;1568;1473;3961
410645;202204;1279;3361;1052;3083;195;610;665;1934;860;2544
410650;202204;2762;7228;1936;5583;348;1072;792;2068;1140;3140
410655;202204;983;2299;707;1837;50;125;358;876;408;1001
410657;202204;683;1817;424;1271;65;213;141;350;206;563
410660;202204;4050;9816;2519;6656;408;1150;918;2143;1326;3293
410670;202204;1146;2772;691;1906;117;315;237;588;354;903
410680;202204;2710;7833;1857;5780;501;1611;374;1159;875;2770
410685;202204;578;1426;425;1166;87;264;171;441;258;705
410690;202204;156017;365628;109337;282862;16468;47953;48122;110370;64590;158323
410700;202204;2738;6723;2278;6029;444;1222;1053;2649;1497;3871
410710;202204;1009;2461;647;1797;116;348;289;734;405;1082
410712;202204;723;1915;601;1700;91;286;331;902;422;1188
410715;202204;958;2657;609;1884;68;220;263;763;331;983
410720;202204;3952;9607;3253;8424;519;1594;1137;2796;1656;4390
410725;202204;1286;3038;786;2148;182;547;158;361;340;908
410730;202204;866;2167;660;1821;119;364;156;438;275;802
410740;202204;964;2604;725;2164;69;253;345;1012;414;1265
410750;202204;2104;4951;1697;4254;280;732;867;2050;1147;2782
410752;202204;433;1028;238;663;37;101;113;285;150;386
410753;202204;366;1034;261;810;38;128;63;175;101;303
410754;202204;1207;2954;1004;2662;65;162;708;1940;773;2102
410755;202204;622;1552;461;1263;52;145;213;528;265;673
410760;202204;4070;10228;2861;8016;666;2183;796;2045;1462;4228
410765;202204;18066;47668;14411;40832;2917;9138;4372;10770;7289;19908
410770;202204;1166;2684;823;2114;85;199;421;1087;506;1286
410773;202204;1438;3610;1256;3339;112;351;859;2203;971;2554
410775;202204;1792;4034;1564;3713;51;135;1151;2616;1202;2751
410780;202204;710;1703;480;1276;88;255;151;367;239;622
410785;202204;810;2017;599;1668;75;257;219;583;294;840
410790;202204;1118;3100;918;2722;211;657;135;317;346;974
410800;202204;3821;8135;3074;7101;82;250;2046;4530;2128;4780
410810;202204;496;1292;370;1056;41;139;152;389;193;528
410820;202204;1090;3000;602;1763;118;373;126;297;244;670
410830;202204;47838;109928;34332;87915;6112;17516;15042;35867;21154;53383
410832;202204;1183;3010;965;2644;94;319;608;1536;702;1855
410840;202204;10035;24256;6047;16909;1219;3666;1759;4357;2978;8023
410845;202204;1274;3028;991;2603;148;416;474;1186;622;1602
410850;202204;2405;6518;2109;6010;352;1123;1015;2778;1367;3901
410855;202204;832;2013;533;1440;60;173;262;624;322;797
410860;202204;5174;11935;4126;10295;213;682;2793;6545;3006;7227
410865;202204;1615;4418;1381;3997;137;441;817;2420;954;2861
410870;202204;1362;3522;1106;3081;130;392;649;1758;779;2150
410880;202204;5272;13463;3727;10750;715;2191;727;2075;1442;4266
410890;202204;1187;3166;942;2719;166;526;382;1029;548;1555
410895;202204;1116;3370;949;3037;300;1046;268;808;568;1854
410900;202204;934;2390;660;1895;106;340;172;402;278;742
410910;202204;475;1065;299;745;12;40;162;357;174;397
410920;202204;976;2269;735;1905;94;268;376;942;470;1210
410930;202204;1932;4760;1357;3794;354;1096;251;687;605;1783
410940;202204;26830;69504;19878;57447;3736;11771;7521;20805;11257;32576
410950;202204;2174;5965;1965;5644;101;323;1590;4507;1691;4830
410960;202204;9015;21112;6404;16933;1487;4339;2782;7122;4269;11461
410965;202204;1314;3164;915;2470;78;231;590;1528;668;1759
410970;202204;4676;12122;3343;9584;834;2740;549;1314;1383;4054
410975;202204;1592;3691;1213;3116;171;508;592;1452;763;1960
410980;202204;8516;20450;5673;15546;632;1925;2643;6557;3275;8482
410990;202204;1608;3697;1111;2943;187;555;505;1313;692;1868
411000;202204;757;1997;551;1630;97;305;176;470;273;775
411005;202204;520;1240;320;842;48;139;112;251;160;390
411007;202204;2798;7230;2108;6000;395;1253;827;2219;1222;3472
411010;202204;4816;13744;3834;11880;975;3227;535;1527;1510;4754
411020;202204;2624;7060;2180;6320;554;1694;722;2026;1276;3720
411030;202204;827;2006;581;1514;65;194;262;584;327;778
411040;202204;1138;2773;603;1661;95;261;165;372;260;633
411050;202204;2229;6625;1828;5812;409;1439;354;948;763;2387
411060;202204;2410;6191;1616;4588;333;1004;434;1149;767;2153
411065;202204;457;1117;286;783;25;80;120;300;145;380
411070;202204;8541;20578;6847;17898;796;2374;3805;9445;4601;11819
411080;202204;2157;5546;1771;4880;422;1326;495;1324;917;2650
411090;202204;902;2331;594;1732;84;253;139;345;223;598
411095;202204;2913;6655;1676;4505;247;685;347;833;594;1518
411100;202204;1353;3389;958;2706;115;375;353;929;468;1304
411110;202204;718;1802;348;1024;38;108;28;54;66;162
411120;202204;1606;4104;1325;3647;302;979;494;1182;796;2161
411125;202204;6028;16690;5388;15565;1135;3293;2638;7816;3773;11109
411130;202204;806;2051;576;1629;139;368;160;500;299;868
411140;202204;2512;7347;2085;6482;534;1749;668;2079;1202;3828
411150;202204;4528;11016;3107;8290;659;1873;332;702;991;2575
411155;202204;1146;2811;751;2095;108;324;342;850;450;1174
411160;202204;422;937;283;719;39;109;79;197;118;306
411170;202204;889;2434;681;2013;134;441;294;813;428;1254
411180;202204;6586;16494;5237;14282;738;2260;2756;6934;3494;9194
411190;202204;2181;5418;1649;4486;222;676;706;1691;928;2367
411200;202204;5523;14254;4160;11846;910;2965;1275;3137;2185;6102
411210;202204;3843;8322;2769;6626;388;1085;1285;2868;1673;3953
411220;202204;1003;2477;713;1954;157;449;229;601;386;1050
411230;202204;968;2483;718;2018;151;470;237;620;388;1090
411240;202204;1802;4097;1258;3196;194;524;557;1330;751;1854
411250;202204;2538;6446;1852;5248;366;1182;615;1623;981;2805
411260;202204;364;902;242;668;28;92;97;233;125;325
411270;202204;2217;5674;1656;4584;259;755;805;2044;1064;2799
411275;202204;1709;3748;1193;2944;135;405;651;1486;786;1891
411280;202204;1557;4049;1107;3218;278;858;245;641;523;1499
411290;202204;928;2334;601;1707;70;226;319;863;389;1089
411295;202204;1384;3387;1001;2698;131;391;455;1136;586;1527
411300;202204;1137;2785;756;2065;77;230;327;767;404;997
411310;202204;1015;2235;796;1944;126;323;377;876;503;1199
411320;202204;6148;15147;4593;12509;690;2020;2133;5209;2823;7229
411325;202204;1620;4332;1340;3823;253;719;673;1980;926;2699
411330;202204;3648;9450;2709;7808;572;1806;882;2528;1454;4334
411340;202204;928;2477;562;1676;89;290;177;476;266;766
411342;202204;1186;2798;650;1734;106;306;227;542;333;848
411345;202204;1316;3157;992;2635;66;210;702;1832;768;2042
411350;202204;3267;8437;2197;6391;579;1767;426;1127;1005;2894
411360;202204;855;1926;643;1606;60;191;352;770;412;961
411370;202204;67529;161349;50084;132600;3883;12239;30082;73580;33965;85819
411373;202204;1616;3874;1296;3408;140;401;683;1809;823;2210
411375;202204;1261;3019;890;2341;112;304;365;905;477;1209
411380;202204;1272;2870;885;2158;51;136;568;1274;619;1410
411390;202204;1702;4494;1358;3794;202;633;541;1288;743;1921
411400;202204;2637;6228;2013;5136;169;508;1143;2728;1312;3236
411410;202204;3126;8417;2356;6856;509;1594;587;1562;1096;3156
411420;202204;4828;11396;2710;7547;401;1212;551;1165;952;2377
411430;202204;4280;10867;3259;9037;669;2072;1161;2857;1830;4929
411435;202204;487;1282;308;932;56;174;96;255;152;429
411440;202204;2840;7528;2285;6523;456;1456;782;2083;1238;3539
411450;202204;2780;7076;2130;6033;247;752;1275;3580;1522;4332
411460;202204;4965;12406;3186;9078;496;1569;720;1754;1216;3323
411470;202204;916;2244;680;1835;123;362;275;659;398;1021
411480;202204;6055;15250;4412;12266;711;2336;1630;4057;2341;6393
411490;202204;1844;4506;1403;3818;160;519;641;1552;801;2071
411500;202204;1502;3882;1040;2931;175;546;233;522;408;1068
411510;202204;2587;6146;2052;5304;315;930;657;1736;972;2666
411520;202204;39139;93133;24096;64395;2870;8875;10071;23770;12941;32645
411530;202204;1057;2641;625;1843;99;322;116;318;215;640
411535;202204;567;1594;384;1185;52;174;124;336;176;510
411540;202204;2983;7033;2098;5489;89;289;1261;3196;1350;3485
411545;202204;996;2781;831;2487;63;214;547;1625;610;1839
411550;202204;791;1897;606;1571;88;239;188;440;276;679
411560;202204;2209;5902;1248;3852;191;636;101;247;292;883
411570;202204;8103;18225;5697;14687;1331;3698;1477;3671;2808;7369
411573;202204;862;2233;710;1966;150;451;305;772;455;1223
411575;202204;2197;5726;1657;4701;311;945;508;1338;819;2283
411580;202204;5401;12328;3370;9222;553;1710;639;1553;1192;3263
411585;202204;667;1916;336;1063;63;198;61;176;124;374
411590;202204;489;1293;365;1051;40;136;190;501;230;637
411600;202204;376;904;237;681;41;129;92;242;133;371
411605;202204;1741;3915;1129;2974;170;483;556;1485;726;1968
411610;202204;3119;6809;2246;5326;56;192;1649;3615;1705;3807
411620;202204;3213;8049;2713;7301;425;1189;1484;3991;1909;5180
411630;202204;928;2263;593;1678;76;261;223;542;299;803
411640;202204;531;1326;370;993;48;123;137;320;185;443
411650;202204;223;612;144;444;29;98;33;75;62;173
411660;202204;1027;2515;727;1950;74;226;291;695;365;921
411670;202204;1657;3769;1137;2834;104;282;641;1455;745;1737
411680;202204;1586;4081;1188;3326;240;738;459;1237;699;1975
411690;202204;4428;10845;3309;8930;659;1746;1030;2922;1689;4668
411695;202204;713;2041;503;1512;50;168;217;603;267;771
411700;202204;1872;4667;1264;3532;294;856;240;632;534;1488
411705;202204;2565;7127;2192;6500;353;1006;1341;4178;1694;5184
411710;202204;2269;5607;1583;4344;348;980;461;1158;809;2138
411720;202204;1195;2756;852;2169;123;324;345;831;468;1155
411721;202204;1122;2687;832;2170;128;337;287;707;415;1044
411722;202204;1034;2761;581;1736;97;321;174;401;271;722
411725;202204;1405;3782;924;2840;212;710;221;634;433;1344
411727;202204;1660;4411;1100;3251;244;748;130;333;374;1081
411729;202204;680;1626;388;1064;64;214;127;280;191;494
411730;202204;6031;15135;4742;12727;757;2234;2435;6266;3192;8500
411740;202204;568;1444;314;910;78;209;61;144;139;353
411745;202204;915;2551;655;1992;73;275;182;415;255;690
411750;202204;6690;16830;5020;13715;625;1876;2552;6500;3177;8376
411760;202204;8003;20238;6227;17375;1893;5367;1511;4586;3404;9953
411770;202204;3610;9954;2695;8028;592;1875;621;1652;1213;3527
411780;202204;2944;7901;2562;7240;632;1860;1018;2935;1650;4795
411790;202204;3290;7615;2004;5416;354;1096;626;1447;980;2543
411800;202204;1297;3570;936;2705;192;596;217;525;409;1121
411810;202204;1751;4364;1333;3584;223;628;548;1357;771;1985
411820;202204;15009;39569;12526;35461;2693;8098;6385;17488;9078;25586
411830;202204;581;1380;438;1136;138;323;63;173;201;496
411840;202204;14046;35892;9902;27661;1600;4864;3235;8050;4835;12914
411845;202204;699;1932;431;1333;76;266;107;288;183;554
411850;202204;8720;21225;6109;16806;1427;4181;1399;3536;2826;7717
411860;202204;787;2114;597;1742;88;275;148;389;236;664
411870;202204;656;1817;469;1417;123;387;103;293;226;680
411880;202204;2641;6165;1911;5031;239;731;851;2071;1090;2802
411885;202204;1232;3131;875;2455;119;393;249;565;368;958
411890;202204;1614;4158;1172;3403;220;711;145;403;365;1114
411900;202204;933;2433;587;1720;123;376;136;381;259;757
411910;202204;1222;3430;895;2790;167;620;305;851;472;1471
411915;202204;17537;41865;12457;32912;1772;5188;5552;13301;7324;18489
411920;202204;1342;3657;1113;3243;215;705;450;1232;665;1937
411925;202204;536;1360;384;1095;67;201;172;452;239;653
411930;202204;5642;16030;4761;14492;2040;6560;594;2051;2634;8611
411940;202204;3732;10282;2965;8756;684;2119;1097;2924;1781;5043
411950;202204;16480;42525;13810;38258;1515;4880;8769;23129;10284;28009
411960;202204;6819;17246;5445;14671;972;2741;2279;5813;3251;8554
411965;202204;542;1443;393;1146;51;170;176;472;227;642
411970;202204;1301;2812;1017;2439;189;397;483;1328;672;1725
411980;202204;1722;3931;1262;3222;255;653;579;1407;834;2060
411990;202204;43809;109914;29387;84703;5111;16149;11935;32458;17046;48607
411995;202204;4883;11416;3820;9815;1021;2914;1237;3021;2258;5935
412000;202204;2031;4543;1439;3576;41;137;1019;2340;1060;2477
412010;202204;693;2042;515;1664;72;253;132;371;204;624
412015;202204;588;1574;474;1365;61;169;267;770;328;939
412020;202204;494;1366;318;1000;53;190;126;369;179;559
412030;202204;672;1855;501;1542;59;204;207;594;266;798
412033;202204;1038;2645;745;2085;77;230;285;675;362;905
412035;202204;775;2044;504;1550;64;208;267;786;331;994
412040;202204;779;2026;458;1376;56;160;77;206;133;366
412050;202204;1716;4145;1176;3188;261;787;286;756;547;1543
412060;202204;8223;22549;6801;19788;1725;5653;2053;5723;3778;11376
412065;202204;698;1860;522;1513;102;336;155;421;257;757
412070;202204;1425;3525;1110;2943;129;400;486;1129;615;1529
412080;202204;2715;6970;1970;5572;275;899;819;1978;1094;2877
412085;202204;360;853;134;395;15;53;36;85;51;138
412090;202204;7149;17380;5295;14153;1082;3061;2242;5971;3324;9032
412100;202204;2027;5099;1505;4189;459;1400;415;1180;874;2580
412110;202204;1035;2650;684;1954;89;272;231;601;320;873
412120;202204;2521;6689;1969;5722;439;1422;604;1527;1043;2949
412125;202204;778;2089;505;1535;93;291;118;339;211;630
412130;202204;899;2162;623;1664;122;323;165;424;287;747
412135;202204;662;1719;328;974;50;173;110;275;160;448
412140;202204;2104;4937;1509;3922;245;710;368;932;613;1642
412150;202204;3129;7729;2607;6799;469;1351;1322;3154;1791;4505
412160;202204;998;3005;566;1850;62;227;49;113;111;340
412170;202204;5003;13024;4242;11835;737;2259;2016;5213;2753;7472
412175;202204;1464;3993;1230;3596;262;774;513;1493;775;2267
412180;202204;1889;5017;1415;4176;181;622;628;1699;809;2321
412190;202204;3733;9025;2722;7243;335;1000;1137;2900;1472;3900
412200;202204;2149;5882;1443;4341;350;1142;285;777;635;1919
412210;202204;738;1693;460;1240;64;198;193;463;257;661
412215;202204;3643;9432;2724;7669;630;1763;1170;3403;1800;5166
412217;202204;1101;2735;918;2425;27;80;679;1697;706;1777
412220;202204;6700;18351;5422;16035;1258;3721;1825;5346;3083;9067
412230;202204;3022;8442;2392;7319;407;1408;547;1467;954;2875
412240;202204;8680;21781;5742;16185;981;3003;1797;4483;2778;7486
412250;202204;2225;5527;1645;4466;392;1136;368;903;760;2039
412260;202204;1488;3744;1133;3059;190;546;396;993;586;1539
412265;202204;1101;2758;891;2419;128;391;508;1259;636;1650
412270;202204;1125;3018;754;2256;105;352;290;790;395;1142
412280;202204;444;1156;348;994;75;216;99;265;174;481
412290;202204;1159;2822;831;2256;151;456;310;784;461;1240
412300;202204;1880;4718;1358;3843;247;740;342;932;589;1672
412310;202204;784;2183;601;1824;105;375;184;499;289;874
412320;202204;853;2106;533;1477;58;189;155;403;213;592
412330;202204;1761;4459;1220;3499;224;686;451;1299;675;1985
412340;202204;1294;3423;956;2743;146;455;128;341;274;796
412350;202204;3431;8729;2295;6556;460;1363;551;1431;1011;2794
412360;202204;303;788;231;643;6;24;155;405;161;429
412370;202204;922;2541;655;2003;132;415;122;370;254;785
412380;202204;1712;4546;1228;3609;331;1067;115;346;446;1413
412382;202204;539;1286;357;984;44;159;179;402;223;561
412385;202204;2547;6520;2081;5680;586;1551;837;2372;1423;3923
412390;202204;2803;6467;2212;5540;377;995;814;2017;1191;3012
412395;202204;816;2186;594;1700;83;217;286;792;369;1009
412400;202204;1013;2554;735;2049;135;384;235;604;370;988
412402;202204;2623;6218;1851;4984;414;1091;451;1231;865;2322
412405;202204;3447;8794;2307;6770;650;1962;272;767;922;2729
412410;202204;7041;17675;5251;14833;882;2932;1734;4565;2616;7497
412420;202204;614;1478;407;1081;38;110;192;444;230;554
412430;202204;622;1538;344;964;39;110;138;360;177;470
412440;202204;3230;8125;2267;6437;525;1519;682;1881;1207;3400
412450;202204;566;1587;391;1155;68;195;46;97;114;292
412460;202204;1247;3039;977;2601;150;438;475;1216;625;1654
412470;202204;1763;5216;1459;4570;350;1202;382;1144;732;2346
412480;202204;1312;3268;910;2483;155;467;360;855;515;1322
412490;202204;1517;3536;1167;2947;95;265;672;1552;767;1817
412500;202204;2274;5482;1742;4554;300;855;614;1425;914;2280
412510;202204;2188;6350;1582;4901;442;1457;277;716;719;2173
412520;202204;1490;3649;894;2477;194;525;167;434;361;959
412530;202204;754;1961;547;1561;77;229;108;288;185;517
412535;202204;868;2218;594;1699;127;402;95;200;222;602
412540;202204;1265;3108;918;2507;148;502;264;712;412;1214
412545;202204;763;1911;544;1493;96;283;178;456;274;739
412550;202204;40025;101859;29521;81867;4329;13223;13527;33864;17856;47087
412555;202204;331;828;230;618;24;82;81;170;105;252
412560;202204;5721;15523;4362;12586;883;2796;1202;3267;2085;6063
412570;202204;4971;12046;3033;8488;577;1833;532;1357;1109;3190
412575;202204;1191;2849;973;2500;158;414;524;1261;682;1675
412580;202204;1709;4209;1235;3369;97;293;699;1777;796;2070
412590;202204;457;1179;262;781;52;179;32;75;84;254
412600;202204;1854;4657;1422;3832;135;435;791;1922;926;2357
412610;202204;944;2453;681;1908;102;314;315;763;417;1077
412620;202204;1435;3568;1096;3047;230;681;398;1028;628;1709
412625;202204;9813;25165;6365;18540;1194;3712;555;1500;1749;5212
412627;202204;1239;3371;854;2604;157;526;263;787;420;1313
412630;202204;3099;8782;2230;6958;396;1337;630;1744;1026;3081
412635;202204;481;1253;318;929;36;115;107;256;143;371
412640;202204;1127;2877;668;1948;81;232;166;411;247;643
412650;202204;1874;4899;1490;4138;244;763;596;1459;840;2222
412660;202204;2956;7277;2182;5871;270;809;837;1998;1107;2807
412665;202204;439;1055;335;872;58;178;150;360;208;538
412667;202204;1961;4971;1455;3992;207;613;643;1700;850;2313
412670;202204;944;2148;644;1680;131;361;191;454;322;815
412680;202204;2334;5965;1633;4692;198;680;574;1402;772;2082
412690;202204;1299;3270;911;2532;177;525;302;769;479;1294
412700;202204;2144;5371;1811;4856;247;744;994;2559;1241;3303
412710;202204;6458;18007;4872;14781;903;3044;1381;3616;2284;6660
412720;202204;1360;3765;1092;3218;165;547;323;765;488;1312
412730;202204;2937;7354;2128;5850;367;1102;840;2138;1207;3240
412740;202204;2190;5878;1538;4630;309;1037;237;674;546;1711
412750;202204;4464;11211;3674;10085;335;1068;2322;6030;2657;7098
412760;202204;3282;8539;2755;7685;474;1502;1581;4169;2055;5671
412770;202204;12346;31184;7056;21033;931;2987;1586;3948;2517;6935
412780;202204;1337;3391;1031;2849;233;712;390;994;623;1706
412785;202204;2444;5508;1722;4333;202;508;1134;2806;1336;3314
412788;202204;1584;4289;1298;3795;315;928;538;1515;853;2443
412790;202204;1499;3821;915;2692;148;482;309;769;457;1251
412795;202204;1352;3407;762;2243;122;384;155;436;277;820
412796;202204;2568;7000;2155;6281;474;1501;723;1926;1197;3427
412800;202204;4271;9881;3071;7742;348;1056;1542;3401;1890;4457
412810;202204;13960;34664;9511;25996;1116;3572;4087;9919;5203;13491
412820;202204;7017;18482;5040;14642;1130;3487;1639;4686;2769;8173
412830;202204;372;1028;285;852;35;102;71;198;106;300
412840;202204;2100;4921;1473;3758;144;419;814;1873;958;2292
412850;202204;3046;7660;2278;6418;277;861;1106;2897;1383;3758
412853;202204;1738;4170;1454;3706;202;584;794;1760;996;2344
412855;202204;1519;3815;857;2449;109;365;207;479;316;844
412860;202204;826;2002;565;1578;87;269;265;657;352;926
412862;202204;735;1781;501;1402;96;272;196;526;292;798
412863;202204;1405;3972;1250;3694;302;965;521;1446;823;2411
412865;202204;763;2010;559;1616;136;397;165;475;301;872
412870;202204;982;2432;719;2019;186;576;226;661;412;1237
412880;202204;997;2617;716;2092;134;429;207;543;341;972
420005;202204;467;1330;287;918;24;76;138;440;162;516
420010;202204;3664;8621;2455;6597;168;489;1835;4918;2003;5407
420020;202204;494;1475;332;1081;54;213;94;235;148;448
420030;202204;120;403;81;299;25;100;22;79;47;179
420040;202204;620;1796;375;1261;91;356;35;101;126;457
420050;202204;792;1762;538;1325;121;323;296;652;417;975
420055;202204;179;529;101;338;18;68;34;105;52;173
420060;202204;139;389;97;295;14;42;33;95;47;137
420070;202204;887;2536;676;2106;146;486;312;925;458;1411
420075;202204;87;223;50;151;8;24;12;20;20;44
420080;202204;454;1237;354;1005;71;239;154;406;225;645
420090;202204;465;1402;299;1023;73;273;71;207;144;480
420100;202204;1556;3742;1297;3339;61;171;1026;2591;1087;2762
420110;202204;298;917;257;830;39;147;145;458;184;605
420120;202204;669;1766;475;1357;59;195;259;663;318;858
420125;202204;410;1197;290;934;67;244;102;311;169;555
420127;202204;339;874;148;447;21;74;60;171;81;245
420130;202204;4633;12278;3576;10567;627;2108;1578;4250;2205;6358
420140;202204;4554;11751;3466;9928;969;3009;874;2418;1843;5427
420150;202204;738;1823;535;1492;48;166;324;871;372;1037
420160;202204;219;523;90;271;12;49;26;67;38;116
420165;202204;182;511;122;382;28;89;45;123;73;212
420170;202204;304;907;219;705;38;131;71;196;109;327
420180;202204;184;580;115;407;20;95;30;91;50;186
420190;202204;228;644;136;415;31;99;51;145;82;244
420195;202204;1931;4802;1496;4144;383;1258;581;1451;964;2709
420200;202204;6540;15449;4339;11462;564;1768;2071;4705;2635;6473
420205;202204;2248;5727;1554;4367;248;770;829;2252;1077;3022
420207;202204;2305;5700;1491;4201;242;773;631;1624;873;2397
420208;202204;366;1003;221;720;73;235;55;155;128;390
420209;202204;179;547;120;373;15;56;60;163;75;219
420210;202204;4079;10083;2942;8234;414;1396;1614;4253;2028;5649
420213;202204;902;2589;743;2276;145;485;307;911;452;1396
420215;202204;252;731;180;562;44;151;51;155;95;306
420220;202204;348;1005;232;766;33;130;94;285;127;415
420230;202204;6193;15964;4863;13566;594;1899;2770;7240;3364;9139
420240;202204;16597;44813;11050;32247;1295;4470;5457;13864;6752;18334
420243;202204;450;1168;376;1033;45;140;255;682;300;822
420245;202204;1814;4498;1392;3779;120;389;904;2311;1024;2700
420250;202204;561;1457;491;1350;40;138;357;930;397;1068
420253;202204;503;1178;368;993;30;92;222;591;252;683
420257;202204;171;436;113;337;15;45;63;185;78;230
420260;202204;1313;3214;985;2779;87;296;747;2065;834;2361
420270;202204;631;1609;332;940;43;130;132;334;175;464
420280;202204;1521;4270;1240;3718;189;661;583;1636;772;2297
420285;202204;123;317;90;250;15;56;33;55;48;111
420287;202204;501;1106;361;921;72;197;169;425;241;622
420290;202204;5738;15758;4537;13187;598;2008;2690;7252;3288;9260
420300;202204;8384;22897;5096;15325;903;2991;1750;4672;2653;7663
420310;202204;961;2097;548;1390;47;145;338;780;385;925
420315;202204;879;2322;620;1906;77;268;343;1013;420;1281
420320;202204;6386;16430;4736;13818;1353;4336;1530;4222;2883;8558
420325;202204;383;1052;271;839;35;110;113;334;148;444
420330;202204;1073;3030;716;2304;127;480;237;683;364;1163
420340;202204;1195;3119;925;2642;200;627;324;809;524;1436
420350;202204;1340;3266;1008;2706;94;310;699;1823;793;2133
420360;202204;3292;8696;1859;5694;383;1269;176;543;559;1812
420370;202204;1460;3632;1182;3170;84;292;833;2093;917;2385
420380;202204;5027;12635;3487;9883;648;2061;1527;4001;2175;6062
420390;202204;1170;2809;835;2167;148;436;336;650;484;1086
420395;202204;1336;3657;948;2893;164;562;176;387;340;949
420400;202204;1195;3164;849;2500;106;361;442;1232;548;1593
420410;202204;641;1615;505;1346;30;88;374;983;404;1071
420415;202204;375;1042;276;820;59;198;112;336;171;534
420417;202204;681;1926;541;1651;118;368;267;829;385;1197
420419;202204;173;594;124;462;49;196;14;55;63;251
420420;202204;14229;36129;9924;28325;2481;7950;3486;9090;5967;17040
420425;202204;706;1878;499;1443;45;149;256;705;301;854
420430;202204;3492;9085;2185;6333;408;1353;882;2293;1290;3646
420435;202204;308;779;170;524;30;101;81;240;111;341
420440;202204;837;2165;539;1534;123;348;204;561;327;909
420445;202204;277;651;182;485;26;80;73;158;99;238
420450;202204;889;2531;649;2000;112;423;233;597;345;1020
420455;202204;2387;5453;1784;4560;360;938;828;2096;1188;3034
420460;202204;10598;27092;8201;22812;1089;3497;4523;11876;5612;15373
420470;202204;697;1777;374;1094;68;223;104;261;172;484
420475;202204;77;204;35;110;7;29;5;9;12;38
420480;202204;6031;14437;3910;10935;619;1903;1696;4623;2315;6526
420490;202204;435;1177;311;916;47;153;144;398;191;551
420500;202204;1502;3903;1019;3060;156;545;507;1463;663;2008
420510;202204;175;484;96;315;20;69;26;75;46;144
420515;202204;111;303;75;225;11;41;25;75;36;116
420517;202204;801;2110;679;1891;74;215;417;1154;491;1369
420519;202204;346;850;257;713;26;80;139;384;165;464
420520;202204;306;808;167;538;29;90;12;36;41;126
420530;202204;904;2574;630;1983;96;355;246;664;342;1019
420535;202204;239;679;109;350;15;50;37;102;52;152
420540;202204;44669;104684;31282;82679;4232;12775;12679;29316;16911;42091
420543;202204;253;735;199;616;31;108;91;249;122;357
420545;202204;1465;4276;1113;3508;245;826;392;1137;637;1963
420550;202204;4243;10740;2845;8375;440;1460;1282;3750;1722;5210
420555;202204;361;1008;262;799;26;93;154;438;180;531
420560;202204;429;1018;294;821;44;114;187;534;231;648
420570;202204;3003;7535;2315;6308;373;1135;1194;3075;1567;4210
420580;202204;1949;5028;1378;4104;289;917;451;1280;740;2197
420590;202204;3135;8245;2018;5871;338;1129;592;1384;930;2513
420600;202204;1217;3317;973;2881;103;398;600;1669;703;2067
420610;202204;484;1344;336;1039;67;213;150;456;217;669
420620;202204;899;2165;635;1743;135;388;262;702;397;1090
420630;202204;1051;3093;781;2450;112;373;417;1230;529;1603
420640;202204;544;1442;292;939;95;315;63;186;158;501
420650;202204;4130;10552;2752;7814;403;1261;1207;2971;1610;4232
420660;202204;470;1174;307;835;71;212;74;172;145;384
420665;202204;768;1936;519;1526;76;257;237;623;313;880
420670;202204;1389;3779;887;2750;118;411;253;646;371;1057
420675;202204;203;528;125;384;13;49;75;227;88;276
420680;202204;321;709;172;504;24;91;90;238;114;329
420690;202204;954;2689;630;1952;82;282;191;491;273;773
420700;202204;3205;8184;2498;6984;187;604;1686;4557;1873;5161
420710;202204;1205;3305;976;2827;116;435;587;1507;703;1942
420720;202204;1434;3828;1065;3168;167;553;614;1697;781;2250
420730;202204;3647;9182;2791;7801;456;1436;1536;4070;1992;5506
420740;202204;530;1543;306;1054;74;268;24;86;98;354
420750;202204;2270;6367;1538;4734;258;962;610;1674;868;2636
420757;202204;108;272;52;163;6;19;25;81;31;100
420760;202204;378;1069;215;646;35;112;71;188;106;300
420765;202204;536;1473;284;874;32;103;163;483;195;586
420768;202204;1484;3966;1298;3663;122;356;1006;2814;1128;3170
420770;202204;433;1180;202;709;22;95;51;160;73;255
420775;202204;320;896;212;665;38;138;82;217;120;355
420780;202204;1054;2918;641;1978;113;352;96;266;209;618
420785;202204;224;573;164;450;19;72;80;167;99;239
420790;202204;1188;3365;914;2820;159;580;544;1567;703;2147
420800;202204;786;1872;471;1289;97;286;240;634;337;920
420810;202204;1633;4778;1373;4291;311;1163;669;1830;980;2993
420820;202204;14811;36120;11012;30135;1719;5267;5632;14352;7351;19619
420830;202204;5237;13242;3979;11067;642;1954;1797;4737;2439;6691
420840;202204;543;1619;285;1028;78;269;38;131;116;400
420845;202204;3070;7634;2074;5895;391;1329;896;2427;1287;3756
420850;202204;1245;3817;822;2739;157;570;214;646;371;1216
420860;202204;445;1163;260;813;54;176;75;205;129;381
420870;202204;878;2383;648;1925;142;453;235;650;377;1103
420880;202204;1245;3609;993;3108;203;714;422;1223;625;1937
420890;202204;8963;23800;5814;17418;831;2770;2106;5605;2937;8375
420895;202204;193;532;130;379;22;68;52;145;74;213
420900;202204;1704;4101;1059;3004;144;517;498;1205;642;1722
420910;202204;37135;95440;25089;73143;3645;12352;11106;28524;14751;40876
420915;202204;563;1942;426;1573;58;241;243;888;301;1129
420917;202204;505;1258;241;645;32;79;124;328;156;407
420920;202204;94;242;47;143;5;17;13;39;18;56
420930;202204;18948;47157;13970;38711;2160;6696;7066;18395;9226;25091
420940;202204;3638;8662;2307;6465;506;1600;588;1344;1094;2944
420945;202204;199;586;128;385;20;74;51;135;71;209
420950;202204;399;1091;253;761;42;135;72;190;114;325
420960;202204;1211;2921;888;2401;133;404;439;1083;572;1487
420970;202204;2636;6901;1822;5444;412;1292;613;1811;1025;3103
420980;202204;296;996;255;906;98;363;79;283;177;646
420985;202204;381;1057;223;737;50;185;66;197;116;382
420990;202204;378;1129;226;764;34;125;54;165;88;290
421000;202204;617;1782;460;1458;104;356;117;303;221;659
421003;202204;503;1194;181;517;15;41;14;33;29;74
421005;202204;102;293;72;232;18;59;27;90;45;149
421010;202204;3832;9995;2834;8229;529;1734;996;2498;1525;4232
421020;202204;424;1286;340;1131;48;189;179;567;227;756
421030;202204;1028;2830;802;2391;187;612;340;948;527;1560
421040;202204;722;1705;456;1294;43;126;281;778;324;904
421050;202204;1237;3221;857;2407;135;408;353;891;488;1299
421055;202204;181;486;107;322;17;59;60;165;77;224
421060;202204;777;2166;556;1703;92;341;272;736;364;1077
421070;202204;740;2133;463;1442;67;228;199;560;266;788
421080;202204;577;1635;464;1419;74;275;226;646;300;921
421085;202204;401;1121;185;616;23;76;33;84;56;160
421090;202204;300;760;174;484;15;50;63;153;78;203
421100;202204;914;1983;423;1196;85;262;130;312;215;574
421105;202204;1790;4647;1290;3736;182;582;638;1745;820;2327
421110;202204;1360;3409;1123;3064;105;345;715;1961;820;2306
421120;202204;1195;3499;856;2768;138;476;246;707;384;1183
421125;202204;354;874;260;709;77;225;109;284;186;509
421130;202204;6057;16845;5030;14836;897;2910;2763;7731;3660;10641
421140;202204;384;1005;261;759;44;137;113;295;157;432
421145;202204;470;1238;314;920;82;258;93;237;175;495
421150;202204;804;2190;556;1683;113;390;238;634;351;1024
421160;202204;609;1646;468;1370;64;243;291;784;355;1027
421165;202204;244;682;154;470;26;83;67;187;93;270
421170;202204;1239;3260;1049;2955;105;296;744;2113;849;2409
421175;202204;1131;2805;670;2022;100;366;317;888;417;1254
421180;202204;431;1101;244;736;36;139;114;295;150;434
421185;202204;352;875;247;677;27;85;133;335;160;420
421187;202204;290;882;187;621;35;113;69;223;104;336
421189;202204;442;1226;341;1021;52;177;143;391;195;568
421190;202204;13955;36178;10111;29081;1742;5688;4332;11245;6074;16933
421200;202204;796;2134;649;1891;94;337;379;1039;473;1376
421205;202204;225;575;167;484;33;101;74;210;107;311
421210;202204;1213;2960;703;2095;146;441;250;731;396;1172
421220;202204;1551;4400;1237;3774;317;1078;446;1239;763;2317
421223;202204;402;1030;272;807;42;142;174;495;216;637
421225;202204;1002;2763;864;2546;107;370;564;1645;671;2015
421227;202204;791;2141;524;1588;96;306;229;702;325;1008
421230;202204;645;1644;424;1239;83;267;161;455;244;722
421240;202204;307;883;149;517;22;94;25;64;47;158
421250;202204;2411;5907;1747;4870;242;702;1031;2798;1273;3500
421260;202204;238;736;60;207;13;50;7;22;20;72
421265;202204;868;2090;747;1932;45;117;636;1627;681;1744
421270;202204;401;1066;199;648;47;154;78;241;125;395
421280;202204;2422;6183;1831;5207;250;856;1059;2838;1309;3694
421290;202204;1159;3145;600;1793;100;305;146;392;246;697
421300;202204;327;851;166;526;24;86;27;88;51;174
421310;202204;229;636;161;504;34;106;85;264;119;370
421315;202204;280;698;194;530;49;123;73;206;122;329
421320;202204;678;2101;381;1267;43;142;42;78;85;220
421330;202204;678;1925;491;1538;104;354;142;393;246;747
421335;202204;414;1210;337;1073;55;204;163;497;218;701
421340;202204;1602;4226;1142;3424;170;603;568;1586;738;2189
421350;202204;1771;4373;1183;3401;202;662;492;1348;694;2010
421360;202204;2476;6356;1509;4469;326;1079;560;1413;886;2492
421370;202204;822;2535;549;1841;99;370;189;525;288;895
421380;202204;951;2356;829;2172;90;281;537;1346;627;1627
421390;202204;175;453;72;232;19;59;23;63;42;122
421400;202204;598;1590;394;1188;63;218;200;542;263;760
421410;202204;214;560;105;343;25;76;29;100;54;176
421415;202204;217;572;155;421;25;81;63;146;88;227
421420;202204;666;1762;515;1448;48;152;295;801;343;953
421430;202204;108;328;73;240;9;27;14;35;23;62
421440;202204;725;1879;444;1349;84;255;195;574;279;829
421450;202204;540;1562;329;1087;47;164;43;140;90;304
421460;202204;399;1200;222;805;15;54;19;56;34;110
421470;202204;356;947;242;723;38;120;86;257;124;377
421480;202204;3113;8097;2169;6245;338;1160;974;2561;1312;3721
421490;202204;130;423;76;278;13;56;13;39;26;95
421500;202204;2422;6834;1699;5343;392;1448;481;1330;873;2778
421505;202204;341;885;289;811;27;96;198;535;225;631
421507;202204;481;1297;286;879;53;175;118;335;171;510
421510;202204;412;1095;286;813;38;132;147;355;185;487
421520;202204;520;1367;327;910;47;142;153;376;200;518
421530;202204;327;956;187;642;24;110;37;109;61;219
421535;202204;448;1133;267;780;41;138;139;377;180;515
421540;202204;369;838;205;586;29;100;75;196;104;296
421545;202204;691;1995;539;1737;103;388;271;815;374;1203
421550;202204;2429;6294;1909;5407;281;872;1107;3038;1388;3910
421555;202204;182;550;75;263;7;24;14;27;21;51
421560;202204;90;296;62;228;8;31;24;78;32;109
421565;202204;1016;2524;717;2071;172;556;277;752;449;1308
421567;202204;572;1683;419;1273;112;383;122;359;234;742
421568;202204;370;1055;231;708;36;134;91;248;127;382
421569;202204;173;497;82;266;8;30;48;151;56;181
421570;202204;1587;4267;1164;3399;226;733;452;1183;678;1916
421575;202204;343;946;256;715;37;114;138;358;175;472
421580;202204;5022;13160;3326;9770;474;1634;1328;3351;1802;4985
421590;202204;192;560;146;460;29;106;61;184;90;290
421600;202204;634;1629;437;1221;80;262;165;393;245;655
421605;202204;745;1916;546;1603;101;292;259;789;360;1081
421610;202204;1121;2904;756;2214;146;445;246;704;392;1149
421620;202204;4426;11323;2893;8620;573;1900;1082;3009;1655;4909
421625;202204;147;414;77;250;11;38;21;61;32;99
421630;202204;3019;7692;2018;5851;337;1099;775;1952;1112;3051
421635;202204;373;975;244;729;21;99;144;374;165;473
421640;202204;754;1930;545;1625;120;371;257;745;377;1116
421650;202204;2786;7363;1937;5846;426;1522;688;1867;1114;3389
421660;202204;12423;33193;9072;26771;1243;4281;4481;12060;5724;16341
421670;202204;891;2449;654;1891;99;330;330;892;429;1222
421680;202204;1624;3615;1341;3178;90;317;1074;2333;1164;2650
421690;202204;1568;4331;1099;3384;228;754;352;1020;580;1774
421700;202204;655;1859;478;1481;104;355;152;414;256;769
421710;202204;229;696;121;387;16;57;48;139;64;196
421715;202204;146;367;109;291;18;57;72;183;90;240
421720;202204;2329;6143;1414;4204;314;1034;445;1140;759;2174
421725;202204;306;747;174;506;27;96;79;190;106;286
421730;202204;524;1483;330;953;53;170;170;433;223;603
421740;202204;903;2467;622;1889;104;352;238;629;342;981
421750;202204;963;2219;483;1351;92;288;193;491;285;779
421755;202204;185;498;108;328;16;57;43;116;59;173
421760;202204;1148;2898;780;2236;150;489;292;724;442;1213
421770;202204;2742;6961;2003;5733;413;1176;859;2444;1272;3620
421775;202204;233;588;144;413;17;57;66;172;83;229
421780;202204;977;2728;651;2045;125;444;299;852;424;1296
421790;202204;960;2532;562;1777;117;401;220;652;337;1053
421795;202204;199;561;142;426;27;86;47;130;74;216
421800;202204;3348;8550;2549;7134;333;1052;1549;4100;1882;5152
421810;202204;668;1773;466;1412;51;170;261;774;312;944
421820;202204;1128;3205;751;2314;134;468;273;718;407;1186
421825;202204;1592;3980;1413;3728;92;294;1107;2844;1199;3138
421830;202204;2029;5614;1593;4786;345;1127;474;1327;819;2454
421835;202204;274;667;188;526;35;123;91;233;126;356
421840;202204;224;697;167;577;29;112;45;138;74;250
421850;202204;422;1164;246;822;46;169;59;158;105;327
421860;202204;336;918;197;631;32;121;68;187;100;308
421870;202204;5266;12807;3990;10480;453;1450;2353;5539;2806;6989
421875;202204;340;982;153;473;22;73;39;101;61;174
421880;202204;741;2031;495;1491;94;300;147;422;241;722
421885;202204;280;752;180;532;34;106;82;218;116;324
421890;202204;1000;2805;753;2322;116;453;456;1312;572;1765
421895;202204;449;1100;389;1016;41;87;283;781;324;868
421900;202204;1198;3151;905;2507;109;373;446;1090;555;1463
421910;202204;352;1018;216;674;31;118;56;142;87;260
421915;202204;455;1274;275;851;60;191;62;167;122;358
421917;202204;657;1447;375;1069;110;332;104;308;214;640
421920;202204;440;1296;314;1045;110;370;111;385;221;755
421930;202204;3189;7861;1831;5330;366;1174;703;1797;1069;2971
421935;202204;451;1329;367;1159;65;209;227;714;292;923
421940;202204;406;1134;197;600;29;97;55;129;84;226
421950;202204;3477;8549;2066;5903;400;1253;601;1522;1001;2775
421960;202204;187;443;103;292;12;39;37;83;49;122
421970;202204;2151;5342;1421;3905;238;771;646;1581;884;2352
421985;202204;356;963;240;731;33;106;107;308;140;414
422000;202204;2187;5343;1794;4759;125;415;1290;3364;1415;3779
430003;202204;625;1607;421;1246;78;238;199;588;277;826
430005;202204;309;816;215;657;16;52;123;360;139;412
430010;202204;2019;4501;1573;3832;299;699;906;2242;1205;2941
430020;202204;642;1444;471;1202;50;147;297;708;347;855
430030;202204;1129;2510;666;1697;131;334;309;744;440;1078
430040;202204;11427;25827;7314;19020;1915;5162;1741;4411;3656;9573
430045;202204;566;1335;418;1076;32;96;314;778;346;874
430047;202204;267;566;111;287;22;56;36;92;58;148
430050;202204;878;2125;526;1450;99;290;223;582;322;872
430055;202204;308;732;150;415;18;54;74;179;92;233
430057;202204;89;188;38;102;11;31;8;19;19;50
430060;202204;20792;52560;16571;46137;2725;8224;8961;24364;11686;32588
430063;202204;856;2276;713;2006;136;373;415;1163;551;1536
430064;202204;1262;3211;944;2608;146;431;512;1364;658;1795
430066;202204;109;230;79;185;7;22;64;140;71;162
430070;202204;767;1950;159;495;35;114;23;55;58;169
430080;202204;1007;2430;616;1667;101;328;316;748;417;1076
430085;202204;1008;2119;627;1526;91;233;299;703;390;936
430087;202204;953;2190;792;1980;69;197;563;1376;632;1573
430090;202204;493;1257;195;621;27;101;45;126;72;227
430100;202204;1082;2512;666;1752;124;364;210;481;334;845
430105;202204;1438;3604;999;2858;136;456;494;1358;630;1814
430107;202204;190;533;100;299;12;30;35;93;47;123
430110;202204;2498;5962;1882;5049;306;877;954;2475;1260;3352
430120;202204;1402;3844;954;2790;169;483;441;1254;610;1737
430130;202204;3930;8512;2930;7140;967;2313;699;1996;1666;4309
430140;202204;1136;2827;819;2264;122;371;440;1157;562;1528
430150;202204;614;1555;342;1021;70;221;97;283;167;504
430155;202204;257;648;132;387;27;84;30;74;57;158
430160;202204;23344;50847;18613;44427;1792;4609;12280;28623;14072;33232
430163;202204;3660;8004;2629;6479;82;289;2018;4818;2100;5107
430165;202204;343;833;124;381;15;41;22;57;37;98
430170;202204;1029;2657;391;1285;70;254;62;158;132;412
430175;202204;843;2170;736;1967;146;362;394;1069;540;1431
430180;202204;723;1727;554;1448;77;188;309;824;386;1012
430185;202204;733;1832;381;1080;107;273;70;195;177;468
430187;202204;897;1824;657;1532;80;174;442;1021;522;1195
430190;202204;1590;3839;1258;3337;225;640;639;1616;864;2256
430192;202204;134;351;56;160;11;30;14;33;25;63
430195;202204;477;1342;82;269;6;18;15;41;21;59
430200;202204;1217;3367;964;2912;298;928;273;873;571;1801
430205;202204;519;1217;470;1128;11;38;433;1019;444;1057
430210;202204;7141;17968;4777;13079;763;2294;1425;3094;2188;5388
430215;202204;383;907;239;634;32;93;104;274;136;367
430220;202204;701;1703;230;734;25;79;65;177;90;256
430222;202204;255;660;175;512;23;73;61;177;84;250
430223;202204;281;707;214;594;19;57;129;352;148;409
430225;202204;19;39;13;30;0;0;9;20;9;20
430230;202204;2193;5631;1827;5098;112;364;1431;3918;1543;4282
430235;202204;452;1213;301;901;52;172;85;204;137;376
430237;202204;570;1278;442;1079;22;65;353;844;375;909
430240;202204;1497;3370;846;2247;95;303;431;1019;526;1322
430245;202204;797;2092;634;1797;113;317;372;1069;485;1386
430250;202204;1057;2413;785;2006;289;776;143;323;432;1099
430258;202204;153;402;113;324;9;30;58;161;67;191
430260;202204;786;1932;543;1499;65;203;320;874;385;1077
430265;202204;246;690;168;550;27;86;65;217;92;303
430270;202204;3407;7742;2739;6757;312;883;1887;4464;2199;5347
430280;202204;5742;12666;4151;10088;723;1788;2033;4783;2756;6571
430290;202204;2468;5388;2031;4890;96;298;1654;3861;1750;4159
430300;202204;11691;27514;8965;23029;1223;3424;5179;12738;6402;16162
430310;202204;14489;34498;10354;27122;1255;3612;5598;13650;6853;17262
430320;202204;1140;2728;654;1796;57;173;405;1082;462;1255
430330;202204;760;1785;469;1231;63;167;196;470;259;637
430340;202204;701;1575;476;1231;64;167;306;759;370;926
430350;202204;9459;21906;7380;18502;760;2091;4779;11339;5539;13430
430355;202204;373;991;146;451;26;81;18;46;44;127
430360;202204;982;2249;638;1659;123;371;241;584;364;955
430367;202204;384;815;229;565;41;123;121;272;162;395
430370;202204;571;1482;240;696;43;127;61;133;104;260
430380;202204;737;1760;375;1115;72;225;102;292;174;517
430390;202204;3878;9015;2528;6647;562;1592;382;770;944;2362
430400;202204;1131;2319;846;1935;115;292;436;961;551;1253
430410;202204;612;1378;447;1125;39;113;322;779;361;892
430420;202204;3129;7690;2467;6395;348;1018;1524;3676;1872;4694
430430;202204;621;1528;288;859;60;203;63;178;123;381
430435;202204;1829;4338;1373;3576;218;604;722;1849;940;2453
430440;202204;4459;11474;3596;10099;325;997;2298;6388;2623;7385
430450;202204;7944;18332;6494;15935;1069;2905;3683;8480;4752;11385
430460;202204;40634;97594;30913;81943;4097;12072;17502;44330;21599;56402
430461;202204;241;624;88;261;15;57;39;94;54;151
430462;202204;346;885;187;577;39;130;50;137;89;267
430463;202204;7326;18348;5509;15132;1018;3087;2642;6946;3660;10033
430465;202204;518;1246;414;1062;61;164;268;667;329;831
430466;202204;5138;12190;4159;10725;715;1906;2290;5651;3005;7557
430467;202204;539;1255;388;1035;48;156;225;541;273;697
430468;202204;1510;3522;1217;3108;101;314;903;2239;1004;2553
430469;202204;668;1814;105;328;14;45;22;44;36;89
430470;202204;6428;15837;4335;12217;1155;3611;1246;3283;2401;6894
430471;202204;692;1835;577;1631;90;263;350;950;440;1213
430480;202204;685;1839;452;1355;66;219;126;311;192;530
430485;202204;182;457;83;235;13;30;21;55;34;85
430490;202204;485;1192;265;769;28;88;124;304;152;392
430495;202204;421;1105;286;860;44;148;130;367;174;515
430500;202204;1092;2694;775;2183;233;718;259;665;492;1383
430510;202204;31416;77852;22957;62368;3735;11343;10894;27096;14629;38439
430511;202204;391;1052;159;511;20;55;20;58;40;113
430512;202204;1138;2418;892;2054;183;429;392;896;575;1325
430513;202204;879;2059;434;1160;68;190;219;532;287;722
430515;202204;423;1121;310;898;39;124;164;467;203;591
430517;202204;1377;3782;1064;3101;153;443;639;1850;792;2293
430520;202204;1532;3707;856;2309;145;416;230;548;375;964
430530;202204;1046;2548;453;1320;64;192;130;356;194;548
430535;202204;3998;9808;2965;8017;411;1133;1558;4044;1969;5177
430537;202204;468;1347;402;1218;30;80;308;938;338;1018
430540;202204;672;1569;398;1110;62;183;223;606;285;789
430543;202204;1148;1966;696;1444;139;253;256;596;395;849
430544;202204;821;2199;563;1650;142;436;200;554;342;990
430545;202204;2739;6548;2078;5591;285;792;1278;3416;1563;4208
430550;202204;389;1061;286;846;59;185;98;266;157;451
430558;202204;172;385;68;182;5;12;26;67;31;79
430560;202204;309;705;164;467;24;73;64;164;88;237
430570;202204;946;2227;678;1763;118;382;324;721;442;1103
430580;202204;907;2181;656;1806;145;397;306;888;451;1285
430583;202204;206;505;47;132;3;8;10;19;13;27
430585;202204;242;586;133;369;27;88;46;106;73;194
430587;202204;219;582;164;490;16;54;70;206;86;260
430590;202204;1492;3443;1213;3028;100;289;913;2217;1013;2506
430593;202204;23;66;17;45;2;4;7;18;9;22
430595;202204;474;1196;127;400;13;41;26;62;39;103
430597;202204;484;1172;261;746;26;86;79;178;105;264
430600;202204;2150;5448;933;2641;139;388;219;547;358;935
430605;202204;1494;3685;1106;3015;140;414;555;1471;695;1885
430607;202204;712;1530;494;1195;30;79;343;800;373;879
430610;202204;6724;15017;4648;11995;1237;3513;1205;3103;2442;6616
430613;202204;297;675;86;244;13;37;21;48;34;85
430620;202204;772;1808;589;1487;118;323;315;703;433;1026
430630;202204;463;1228;147;444;26;84;39;101;65;185
430632;202204;481;1226;220;626;36;97;91;252;127;349
430635;202204;646;1386;482;1116;31;65;366;841;397;906
430637;202204;486;1140;377;985;33;108;263;665;296;773
430640;202204;1220;3184;844;2434;131;407;361;942;492;1349
430642;202204;389;1037;280;803;43;140;125;335;168;475
430645;202204;168;386;75;189;12;36;26;50;38;86
430650;202204;1993;5163;1562;4476;446;1169;708;2223;1154;3392
430655;202204;332;789;205;549;31;97;106;244;137;341
430660;202204;5737;13860;4450;11865;766;2156;2305;6005;3071;8161
430670;202204;695;1610;527;1334;87;219;249;623;336;842
430673;202204;573;1260;259;703;42;121;108;265;150;386
430675;202204;274;785;73;242;12;40;13;38;25;78
430676;202204;6111;14423;4980;12756;609;1681;3227;8055;3836;9736
430680;202204;1203;3030;750;2147;246;688;211;545;457;1233
430690;202204;3376;8456;2700;7296;787;2151;1059;2851;1846;5002
430692;202204;226;666;180;587;10;36;140;466;150;502
430693;202204;1037;2636;648;1900;123;407;190;515;313;922
430695;202204;430;1030;265;707;31;89;141;351;172;440
430697;202204;505;1185;387;1014;69;190;218;592;287;782
430700;202204;8926;20916;5795;15378;1146;3287;1641;3897;2787;7184
430705;202204;419;951;211;586;22;64;94;237;116;301
430710;202204;1889;3776;1334;3052;123;339;903;1970;1026;2309
430720;202204;913;2104;477;1338;56;173;250;648;306;821
430730;202204;1081;2827;763;2231;104;304;376;1048;480;1352
430740;202204;764;1985;399;1215;68;227;118;354;186;581
430745;202204;461;1111;322;843;46;157;164;352;210;509
430750;202204;1705;4045;1169;3129;306;841;469;1209;775;2050
430755;202204;492;1180;337;880;31;93;189;449;220;542
430760;202204;2503;5883;1958;5071;393;1102;967;2374;1360;3476
430770;202204;7847;18591;6244;16224;682;2036;4163;10374;4845;12410
430780;202204;2196;5282;1435;4019;227;699;711;1916;938;2615
430781;202204;555;1431;354;994;101;282;128;305;229;587
430783;202204;382;858;245;652;33;108;143;363;176;471
430786;202204;35;112;21;77;3;13;2;7;5;20
430790;202204;5220;12264;3834;9958;366;1158;2387;5745;2753;6903
430800;202204;898;1915;679;1618;41;105;482;1111;523;1216
430805;202204;401;978;268;716;15;54;190;481;205;535
430807;202204;629;1503;389;1048;50;155;211;508;261;663
430810;202204;831;1940;395;1107;59;200;155;368;214;568
430820;202204;1375;3684;843;2595;128;417;288;810;416;1227
430825;202204;304;722;116;292;16;36;42;105;58;141
430830;202204;1992;5129;1633;4478;176;420;1113;3042;1289;3462
430840;202204;1160;2663;800;2102;115;283;520;1368;635;1651
430843;202204;191;453;94;257;5;11;33;83;38;94
430845;202204;544;1206;361;910;28;84;227;525;255;609
430850;202204;2603;6557;1834;5161;411;1190;627;1833;1038;3023
430860;202204;1103;2564;557;1528;70;229;265;622;335;851
430865;202204;577;1417;380;1069;100;293;86;213;186;506
430870;202204;615;1595;277;847;53;159;65;175;118;334
430880;202204;1652;3577;1175;2864;139;384;755;1733;894;2117
430885;202204;177;469;98;306;13;41;56;170;69;211
430890;202204;1220;2881;801;2185;99;350;134;342;233;692
430900;202204;3458;7055;2475;5703;134;444;1807;3880;1941;4324
430905;202204;1011;2440;700;1880;124;357;295;739;419;1096
430910;202204;2454;6372;1912;5300;283;895;947;2323;1230;3218
430912;202204;549;1494;382;1158;30;84;237;728;267;812
430915;202204;547;1580;393;1252;119;395;119;387;238;782
430920;202204;27847;67071;22190;58013;2537;7473;14371;36174;16908;43647
430925;202204;88;191;39;108;4;13;19;50;23;63
430930;202204;12427;27831;8691;22328;1278;3387;4592;11645;5870;15032
430940;202204;1225;3020;809;2223;165;471;293;731;458;1202
430950;202204;942;1962;612;1430;42;136;440;945;482;1081
430955;202204;431;1103;123;346;23;71;41;89;64;160
430957;202204;189;598;170;559;32;102;103;346;135;448
430960;202204;1556;3552;914;2431;189;546;375;920;564;1466
430965;202204;1681;3809;1330;3290;65;154;1018;2557;1083;2711
430970;202204;424;974;237;636;34;101;123;295;157;396
430975;202204;556;1545;431;1266;78;250;188;530;266;780
430980;202204;439;956;259;660;22;72;139;314;161;386
430990;202204;648;1741;449;1311;71;235;200;563;271;798
430995;202204;612;1483;444;1218;57;165;245;642;302;807
431000;202204;1498;3473;669;1912;131;395;56;131;187;526
431010;202204;2728;6929;1972;5661;400;1248;639;1632;1039;2880
431020;202204;8993;18985;5523;13863;973;2795;2360;5234;3333;8029
431030;202204;370;1001;189;623;39;141;30;99;69;240
431033;202204;4422;10028;2980;7779;596;1584;1235;3146;1831;4730
431036;202204;341;736;77;220;5;13;25;57;30;70
431040;202204;979;2357;640;1798;63;229;346;898;409;1127
431041;202204;493;1099;357;890;51;132;192;455;243;587
431043;202204;386;937;233;656;35;118;121;319;156;437
431046;202204;115;290;47;138;7;20;9;24;16;44
431050;202204;1442;3358;1024;2700;177;452;518;1412;695;1864
431053;202204;753;1877;418;1233;73;229;139;350;212;579
431055;202204;670;1545;528;1317;46;118;387;952;433;1070
431057;202204;241;686;144;462;28;101;57;166;85;267
431060;202204;6367;15088;4375;11848;979;2880;1548;3983;2527;6863
431065;202204;446;1070;333;882;45;125;182;471;227;596
431070;202204;447;1162;279;812;64;208;66;180;130;388
431075;202204;266;727;149;467;31;110;49;151;80;261
431080;202204;629;1663;448;1294;75;235;170;455;245;690
431085;202204;845;2119;528;1433;52;151;282;740;334;891
431087;202204;456;1201;365;1020;47;131;213;579;260;710
431090;202204;442;1018;183;545;30;98;47;147;77;245
431100;202204;4088;8555;2923;7076;282;751;1844;4342;2126;5093
431110;202204;1564;3456;1106;2671;182;475;553;1213;735;1688
431112;202204;694;1748;580;1554;73;230;388;978;461;1208
431113;202204;466;1181;391;1044;72;197;222;569;294;766
431115;202204;1043;2843;819;2433;69;261;556;1570;625;1831
431120;202204;2999;7386;2107;5734;484;1442;729;1839;1213;3281
431123;202204;388;1015;260;754;52;144;137;395;189;539
431125;202204;1147;2982;891;2512;246;691;443;1289;689;1980
431127;202204;202;545;72;224;8;29;11;30;19;59
431130;202204;3499;8352;2699;7136;345;993;1556;4001;1901;4994
431140;202204;6343;14721;4019;10467;487;1375;1746;3947;2233;5322
431142;202204;613;1477;470;1252;71;193;302;799;373;992
431150;202204;1136;2870;838;2347;133;411;425;1163;558;1574
431160;202204;739;1932;499;1439;107;322;145;398;252;720
431162;202204;628;1527;401;1119;37;127;221;553;258;680
431164;202204;190;441;51;156;4;11;9;23;13;34
431170;202204;501;1305;369;1046;98;284;112;302;210;586
431171;202204;837;1813;712;1663;121;262;494;1145;615;1407
431173;202204;507;1259;371;1063;112;369;129;335;241;704
431175;202204;1443;3225;933;2376;135;346;400;979;535;1325
431177;202204;937;2351;728;2034;120;376;450;1223;570;1599
431179;202204;356;767;109;316;23;70;34;99;57;169
431180;202204;2516;6176;1573;4356;343;1004;421;1025;764;2029
431190;202204;657;1622;279;807;37;116;70;156;107;272
431198;202204;442;1237;365;1098;92;289;149;472;241;761
431200;202204;383;940;114;308;24;65;16;40;40;105
431205;202204;246;637;133;394;38;115;39;119;77;234
431210;202204;700;1566;566;1376;134;318;265;687;399;1005
431213;202204;305;765;230;627;13;29;131;352;144;381
431215;202204;680;1585;348;981;33;111;178;462;211;573
431217;202204;182;459;125;347;23;84;60;142;83;226
431220;202204;619;1531;386;1097;44;145;200;514;244;659
431225;202204;1685;3723;1325;3165;113;291;954;2231;1067;2522
431230;202204;761;2039;602;1707;120;367;318;833;438;1200
431235;202204;186;503;24;85;1;1;4;18;5;19
431237;202204;386;1159;309;993;53;196;146;441;199;637
431238;202204;37;110;31;97;6;18;14;37;20;55
431240;202204;5464;12688;4393;11014;468;1382;2887;6820;3355;8202
431242;202204;305;719;268;660;24;73;202;475;226;548
431244;202204;422;1013;218;594;28;85;85;204;113;289
431245;202204;1466;3293;973;2466;68;182;539;1282;607;1464
431247;202204;306;728;190;503;29;91;96;222;125;313
431250;202204;1992;4713;1525;4107;331;816;817;2338;1148;3154
431260;202204;316;820;191;578;24;85;74;213;98;298
431261;202204;297;879;245;787;24;105;143;431;167;536
431262;202204;333;907;174;551;19;65;97;313;116;378
431265;202204;1714;3961;740;2081;115;362;219;534;334;896
431267;202204;264;650;174;466;13;44;120;292;133;336
431270;202204;3103;6650;1702;4292;365;948;585;1467;950;2415
431275;202204;151;398;93;267;22;66;37;93;59;159
431280;202204;248;655;93;292;13;42;15;34;28;76
431290;202204;386;1120;253;788;52;177;44;119;96;296
431295;202204;78;187;28;77;7;23;6;12;13;35
431300;202204;329;856;82;252;8;28;31;79;39;107
431301;202204;295;827;75;241;14;47;10;27;24;74
431303;202204;699;1727;444;1223;28;99;201;476;229;575
431306;202204;2521;5815;1609;4320;176;521;732;1788;908;2309
431308;202204;34;95;30;86;9;28;17;49;26;77
431310;202204;597;1528;428;1180;63;175;207;533;270;708
431320;202204;768;2034;446;1368;84;262;135;367;219;629
431330;202204;1965;4522;1049;2913;139;457;466;1148;605;1605
431333;202204;229;588;126;367;14;50;47;115;61;165
431335;202204;38;114;23;82;8;31;2;4;10;35
431337;202204;3428;8193;2738;7169;253;842;1975;4922;2228;5764
431339;202204;482;1183;358;974;82;208;156;427;238;635
431340;202204;20521;48342;14777;38948;2061;6099;7719;18929;9780;25028
431342;202204;454;993;337;808;39;88;246;588;285;676
431344;202204;428;1048;253;731;33;102;120;338;153;440
431346;202204;236;577;93;285;16;50;17;43;33;93
431349;202204;922;2114;617;1502;91;243;334;750;425;993
431350;202204;5047;12056;3905;10227;445;1352;2356;5849;2801;7201
431360;202204;621;1424;324;868;92;266;85;208;177;474
431365;202204;2424;5228;1936;4574;101;292;1561;3603;1662;3895
431370;202204;5409;12257;4044;10168;729;1957;2183;5400;2912;7357
431380;202204;991;2530;807;2231;114;320;503;1396;617;1716
431390;202204;3028;7204;1973;5369;208;692;1068;2538;1276;3230
431395;202204;1710;3786;1306;3200;173;430;833;2007;1006;2437
431400;202204;323;889;189;592;36;119;41;110;77;229
431402;202204;983;2080;738;1716;93;226;514;1152;607;1378
431403;202204;215;585;167;496;32;109;78;206;110;315
431405;202204;5746;14288;4580;12396;728;2256;2349;5917;3077;8173
431406;202204;630;1657;435;1250;98;263;170;522;268;785
431407;202204;583;1479;434;1184;59;164;296;792;355;956
431410;202204;20389;48188;14517;38494;1821;5673;8417;20629;10238;26302
431413;202204;258;698;63;211;8;23;15;44;23;67
431415;202204;769;1810;496;1353;86;267;235;559;321;826
431417;202204;632;1349;420;1013;62;178;237;540;299;718
431420;202204;1851;3912;1429;3356;126;327;933;2109;1059;2436
431430;202204;634;1554;313;929;46;155;106;277;152;432
431440;202204;35853;79607;26087;65115;4240;11418;12268;28528;16508;39946
431442;202204;154;432;79;265;15;56;12;36;27;92
431445;202204;395;1090;120;385;11;34;18;43;29;77
431446;202204;305;835;232;695;30;93;124;367;154;460
431447;202204;840;2085;491;1399;89;249;151;433;240;682
431449;202204;872;2138;579;1583;102;268;251;665;353;933
431450;202204;2572;4931;2039;4191;56;132;1696;3360;1752;3492
431454;202204;41;129;32;107;8;29;15;45;23;74
431455;202204;640;1462;337;865;32;89;175;392;207;481
431460;202204;3224;7347;2257;5698;537;1378;790;1973;1327;3351
431470;202204;1551;4062;1150;3254;210;628;461;1262;671;1890
431475;202204;265;709;63;212;3;14;9;19;12;33
431477;202204;483;1195;291;821;59;159;107;280;166;439
431478;202204;236;627;57;178;10;29;6;17;16;46
431480;202204;3814;9107;3040;7922;693;1838;1507;3919;2200;5757
431490;202204;127071;285101;98374;242265;5865;17962;73774;173274;79639;191236
431500;202204;537;1314;412;1096;57;166;224;568;281;734
431505;202204;279;649;195;528;14;46;139;372;153;418
431507;202204;341;803;147;427;47;149;19;46;66;195
431510;202204;1853;4508;1292;3447;317;880;448;1200;765;2080
431513;202204;241;521;132;336;38;112;35;65;73;177
431514;202204;131;313;103;266;3;8;69;159;72;167
431515;202204;536;1252;407;1038;95;259;225;540;320;799
431517;202204;66;186;54;163;4;15;29;81;33;96
431520;202204;421;1008;183;518;24;84;82;188;106;272
431530;202204;5747;12117;3585;8943;641;1612;1639;3978;2280;5590
431531;202204;231;533;150;388;21;55;58;140;79;195
431532;202204;603;1359;385;978;76;214;166;408;242;622
431535;202204;312;788;141;415;25;78;29;81;54;159
431540;202204;1921;5791;1773;5596;75;281;1425;4543;1500;4824
431545;202204;375;932;74;215;8;23;26;72;34;95
431550;202204;2445;5895;1756;4633;260;756;948;2341;1208;3097
431555;202204;721;1585;438;1115;44;129;263;665;307;794
431560;202204;28217;64612;19480;51173;3946;10048;7482;20402;11428;30450
431570;202204;5195;11369;4435;10310;278;780;3597;8018;3875;8798
431575;202204;389;901;325;806;75;147;175;439;250;586
431580;202204;639;1620;417;1194;52;177;225;603;277;780
431590;202204;742;1960;541;1551;116;318;200;562;316;880
431595;202204;411;1056;267;763;51;156;104;265;155;421
431600;202204;1753;4045;1280;3343;237;659;616;1562;853;2221
431610;202204;1598;3797;1069;2865;156;418;506;1405;662;1823
431620;202204;520;1274;272;723;64;180;125;296;189;476
431630;202204;1451;3475;695;1967;130;395;235;621;365;1016
431640;202204;7347;16049;6260;14685;646;1614;4513;10535;5159;12149
431642;202204;692;1531;435;1077;72;155;191;450;263;605
431643;202204;395;947;193;548;23;64;60;160;83;224
431645;202204;2243;4480;1801;3907;45;134;1560;3313;1605;3447
431647;202204;349;810;122;342;13;36;36;94;49;130
431650;202204;135;360;97;303;11;39;38;103;49;142
431660;202204;981;2498;476;1452;85;301;118;318;203;619
431670;202204;1322;3040;790;2092;134;362;364;879;498;1241
431673;202204;249;635;107;331;15;50;32;81;47;131
431675;202204;408;1015;128;411;14;46;21;60;35;106
431680;202204;9831;23441;7444;19242;1417;3909;3684;8995;5101;12904
431690;202204;28274;66053;20249;52288;3104;8919;10686;26409;13790;35328
431695;202204;241;567;139;382;20;77;78;185;98;262
431697;202204;511;1149;397;980;55;129;237;592;292;721
431700;202204;1576;3736;1281;3232;200;452;712;1832;912;2284
431710;202204;15563;34523;11299;28669;1524;4064;6768;16961;8292;21025
431720;202204;7566;17697;4660;12531;1108;3073;1150;2821;2258;5894
431725;202204;42;101;31;82;8;27;16;36;24;63
431730;202204;4686;10584;3109;8232;589;1626;1422;3714;2011;5340
431740;202204;5932;13445;4043;10446;968;2822;1236;2867;2204;5689
431750;202204;8864;21813;6743;18526;1538;4393;2678;7251;4216;11644
431755;202204;341;910;94;304;10;36;22;58;32;94
431760;202204;5942;12906;4164;10138;443;1243;2649;6074;3092;7317
431770;202204;2211;4790;1699;4122;198;451;1196;2913;1394;3364
431775;202204;224;548;124;359;26;82;26;65;52;147
431780;202204;2405;5567;1576;4100;247;681;653;1652;900;2333
431790;202204;827;2106;551;1569;65;184;261;732;326;916
431795;202204;306;743;149;433;28;80;45;124;73;204
431800;202204;9269;21117;5962;16056;1565;4922;720;1917;2285;6839
431805;202204;308;772;71;251;4;12;3;5;7;17
431810;202204;3667;8069;2362;5804;357;920;1219;2827;1576;3747
431820;202204;2393;6035;1867;5216;469;1412;822;2275;1291;3687
431830;202204;9872;20940;7358;17587;2072;5607;1588;3991;3660;9598
431840;202204;3051;7311;2475;6438;301;820;1625;4216;1926;5036
431842;202204;519;1263;186;558;32;113;64;165;96;278
431843;202204;347;907;249;702;45;139;117;308;162;447
431844;202204;201;548;76;251;13;49;19;59;32;108
431845;202204;547;1381;381;1058;35;98;232;634;267;732
431846;202204;316;761;277;705;11;34;248;622;259;656
431848;202204;174;443;95;272;12;45;27;62;39;107
431849;202204;418;1008;92;261;8;28;19;36;27;64
431850;202204;4752;12056;3688;10110;850;2502;1352;3498;2202;6000
431860;202204;703;1611;402;1051;45;129;248;629;293;758
431861;202204;113;297;73;212;16;48;25;66;41;114
431862;202204;525;1590;431;1419;89;331;209;648;298;979
431870;202204;25009;59316;20201;52116;2028;6025;13059;32272;15087;38297
431880;202204;4390;10770;3207;8758;409;1286;1720;4435;2129;5721
431890;202204;5387;12940;3501;9433;1047;2802;855;2388;1902;5190
431900;202204;1114;2715;728;2034;117;350;357;923;474;1273
431910;202204;841;1923;347;919;49;128;114;238;163;366
431912;202204;562;1396;452;1216;67;197;299;789;366;986
431915;202204;1227;2727;970;2340;62;146;718;1694;780;1840
431920;202204;1404;2987;1165;2687;34;87;1016;2304;1050;2391
431930;202204;780;1929;533;1491;170;445;207;602;377;1047
431935;202204;94;245;67;194;11;36;19;47;30;83
431936;202204;337;894;201;557;40;109;96;258;136;367
431937;202204;160;405;104;302;16;49;41;107;57;156
431940;202204;3334;7489;2107;5370;160;463;1267;3051;1427;3514
431950;202204;2312;5640;1846;4911;432;1205;823;2142;1255;3347
431960;202204;3338;7741;2586;6458;734;1885;843;2037;1577;3922
431970;202204;414;1013;193;538;47;137;46;116;93;253
431971;202204;86;201;38;110;4;11;8;20;12;31
431973;202204;633;1844;436;1444;48;182;305;1001;353;1183
431975;202204;121;246;35;95;6;21;10;22;16;43
431980;202204;1211;2883;968;2517;118;379;626;1502;744;1881
431990;202204;6680;15391;4929;12941;441;1389;3027;7640;3468;9029
432000;202204;14806;33146;11048;27559;1636;4388;6502;15590;8138;19978
432010;202204;3059;6837;2061;5243;417;1094;835;1980;1252;3074
432020;202204;1873;4760;1170;3312;284;855;326;877;610;1732
432023;202204;587;1351;290;784;40;109;130;307;170;416
432026;202204;1129;2915;868;2423;240;663;336;985;576;1648
432030;202204;475;1062;273;708;19;50;166;392;185;442
432032;202204;362;880;249;653;22;72;139;326;161;398
432035;202204;740;1977;637;1808;170;439;318;966;488;1405
432040;202204;1195;2755;472;1407;57;194;200;541;257;735
432045;202204;184;493;121;367;21;68;53;149;74;217
432050;202204;612;1434;450;1161;67;206;235;588;302;794
432055;202204;751;1831;523;1421;173;458;148;412;321;870
432057;202204;180;469;150;398;8;21;86;206;94;227
432060;202204;467;1127;144;456;21;73;39;118;60;191
432065;202204;242;636;181;514;39;110;75;211;114;321
432067;202204;860;2312;734;2043;62;201;546;1459;608;1660
432070;202204;1887;4529;1348;3575;212;625;670;1637;882;2262
432080;202204;5563;12231;4218;10251;586;1649;2193;5053;2779;6702
432085;202204;432;1107;327;945;60;191;177;488;237;679
432090;202204;2893;6887;1734;4730;306;849;788;2010;1094;2859
432100;202204;1034;2502;521;1535;87;278;117;282;204;560
432110;202204;2366;5839;1740;4779;450;1326;333;844;783;2170
432120;202204;3879;9799;3133;8604;488;1483;1651;4318;2139;5801
432130;202204;2995;7066;2516;6372;423;1096;1446;3665;1869;4761
432132;202204;239;653;132;415;22;75;58;159;80;234
432135;202204;1121;2505;764;1909;77;193;521;1301;598;1494
432140;202204;1949;5312;1535;4536;177;616;1028;2920;1205;3536
432143;202204;1644;4112;1248;3498;79;245;808;2221;887;2466
432145;202204;1964;5003;1304;3721;195;594;448;1064;643;1658
432146;202204;118;322;95;293;35;129;28;76;63;205
432147;202204;539;1400;327;989;113;350;69;203;182;553
432149;202204;496;1164;257;689;36;99;104;246;140;345
432150;202204;4037;9570;3063;7983;558;1553;1469;3641;2027;5194
432160;202204;6641;15978;4991;13487;1226;3394;1905;5247;3131;8641
432162;202204;240;526;40;114;7;19;12;22;19;41
432163;202204;169;396;33;90;2;8;6;8;8;16
432166;202204;700;1858;566;1605;104;339;209;529;313;868
432170;202204;1709;4433;1195;3524;206;660;527;1434;733;2094
432180;202204;3381;7705;1892;5024;281;827;843;1967;1124;2794
432183;202204;414;1146;303;910;56;211;125;340;181;551
432185;202204;907;2289;537;1581;91;269;240;698;331;967
432190;202204;2268;5270;1624;4299;146;464;1040;2570;1186;3034
432195;202204;1057;2607;703;1961;135;360;293;818;428;1178
432200;202204;3992;9348;3006;7867;259;740;2021;5161;2280;5901
432210;202204;434;1100;292;832;53;153;145;378;198;531
432215;202204;708;1863;630;1744;48;112;466;1302;514;1414
432218;202204;263;618;120;326;16;53;43;84;59;137
432220;202204;4005;8974;2923;7258;520;1296;1560;3782;2080;5078
432225;202204;127;332;92;266;9;30;55;156;64;186
432230;202204;848;1948;450;1225;61;188;202;499;263;687
432232;202204;548;1295;356;988;61;190;161;404;222;594
432234;202204;296;722;154;435;33;78;35;84;68;162
432235;202204;45;127;20;61;5;17;6;17;11;34
432237;202204;333;830;298;774;12;33;250;633;262;666
432240;202204;18833;42920;13931;36567;1287;3136;9458;25125;10745;28261
432250;202204;6627;17691;4971;14459;961;2960;2427;6949;3388;9909
432252;202204;519;1194;337;852;41;109;183;425;224;534
432253;202204;994;2756;691;2033;178;559;99;265;277;824
432254;202204;712;1643;218;640;25;66;37;94;62;160
432255;202204;108;274;62;178;8;25;30;80;38;105
432260;202204;6011;14528;4539;11870;987;2744;2001;4930;2988;7674
432270;202204;2402;6048;1961;5264;545;1550;718;1861;1263;3411
432280;202204;1510;3650;818;2356;130;408;277;662;407;1070
432285;202204;150;446;29;86;2;4;7;19;9;23
432290;202204;384;1005;242;702;68;211;66;156;134;367
432300;202204;31856;74818;24327;63284;2506;7664;16117;39962;18623;47626
432310;202204;1043;2505;775;2037;60;181;605;1557;665;1738
432320;202204;212;477;93;266;12;40;32;76;44;116
432330;202204;209;471;71;221;13;35;13;43;26;78
432335;202204;172;499;64;230;7;23;13;43;20;66
432340;202204;351;863;157;498;23;74;48;149;71;223
432345;202204;862;1741;742;1600;12;31;642;1351;654;1382
432350;202204;372;899;199;574;35;103;66;175;101;278
432360;202204;244;708;50;162;5;13;14;37;19;50
432370;202204;374;843;224;589;21;68;130;327;151;395
432375;202204;575;1350;406;1024;96;244;173;432;269;676
432377;202204;170;502;40;136;1;3;10;21;11;24
432380;202204;2107;5528;1494;4432;220;689;778;2241;998;2930
500020;202204;3600;8405;2539;6760;220;715;1655;4238;1875;4953
500025;202204;1291;3074;834;2222;108;277;439;1134;547;1411
500060;202204;9067;24400;6329;18817;783;2503;3724;11145;4507;13648
500070;202204;5444;12943;3952;10520;719;2055;1853;4918;2572;6973
500080;202204;1810;4231;1121;2995;185;551;454;1082;639;1633
500085;202204;2293;5479;1640;4357;423;1206;721;1822;1144;3028
500090;202204;2333;5845;1613;4661;272;856;547;1700;819;2556
500100;202204;4222;10184;3249;8660;478;1459;1591;3968;2069;5427
500110;202204;10923;25827;7606;20779;1559;4378;3359;9512;4918;13890
500124;202204;2435;6560;1952;5812;296;881;1153;3497;1449;4378
500150;202204;1667;3526;1157;2845;195;535;623;1411;818;1946
500190;202204;5767;14373;3799;10663;765;2204;1284;3354;2049;5558
500200;202204;3080;6836;2119;5269;204;526;1355;3233;1559;3759
500210;202204;5524;12246;3960;10235;1077;2754;1951;5062;3028;7816
500215;202204;1612;4195;1203;3469;113;350;701;2003;814;2353
500220;202204;3422;8830;2484;7250;397;1270;1233;3414;1630;4684
500230;202204;2312;5132;1797;4441;203;537;1240;2988;1443;3525
500240;202204;4634;12950;3425;10507;521;1721;1513;4689;2034;6410
500260;202204;3690;7572;2426;5873;237;679;1487;3360;1724;4039
500270;202204;163194;370153;105745;277438;14860;43723;46352;111163;61212;154886
500280;202204;1570;3779;1064;3013;168;495;560;1581;728;2076
500290;202204;4124;9656;2542;6961;366;1122;984;2399;1350;3521
500295;202204;4399;10164;2937;7681;492;1454;1308;3035;1800;4489
500310;202204;1135;2197;789;1775;131;258;433;973;564;1231
500315;202204;4601;11468;3716;10223;254;743;2839;7831;3093;8574
500320;202204;23046;58263;16089;47015;3926;11606;6161;19077;10087;30683
500325;202204;6358;13487;4512;10993;497;1259;2810;6744;3307;8003
500330;202204;7654;16627;5150;13098;494;1242;2854;7377;3348;8619
500345;202204;2378;5583;1626;4403;264;738;692;1822;956;2560
500348;202204;2629;6420;1981;5344;213;613;1268;3430;1481;4043
500350;202204;1397;3696;826;2516;102;323;305;875;407;1198
500370;202204;30980;76485;22770;63425;2710;8681;12359;33563;15069;42244
500375;202204;2930;7358;1990;5492;275;828;813;2013;1088;2841
500380;202204;3943;9441;2766;7515;755;2106;564;1591;1319;3697
500390;202204;726;1480;448;1136;64;187;254;638;318;825
500400;202204;1777;4416;1195;3293;223;706;443;1090;666;1796
500410;202204;2709;6186;1897;5012;207;497;1079;2994;1286;3491
500430;202204;3170;7396;2190;5970;328;897;937;2768;1265;3665
500440;202204;1796;4148;988;2768;152;426;373;1106;525;1532
500450;202204;2012;4761;1298;3555;253;686;363;948;616;1634
500460;202204;4197;10627;2581;7513;459;1496;757;2071;1216;3567
500470;202204;2829;7329;1840;5395;472;1508;491;1271;963;2779
500480;202204;2254;6700;1877;6117;161;560;1387;4583;1548;5143
500490;202204;1282;2862;783;2109;145;467;216;594;361;1061
500500;202204;4639;11725;3075;9303;880;2950;421;1362;1301;4312
500510;202204;787;1909;521;1435;36;116;333;860;369;976
500515;202204;1862;4627;1456;4000;206;631;843;2228;1049;2859
500520;202204;3844;10479;2980;9063;636;1946;1518;4805;2154;6751
500525;202204;1090;3019;877;2722;117;377;547;1675;664;2052
500540;202204;5793;14428;3571;10546;1032;3423;577;1488;1609;4911
500560;202204;6008;15415;4834;13978;222;677;4048;11841;4270;12518
500568;202204;5064;10658;3158;7837;643;1604;1314;3104;1957;4708
500570;202204;9295;20776;6388;16152;908;2649;3264;7565;4172;10214
500580;202204;3533;8819;2609;7228;603;1716;1163;3233;1766;4949
500600;202204;4133;9881;3064;8206;697;1924;1080;2939;1777;4863
500620;202204;8842;22256;6182;17338;934;2822;3014;8008;3948;10830
500625;202204;604;1567;413;1201;62;206;164;444;226;650
500627;202204;895;2289;555;1698;90;294;181;523;271;817
500630;202204;8525;18406;4968;12754;954;2660;1635;4042;2589;6702
500635;202204;3147;9595;2423;8622;249;790;1710;6602;1959;7392
500640;202204;2038;4203;1360;3319;75;209;904;2101;979;2310
500660;202204;22722;53989;15754;44036;4782;13624;5010;14521;9792;28145
500690;202204;2995;7387;2054;5897;440;1467;920;2475;1360;3942
500710;202204;3594;9100;2688;7562;648;2004;906;2404;1554;4408
500720;202204;5846;14281;3941;11164;782;2376;1405;3918;2187;6294
500730;202204;1228;2887;695;1934;126;347;215;600;341;947
500740;202204;5386;12331;3533;9489;541;1601;1693;4327;2234;5928
500750;202204;1206;2888;847;2302;119;346;370;913;489;1259
500755;202204;1174;2944;739;2145;137;428;214;547;351;975
500769;202204;5893;14007;3365;9382;665;1998;545;1354;1210;3352
500770;202204;1564;4061;1091;3303;211;665;366;1092;577;1757
500780;202204;1378;3251;908;2492;179;566;256;614;435;1180
500790;202204;8182;20956;6117;17320;1189;3618;2567;7241;3756;10859
500793;202204;2332;5639;1711;4611;330;938;718;1792;1048;2730
500795;202204;3183;7287;2518;6418;129;341;2048;5341;2177;5682
500797;202204;900;2239;606;1701;185;527;185;520;370;1047
500800;202204;3992;8726;2535;6581;702;2043;492;1351;1194;3394
500830;202204;21644;51755;15087;40147;3264;9102;5425;13777;8689;22879
500840;202204;1656;3856;1031;2676;112;297;486;1175;598;1472
510010;202204;2079;4436;1471;3666;196;459;975;2428;1171;2887
510020;202204;4659;11256;2601;7303;485;1455;761;1875;1246;3330
510025;202204;7944;18424;5185;14171;634;1932;2704;7061;3338;8993
510030;202204;3565;7488;2414;5770;244;618;1361;3119;1605;3737
510035;202204;1335;3360;873;2626;211;632;380;1262;591;1894
510040;202204;2721;5744;2038;4896;240;499;1290;3224;1530;3723
510050;202204;2503;4924;1719;3940;229;584;1144;2564;1373;3148
510060;202204;1594;3899;1053;2941;208;611;261;658;469;1269
510080;202204;1674;4161;1147;3323;212;669;544;1496;756;2165
510100;202204;773;1687;564;1372;62;171;339;766;401;937
510120;202204;304;529;171;374;9;21;135;288;144;309
510125;202204;2335;5643;1868;4968;219;692;1029;2559;1248;3251
510130;202204;1776;4271;1251;3457;284;804;542;1501;826;2305
510140;202204;3401;8446;2329;7106;793;2625;866;2764;1659;5389
510160;202204;2076;4758;1582;4135;63;183;1369;3572;1432;3755
510170;202204;5578;13830;4267;11776;810;2442;2041;5473;2851;7915
510180;202204;16830;35761;11391;28271;2069;5461;5227;13494;7296;18955
510185;202204;1962;4961;1277;3963;525;1646;286;1168;811;2814
510190;202204;2528;6800;1645;5380;394;1434;398;1391;792;2825
510250;202204;19668;46968;14744;39701;2318;6697;8227;22395;10545;29092
510260;202204;1965;8163;1660;7648;258;1189;1028;5295;1286;6484
510263;202204;3816;10429;2507;7831;475;1692;547;1517;1022;3209
510267;202204;6238;17262;3726;11695;682;2358;679;1815;1361;4173
510268;202204;1475;3672;1051;2957;255;737;330;829;585;1566
510269;202204;1145;2973;754;2269;153;498;314;886;467;1384
510270;202204;3405;9217;2406;7519;370;1303;1062;3267;1432;4570
510279;202204;2036;5098;1203;3601;162;554;405;1089;567;1643
510285;202204;1231;3119;833;2432;204;654;278;755;482;1409
510300;202204;4317;10254;3283;8916;338;941;2272;6305;2610;7246
510305;202204;1617;4294;1050;3250;216;685;281;922;497;1607
510310;202204;1116;2632;781;2104;187;513;292;817;479;1330
510320;202204;4322;10174;3072;8170;641;1820;977;2471;1618;4291
510325;202204;4751;13443;3426;11000;865;2917;1035;3351;1900;6268
510330;202204;2849;8173;1941;6610;429;1501;708;2736;1137;4237
510335;202204;5547;15329;4255;13221;718;2454;2161;6747;2879;9201
510336;202204;514;1388;379;1188;53;151;213;737;266;888
510337;202204;1622;4502;1083;3581;380;1326;319;1082;699;2408
510340;202204;107149;231477;73461;184464;15439;42820;30066;72117;45505;114937
510343;202204;1334;3174;893;2435;110;346;471;1190;581;1536
510345;202204;1397;3795;1067;3178;168;500;530;1532;698;2032
510350;202204;3465;8354;2362;6616;631;1860;778;2102;1409;3962
510360;202204;2230;4360;1421;3428;61;123;1030;2624;1091;2747
510370;202204;1950;5286;1465;4512;193;659;914;2848;1107;3507
510380;202204;659;1538;393;1099;56;185;173;464;229;649
510385;202204;1314;4254;984;3667;89;388;670;2583;759;2971
510390;202204;1515;3607;1041;3057;327;874;434;1446;761;2320
510395;202204;794;1661;529;1291;38;84;365;913;403;997
510410;202204;5555;14438;4074;11940;720;2132;2254;6826;2974;8958
510420;202204;2845;5548;1954;4397;84;192;1455;3255;1539;3447
510450;202204;624;1469;365;1031;74;219;109;290;183;509
510452;202204;939;2567;699;2120;101;343;413;1220;514;1563
510454;202204;1127;2922;874;2513;108;284;548;1668;656;1952
510455;202204;1062;2699;705;2049;134;449;284;749;418;1198
510460;202204;2195;5319;1624;4480;265;796;865;2206;1130;3002
510480;202204;5517;12865;3753;9733;673;1886;1585;3834;2258;5720
510490;202204;1954;4722;1475;4122;230;657;964;2699;1194;3356
510500;202204;1697;3984;1027;2945;219;656;309;868;528;1524
510510;202204;4336;11557;3096;9523;826;2737;1026;3240;1852;5977
510515;202204;5950;14518;4062;11323;802;2506;1457;3650;2259;6156
510517;202204;1672;4085;1150;3325;382;1191;286;784;668;1975
510520;202204;2580;5069;1438;3632;122;315;684;1852;806;2167
510523;202204;1402;3149;1002;2570;118;338;668;1669;786;2007
510525;202204;8647;22706;6510;18688;994;3110;3075;8339;4069;11449
510530;202204;560;1419;410;1210;29;99;270;795;299;894
510550;202204;2845;7850;2158;6719;381;1273;1174;3577;1555;4850
510558;202204;2606;6718;1971;5791;258;682;1024;3244;1282;3926
510560;202204;1907;5229;1203;3855;276;931;296;982;572;1913
510562;202204;6692;15560;4966;12712;830;2096;2451;6392;3281;8488
510590;202204;3413;8168;2545;7058;198;567;1823;5186;2021;5753
510600;202204;1502;3124;1007;2432;130;318;559;1302;689;1620
510610;202204;3015;6936;2076;5716;331;1025;1165;3141;1496;4166
510615;202204;3195;7491;2248;6040;295;853;1404;3761;1699;4614
510617;202204;1126;3263;904;2930;89;334;665;2192;754;2526
510618;202204;1401;3545;1020;2955;205;652;504;1433;709;2085
510619;202204;845;2093;487;1442;82;246;102;252;184;498
510620;202204;1549;3399;779;2185;265;835;63;144;328;979
510621;202204;1765;4525;1056;3210;247;812;295;806;542;1618
510622;202204;5760;15278;3939;11618;1306;4166;682;1814;1988;5980
510623;202204;3141;7426;2293;6120;547;1535;847;2281;1394;3816
510624;202204;1789;4507;956;2995;118;422;212;586;330;1008
510625;202204;3681;8589;2214;6063;400;1196;706;1898;1106;3094
510626;202204;1619;3863;1069;3006;265;837;300;861;565;1698
510627;202204;720;1766;400;1169;98;299;114;355;212;654
510628;202204;1677;3609;1099;2884;281;815;468;1198;749;2013
510629;202204;1904;5071;1344;4086;280;897;417;1277;697;2174
510630;202204;3784;10033;2394;7544;542;1834;560;1910;1102;3744
510631;202204;691;1528;518;1285;22;42;407;1031;429;1073
510637;202204;4115;9238;2941;7618;631;1788;1100;2860;1731;4648
510642;202204;6471;17005;5044;14946;898;3008;2991;8754;3889;11762
510645;202204;1164;2198;732;1672;172;367;354;851;526;1218
510650;202204;7877;18786;6211;16984;881;1547;4407;13504;5288;15051
510665;202204;1988;4205;1283;3107;283;597;496;1340;779;1937
510670;202204;485;1010;287;745;38;97;152;396;190;493
510675;202204;7142;18824;4887;14742;1302;4341;962;2763;2264;7104
510677;202204;2525;6174;1795;5122;293;927;1002;2801;1295;3728
510680;202204;789;1935;463;1368;94;311;121;306;215;617
510682;202204;1818;4931;1343;4194;416;1493;476;1403;892;2896
510685;202204;563;1537;408;1237;40;127;244;739;284;866
510700;202204;4726;10680;3297;8742;274;788;2438;6413;2712;7201
510704;202204;12387;28379;8450;21906;2093;5649;2385;5827;4478;11476
510706;202204;2542;7142;1763;5860;340;1159;755;2785;1095;3944
510710;202204;3322;7846;2153;5677;514;1348;670;1682;1184;3030
510715;202204;725;1461;494;1175;32;87;315;726;347;813
510718;202204;2579;5748;1572;4391;333;914;733;2336;1066;3250
510719;202204;514;1062;302;774;32;95;172;406;204;501
510720;202204;1034;2282;685;1794;169;463;276;696;445;1159
510724;202204;990;2640;687;2073;105;364;345;963;450;1327
510726;202204;1092;1973;625;1420;64;153;340;783;404;936
510729;202204;680;1537;316;875;36;110;89;257;125;367
510730;202204;3360;7782;2315;6224;294;883;1256;3184;1550;4067
510735;202204;1327;3505;1058;3134;97;316;827;2426;924;2742
510740;202204;1112;2612;740;1965;74;228;453;1122;527;1350
510757;202204;523;1647;407;1467;139;567;139;466;278;1033
510760;202204;50678;107506;31760;79856;6325;17588;11541;26570;17866;44158
510770;202204;4702;10077;3296;8319;245;535;2301;6061;2546;6596
510774;202204;423;1040;307;863;52;141;178;506;230;647
510775;202204;734;1836;458;1397;107;346;118;333;225;679
510776;202204;748;1805;514;1368;97;302;237;606;334;908
510777;202204;1708;4311;1236;3709;163;572;838;2461;1001;3033
510779;202204;871;2224;655;1890;64;167;412;1246;476;1413
510780;202204;4606;10957;3413;9293;701;1795;1728;5141;2429;6936
510785;202204;2284;5766;1356;4111;344;1072;338;1087;682;2159
510787;202204;3532;9588;2324;7208;741;2376;224;660;965;3036
510788;202204;633;1421;425;1117;63;154;202;602;265;756
510790;202204;21588;53361;14297;40882;3600;11132;2461;6653;6061;17785
510792;202204;11079;29625;7133;22107;1609;5477;1512;4309;3121;9786
510794;202204;1367;3577;988;2974;317;1096;231;597;548;1693
510795;202204;10880;26799;7619;21251;1692;5146;2578;6782;4270;11928
510800;202204;1705;4337;1200;3542;376;1206;176;440;552;1646
510805;202204;1717;4575;1167;3596;243;843;467;1314;710;2157
510810;202204;754;1475;505;1163;156;307;227;574;383;881
510820;202204;884;1623;504;1166;28;61;311;709;339;770
510830;202204;1054;2386;813;2086;64;157;616;1641;680;1798
510835;202204;675;1534;449;1217;64;195;275;714;339;909
510840;202204;67477;136665;48048;113331;7857;17366;27928;68694;35785;86060
510850;202204;2123;5089;1366;3933;582;1863;114;241;696;2104
510860;202204;2886;7214;1889;5653;597;1910;381;1172;978;3082
510880;202204;862;2322;639;1933;152;465;198;608;350;1073
510885;202204;705;1655;467;1305;93;274;122;338;215;612
510890;202204;887;2373;676;2020;144;464;327;989;471;1453
510895;202204;1543;3790;1005;2888;148;494;459;1206;607;1700
520005;202204;3656;8966;2901;7996;860;2046;1279;4121;2139;6167
520010;202204;3067;7922;2258;6422;468;1465;890;2276;1358;3741
520013;202204;3851;9285;2578;7074;608;1669;788;2297;1396;3966
520015;202204;580;1407;424;1178;92;262;175;511;267;773
520017;202204;1373;3300;987;2704;197;583;427;1080;624;1663
520020;202204;547;1093;424;952;18;51;366;800;384;851
520025;202204;40649;105445;34813;97439;4514;13200;23482;65655;27996;78855
520030;202204;7228;16574;5983;14931;351;932;4696;11578;5047;12510
520050;202204;451;1063;274;746;38;91;154;430;192;521
520055;202204;2051;4831;1307;3375;219;541;570;1409;789;1950
520060;202204;2009;4995;1416;3990;307;977;374;1063;681;2040
520080;202204;2106;5175;1615;4513;290;727;812;2464;1102;3191
520082;202204;1033;2476;742;1989;111;310;351;998;462;1308
520085;202204;1148;2718;919;2397;170;450;483;1247;653;1697
520090;202204;985;1849;706;1549;41;69;583;1293;624;1362
520110;202204;44841;114470;31801;93123;9188;29827;4478;12394;13666;42221
520120;202204;273;614;146;393;19;57;60;155;79;212
520130;202204;4421;10150;3432;8635;687;1760;1481;3690;2168;5450
520140;202204;53462;134901;37865;108868;12657;38515;5794;17318;18451;55833
520145;202204;678;1509;458;1193;92;252;218;519;310;771
520150;202204;735;1685;547;1450;74;195;280;720;354;915
520160;202204;990;2260;680;1732;131;293;252;683;383;976
520170;202204;5272;10539;3531;8527;231;643;2640;6287;2871;6930
520180;202204;2962;7324;2402;6537;316;1009;1517;3973;1833;4982
520215;202204;1997;4588;1458;3794;254;688;777;1978;1031;2666
520235;202204;852;1810;575;1425;105;269;291;739;396;1008
520250;202204;1796;4328;1308;3554;409;1152;354;1102;763;2254
520260;202204;879;1988;549;1464;95;248;220;582;315;830
520280;202204;955;2074;753;1778;146;328;402;975;548;1303
520310;202204;1130;2327;734;1755;185;481;269;670;454;1151
520320;202204;2034;5174;1588;4482;167;490;941;2701;1108;3191
520330;202204;5475;13519;4205;11445;635;2004;2299;5923;2934;7927
520340;202204;2680;5670;1657;4278;179;401;945;2536;1124;2937
520350;202204;3429;7963;2407;6424;626;1697;958;2628;1584;4325
520355;202204;2114;5525;1533;4424;464;1405;272;697;736;2102
520357;202204;913;2063;667;1702;30;66;532;1366;562;1432
520360;202204;875;2139;692;1855;128;361;291;766;419;1127
520380;202204;1581;3792;968;2701;153;454;373;954;526;1408
520390;202204;1277;2825;808;2217;223;655;225;666;448;1321
520393;202204;737;1666;494;1287;65;181;204;507;269;688
520396;202204;997;2407;843;2181;47;116;601;1522;648;1638
520400;202204;1770;4082;1371;3559;104;295;1025;2658;1129;2953
520410;202204;2408;5004;1629;3881;233;634;929;2060;1162;2694
520420;202204;431;943;336;803;17;48;258;590;275;638
520425;202204;1734;4126;983;2711;274;804;180;464;454;1268
520430;202204;2698;5998;1654;4367;407;1162;242;570;649;1732
520440;202204;3321;7701;1902;5189;394;1202;467;1203;861;2405
520450;202204;14908;33940;10439;27377;3165;8459;2880;7887;6045;16346
520455;202204;827;2114;598;1765;165;486;177;554;342;1040
520460;202204;1185;2646;916;2300;122;272;673;1733;795;2005
520465;202204;991;2319;822;2092;64;207;646;1587;710;1794
520470;202204;2575;6035;2013;5316;523;1347;981;2780;1504;4127
520480;202204;1019;2673;730;2180;169;542;280;798;449;1340
520485;202204;1719;4874;1386;4377;216;740;765;2316;981;3056
520490;202204;4705;11962;3591;10239;705;2055;1936;5617;2641;7672
520495;202204;1830;3731;1399;3163;100;231;1056;2408;1156;2639
520500;202204;1859;4469;1388;3661;202;583;736;1872;938;2455
520505;202204;988;1988;757;1710;49;116;584;1280;633;1396
520510;202204;9282;21969;6693;18129;1215;3675;2935;7784;4150;11459
520520;202204;1361;3232;1048;2774;233;665;451;1189;684;1854
520530;202204;2831;7215;2080;5895;372;1051;1044;3115;1416;4166
520540;202204;3469;8698;2310;6496;440;1279;673;1763;1113;3042
520545;202204;1441;3391;1142;2952;239;618;567;1471;806;2089
520547;202204;1365;3366;1063;2845;217;595;562;1491;779;2086
520549;202204;17054;42393;14260;38508;1665;4895;9892;26189;11557;31084
520551;202204;5373;13402;4524;12205;448;1401;3280;8600;3728;10001
520552;202204;1063;2569;832;2230;171;457;431;1227;602;1684
520570;202204;613;1326;404;1013;83;184;172;440;255;624
520580;202204;2513;5327;1886;4606;243;591;1204;2936;1447;3527
520590;202204;1530;3587;1051;2826;266;740;366;956;632;1696
520620;202204;9803;24649;7856;21850;1624;4699;4144;11532;5768;16231
520630;202204;986;2306;701;1849;86;222;317;816;403;1038
520640;202204;2713;6244;2061;5156;450;1107;842;2168;1292;3275
520650;202204;1180;2472;839;2010;174;377;425;1081;599;1458
520660;202204;597;1426;330;955;58;184;91;264;149;448
520670;202204;1097;2786;920;2526;95;250;626;1711;721;1961
520680;202204;933;2113;741;1830;128;267;442;1126;570;1393
520690;202204;360;839;237;641;85;209;66;189;151;398
520710;202204;492;1128;333;863;20;51;221;546;241;597
520725;202204;1605;3688;1092;2826;158;463;601;1504;759;1967
520735;202204;1023;2294;695;1779;180;410;253;684;433;1094
520740;202204;2823;6033;2126;5174;468;1036;1054;2735;1522;3771
520750;202204;804;1787;573;1451;83;219;303;731;386;950
520753;202204;1470;3715;1106;3070;213;646;474;1246;687;1892
520760;202204;1601;3263;1360;2977;30;61;1242;2741;1272;2802
520780;202204;1710;3906;1239;3233;164;409;667;1718;831;2127
520790;202204;3776;8616;2649;6828;405;976;1421;3858;1826;4834
520800;202204;19868;47894;15655;41858;2199;5804;9692;26488;11891;32292
520810;202204;1442;2897;1093;2506;223;476;630;1591;853;2067
520815;202204;657;1951;495;1595;98;338;149;483;247;821
520830;202204;2082;4265;1496;3575;106;261;1175;2780;1281;3041
520840;202204;3208;8048;2595;7241;822;2516;940;2683;1762;5199
520850;202204;856;1899;657;1620;143;419;307;730;450;1149
520860;202204;9616;24183;7260;20305;1568;4593;3055;8322;4623;12915
520870;202204;148710;330598;106718;268110;19613;51585;48271;116643;67884;168228
520880;202204;9679;26252;7719;22750;1594;4900;3202;9273;4796;14173
520890;202204;5114;11220;3589;8923;552;1552;1813;4342;2365;5894
520910;202204;5261;12549;3451;9565;707;2118;965;2519;1672;4637
520915;202204;842;2182;551;1589;115;361;193;509;308;870
520920;202204;5145;10848;3712;9113;684;1439;1998;5230;2682;6669
520929;202204;762;1739;589;1490;99;205;285;778;384;983
520940;202204;1111;2818;859;2445;77;245;618;1722;695;1967
520945;202204;547;1172;390;963;28;74;247;594;275;668
520960;202204;1274;2778;986;2370;281;611;432;1164;713;1775
520970;202204;3555;8896;2707;7566;804;2385;590;1796;1394;4181
520980;202204;877;1955;641;1647;105;268;300;738;405;1006
520990;202204;3472;8272;2815;7460;410;970;1932;5272;2342;6242
520993;202204;1387;3263;924;2450;134;398;459;1168;593;1566
520995;202204;2825;6730;2156;5802;359;933;827;2366;1186;3299
521000;202204;10516;26273;7059;19947;1169;3499;2102;5675;3271;9174
521010;202204;4174;10365;3092;8502;406;1151;1647;4437;2053;5588
521015;202204;897;2131;634;1671;52;147;410;1029;462;1176
521020;202204;4533;10950;2790;7702;710;2033;544;1530;1254;3563
521030;202204;807;1529;634;1287;30;69;524;1030;554;1099
521040;202204;9266;21661;6948;18172;1601;4175;2701;7568;4302;11743
521056;202204;1079;2719;811;2302;225;607;263;809;488;1416
521060;202204;1183;2974;850;2356;187;529;296;821;483;1350
521080;202204;1238;2551;652;1664;97;265;305;714;402;979
521090;202204;3526;9112;2392;6821;586;1812;294;838;880;2650
521100;202204;2208;4680;1659;3936;210;506;1100;2633;1310;3139
521120;202204;5581;12625;4230;10932;655;1385;1856;5718;2511;7103
521130;202204;1129;2517;571;1514;52;109;283;789;335;898
521140;202204;1675;4065;1254;3321;154;410;704;1812;858;2222
521150;202204;14557;30880;9400;23602;1837;5018;4324;10846;6161;15864
521160;202204;836;1660;576;1290;66;126;365;794;431;920
521170;202204;1224;2733;908;2264;102;283;501;1181;603;1464
521180;202204;9232;23315;7454;20381;1300;3860;3843;10181;5143;14041
521190;202204;12560;29788;7910;22336;1942;5757;2179;6133;4121;11890
521200;202204;804;1846;556;1461;60;160;316;805;376;965
521205;202204;724;1667;561;1418;24;66;441;1072;465;1138
521210;202204;856;2178;492;1420;86;263;133;301;219;564
521220;202204;4306;9747;2979;7778;598;1666;1326;3467;1924;5133
521225;202204;463;943;346;814;49;111;237;566;286;677
521230;202204;1597;3823;1376;3546;549;1402;520;1438;1069;2840
521250;202204;40311;96512;32679;85906;8719;23474;16107;42321;24826;65795
521260;202204;591;1322;454;1124;71;189;267;638;338;827
521270;202204;2272;5121;1982;4779;177;378;1469;3670;1646;4048
521280;202204;2060;5260;1562;4465;332;995;687;1994;1019;2989
521290;202204;623;1354;434;1121;43;127;280;697;323;824
521295;202204;1371;2877;1076;2520;142;270;756;1823;898;2093
521300;202204;2131;5023;1658;4332;322;795;945;2526;1267;3321
521305;202204;774;1736;537;1405;58;176;336;855;394;1031
521308;202204;5492;13700;3863;10783;343;1059;2399;6433;2742;7492
521310;202204;11058;26770;7746;21048;1387;4159;3581;9220;4968;13379
521340;202204;457;993;321;798;29;70;200;493;229;563
521350;202204;2232;5470;1704;4676;145;461;1223;3257;1368;3718
521370;202204;1414;3490;903;2644;281;896;153;470;434;1366
521375;202204;1598;3930;1099;3115;225;663;331;1023;556;1686
521377;202204;1635;3316;1205;2787;129;229;900;2217;1029;2446
521380;202204;6975;17844;4519;13383;711;2105;1000;3164;1711;5269
521385;202204;785;1778;596;1526;83;181;330;918;413;1099
521390;202204;769;1853;539;1481;143;428;101;291;244;719
521400;202204;3309;7350;2671;6573;273;666;1883;4644;2156;5310
521405;202204;1602;3962;1091;3025;131;371;610;1651;741;2022
521410;202204;1015;2374;806;2055;191;445;419;1111;610;1556
521440;202204;1588;3670;1223;3145;371;933;505;1344;876;2277
521450;202204;4583;12824;3403;10569;911;2829;821;2699;1732;5528
521460;202204;6722;16494;4894;13327;1317;3710;1786;4785;3103;8495
521470;202204;846;2090;586;1624;69;201;284;722;353;923
521480;202204;539;1221;373;942;78;183;152;358;230;541
521483;202204;2687;6185;1919;5055;383;1000;870;2338;1253;3338
521486;202204;2034;4657;1547;3966;137;259;1026;2660;1163;2919
521487;202204;458;1040;315;849;56;143;185;519;241;662
521490;202204;1001;2536;748;2121;37;131;529;1423;566;1554
521500;202204;2383;5732;1827;4952;162;597;1221;3131;1383;3728
521520;202204;888;1965;678;1672;109;233;361;921;470;1154
521523;202204;14793;41578;12219;37645;3391;10793;4446;13838;7837;24631
521525;202204;1238;2765;954;2370;68;204;666;1593;734;1797
521530;202204;2584;6426;1614;4512;334;934;421;1114;755;2048
521540;202204;937;2319;670;1885;136;426;284;788;420;1214
521550;202204;1861;4548;1034;2921;193;566;280;802;473;1368
521560;202204;6062;14519;4383;12266;1188;3056;1925;5956;3113;9012
521565;202204;778;1814;556;1454;84;229;261;680;345;909
521570;202204;4120;10732;2872;8397;597;2029;194;580;791;2609
521580;202204;565;1304;357;955;51;150;145;352;196;502
521590;202204;897;1901;653;1563;90;223;371;849;461;1072
521600;202204;499;1254;322;928;50;128;155;442;205;570
521630;202204;1921;4002;1224;3026;327;781;390;965;717;1746
521640;202204;2192;4939;1443;3834;313;882;479;1242;792;2124
521645;202204;603;1482;366;1057;132;358;52;147;184;505
521680;202204;1534;4075;1187;3497;342;1043;361;1051;703;2094
521690;202204;620;1461;516;1325;79;219;317;801;396;1020
521710;202204;3946;9217;2587;7007;471;1416;798;1894;1269;3310
521720;202204;2723;5891;1791;4528;239;620;1021;2575;1260;3195
521730;202204;4299;11184;3329;9609;908;3030;959;2394;1867;5424
521740;202204;4739;11695;3667;10128;1174;3362;933;2621;2107;5983
521760;202204;17588;44428;13923;39168;3046;8693;6282;18936;9328;27629
521770;202204;3681;8273;2504;6480;622;1690;661;1740;1283;3430
521800;202204;7704;19374;5647;16010;1472;4130;2155;6736;3627;10866
521805;202204;1124;2271;808;1887;179;387;433;1073;612;1460
521810;202204;773;1754;567;1471;105;264;329;884;434;1148
521830;202204;6473;16670;5215;14752;329;1156;3878;10674;4207;11830
521839;202204;1017;2211;773;1832;76;221;540;1174;616;1395
521850;202204;7475;16397;4700;12261;1279;3254;784;2068;2063;5322
521860;202204;1828;4762;1261;3722;217;704;407;1098;624;1802
521870;202204;778;2059;563;1654;110;360;174;431;284;791
521878;202204;913;2225;632;1697;72;237;361;893;433;1130
521880;202204;22946;54215;16381;44190;3763;10521;6865;18183;10628;28704
521890;202204;3901;9451;2692;7388;708;1976;747;1922;1455;3898
521900;202204;1546;3524;809;2268;251;677;43;119;294;796
521910;202204;1619;3332;1165;2789;253;594;531;1282;784;1876
521920;202204;603;1520;453;1278;53;181;266;716;319;897
521925;202204;873;2172;647;1832;136;435;306;839;442;1274
521930;202204;6179;14214;4177;11268;1082;2437;1794;5370;2876;7807
521935;202204;1201;2739;828;2112;73;205;481;1159;554;1364
521940;202204;1485;3085;970;2382;162;436;502;1177;664;1613
521945;202204;753;1834;542;1472;90;245;287;790;377;1035
521950;202204;858;1944;596;1538;109;277;277;719;386;996
521960;202204;796;1969;551;1522;60;200;312;788;372;988
521970;202204;3264;7019;2456;6036;285;579;1722;4453;2007;5032
521971;202204;856;1991;605;1611;151;385;172;448;323;833
521973;202204;1675;4120;1390;3743;83;196;1124;3058;1207;3254
521975;202204;14419;35746;11830;32186;1973;5497;7192;19609;9165;25106
521980;202204;2743;6066;2104;5236;143;336;1611;4089;1754;4425
521990;202204;1399;3498;1157;3126;245;715;601;1620;846;2335
522000;202204;3114;7694;2449;6837;529;1516;1293;3810;1822;5326
522005;202204;390;891;278;728;42;121;138;361;180;482
522010;202204;4900;11568;3568;9460;719;2028;1412;3609;2131;5637
522015;202204;1200;2960;890;2488;252;704;354;1001;606;1705
522020;202204;6176;13953;4113;10823;848;2175;1780;4879;2628;7054
522026;202204;895;2240;582;1722;104;358;177;450;281;808
522028;202204;567;1344;393;1054;91;274;158;385;249;659
522040;202204;3963;8243;2866;6800;308;763;1989;4597;2297;5360
522045;202204;21602;56120;16441;47617;3542;10951;5339;14870;8881;25821
522050;202204;1361;3296;953;2605;184;578;405;988;589;1566
522060;202204;3395;8515;2462;7033;360;1000;1310;3787;1670;4787
522068;202204;2129;4928;1712;4439;99;222;1412;3699;1511;3921
522070;202204;872;1862;713;1641;18;33;621;1402;639;1435
522100;202204;933;2270;642;1775;83;241;320;853;403;1094
522108;202204;1240;2705;984;2351;47;138;812;1902;859;2040
522119;202204;2099;4729;1664;4181;287;664;916;2468;1203;3132
522130;202204;558;1299;420;1117;38;93;314;852;352;945
522140;202204;26289;64318;18994;51708;4256;12281;6487;16610;10743;28891
522145;202204;916;2108;651;1721;134;370;328;860;462;1230
522150;202204;1208;2778;834;2202;205;545;257;681;462;1226
522155;202204;1171;2853;918;2489;157;373;542;1529;699;1902
522157;202204;804;1675;663;1510;36;76;544;1256;580;1332
522160;202204;6804;16641;4416;12475;1222;3693;557;1710;1779;5403
522170;202204;3079;7551;2394;6556;276;769;1515;4178;1791;4947
522180;202204;670;1569;449;1150;83;218;126;327;209;545
522185;202204;25212;58555;18631;49756;6743;19184;4610;13376;11353;32560
522190;202204;901;1978;632;1547;125;309;282;662;407;971
522200;202204;2121;5629;1552;4618;402;1193;409;1242;811;2435
522205;202204;1884;4351;1409;3693;311;807;649;1719;960;2526
522220;202204;1427;3278;1056;2765;116;299;686;1835;802;2134
522230;202204;1474;3442;1168;3006;194;558;657;1687;851;2245
530010;202204;222431;574160;185852;521267;23261;71874;118984;325272;142245;397146
110001;202203;4427;11859;2996;9250;648;2152;1173;3674;1821;5826
110002;202203;15041;37257;11127;30875;2745;8048;3497;9835;6242;17883
110003;202203;762;2138;566;1753;152;491;205;597;357;1088
110004;202203;14162;35081;9779;27635;1861;5668;3458;9670;5319;15338
110005;202203;2772;6946;1981;5678;384;1087;662;2040;1046;3127
110006;202203;1811;4946;1138;3539;205;677;248;734;453;1411
110007;202203;1446;3602;955;2784;261;753;324;1100;585;1853
110008;202203;3902;9646;2882;8229;341;836;1898;5942;2239;6778
110009;202203;5009;13313;3253;10197;637;2182;1312;4057;1949;6239
110010;202203;9049;26439;6879;22535;1282;4023;3610;12968;4892;16991
110011;202203;8193;20818;5690;16507;1748;5275;1230;3664;2978;8939
110012;202203;17753;42684;11331;32025;2834;8387;1790;5178;4624;13565
110013;202203;6183;16839;4364;13373;1689;5415;753;2496;2442;7911
110014;202203;4314;10898;2984;8418;442;1362;1518;4160;1960;5522
110015;202203;6462;15872;4112;11570;780;2444;1326;3363;2106;5807
110018;202203;4307;10477;2637;7679;528;1631;745;2192;1273;3823
110020;202203;89229;201110;66763;171427;14448;35627;31970;88266;46418;123893
110025;202203;5817;13520;3964;10427;610;1720;2101;5441;2711;7161
110026;202203;607;1505;447;1271;94;289;182;563;276;852
110028;202203;8044;19574;5096;14452;1260;3973;797;2279;2057;6252
110029;202203;1745;4160;1057;2986;200;558;447;1294;647;1852
110030;202203;14862;33611;9417;25611;2323;6935;1564;4866;3887;11801
110032;202203;3902;10420;2429;7421;710;2163;575;1851;1285;4014
110033;202203;4280;12647;3311;10891;1060;3561;1051;3769;2111;7330
110034;202203;3571;8129;2430;6576;759;2230;784;2431;1543;4661
110037;202203;1802;5136;1315;4258;288;940;588;1954;876;2894
110040;202203;3365;8885;2474;7306;563;1802;886;2538;1449;4340
110045;202203;5295;14605;3865;12064;951;3147;1470;4750;2421;7897
110050;202203;1932;5031;1323;3986;415;1429;236;651;651;2080
110060;202203;984;2803;679;2097;169;553;189;572;358;1125
110070;202203;1742;5175;1263;4138;361;1297;319;967;680;2264
110080;202203;7205;16168;5502;14134;976;2384;3304;9070;4280;11454
110090;202203;650;1725;453;1378;94;314;142;432;236;746
110092;202203;1436;3942;1009;3146;178;544;516;1699;694;2243
110094;202203;3183;8952;2391;7475;973;3201;364;1227;1337;4428
110100;202203;1932;5358;1524;4616;427;1355;641;1995;1068;3350
110110;202203;1984;5112;1441;4283;439;1360;389;1281;828;2641
110120;202203;1437;3936;1086;3282;249;790;402;1216;651;2006
110130;202203;3130;7485;1909;5299;281;762;212;525;493;1287
110140;202203;2501;6955;1810;5637;356;1189;700;2165;1056;3354
110143;202203;1526;3987;1104;3208;309;960;300;860;609;1820
110145;202203;1086;2723;646;1907;138;415;264;814;402;1229
110146;202203;552;1390;390;1132;71;162;196;627;267;789
110147;202203;848;2133;565;1605;85;274;257;651;342;925
110148;202203;1069;2810;542;1686;146;507;77;242;223;749
110149;202203;3693;9362;2506;7512;778;2428;687;2249;1465;4677
110150;202203;3021;7327;1996;5783;517;1638;595;1983;1112;3621
110155;202203;869;2421;622;1864;125;418;251;690;376;1108
110160;202203;1594;4608;1195;3764;338;1098;331;1083;669;2181
110170;202203;2317;5714;1507;4257;210;671;876;2335;1086;3006
110175;202203;2317;6365;1581;4778;281;868;623;1889;904;2757
110180;202203;1595;4126;1144;3269;135;395;625;1760;760;2155
120001;202203;3743;10266;3050;9231;452;1501;2005;6131;2457;7632
120005;202203;2138;7709;1950;7448;165;680;1565;6108;1730;6788
120010;202203;6043;16457;5199;15263;402;1169;4079;12163;4481;13332
120013;202203;2625;8221;2306;7822;503;1626;1373;5077;1876;6703
120017;202203;3011;8500;2606;7903;354;1083;1745;5578;2099;6661
120020;202203;16567;59056;15276;56713;955;4206;12557;46694;13512;50900
120025;202203;3783;9476;3101;8681;312;853;2358;6746;2670;7599
120030;202203;6914;26082;6417;25232;420;2138;5071;20170;5491;22308
120032;202203;1932;8060;1844;7903;101;626;1604;6749;1705;7375
120033;202203;4629;15817;4330;15283;107;608;3827;13358;3934;13966
120034;202203;3158;10329;2737;9643;114;627;2331;8069;2445;8696
120035;202203;4219;15260;3957;14818;213;1053;3391;12567;3604;13620
120038;202203;3206;9314;2761;8619;387;1296;1853;5786;2240;7082
120039;202203;2181;8956;2041;8689;119;674;1673;7131;1792;7805
120040;202203;56398;157281;48813;145896;5839;18859;33114;99197;38953;118056
120042;202203;3730;12833;3461;12365;153;758;2938;10394;3091;11152
120043;202203;1647;6202;1454;5936;34;207;1333;5458;1367;5665
120045;202203;6746;16397;5788;15302;331;978;4907;12970;5238;13948
120050;202203;10703;35241;9860;34032;482;1976;8353;29035;8835;31011
120060;202203;10917;38842;10030;37578;453;2281;8828;32975;9281;35256
120070;202203;3788;10989;3295;10336;380;1062;2329;7697;2709;8759
120080;202203;5351;14676;4807;13902;497;1414;3724;10962;4221;12376
130002;202203;3592;12689;3217;12175;217;679;2778;10860;2995;11539
130006;202203;2830;9545;2365;8788;310;1118;1592;6428;1902;7546
130008;202203;3039;9812;2677;9311;119;480;2233;7911;2352;8391
130010;202203;4287;11964;3626;11223;110;294;3259;10247;3369;10541
130014;202203;4002;10860;3138;9529;463;1425;2011;6295;2474;7720
130020;202203;3237;11875;2879;11351;139;767;2409;9478;2548;10245
130030;202203;13851;36434;12732;35167;267;703;11840;32804;12107;33507
130040;202203;4580;12745;3819;11777;402;1102;2962;9457;3364;10559
130050;202203;8306;28555;6999;26894;236;933;6327;24727;6563;25660
130060;202203;8328;31533;7115;29979;375;2192;6047;25263;6422;27455
130063;202203;7170;22353;6383;21489;167;761;5878;19822;6045;20583
130068;202203;4254;13512;3604;12656;174;936;2883;10025;3057;10961
130070;202203;8365;22111;6861;20487;385;955;5709;17615;6094;18570
130080;202203;8366;27409;7339;26261;431;1432;6409;23368;6840;24800
130083;202203;3053;9434;2713;9022;206;659;2234;7682;2440;8341
130090;202203;4116;11768;3669;11244;72;190;3367;10481;3439;10671
130100;202203;8547;24911;7212;23521;159;308;6753;22546;6912;22854
130110;202203;9118;24605;7408;22500;952;2541;5477;17652;6429;20193
130115;202203;5541;16844;4764;15967;138;415;4218;14418;4356;14833
130120;202203;14685;50114;12922;47805;953;3944;10665;39923;11618;43867
130130;202203;6452;18298;5005;16431;467;1469;3765;12831;4232;14300
130140;202203;7882;26025;6878;24887;324;1447;5910;21595;6234;23042
130150;202203;4123;14218;3880;13945;77;434;3616;13013;3693;13447
130160;202203;6573;19854;5693;18776;320;927;4971;16754;5291;17681
130165;202203;3581;12812;3369;12575;128;546;3064;11544;3192;12090
130170;202203;13369;35881;10887;33080;571;1949;9349;28686;9920;30635
130180;202203;4757;14836;4526;14582;41;235;4384;14087;4425;14322
130185;202203;21512;49163;17751;45151;1288;1796;15256;40912;16544;42708
130190;202203;21155;65724;17127;59974;1429;5146;13163;47276;14592;52422
130195;202203;2715;9314;2241;8706;97;442;1897;7426;1994;7868
130200;202203;3164;7993;2609;7284;99;356;2265;6282;2364;6638
130210;202203;1492;5362;1345;5188;110;583;1108;4181;1218;4764
130220;202203;2631;8200;2206;7689;79;281;1958;6952;2037;7233
130230;202203;5448;20490;4752;19555;200;1134;4194;17288;4394;18422
130240;202203;15020;39102;12448;35867;179;914;11541;33024;11720;33938
130250;202203;28965;81822;24848;77164;1330;3847;20924;66880;22254;70727
130255;202203;5348;16177;4599;14897;169;671;3800;12298;3969;12969
130260;202203;299613;772391;246807;701333;58100;161114;136307;406178;194407;567292
130270;202203;10846;35611;8990;32826;1429;4875;5923;22772;7352;27647
130280;202203;3868;14693;3553;14339;107;444;3306;13518;3413;13962
130290;202203;15643;47194;13785;44948;717;2383;12143;40094;12860;42477
130300;202203;5448;17254;4888;16520;198;917;4284;14483;4482;15400
130310;202203;8012;22813;7038;21633;394;1250;5966;18675;6360;19925
130320;202203;3792;11953;3178;11160;376;1279;2408;8749;2784;10028
130330;202203;5083;15242;4091;14080;194;821;3527;12194;3721;13015
130340;202203;27602;76857;23840;72671;995;3211;20940;64747;21935;67958
130350;202203;4361;14929;3932;14400;129;703;3514;12793;3643;13496
130353;202203;8788;22092;7150;20058;814;2082;5325;15570;6139;17652
130356;202203;5962;17759;5025;16354;782;2405;3252;11184;4034;13589
130360;202203;3378;10403;2793;9676;64;282;2558;8879;2622;9161
130370;202203;5931;23437;5072;22248;463;2464;3862;17039;4325;19503
130380;202203;8055;33239;7510;32447;525;2851;6338;27331;6863;30182
130390;202203;6893;26824;6162;25702;472;2162;5203;21908;5675;24070
130395;202203;2725;8240;2342;7647;194;635;1869;6134;2063;6769
130400;202203;3114;9056;2674;8485;90;273;2419;7798;2509;8071
130406;202203;11727;38892;9879;36673;1275;4734;7414;28466;8689;33200
130410;202203;4820;15986;4156;14940;1079;4004;2236;8366;3315;12370
130420;202203;15945;51717;13390;48582;975;4296;10695;39001;11670;43297
130423;202203;4913;14564;4322;13892;170;729;3886;12402;4056;13131
130426;202203;3042;11396;2805;11113;60;284;2621;10495;2681;10779
130430;202203;4976;12781;4271;11900;172;533;3792;10544;3964;11077
130440;202203;5649;16408;4761;15366;91;367;4456;14467;4547;14834
140002;202203;2549;7247;2227;6862;106;344;1916;5995;2022;6339
140005;202203;3531;9605;3070;9073;477;1386;2252;6871;2729;8257
140010;202203;58339;151621;47300;135811;10956;33022;21956;64717;32912;97739
140015;202203;4559;12166;3857;11357;271;755;3298;10012;3569;10767
140017;202203;5977;14575;5308;13746;308;780;4542;11938;4850;12718
140020;202203;5809;15741;5027;14773;263;996;4217;12322;4480;13318
140023;202203;2842;7900;2327;7182;221;670;1788;5687;2009;6357
140028;202203;2142;5328;1824;4941;87;275;1489;4053;1576;4328
140030;202203;5967;14306;5316;13563;214;377;4852;12649;5066;13026
140040;202203;2860;10656;2645;10385;90;504;2445;9526;2535;10030
140045;202203;2847;10163;2368;9521;416;1346;1563;6955;1979;8301
140047;202203;6866;18618;5764;17051;571;1807;4290;12866;4861;14673
140050;202203;1635;4674;1394;4334;200;578;994;3197;1194;3775
140060;202203;2050;4989;1789;4633;120;308;1506;3949;1626;4257
140070;202203;2062;10319;1996;10212;122;813;1741;8822;1863;9635
150010;202203;51806;122188;46940;116020;1022;2474;42453;104635;43475;107109
150013;202203;2221;5215;1874;4836;87;203;1593;4231;1680;4434
150020;202203;15411;44182;14207;42616;1303;3223;11783;36494;13086;39717
150030;202203;9075;33364;8201;32336;367;1651;7371;29255;7738;30906
150034;202203;4850;11012;3962;9936;223;502;3372;8608;3595;9110
150040;202203;17857;43511;15671;41130;1290;1558;13766;38369;15056;39927
150050;202203;8238;25492;7552;24618;164;574;7001;23074;7165;23648
150060;202203;24597;63675;19966;56887;2413;7057;13981;40417;16394;47474
150070;202203;9963;28971;8932;27768;178;769;8431;26089;8609;26858
150080;202203;101892;222018;84313;198718;21788;51366;27115;76736;48903;128102
150085;202203;9391;24504;8519;23498;110;378;8036;22301;8146;22679
150090;202203;12080;37823;11384;36595;606;2122;9818;31427;10424;33549
150095;202203;7464;18104;6629;17104;385;612;5898;15635;6283;16247
150100;202203;3086;10273;2724;9684;212;718;2168;7880;2380;8598
150110;202203;4572;17978;4249;17620;143;651;3966;16581;4109;17232
150120;202203;8778;25978;8237;25343;311;634;7456;23463;7767;24097
150125;202203;906;2180;673;1878;97;310;441;1226;538;1536
150130;202203;24840;67627;21408;62536;3694;9452;13875;43410;17569;52862
150140;202203;305500;655889;260076;596806;33636;70270;166881;392374;200517;462644
150145;202203;4667;13915;3906;12739;1107;3392;1878;6953;2985;10345
150150;202203;19586;45569;16967;42336;1045;2494;13822;34728;14867;37222
150157;202203;4051;10430;3240;9381;330;918;2292;6898;2622;7816
150160;202203;3987;9755;3720;9381;359;882;2927;7353;3286;8235
150170;202203;28663;83688;25470;78557;3741;10432;17124;55828;20865;66260
150172;202203;5783;14577;4696;13122;286;693;3660;10518;3946;11211
150175;202203;1879;5445;1559;4899;212;705;1024;3223;1236;3928
150178;202203;11880;29405;9713;26957;491;898;8403;24195;8894;25093
150180;202203;28125;83689;25564;80835;1585;3686;21961;72878;23546;76564
150190;202203;7718;22956;7176;22314;183;759;6612;20482;6795;21241
150195;202203;5877;17185;5511;16655;213;698;4969;15040;5182;15738
150200;202203;6505;17984;5934;17354;31;128;5655;16590;5686;16718
150210;202203;30574;96290;28702;93982;1326;4123;25087;83888;26413;88011
150215;202203;10069;27088;8759;25096;1420;4028;5425;15983;6845;20011
150220;202203;14429;37698;12660;35288;943;2534;9455;26583;10398;29117
150230;202203;14483;38286;12871;36140;1235;2779;9320;27415;10555;30194
150240;202203;37651;97688;31771;88238;6653;19097;14887;40674;21540;59771
150250;202203;4660;16661;4348;16316;456;1707;3653;13976;4109;15683
150260;202203;2860;8687;2573;8274;101;350;2163;6996;2264;7346
150270;202203;10124;27228;7239;22151;2018;6482;2218;7121;4236;13603
150275;202203;7630;22370;6961;21472;173;717;6187;18944;6360;19661
150276;202203;2589;6553;2228;6109;277;630;1552;4731;1829;5361
150277;202203;5810;13955;4645;12627;488;1317;3408;9729;3896;11046
150280;202203;7782;28790;7500;28357;342;1362;6670;25508;7012;26870
150285;202203;3612;12016;3168;11329;211;829;2456;8913;2667;9742
150290;202203;12329;30659;11184;29447;490;725;10150;27472;10640;28197
150293;202203;10620;24559;8370;21670;1074;2574;5569;14956;6643;17530
150295;202203;8234;20895;5936;17748;1854;5566;2281;7920;4135;13486
150300;202203;2770;7432;2499;7111;28;101;2339;6685;2367;6786
150304;202203;4866;13338;4075;12138;576;1486;2810;8836;3386;10322
150307;202203;6453;19479;5889;18579;328;1057;4740;15106;5068;16163
150309;202203;7228;19783;5868;17587;744;2182;3825;11800;4569;13982
150310;202203;8099;30227;7642;29687;223;1128;6840;26886;7063;28014
150320;202203;10026;25965;9123;24691;442;1381;7259;19447;7701;20828
150330;202203;15070;45167;13985;43639;1316;3555;10622;34767;11938;38322
150340;202203;2720;7638;2402;7190;250;702;1796;5477;2046;6179
150345;202203;9630;25325;8604;23994;329;1037;7633;21252;7962;22289
150350;202203;9914;23686;9073;22636;517;1079;7860;19774;8377;20853
150360;202203;26637;69242;21301;62672;2302;4784;15812;49519;18114;54303
150370;202203;12604;35015;10308;31956;1154;3046;7603;25221;8757;28267
150375;202203;4117;15914;3754;15423;183;821;3344;13880;3527;14701
150380;202203;12122;28970;9942;26148;154;551;8824;23123;8978;23674
150390;202203;7985;30851;7135;29565;814;3032;5496;23751;6310;26783
150400;202203;7297;24374;6974;23830;144;593;6285;21520;6429;22113
150405;202203;10065;24855;8748;23309;534;1054;7222;19809;7756;20863
150410;202203;2175;6275;1866;5782;187;524;1326;4223;1513;4747
150420;202203;46641;120668;36245;105806;8373;24162;16127;52693;24500;76855
150430;202203;9117;24993;8291;23963;650;1504;6928;20528;7578;22032
150440;202203;6459;18528;5847;17725;675;1797;4407;13858;5082;15655
150442;202203;32221;69867;26981;63698;2249;4879;20461;48602;22710;53481
150445;202203;7613;20925;6714;19636;171;552;6009;17559;6180;18111
150450;202203;5762;22506;5333;21946;363;1794;4657;19114;5020;20908
150460;202203;9509;28793;8683;27772;388;1063;7469;24778;7857;25841
150470;202203;23623;58225;21250;55527;241;901;20279;52731;20520;53632
150475;202203;5861;17046;4986;15725;669;1846;3547;11707;4216;13553
150480;202203;15310;45123;13743;42906;1951;4894;10048;33459;11999;38353
150490;202203;9288;30413;8441;29333;462;1532;7193;25458;7655;26990
150495;202203;6003;18586;5689;18181;130;562;5226;16648;5356;17210
150497;202203;3059;9192;2469;8169;440;1469;1419;5001;1859;6470
150500;202203;3612;8767;3209;8207;221;533;2536;6443;2757;6976
150503;202203;5601;13780;3954;11680;1213;3403;1578;5169;2791;8572
150506;202203;12639;34524;10657;31841;1682;4385;7398;23839;9080;28224
150510;202203;11716;37453;10222;34926;1047;3429;7546;26409;8593;29838
150520;202203;8568;29908;8227;29493;183;1065;7645;27225;7828;28290
150530;202203;13356;43287;11561;40771;986;2905;9046;33124;10032;36029
150540;202203;5710;14113;4920;12973;262;646;4168;10991;4430;11637
150543;202203;7752;20190;6424;18549;406;1159;5152;15447;5558;16606
150548;202203;11148;33121;10003;31534;260;977;9042;28492;9302;29469
150549;202203;2203;5987;1868;5521;64;207;1545;4588;1609;4795
150550;202203;23168;64235;19215;58030;4304;13196;8963;28454;13267;41650
150553;202203;39839;104158;31222;89746;7105;20656;14416;42560;21521;63216
150555;202203;2177;5473;1712;4758;158;333;1135;3371;1293;3704
150560;202203;2122;5847;1895;5438;226;617;1252;3679;1478;4296
150563;202203;2898;8186;2400;7334;426;1368;1389;4301;1815;5669
150565;202203;4859;14820;4335;14020;115;502;3654;11889;3769;12391
150570;202203;7364;21003;6846;20342;309;990;6051;17976;6360;18966
150580;202203;11892;43291;10176;41400;1117;3726;8068;34890;9185;38616
150590;202203;8823;29026;7538;27505;167;939;6941;25259;7108;26198
150600;202203;11048;33322;10236;32347;196;830;9531;30119;9727;30949
150610;202203;3321;8640;2968;8116;102;387;2556;6873;2658;7260
150611;202203;3635;9445;3238;8913;90;322;2892;7899;2982;8221
150613;202203;15767;40884;12121;34998;1981;6151;6714;19066;8695;25217
150616;202203;4131;10951;3021;9076;605;1920;1408;4226;2013;6146
150618;202203;7716;20977;6310;18850;730;2165;4066;12585;4796;14750
150619;202203;7527;19607;6218;17845;337;823;5193;15192;5530;16015
150620;202203;7395;23387;6428;21836;665;2089;4473;15718;5138;17807
150630;202203;7353;18038;6710;17282;166;501;6077;15577;6243;16078
150635;202203;5773;14813;4880;13403;556;1425;3335;9283;3891;10708
150640;202203;2375;6822;2168;6563;36;113;2025;6178;2061;6291
150650;202203;12955;33322;11287;30822;2730;6961;5751;16857;8481;23818
150655;202203;6035;16608;5469;15801;140;496;4844;13930;4984;14426
150658;202203;5018;13742;3788;11711;770;2464;1952;6301;2722;8765
150660;202203;6430;17076;5694;16061;700;1883;3940;11291;4640;13174
150670;202203;10340;21910;8242;19541;564;1017;6918;17035;7482;18052
150680;202203;78794;215753;62302;190722;12941;38308;31799;106915;44740;145223
150690;202203;3043;7041;2616;6560;124;249;2292;5877;2416;6126
150700;202203;7227;19706;6483;18778;430;1029;5319;15804;5749;16833
150710;202203;4113;13004;3722;12403;248;820;2925;9924;3173;10744
150715;202203;5832;15093;4811;13624;242;640;4001;11409;4243;12049
150720;202203;8151;24793;7563;23973;394;1372;6499;20755;6893;22127
150730;202203;14351;40549;12223;37459;1342;4194;9080;28587;10422;32781
150740;202203;4493;11728;3949;10913;328;735;3034;8635;3362;9370
150745;202203;5950;15726;4849;14182;577;1669;3567;10699;4144;12368
150746;202203;1917;5261;1724;4990;61;186;1469;4248;1530;4434
150747;202203;5593;15810;4969;14907;435;1158;3813;11739;4248;12897
150750;202203;4095;11959;3372;10872;241;839;2552;8519;2793;9358
150760;202203;12806;35743;11593;34113;1558;4101;8392;25606;9950;29707
150770;202203;7610;24506;7068;23912;226;545;6500;22631;6726;23176
150775;202203;1238;3099;961;2744;110;344;676;1938;786;2282
150780;202203;4859;14293;4319;13661;154;419;3925;12713;4079;13132
150790;202203;6759;17382;5767;16324;411;805;4105;13672;4516;14477
150795;202203;16408;46611;14231;43424;2585;7562;9170;29119;11755;36681
150796;202203;4265;9675;3702;9040;152;336;3238;8000;3390;8336
150797;202203;4636;13196;3991;12323;269;619;3298;10468;3567;11087
150800;202203;14661;43416;13120;41452;1210;3646;10364;33565;11574;37211
150803;202203;8669;23884;8030;22993;315;982;7154;20506;7469;21488
150805;202203;3923;11344;3343;10536;269;800;2607;8451;2876;9251
150808;202203;7159;19729;5338;16757;1842;6238;1093;3855;2935;10093
150810;202203;23326;56826;17644;50057;3481;9306;9517;30443;12998;39749
150812;202203;6472;16641;5743;15546;396;1217;4559;12070;4955;13287
150815;202203;10590;29227;8837;27175;726;2180;7282;22909;8008;25089
150820;202203;14887;34911;12894;32516;1639;2827;9680;26472;11319;29299
150830;202203;13095;43816;12086;42608;774;2120;10348;38176;11122;40296
150835;202203;3342;9544;2920;8933;328;1047;2118;6430;2446;7477
150840;202203;8880;23161;7195;20604;1025;3313;4437;12483;5462;15796
160005;202203;1333;3392;1176;3206;55;182;1029;2814;1084;2996
160010;202203;2507;6555;2329;6362;23;112;2258;6114;2281;6226
160015;202203;3808;9185;3441;8756;57;175;3255;8258;3312;8433
160020;202203;2509;7174;2191;6777;212;571;1726;5560;1938;6131
160021;202203;1396;4804;1275;4658;64;291;1015;3798;1079;4089
160023;202203;1473;4822;1318;4571;179;586;899;3289;1078;3875
160025;202203;2057;5827;1939;5697;23;55;1871;5525;1894;5580
160027;202203;10626;26431;9570;25122;545;1517;8215;21559;8760;23076
160030;202203;87799;229712;72558;210009;13487;35959;42667;133917;56154;169876
160040;202203;6435;20285;5846;19553;145;468;5446;18370;5591;18838
160050;202203;5704;15744;4556;14266;1356;3598;2276;8580;3632;12178
160053;202203;4523;12693;4058;12116;237;611;3359;10443;3596;11054
160055;202203;1202;2944;1166;2906;19;48;1110;2763;1129;2811
160060;202203;30741;72512;25766;66952;1690;3931;21075;56745;22765;60676
160070;202203;3166;10877;2786;10317;244;840;2196;8490;2440;9330
160080;202203;3820;10774;3367;10276;45;167;3180;9768;3225;9935
170025;202203;738;1824;511;1453;87;239;252;747;339;986
170030;202203;1334;3841;1047;3367;188;588;480;1592;668;2180
170035;202203;1651;4070;1217;3393;87;265;788;2135;875;2400
170040;202203;2136;5537;1705;4950;170;500;1078;3241;1248;3741
170070;202203;2108;4671;1505;3925;78;201;931;2516;1009;2717
170100;202203;2626;7138;2168;6394;166;506;1463;4346;1629;4852
170105;202203;763;2115;545;1679;131;405;189;559;320;964
170110;202203;1102;3084;858;2671;78;302;521;1544;599;1846
170130;202203;1521;4153;1154;3517;142;497;667;2025;809;2522
170190;202203;1727;4308;1330;3707;235;806;705;1865;940;2671
170200;202203;2299;5181;1535;3979;235;610;687;1773;922;2383
170210;202203;29637;76495;22719;65391;6606;20455;4795;14544;11401;34999
170215;202203;1461;3732;1176;3346;50;181;930;2630;980;2811
170220;202203;6482;18980;5407;17100;1532;4645;2075;7438;3607;12083
170230;202203;1363;3775;1025;3153;290;904;270;871;560;1775
170240;202203;2898;7551;2348;6698;137;486;1759;4888;1896;5374
170255;202203;4227;11637;3103;9734;552;1780;1483;4781;2035;6561
170270;202203;993;2339;684;1899;87;223;387;1070;474;1293
170290;202203;3352;9083;2924;8535;202;496;2330;6986;2532;7482
170300;202203;2340;5746;1921;5140;158;399;1432;3834;1590;4233
170305;202203;736;1928;616;1731;69;189;340;976;409;1165
170307;202203;1130;3449;942;3111;105;366;594;1943;699;2309
170310;202203;1751;4180;1269;3444;158;471;681;1849;839;2320
170320;202203;1150;2911;872;2465;94;295;545;1558;639;1853
170330;202203;988;2858;892;2721;34;155;763;2259;797;2414
170360;202203;621;1546;451;1281;24;97;318;851;342;948
170370;202203;1444;3572;1049;2938;195;543;467;1291;662;1834
170380;202203;2032;5483;1562;4787;111;362;943;2997;1054;3359
170382;202203;590;1646;488;1480;29;117;369;1085;398;1202
170384;202203;1833;5977;1518;5413;311;1081;821;3010;1132;4091
170386;202203;1081;2815;694;2106;77;269;271;784;348;1053
170388;202203;800;2074;568;1687;72;227;270;782;342;1009
170389;202203;1065;3123;867;2784;75;258;594;1957;669;2215
170390;202203;1999;4231;1521;3671;38;98;1305;3185;1343;3283
170410;202203;680;1750;495;1448;37;130;338;954;375;1084
170460;202203;440;1136;363;1019;35;112;264;732;299;844
170510;202203;1009;2665;734;2201;38;166;482;1350;520;1516
170550;202203;7389;18707;5613;15973;1486;4556;1721;4967;3207;9523
170555;202203;1529;3904;1232;3467;114;267;617;1834;731;2101
170560;202203;1130;3012;872;2654;99;291;542;1734;641;2025
170600;202203;1464;3701;1167;3283;220;574;649;1922;869;2496
170610;202203;1798;4423;1364;3790;106;353;890;2410;996;2763
170625;202203;476;1202;328;932;34;90;139;363;173;453
170650;202203;1456;3993;1199;3599;130;423;776;2321;906;2744
170700;202203;3827;10747;2957;9133;574;1790;1352;4177;1926;5967
170710;202203;1696;4087;1329;3545;165;444;871;2339;1036;2783
170720;202203;1991;4666;1534;3955;187;527;992;2521;1179;3048
170730;202203;1193;3028;902;2582;97;247;543;1587;640;1834
170740;202203;2271;7087;1959;6546;162;627;1445;4785;1607;5412
170755;202203;964;2471;691;2028;119;376;294;842;413;1218
170765;202203;1272;3098;921;2574;182;492;462;1301;644;1793
170770;202203;2033;5472;1646;4894;150;504;1180;3468;1330;3972
170820;202203;4082;11314;3173;9763;588;1821;1584;5035;2172;6856
170825;202203;1128;2479;931;2227;76;175;725;1723;801;1898
170830;202203;1503;3764;1202;3304;272;759;610;1688;882;2447
170900;202203;3026;8931;2570;8287;178;620;2108;6864;2286;7484
170930;202203;4162;10909;3222;9233;731;2197;1097;3154;1828;5351
170950;202203;12491;33286;8931;27082;2534;8222;1321;4427;3855;12649
170980;202203;532;1321;401;1121;50;153;232;626;282;779
171050;202203;1802;5380;1573;5003;76;298;1296;4099;1372;4397
171070;202203;1469;3952;1255;3643;263;668;674;2272;937;2940
171090;202203;1136;2792;894;2448;121;336;520;1437;641;1773
171110;202203;631;1604;434;1260;79;233;199;539;278;772
171150;202203;1178;2778;743;2060;55;173;472;1287;527;1460
171180;202203;849;2200;575;1706;87;239;269;789;356;1028
171190;202203;2165;6661;1883;6187;289;993;1188;4006;1477;4999
171195;202203;892;2661;710;2328;84;344;450;1418;534;1762
171200;202203;672;1802;508;1533;110;377;197;572;307;949
171215;202203;432;1111;346;973;43;138;216;597;259;735
171240;202203;847;2633;671;2325;31;188;466;1556;497;1744
171245;202203;868;2324;678;1955;59;201;440;1208;499;1409
171250;202203;1086;2819;799;2376;136;431;401;1209;537;1640
171270;202203;529;1754;409;1485;87;327;190;726;277;1053
171280;202203;974;2758;790;2451;70;234;511;1611;581;1845
171320;202203;4399;11733;3484;10207;579;1657;1596;4817;2175;6474
171330;202203;3080;8107;2412;6966;529;1573;1141;3331;1670;4904
171360;202203;1624;4317;1250;3774;110;285;861;2786;971;3071
171370;202203;805;1888;628;1648;42;113;468;1232;510;1345
171380;202203;1620;4285;1370;3957;152;379;987;3017;1139;3396
171395;202203;1129;2806;781;2208;62;196;535;1466;597;1662
171420;202203;2183;5886;1648;4917;272;856;833;2453;1105;3309
171430;202203;1177;3253;993;2936;60;196;699;1981;759;2177
171488;202203;2694;7219;2156;6369;345;1033;1256;3760;1601;4793
171500;202203;1030;2514;767;2114;69;190;498;1354;567;1544
171510;202203;918;2759;794;2541;58;227;578;1834;636;2061
171515;202203;541;1294;413;1108;34;109;270;664;304;773
171525;202203;797;2082;600;1756;45;171;400;1119;445;1290
171550;202203;379;1038;299;916;40;159;176;499;216;658
171570;202203;1196;3382;1007;3053;117;363;626;1947;743;2310
171575;202203;1865;4815;1234;3732;128;384;593;1801;721;2185
171610;202203;6420;17219;4854;14639;1064;3492;1270;4214;2334;7706
171620;202203;2996;7702;2551;7081;122;413;2153;5941;2275;6354
171630;202203;1168;2843;911;2504;87;240;651;1837;738;2077
171650;202203;2402;6474;1888;5658;471;1505;609;1986;1080;3491
171660;202203;2563;6159;1810;4968;195;503;1131;3117;1326;3620
171665;202203;1360;3646;1085;3216;193;585;552;1690;745;2275
171670;202203;2084;5315;1564;4467;209;630;782;2233;991;2863
171700;202203;1296;3470;957;2878;103;329;565;1679;668;2008
171720;202203;868;2109;681;1833;40;123;515;1373;555;1496
171750;202203;1425;3825;973;2984;247;767;171;616;418;1383
171780;202203;1399;3335;1042;2804;78;242;755;2003;833;2245
171790;202203;1547;4732;1254;4143;192;660;655;2165;847;2825
171800;202203;807;2032;623;1774;74;241;365;1010;439;1251
171820;202203;12787;34301;9637;29144;2316;7433;2771;8966;5087;16399
171830;202203;1710;5116;1463;4702;202;674;882;2909;1084;3583
171840;202203;811;2058;628;1784;27;96;395;1096;422;1192
171845;202203;726;1674;560;1429;45;143;400;981;445;1124
171850;202203;1027;3167;876;2847;73;307;635;2008;708;2315
171855;202203;1129;3267;964;2971;72;226;640;1934;712;2160
171865;202203;517;1419;446;1312;58;192;266;756;324;948
171870;202203;895;2329;629;1872;71;216;339;1014;410;1230
171875;202203;1469;3933;1198;3525;36;167;941;2742;977;2909
171880;202203;1439;3894;1248;3647;42;130;998;2958;1040;3088
171884;202203;1074;2868;815;2433;155;472;367;1124;522;1596
171886;202203;1624;4210;1188;3567;301;1003;317;1004;618;2007
171888;202203;704;1897;486;1496;23;95;295;879;318;974
171889;202203;437;1255;317;1040;68;228;118;374;186;602
171890;202203;1308;3580;961;3019;135;428;590;1837;725;2265
171900;202203;605;1953;475;1686;70;227;217;802;287;1029
172000;202203;634;1789;523;1613;76;234;275;834;351;1068
172010;202203;1223;3744;1058;3465;107;380;715;2328;822;2708
172015;202203;406;1317;313;1146;55;190;137;516;192;706
172020;202203;3077;8144;2695;7670;164;508;2051;6031;2215;6539
172025;202203;781;2061;566;1718;45;138;395;1202;440;1340
172030;202203;1377;3917;1124;3492;69;234;843;2614;912;2848
172049;202203;1410;3324;941;2678;132;361;499;1511;631;1872
172065;202203;1609;3829;1282;3414;127;244;975;2820;1102;3064
172080;202203;2629;7287;2130;6446;126;426;1444;4330;1570;4756
172085;202203;508;1317;326;940;59;177;125;331;184;508
172090;202203;4436;10346;3492;9121;140;369;2780;7304;2920;7673
172093;202203;491;1423;355;1193;24;111;213;688;237;799
172097;202203;773;1934;543;1552;80;248;233;653;313;901
172100;202203;55221;130665;41008;109267;7113;20426;17355;46629;24468;67055
172110;202203;1731;5926;1489;5569;101;438;1166;4435;1267;4873
172120;202203;5567;15510;4398;13660;505;1720;2654;8287;3159;10007
172125;202203;443;1135;337;978;30;102;202;550;232;652
172130;202203;684;1616;525;1359;20;84;368;881;388;965
172208;202203;2914;6621;2329;5889;171;375;1790;4573;1961;4948
172210;202203;2891;6941;2239;6136;262;707;1442;4161;1704;4868
210005;202203;20685;56293;15698;48350;3733;11979;7064;22639;10797;34618
210010;202203;2147;6104;1953;5878;53;233;1755;5254;1808;5487
210015;202203;3584;10188;3110;9572;165;537;2601;8053;2766;8590
210020;202203;7836;17825;6694;16501;97;304;6197;15280;6294;15584
210030;202203;4935;15629;4520;15004;471;1486;3577;12161;4048;13647
210040;202203;2288;4785;2014;4460;72;160;1744;3811;1816;3971
210043;202203;6436;17576;5441;16208;376;1173;4368;13159;4744;14332
210047;202203;7164;21058;5836;19322;184;829;5040;16729;5224;17558
210050;202203;2442;7588;1950;6720;181;746;1417;4834;1598;5580
210055;202203;2145;6300;1940;6017;52;189;1709;5343;1761;5532
210060;202203;7988;27931;7118;26414;658;2566;5066;19259;5724;21825
210070;202203;7687;20051;7140;19362;46;158;6760;18291;6806;18449
210080;202203;4707;14709;4442;14424;48;261;4131;13462;4179;13723
210083;202203;6216;16388;5194;15286;133;390;4840;14356;4973;14746
210087;202203;3129;8426;2666;7811;140;442;2168;6355;2308;6797
210090;202203;9758;29010;9103;27924;618;1574;7677;23871;8295;25445
210095;202203;7026;21815;6413;21042;406;1344;5320;18086;5726;19430
210100;202203;7195;21357;6305;19877;588;1884;4627;14732;5215;16616
210110;202203;3101;9278;2845;8964;69;334;2555;8018;2624;8352
210120;202203;27184;67271;22875;61886;1793;3831;17025;48007;18818;51838
210125;202203;4739;12265;4136;11583;562;1219;3139;9272;3701;10491
210130;202203;4551;11289;3729;10282;103;257;3255;9013;3358;9270
210135;202203;1813;4599;1511;4171;52;140;1305;3615;1357;3755
210140;202203;21839;54733;17015;48571;2820;7668;10467;30981;13287;38649
210150;202203;5078;11242;4506;10485;112;333;3980;9085;4092;9418
210160;202203;20060;51979;17066;48326;1444;3803;13018;37959;14462;41762
210170;202203;16848;48706;15596;47132;612;1933;13971;42270;14583;44203
210173;202203;2438;8975;2291;8737;108;567;1989;7545;2097;8112
210177;202203;3623;9625;3136;9009;375;905;2442;7312;2817;8217
210180;202203;1520;3901;1326;3673;22;69;1212;3351;1234;3420
210190;202203;5886;14671;4990;13496;97;362;4325;11585;4422;11947
210193;202203;1459;3986;1270;3690;49;163;971;2826;1020;2989
210197;202203;2228;6609;2033;6347;121;379;1717;5468;1838;5847
210200;202203;8374;25550;7400;24043;427;1631;5997;19441;6424;21072
210203;202203;7681;21579;6484;20015;389;1222;5266;16609;5655;17831
210207;202203;4206;9827;3290;8830;116;297;2779;7527;2895;7824
210210;202203;8219;25527;7462;24476;196;1011;6413;20917;6609;21928
210215;202203;2648;8072;2288;7547;181;849;1750;5688;1931;6537
210220;202203;7056;22131;6655;21555;154;968;6009;19030;6163;19998
210230;202203;5763;16218;5221;15422;218;620;4646;13801;4864;14421
210232;202203;12541;36645;10282;33269;1564;4891;6761;23211;8325;28102
210235;202203;3622;10581;3185;9957;163;580;2684;8408;2847;8988
210237;202203;3937;10221;3313;9514;30;166;3133;8934;3163;9100
210240;202203;2770;8218;2539;7852;65;267;2097;6364;2162;6631
210250;202203;6253;17859;5665;17120;73;370;5187;15606;5260;15976
210255;202203;2839;8285;2440;7609;280;973;1639;5037;1919;6010
210260;202203;5782;16679;5080;15690;328;1129;4222;13080;4550;14209
210270;202203;5491;14124;4885;13367;83;396;4444;12030;4527;12426
210275;202203;3680;9041;3178;8437;157;413;2604;6960;2761;7373
210280;202203;6305;16559;5117;14830;209;873;4078;11552;4287;12425
210290;202203;8652;20546;7776;19482;154;394;7290;18296;7444;18690
210300;202203;35146;92465;28620;83205;4269;11787;17179;53838;21448;65625
210310;202203;3287;8008;2888;7460;63;177;2610;6730;2673;6907
210312;202203;3077;7088;2756;6747;14;69;2651;6455;2665;6524
210315;202203;3445;8774;3006;8286;110;273;2685;7550;2795;7823
210317;202203;4717;13839;4284;13334;94;461;3934;12161;4028;12622
210320;202203;24653;63910;22845;61617;335;1614;21148;56290;21483;57904
210325;202203;3879;10531;3288;9774;255;670;2723;8357;2978;9027
210330;202203;27063;70222;21823;63765;3689;8977;14136;45442;17825;54419
210340;202203;11912;30894;10682;29320;395;1307;9131;24988;9526;26295
210350;202203;9629;26428;8435;24980;143;528;7622;22573;7765;23101
210355;202203;4392;14155;3875;13354;132;589;3297;11398;3429;11987
210360;202203;13980;42262;12516;39999;610;2735;9593;29944;10203;32679
210370;202203;12614;25840;9759;22844;445;622;8768;21217;9213;21839
210375;202203;3542;9189;2669;7941;814;2515;907;3028;1721;5543
210380;202203;5838;14339;5024;13367;276;713;4269;11400;4545;12113
210390;202203;3174;9446;2942;9079;85;400;2630;8011;2715;8411
210400;202203;4858;13922;4293;13264;157;431;3850;12091;4007;12522
210405;202203;7792;19453;6376;17537;1139;2703;3789;11252;4928;13955
210407;202203;2210;6757;1860;6161;101;379;1462;4840;1563;5219
210408;202203;2859;9949;2649;9669;156;716;2146;7844;2302;8560
210409;202203;4139;13388;3760;12890;156;661;3145;10993;3301;11654
210410;202203;3865;10950;3262;9918;106;437;2666;7969;2772;8406
210420;202203;4112;12551;3662;11761;192;558;3088;10021;3280;10579
210430;202203;2375;6722;2096;6360;121;342;1758;5435;1879;5777
210440;202203;4643;11974;4019;11202;72;275;3689;10199;3761;10474
210450;202203;2467;6978;2123;6484;128;393;1741;5343;1869;5736
210455;202203;4932;12225;3793;10796;921;2590;2007;6002;2928;8592
210460;202203;3942;10964;3328;10167;75;322;2912;8860;2987;9182
210462;202203;1827;5210;1544;4779;60;178;1227;3836;1287;4014
210465;202203;2906;8011;2530;7497;120;502;2091;6059;2211;6561
210467;202203;6681;19303;5821;18211;291;1042;4951;15631;5242;16673
210470;202203;2075;5430;1550;4692;124;348;1166;3621;1290;3969
210480;202203;18230;50706;15178;47022;1610;3656;11197;37905;12807;41561
210490;202203;3749;9056;3004;8058;64;217;2586;6885;2650;7102
210500;202203;6783;24627;6256;23762;377;1786;5268;19878;5645;21664
210510;202203;6266;19712;5482;18884;119;534;4953;17291;5072;17825
210515;202203;4070;11321;3471;10610;191;642;2891;8991;3082;9633
210520;202203;2768;7698;2495;7341;95;339;2123;6201;2218;6540
210530;202203;56995;136429;44453;118391;7760;22103;16312;50897;24072;73000
210535;202203;3893;11612;3542;11109;126;487;3099;9726;3225;10213
210540;202203;16360;44763;13696;41024;1564;4272;9696;30448;11260;34720
210542;202203;7147;16068;5614;14350;503;1071;4472;11885;4975;12956
210545;202203;2422;7137;2252;6874;44;190;1996;6034;2040;6224
210547;202203;3943;13301;3490;12508;227;869;2739;9990;2966;10859
210550;202203;6286;18470;4888;16254;430;1584;3361;11513;3791;13097
210560;202203;4016;11656;3555;10935;102;393;3054;9282;3156;9675
210565;202203;1577;4746;1315;4374;75;342;1038;3452;1113;3794
210570;202203;11549;30236;10267;28671;324;909;9148;25813;9472;26722
210580;202203;3283;8213;2600;7375;185;482;1834;5511;2019;5993
210590;202203;4580;12936;3954;12161;77;383;3554;10884;3631;11267
210592;202203;2813;7908;2589;7560;26;134;2248;6482;2274;6616
210594;202203;2704;7057;2116;6163;129;344;1573;4749;1702;5093
210596;202203;3033;9811;2708;9243;259;912;2068;7231;2327;8143
210598;202203;2009;5446;1850;5225;84;242;1614;4574;1698;4816
210600;202203;3226;8459;2642;7648;239;626;1849;5419;2088;6045
210610;202203;3162;8003;2717;7473;62;269;2388;6519;2450;6788
210620;202203;3252;7600;2685;6915;128;266;2355;6105;2483;6371
210630;202203;3350;10433;3011;9863;134;574;2491;8080;2625;8654
210632;202203;5432;14937;4808;14106;206;851;4092;11795;4298;12646
210635;202203;1835;6244;1728;6052;128;425;1378;4946;1506;5371
210637;202203;2766;8614;2363;8047;177;707;1801;6230;1978;6937
210640;202203;4967;16554;4643;16176;62;319;4330;15119;4392;15438
210650;202203;7654;21065;6916;20136;122;429;6206;18125;6328;18554
210660;202203;8718;24301;7817;22888;253;1054;6689;19137;6942;20191
210663;202203;3153;7900;2842;7526;237;400;2237;6337;2474;6737
210667;202203;2145;6587;1926;6274;49;174;1679;5602;1728;5776
210670;202203;5372;16247;4853;15451;108;485;4332;13717;4440;14202
210675;202203;5655;14236;4858;13265;378;842;3933;11123;4311;11965
210680;202203;5146;11534;4351;10615;126;208;3973;9782;4099;9990
210690;202203;8234;23771;6838;22204;306;1077;6054;19822;6360;20899
210700;202203;2951;7922;2362;7080;168;495;1757;5415;1925;5910
210710;202203;5510;15841;4863;14979;109;513;4367;13318;4476;13831
210720;202203;3329;10081;2914;9580;88;442;2601;8479;2689;8921
210725;202203;1416;4409;1234;4136;58;216;869;3037;927;3253
210730;202203;1490;3354;1280;3074;56;135;1108;2649;1164;2784
210735;202203;5017;13809;4265;12867;209;562;3662;11361;3871;11923
210740;202203;5604;13930;4809;13033;115;329;4142;11210;4257;11539
210745;202203;4748;12316;4358;11835;64;250;3989;10748;4053;10998
210750;202203;25703;64645;22337;60424;2534;6196;15512;44076;18046;50272
210760;202203;6335;15525;5286;14423;103;203;4959;13733;5062;13936
210770;202203;6768;16208;5814;15129;66;256;5479;14172;5545;14428
210780;202203;8049;23971;7007;22262;482;1570;5580;17838;6062;19408
210790;202203;4821;14003;4306;13332;267;533;3576;11559;3843;12092
210800;202203;5157;13360;4413;12381;76;321;3964;11006;4040;11327
210805;202203;4336;14774;4096;14430;167;682;3574;12636;3741;13318
210810;202203;5218;14499;4747;13903;425;1003;3811;11607;4236;12610
210820;202203;7588;20763;6338;18804;709;2095;4075;12408;4784;14503
210825;202203;7875;22118;7092;21110;398;1062;6087;18492;6485;19554
210830;202203;8704;22890;7860;21883;494;1130;6718;19221;7212;20351
210840;202203;3483;8691;3161;8281;38;174;2875;7415;2913;7589
210845;202203;6822;17672;6016;16789;44;162;5760;16133;5804;16295
210850;202203;6690;20491;5496;18732;322;1257;4379;15045;4701;16302
210860;202203;22792;54302;18903;49619;1101;2363;15352;42064;16453;44427
210870;202203;7988;19348;6387;17555;144;414;5773;15846;5917;16260
210880;202203;4468;13074;4008;12506;202;753;3209;10013;3411;10766
210890;202203;4481;11834;4070;11371;331;763;3356;9568;3687;10331
210900;202203;5183;14192;4072;12237;1547;4798;858;2988;2405;7786
210905;202203;2338;5671;1988;5237;55;95;1837;4919;1892;5014
210910;202203;7639;22465;6324;20405;698;2316;4349;14159;5047;16475
210920;202203;3393;10498;2958;9927;82;408;2662;8852;2744;9260
210923;202203;1761;4809;1500;4417;94;280;1157;3402;1251;3682
210927;202203;5222;16433;4542;15606;524;1722;3283;11795;3807;13517
210930;202203;2661;8425;2326;7806;121;481;1871;6204;1992;6685
210940;202203;4168;11422;3837;11039;92;447;3524;9953;3616;10400
210945;202203;7873;20523;7032;19547;325;812;5907;16904;6232;17716
210950;202203;5793;15065;4506;13319;511;1183;3215;10124;3726;11307
210955;202203;1663;4881;1422;4500;320;935;803;2693;1123;3628
210960;202203;10061;28075;8714;26096;1874;5246;5077;16310;6951;21556
210970;202203;1643;4385;1349;3897;89;290;1091;3070;1180;3360
210975;202203;1969;5613;1779;5328;161;477;1361;4113;1522;4590
210980;202203;10745;23640;9396;22242;110;246;8884;21103;8994;21349
210990;202203;18471;48401;14282;43077;1240;3255;10525;33278;11765;36533
211000;202203;15802;42986;13092;39660;1032;3056;10194;32028;11226;35084
211003;202203;6212;17095;5168;15858;139;507;4501;14088;4640;14595
211010;202203;6821;22647;6095;21750;105;473;5505;19920;5610;20393
211020;202203;9043;24382;7871;23076;227;810;6820;20542;7047;21352
211023;202203;2210;6762;2050;6559;92;332;1756;5587;1848;5919
211027;202203;3602;10123;3421;9850;146;467;3076;8822;3222;9289
211030;202203;4083;10888;3654;10354;305;741;2829;8284;3134;9025
211040;202203;4959;16789;4568;16134;124;651;4092;14385;4216;15036
211050;202203;9852;24015;8928;22849;142;463;8128;20756;8270;21219
211060;202203;7480;21416;6790;20498;166;709;6065;18194;6231;18903
211065;202203;2577;6442;2166;5935;101;263;1860;5161;1961;5424
211070;202203;8769;25446;7509;23625;355;1272;6328;19929;6683;21201
211080;202203;1407;3719;1133;3293;34;184;912;2521;946;2705
211085;202203;2343;6132;1972;5655;148;281;1627;4915;1775;5196
211090;202203;3380;8982;3054;8615;31;152;2839;7967;2870;8119
211100;202203;7130;17447;6600;16827;36;128;6193;15838;6229;15966
211102;202203;3544;10928;3214;10445;266;945;2612;8503;2878;9448
211105;202203;2551;7596;2141;6885;129;458;1620;5137;1749;5595
211107;202203;5165;15511;4411;14420;180;620;3500;11969;3680;12589
211110;202203;6704;16928;5324;14911;303;846;4182;11668;4485;12514
211120;202203;49737;116354;41031;106245;6475;15123;26578;72598;33053;87721
211125;202203;2157;6257;1821;5749;47;211;1553;4896;1600;5107
211130;202203;196595;450944;169533;416408;24942;53478;101180;266971;126122;320449
211140;202203;5282;14945;4613;14104;216;662;3903;12034;4119;12696
211150;202203;10207;26012;8586;23989;359;965;7254;20421;7613;21386
211153;202203;2740;7531;2166;6836;320;970;1419;4743;1739;5713
211157;202203;1315;3854;1119;3494;81;257;812;2536;893;2793
211160;202203;5112;12783;4101;11397;141;553;3312;8889;3453;9442
211163;202203;1672;5168;1514;4946;50;192;1341;4404;1391;4596
211167;202203;1775;5060;1651;4881;24;85;1543;4549;1567;4634
211170;202203;7229;16495;6705;15900;50;142;6403;15100;6453;15242
211172;202203;2788;7335;2411;6805;96;352;1963;5363;2059;5715
211174;202203;3029;8341;2735;8010;34;177;2587;7532;2621;7709
211176;202203;4587;12338;3599;10908;203;743;2923;8824;3126;9567
211178;202203;5616;11623;4849;10814;24;93;4702;10408;4726;10501
211180;202203;4488;13963;4129;13461;171;677;3476;11289;3647;11966
211190;202203;3446;9312;2927;8568;33;185;2667;7724;2700;7909
211195;202203;1622;4148;1399;3821;80;194;1196;3282;1276;3476
211200;202203;2353;6493;1881;5813;195;640;1341;4127;1536;4767
211210;202203;6496;19274;5827;18367;336;1271;4863;15257;5199;16528
211220;202203;42345;100472;34997;91603;3020;7469;26594;70923;29614;78392
211223;202203;5744;14514;4729;13187;486;1364;3337;9393;3823;10757
211227;202203;1857;5753;1635;5447;80;329;1301;4378;1381;4707
211230;202203;8873;23446;7558;21571;356;801;6338;18388;6694;19189
211240;202203;8283;25289;7776;24647;234;907;7087;22414;7321;23321
211245;202203;7842;19493;6854;18456;114;306;6490;17474;6604;17780
211250;202203;15270;43775;13825;41697;1035;3343;11058;33311;12093;36654
211260;202203;8580;26350;7571;25068;200;899;6792;22599;6992;23498
211270;202203;10928;33005;9318;30904;403;1699;7637;25581;8040;27280
211280;202203;15052;36512;13605;34702;617;1405;12064;31071;12681;32476
211285;202203;2104;6319;1889;6037;144;500;1472;4766;1616;5266
211290;202203;7795;22564;7014;21533;287;998;5919;18191;6206;19189
211300;202203;8036;22594;7045;20991;416;1363;5550;16332;5966;17695
211400;202203;12758;33658;10440;30517;1256;3488;7056;21764;8312;25252
220005;202203;2076;5010;1882;4746;29;97;1608;3973;1637;4070
220010;202203;1573;4347;1284;3845;38;132;993;2940;1031;3072
220020;202203;4468;10846;3854;10028;114;381;3312;8472;3426;8853
220025;202203;2480;5256;2139;4766;45;93;1801;3909;1846;4002
220027;202203;1482;3403;1275;3129;28;92;1124;2707;1152;2799
220030;202203;3903;9071;3654;8757;123;311;3200;7592;3323;7903
220040;202203;8108;23343;7057;21413;1380;3865;3989;12638;5369;16503
220045;202203;1756;4769;1471;4322;26;140;1265;3619;1291;3759
220050;202203;5275;13190;4511;12235;63;281;4193;11239;4256;11520
220060;202203;3010;5515;2603;5054;22;47;2485;4784;2507;4831
220070;202203;2609;6336;2202;5762;74;168;1848;4802;1922;4970
220080;202203;820;2225;707;2069;21;84;611;1769;632;1853
220090;202203;1942;4417;1590;3903;86;120;1270;3251;1356;3371
220095;202203;929;1886;879;1836;41;60;788;1669;829;1729
220100;202203;1591;3998;1287;3546;33;117;1073;2854;1106;2971
220105;202203;2293;6545;2011;6063;126;408;1536;4594;1662;5002
220110;202203;3773;9898;3372;9243;38;187;3029;8190;3067;8377
220115;202203;2998;8188;2767;7894;75;223;2529;7208;2604;7431
220117;202203;1540;3476;1216;3041;7;28;1028;2507;1035;2535
220120;202203;15184;36470;13929;34953;73;322;13155;32804;13228;33126
220130;202203;1280;3150;1086;2893;13;68;985;2562;998;2630
220140;202203;2356;4635;1998;4227;58;144;1820;3800;1878;3944
220150;202203;7189;19520;6560;18471;169;623;5602;15472;5771;16095
220155;202203;1312;3530;1061;3082;25;84;775;2189;800;2273
220157;202203;1177;2660;995;2395;40;91;797;1882;837;1973
220160;202203;3098;8089;2660;7321;52;196;2155;5787;2207;5983
220170;202203;1723;4356;1465;3980;23;94;1291;3476;1314;3570
220173;202203;2371;6221;1903;5411;50;199;1510;4193;1560;4392
220177;202203;2322;5925;2211;5801;7;25;2188;5736;2195;5761
220180;202203;1253;2795;1030;2444;5;24;836;1860;841;1884
220190;202203;8421;18697;7231;17140;420;901;5828;14069;6248;14970
220191;202203;1747;4887;1586;4621;102;343;1161;3295;1263;3638
220192;202203;2243;5601;1638;4560;36;123;1327;3619;1363;3742
220194;202203;1944;5114;1719;4776;48;167;1458;3980;1506;4147
220196;202203;2319;5607;2108;5304;25;119;1876;4617;1901;4736
220198;202203;1453;3533;1231;3262;10;21;1136;3028;1146;3049
220200;202203;5541;15420;4837;14512;79;358;4201;12566;4280;12924
220202;202203;2348;6191;2010;5664;38;172;1727;4764;1765;4936
220205;202203;2737;7427;2439;6903;62;246;2077;5772;2139;6018
220207;202203;831;2401;698;2180;60;192;462;1459;522;1651
220208;202203;1900;5466;1541;4807;157;492;988;3082;1145;3574
220209;202203;1723;4709;1479;4278;31;111;1217;3474;1248;3585
220210;202203;2020;4477;1767;4103;20;72;1567;3533;1587;3605
220211;202203;1963;4246;1807;4045;19;73;1607;3542;1626;3615
220213;202203;2024;4984;1735;4504;24;87;1437;3603;1461;3690
220217;202203;2534;6723;2374;6544;69;133;2189;6156;2258;6289
220220;202203;12492;29453;10624;26736;782;1644;7857;20247;8639;21891
220225;202203;1065;2660;858;2399;4;23;802;2225;806;2248
220230;202203;6308;14825;5419;13611;135;312;4771;12008;4906;12320
220240;202203;3422;9299;2938;8493;94;363;2432;6921;2526;7284
220245;202203;2062;4224;1556;3633;14;57;1430;3334;1444;3391
220250;202203;3326;8586;2926;8095;18;88;2753;7568;2771;7656
220253;202203;1813;4560;1546;4147;33;116;1331;3491;1364;3607
220255;202203;2200;4761;1902;4350;33;125;1679;3706;1712;3831
220260;202203;5303;14406;4609;13181;219;652;3693;10511;3912;11163
220265;202203;1573;4494;1432;4316;68;260;1207;3586;1275;3846
220270;202203;6361;19947;5992;19304;196;1037;5046;15738;5242;16775
220271;202203;1604;3936;1403;3659;25;100;1222;3152;1247;3252
220272;202203;1883;5209;1667;4811;54;194;1275;3539;1329;3733
220273;202203;1406;3735;1183;3340;53;183;904;2523;957;2706
220275;202203;2760;5722;2240;5031;30;57;2045;4546;2075;4603
220277;202203;2543;5763;2165;5248;54;131;1831;4359;1885;4490
220280;202203;1993;4117;1670;3718;30;59;1478;3231;1508;3290
220285;202203;1627;3757;1391;3479;11;45;1306;3231;1317;3276
220290;202203;7592;19684;6067;17608;452;1252;4449;13328;4901;14580
220300;202203;2195;5925;1746;5356;32;172;1456;4407;1488;4579
220310;202203;3405;8574;2676;7730;46;190;2312;6632;2358;6822
220320;202203;3369;9193;2626;7882;79;368;2086;6067;2165;6435
220323;202203;1814;4912;1415;4292;59;232;1178;3492;1237;3724
220325;202203;1339;3832;1137;3474;31;142;931;2790;962;2932
220327;202203;1757;4566;1548;4243;49;187;1290;3430;1339;3617
220330;202203;5470;11612;4724;10741;44;148;4382;9868;4426;10016
220335;202203;1942;5302;1765;5066;51;129;1579;4542;1630;4671
220340;202203;2041;5171;1565;4384;65;199;1051;2856;1116;3055
220342;202203;1284;3549;1157;3366;56;170;926;2677;982;2847
220345;202203;3342;7215;2546;6124;24;72;2282;5448;2306;5520
220350;202203;3682;8848;2957;7788;183;397;2122;5651;2305;6048
220360;202203;1377;3390;1092;2927;21;63;886;2336;907;2399
220370;202203;9478;25754;8627;24460;283;902;7382;20833;7665;21735
220375;202203;1795;4729;1580;4465;3;3;1516;4309;1519;4312
220380;202203;1703;3637;1393;3211;14;34;1244;2844;1258;2878
220385;202203;981;2153;809;1865;7;13;714;1624;721;1637
220390;202203;12306;29182;9734;25458;1923;4862;4659;12783;6582;17645
220400;202203;1666;3750;1283;3176;21;75;996;2358;1017;2433
220410;202203;1309;3416;1075;3028;33;100;895;2491;928;2591
220415;202203;913;2226;763;1978;20;43;617;1582;637;1625
220420;202203;2138;5757;1720;4965;63;215;1304;3690;1367;3905
220430;202203;3076;7129;2780;6730;56;154;2491;5930;2547;6084
220435;202203;2101;4903;1816;4477;36;120;1575;3792;1611;3912
220440;202203;3266;8341;2810;7687;64;310;2517;6606;2581;6916
220450;202203;2894;6967;2388;6347;44;170;2115;5580;2159;5750
220455;202203;1409;4115;1350;4038;12;66;1228;3672;1240;3738
220460;202203;1145;2601;1066;2502;29;71;932;2146;961;2217
220465;202203;2580;7485;2271;7024;147;456;1793;5632;1940;6088
220470;202203;4125;10488;3684;9783;165;390;2940;7725;3105;8115
220480;202203;3048;7430;2480;6554;223;444;1708;4544;1931;4988
220490;202203;2734;6401;2345;5926;29;134;2058;5104;2087;5238
220500;202203;3513;8064;2981;7272;114;229;2312;5568;2426;5797
220510;202203;2925;7485;2368;6523;104;254;1920;5313;2024;5567
220515;202203;1916;4248;1777;4059;48;66;1555;3523;1603;3589
220520;202203;5673;13635;5122;12875;108;286;4333;11047;4441;11333
220525;202203;1596;3642;1356;3351;12;40;1248;3073;1260;3113
220527;202203;1610;3855;1394;3553;31;71;1241;3180;1272;3251
220530;202203;1818;3929;1554;3596;115;219;1278;3090;1393;3309
220535;202203;922;2358;856;2260;39;117;687;1778;726;1895
220540;202203;3502;10506;3247;10025;171;546;2691;8299;2862;8845
220545;202203;1591;4448;1459;4251;55;223;1236;3554;1291;3777
220550;202203;9420;27896;8387;26053;439;1572;6440;19652;6879;21224
220551;202203;1600;4120;1417;3830;22;98;1186;3126;1208;3224
220552;202203;1817;4950;1467;4337;24;130;1195;3407;1219;3537
220553;202203;2220;4837;1887;4413;31;64;1691;3962;1722;4026
220554;202203;1034;2448;798;2091;60;135;568;1475;628;1610
220555;202203;3230;7505;2870;7062;38;141;2503;6186;2541;6327
220556;202203;1357;3680;1189;3376;39;167;914;2495;953;2662
220557;202203;1879;5365;1556;4687;109;377;1115;3264;1224;3641
220558;202203;1569;3856;1246;3406;19;84;1061;2837;1080;2921
220559;202203;2005;4607;1711;4161;53;82;1397;3416;1450;3498
220560;202203;1948;4081;1605;3668;33;72;1473;3358;1506;3430
220570;202203;8341;23068;7503;21847;388;1138;6107;17733;6495;18871
220580;202203;7453;19191;6760;18137;95;299;6103;16281;6198;16580
220585;202203;2263;6669;1871;5988;40;133;1561;5001;1601;5134
220590;202203;1599;3942;1314;3535;100;233;990;2690;1090;2923
220595;202203;3044;7488;2751;7118;43;116;2455;6321;2498;6437
220600;202203;1882;3509;1635;3228;31;58;1502;2940;1533;2998
220605;202203;1675;4700;1441;4291;26;135;1185;3417;1211;3552
220610;202203;2964;8188;2769;7908;21;112;2595;7367;2616;7479
220620;202203;8840;25003;8094;24002;139;713;7454;21856;7593;22569
220630;202203;406;1139;319;988;24;78;215;649;239;727
220635;202203;2003;5576;1788;5145;52;210;1445;4037;1497;4247
220640;202203;2594;6899;2224;6388;76;289;1824;5185;1900;5474
220650;202203;2524;6182;2183;5681;110;232;1703;4506;1813;4738
220660;202203;2810;8345;2373;7623;83;366;1972;6240;2055;6606
220665;202203;1369;3895;1164;3568;32;155;990;2964;1022;3119
220667;202203;1800;5143;1627;4838;66;244;1336;3915;1402;4159
220669;202203;1768;4985;1690;4871;44;177;1523;4302;1567;4479
220670;202203;2474;5860;1980;5177;32;113;1729;4500;1761;4613
220672;202203;3657;8421;3011;7649;86;302;2716;6791;2802;7093
220675;202203;1443;3723;1287;3452;44;98;1038;2793;1082;2891
220680;202203;3220;7670;3064;7473;164;268;2754;6868;2918;7136
220690;202203;1742;4316;1514;3971;102;270;1159;3034;1261;3304
220695;202203;1042;2666;968;2541;21;53;833;2173;854;2226
220700;202203;12523;26948;10254;23993;529;1123;8026;18501;8555;19624
220710;202203;985;2527;741;2103;24;77;566;1556;590;1633
220720;202203;2516;5351;2270;5033;22;70;2040;4434;2062;4504
220730;202203;1423;3775;1220;3463;18;88;1040;2884;1058;2972
220735;202203;1125;2409;876;2043;26;66;721;1637;747;1703
220740;202203;1512;3664;1211;3267;42;107;1003;2755;1045;2862
220750;202203;4595;10360;4055;9631;173;369;3643;8643;3816;9012
220755;202203;1642;3562;1381;3188;20;62;1172;2635;1192;2697
220760;202203;3822;8892;3377;8311;61;188;3169;7779;3230;7967
220770;202203;27498;75817;23602;69484;6162;18378;10068;31060;16230;49438
220775;202203;1441;3230;1299;3057;8;31;1259;2933;1267;2964
220777;202203;1744;4212;1358;3627;60;118;1010;2778;1070;2896
220779;202203;1361;3406;1178;3139;28;101;1016;2660;1044;2761
220780;202203;6569;15167;5690;13901;235;681;4640;11095;4875;11776
220785;202203;1644;3387;1451;3149;8;26;1385;2974;1393;3000
220790;202203;11257;29702;10097;28083;219;948;8632;23697;8851;24645
220793;202203;1071;2548;862;2203;12;24;729;1862;741;1886
220795;202203;1524;3692;1351;3464;21;81;1196;3042;1217;3123
220800;202203;22832;45429;19744;41463;1098;1998;15741;32667;16839;34665
220810;202203;3291;8680;2778;7824;61;163;2312;6465;2373;6628
220820;202203;6053;14006;5321;12978;286;580;4352;10596;4638;11176
220830;202203;8018;19788;7149;18582;299;853;5896;15104;6195;15957
220840;202203;13791;38531;11623;34486;2268;6161;6347;19285;8615;25446
220850;202203;3401;9867;3043;9432;67;303;2738;8502;2805;8805
220855;202203;893;1895;786;1762;19;58;717;1584;736;1642
220860;202203;1180;2669;1035;2458;19;69;963;2251;982;2320
220865;202203;2558;6540;1984;5548;57;243;1511;4084;1568;4327
220870;202203;3591;8737;3009;7998;32;140;2783;7346;2815;7486
220880;202203;6458;13504;5651;12514;63;241;5310;11580;5373;11821
220885;202203;1560;4267;1293;3858;69;214;1011;3043;1080;3257
220887;202203;1753;3521;1464;3152;25;39;1351;2910;1376;2949
220890;202203;1533;4363;1338;4092;59;192;1105;3397;1164;3589
220900;202203;2337;5005;1978;4548;34;83;1766;4004;1800;4087
220910;202203;1879;4460;1616;4081;171;285;1246;3317;1417;3602
220915;202203;1040;2657;844;2320;13;50;627;1644;640;1694
220920;202203;1642;4716;1420;4434;74;280;1191;3729;1265;4009
220930;202203;2105;5008;1781;4574;16;62;1673;4263;1689;4325
220935;202203;1186;3269;967;2813;20;84;640;1757;660;1841
220937;202203;1659;4098;1418;3717;41;126;1136;2932;1177;3058
220940;202203;1892;4577;1548;4005;30;132;1273;3172;1303;3304
220945;202203;548;1712;434;1509;21;118;306;1036;327;1154
220950;202203;1540;3387;1042;2646;19;52;833;2025;852;2077
220955;202203;1744;4215;1456;3733;19;65;1260;3194;1279;3259
220960;202203;844;2088;626;1723;39;119;425;1110;464;1229
220965;202203;1963;4980;1715;4631;28;131;1478;3914;1506;4045
220970;202203;2339;4948;1768;4128;20;55;1552;3540;1572;3595
220975;202203;811;2009;697;1874;13;71;626;1625;639;1696
220980;202203;1317;3402;1175;3216;27;95;1008;2726;1035;2821
220985;202203;1534;3549;1336;3259;66;151;1081;2593;1147;2744
220987;202203;1631;4492;1440;4167;56;209;1195;3405;1251;3614
220990;202203;1829;4841;1603;4507;22;119;1360;3760;1382;3879
220995;202203;1398;3616;1155;3199;23;75;922;2509;945;2584
220997;202203;2588;7381;2378;7050;57;222;2120;6205;2177;6427
221000;202203;4978;12651;4365;11794;119;453;3751;10016;3870;10469
221005;202203;1654;4024;1493;3755;22;102;1289;3134;1311;3236
221010;202203;1430;2910;1128;2540;31;53;982;2189;1013;2242
221020;202203;1706;4926;1545;4656;25;101;1217;3639;1242;3740
221030;202203;1796;4082;1537;3772;28;84;1345;3346;1373;3430
221035;202203;1738;4125;1504;3803;21;25;1354;3470;1375;3495
221037;202203;794;2002;669;1793;13;41;501;1273;514;1314
221038;202203;565;1506;435;1284;23;74;301;878;324;952
221039;202203;934;2450;778;2193;29;129;625;1709;654;1838
221040;202203;4797;13034;4185;12002;196;573;3408;9750;3604;10323
221050;202203;4664;10652;4168;10033;95;268;3786;9086;3881;9354
221060;202203;9959;26063;8246;23287;402;1000;6573;18693;6975;19693
221062;202203;1273;3789;1095;3514;49;199;884;2790;933;2989
221063;202203;1256;3193;1091;2962;57;187;885;2342;942;2529
221065;202203;2961;7058;2589;6446;19;63;2297;5637;2316;5700
221070;202203;3695;10746;3010;9352;376;1085;1860;5913;2236;6998
221080;202203;3874;8955;3198;7962;57;201;2689;6536;2746;6737
221090;202203;1565;3680;1296;3276;15;55;1122;2775;1137;2830
221093;202203;1721;4279;1584;4034;163;341;1129;2872;1292;3213
221095;202203;976;2401;806;2154;17;62;672;1765;689;1827
221097;202203;925;2262;705;1894;19;61;535;1362;554;1423
221100;202203;137082;340718;115590;306382;8930;26957;81688;208417;90618;235374
221110;202203;10974;30492;10047;29300;146;720;9148;26415;9294;27135
221120;202203;5251;14114;4682;13269;132;418;4118;11670;4250;12088
221130;202203;6287;14810;4902;12341;711;1729;2979;7290;3690;9019
221135;202203;2196;4867;1946;4556;57;117;1680;4032;1737;4149
221140;202203;1577;3323;1334;3026;25;63;1212;2701;1237;2764
221150;202203;1213;2862;958;2434;25;119;753;1792;778;1911
221160;202203;810;1916;717;1801;40;62;563;1440;603;1502
221170;202203;1112;2939;1023;2785;7;26;909;2419;916;2445
230010;202203;3361;8315;2785;7351;37;132;2308;5909;2345;6041
230015;202203;3562;10611;3157;9815;179;637;2246;6942;2425;7579
230020;202203;14725;43192;13822;41879;484;1837;12018;36165;12502;38002
230030;202203;13773;32868;11565;30025;306;848;9958;25821;10264;26669
230040;202203;4908;11898;4087;10588;55;237;3478;8851;3533;9088
230050;202203;2877;8578;2232;7161;288;950;1088;3307;1376;4257
230060;202203;2684;6834;2137;5897;37;153;1714;4606;1751;4759
230070;202203;4809;11466;3865;9831;448;1001;2536;6542;2984;7543
230075;202203;10070;29898;9195;28433;520;1922;7384;22510;7904;24432
230080;202203;3431;6722;2637;5767;7;18;2450;5344;2457;5362
230090;202203;4993;11336;4223;10162;166;420;3506;8290;3672;8710
230100;202203;22109;51650;19375;48133;1402;3546;14389;35578;15791;39124
230110;202203;14010;39541;11765;35298;1662;5121;6603;19708;8265;24829
230120;202203;8862;21878;7770;20208;431;1155;6044;15564;6475;16719
230125;202203;3482;8665;2831;7677;91;325;2248;5911;2339;6236
230130;202203;6336;18104;5192;15721;415;1226;3523;10573;3938;11799
230140;202203;3812;10769;3234;9634;97;450;2530;7275;2627;7725
230150;202203;1798;5001;1494;4385;176;490;936;2760;1112;3250
230160;202203;7560;17406;6542;15946;133;402;5670;13523;5803;13925
230170;202203;7021;18870;5740;16344;418;1145;4056;11400;4474;12545
230180;202203;1819;4717;1537;4197;19;84;1260;3315;1279;3399
230185;202203;4937;12977;4194;11781;308;910;3120;8826;3428;9736
230190;202203;15710;43720;13208;39196;1364;4253;8173;23866;9537;28119
230195;202203;6109;16641;5551;15684;345;973;4304;12105;4649;13078
230200;202203;5283;13991;4394;12396;193;602;3373;9322;3566;9924
230205;202203;4805;12687;4208;11859;237;748;3347;9260;3584;10008
230210;202203;11925;25869;10162;23592;456;1108;8198;18619;8654;19727
230220;202203;16297;37912;14358;35216;739;1843;11873;28753;12612;30596
230230;202203;7867;21261;7077;19755;449;1240;5463;15081;5912;16321
230240;202203;14588;36217;12546;32833;401;1354;10302;26300;10703;27654
230250;202203;9708;25541;8972;24453;254;849;7259;19155;7513;20004
230260;202203;16603;45150;14398;41466;2229;6196;8377;24518;10606;30714
230270;202203;8414;21034;6514;17659;729;1759;4041;11315;4770;13074
230280;202203;21803;54931;17989;48767;442;1895;14435;37463;14877;39358
230290;202203;5429;14093;4517;12444;188;531;3574;9681;3762;10212
230300;202203;5310;13316;4784;12611;94;274;4247;11167;4341;11441
230310;202203;5142;13928;4344;12532;177;621;3121;8808;3298;9429
230320;202203;8554;23436;7150;20986;253;1043;5579;15969;5832;17012
230330;202203;5264;13480;4160;11451;137;484;3180;8489;3317;8973
230340;202203;4195;12247;3622;11130;202;720;2644;7907;2846;8627
230350;202203;20316;51402;17794;47868;849;2734;12955;34350;13804;37084
230360;202203;3293;8164;2607;7007;147;400;1886;5000;2033;5400
230365;202203;3434;7801;2836;6947;68;253;2439;5897;2507;6150
230370;202203;71193;178505;61462;164984;5288;15551;44229;116283;49517;131834
230380;202203;6950;18140;5511;15556;134;535;4157;11338;4291;11873
230390;202203;3698;10248;3180;9438;94;403;2507;7309;2601;7712
230393;202203;3736;10162;2971;8659;97;513;2341;6510;2438;7023
230395;202203;6229;16335;5377;14936;456;1230;3718;10339;4174;11569
230400;202203;6098;15627;5354;14473;95;466;4331;11263;4426;11729
230410;202203;14348;40910;11861;36522;876;2939;8287;25546;9163;28485
230420;202203;32554;83897;26877;74583;2722;7936;16609;45140;19331;53076
230423;202203;5140;14432;4505;13239;278;899;3363;9725;3641;10624
230425;202203;6353;18330;5818;17326;513;1555;4190;12385;4703;13940
230426;202203;3039;7538;2240;6068;46;180;1702;4473;1748;4653
230427;202203;2037;5410;1491;4336;115;363;875;2387;990;2750
230428;202203;10921;27665;9403;25503;1396;3736;5588;14975;6984;18711
230430;202203;5391;14376;4287;12485;158;586;3251;9252;3409;9838
230435;202203;6973;16693;5804;14720;727;1723;3599;9144;4326;10867
230440;202203;493864;1127787;419368;1024217;29199;79076;304205;722184;333404;801260
230445;202203;4563;11760;3706;10305;219;622;2539;6864;2758;7486
230450;202203;4022;10787;3516;10074;209;832;2664;7362;2873;8194
230460;202203;2305;6054;1995;5569;60;242;1681;4614;1741;4856
230465;202203;4639;12104;3920;10762;132;456;3015;7949;3147;8405
230470;202203;12248;38072;11024;35914;803;3206;8018;25563;8821;28769
230480;202203;1639;4442;1370;3969;70;292;1041;2868;1111;3160
230490;202203;3024;7840;2575;7030;198;618;1722;4399;1920;5017
230495;202203;6538;17583;5761;16271;707;1966;3610;10260;4317;12226
230500;202203;9977;30526;8815;28457;317;1291;7153;23057;7470;24348
230510;202203;1873;4992;1494;4238;153;454;891;2428;1044;2882
230520;202203;5232;13491;4528;12329;429;999;3200;8716;3629;9715
230523;202203;17246;48481;13885;41721;3056;9028;4177;12952;7233;21980
230526;202203;4270;11086;3646;10081;244;622;2656;7481;2900;8103
230530;202203;6092;18043;5133;16278;768;2450;3297;10501;4065;12951
230533;202203;5227;11070;4222;9583;74;198;3618;7979;3692;8177
230535;202203;5606;15079;4751;13674;348;1098;3204;9208;3552;10306
230540;202203;16939;44550;14509;40972;343;1242;12005;33627;12348;34869
230550;202203;24151;59156;19666;51931;1458;4048;13670;35190;15128;39238
230560;202203;8672;20043;7056;17600;123;335;6035;15030;6158;15365
230565;202203;3373;8841;2817;7842;114;414;2212;6017;2326;6431
230570;202203;3665;8968;3115;8220;83;258;2579;6740;2662;6998
230580;202203;12934;30404;11142;27917;542;1139;9169;23059;9711;24198
230590;202203;10198;27179;8496;24226;520;1595;6325;17628;6845;19223
230600;202203;4166;9879;3279;8394;140;325;2254;5819;2394;6144
230610;202203;7426;19084;6604;17731;415;1189;5323;14152;5738;15341
230620;202203;2289;5848;1799;4944;101;327;1167;3064;1268;3391
230625;202203;9827;25473;8413;23036;1946;5471;3676;9983;5622;15454
230630;202203;12909;33894;11380;31143;1178;2971;7758;21339;8936;24310
230640;202203;29814;85809;26988;81334;1166;4754;22100;65202;23266;69956
230650;202203;5854;14751;4958;13279;121;522;4126;10674;4247;11196
230655;202203;10181;32116;9560;31114;610;2142;7933;25853;8543;27995
230660;202203;6499;18505;5267;16352;176;881;4257;12935;4433;13816
230670;202203;6792;15161;4959;12349;158;433;3956;9568;4114;10001
230680;202203;3042;7721;2554;6895;150;333;1835;4985;1985;5318
230690;202203;7722;21705;6594;19592;398;1374;4384;12773;4782;14147
230700;202203;11572;27358;9344;23435;493;1212;7019;17228;7512;18440
230710;202203;7452;22398;6549;20551;578;1829;4565;14212;5143;16041
230720;202203;2103;5876;1741;5218;114;349;1226;3606;1340;3955
230725;202203;4897;13332;4417;12542;374;1213;3014;8336;3388;9549
230730;202203;65268;163607;51671;144075;11511;31928;19315;57720;30826;89648
230740;202203;6675;17680;5637;16043;177;566;4522;12840;4699;13406
230750;202203;9196;23325;7629;20785;169;637;6154;16289;6323;16926
230760;202203;12584;31030;10945;28616;451;1485;8437;21411;8888;22896
230763;202203;5434;13876;4503;12298;109;493;3666;9666;3775;10159
230765;202203;45898;116974;38552;105763;4604;13525;23016;61368;27620;74893
230770;202203;30969;67214;26347;61392;1973;4607;19876;45591;21849;50198
230780;202203;7107;23417;6457;21943;825;2805;3955;13672;4780;16477
230790;202203;3358;8970;3010;8440;117;473;2356;6337;2473;6810
230800;202203;9374;27511;8240;25343;1052;3302;4937;14913;5989;18215
230810;202203;11851;34223;10582;32200;455;1698;8285;24716;8740;26414
230820;202203;3911;11838;3259;10500;284;1110;2093;6389;2377;7499
230830;202203;8387;21437;7141;19456;145;581;5972;15785;6117;16366
230835;202203;4563;10345;3567;8848;120;308;2875;7026;2995;7334
230837;202203;3656;9922;3272;9294;103;387;2718;7529;2821;7916
230840;202203;10563;28872;9126;26484;741;2119;6835;19716;7576;21835
230850;202203;10992;29169;9263;26007;442;1389;7000;19289;7442;20678
230860;202203;6450;14297;5404;12848;74;209;4821;11278;4895;11487
230870;202203;18735;41822;16161;37696;612;1459;13265;30396;13877;31855
230880;202203;2257;6473;2069;6180;53;252;1651;4799;1704;5051
230890;202203;4868;14668;4429;13875;278;959;3316;10233;3594;11192
230900;202203;3479;9304;3010;8454;158;555;2168;5833;2326;6388
230910;202203;3583;8862;2840;7756;69;263;2303;6266;2372;6529
230920;202203;5348;13901;4419;12434;116;463;3475;9496;3591;9959
230930;202203;7581;19901;6275;17644;297;864;4407;12203;4704;13067
230940;202203;9123;21414;7961;19722;165;428;6858;16829;7023;17257
230945;202203;7106;19265;6057;17382;296;1030;4414;12296;4710;13326
230950;202203;6837;16185;6052;15144;131;323;5242;13137;5373;13460
230960;202203;14816;40088;13009;36877;2018;5751;6896;19277;8914;25028
230970;202203;16584;40954;14185;37404;1311;3616;9626;24845;10937;28461
230980;202203;3335;8409;2918;7727;315;754;1982;5376;2297;6130
230990;202203;1830;4868;1516;4267;71;259;1099;2955;1170;3214
231000;202203;2830;7187;2276;6139;76;233;1718;4456;1794;4689
231010;202203;4331;8869;3469;7509;19;97;3133;6560;3152;6657
231020;202203;9332;26385;8321;24578;1071;2939;5421;16321;6492;19260
231025;202203;8622;21589;7571;19948;556;1400;5839;15303;6395;16703
231030;202203;8087;22750;6370;19329;867;2566;3604;10917;4471;13483
231040;202203;3321;8607;2872;7828;77;265;2369;6241;2446;6506
231050;202203;13274;31395;10947;27520;484;1321;8557;20836;9041;22157
231060;202203;3191;8346;2848;7823;79;286;2308;6370;2387;6656
231070;202203;8854;24051;7635;21964;591;1861;5350;15106;5941;16967
231080;202203;4290;11485;3604;10381;171;665;2724;7698;2895;8363
231085;202203;7725;17449;6214;15709;229;545;5027;12703;5256;13248
231090;202203;4887;12148;3657;9860;131;501;2550;6580;2681;7081
231095;202203;2433;6924;1945;5931;187;571;1296;3942;1483;4513
231100;202203;3422;9405;2829;8329;116;435;2153;6243;2269;6678
231110;202203;4089;11247;3771;10692;234;705;2798;7755;3032;8460
231120;202203;2632;7093;2208;6389;105;335;1640;4693;1745;5028
231123;202203;2087;5191;1729;4585;93;254;1240;3245;1333;3499
231126;202203;6089;15727;5024;13782;285;746;3677;9981;3962;10727
231130;202203;25092;58000;20948;52925;1198;3677;16259;40012;17457;43689
231135;202203;4593;12221;3813;10775;186;590;2743;7640;2929;8230
231140;202203;18288;48834;14853;43194;707;2746;10940;30860;11647;33606
231150;202203;6583;16877;4833;13572;704;2009;2089;5954;2793;7963
231160;202203;7260;20610;6477;19197;743;1981;4027;12223;4770;14204
231170;202203;5128;13694;4279;12153;266;841;3081;8411;3347;9252
231180;202203;16416;43575;13456;37745;2354;6617;6656;18455;9010;25072
231190;202203;4466;11783;3593;10244;96;369;2774;7733;2870;8102
231195;202203;5572;15679;4622;13825;299;1005;3405;10065;3704;11070
231200;202203;8835;24704;7712;22598;182;889;6340;17877;6522;18766
231210;202203;5377;14686;4570;13364;168;668;3586;10193;3754;10861
231220;202203;14490;33867;11515;28627;490;1275;8717;20838;9207;22113
231230;202203;10173;30763;8995;28653;684;2390;6680;21214;7364;23604
231240;202203;12999;35839;11519;33229;1512;4334;7427;21381;8939;25715
231250;202203;2291;5517;1541;3968;97;240;950;2369;1047;2609
231260;202203;3557;9281;3100;8582;295;722;2181;6158;2476;6880
231270;202203;7028;17301;5717;15200;161;607;4384;11262;4545;11869
231280;202203;1907;5577;1709;5240;122;332;1244;3830;1366;4162
231290;202203;41140;116272;34684;104270;4827;14831;18405;54072;23232;68903
231300;202203;4559;11845;3595;10002;124;425;2531;6795;2655;7220
231310;202203;8418;20199;6783;17314;505;1340;4820;11959;5325;13299
231320;202203;8024;21363;6291;18332;113;451;4963;14345;5076;14796
231325;202203;2769;6674;2283;5982;175;374;1664;4404;1839;4778
231330;202203;11181;30706;9419;27416;1480;3885;5612;16858;7092;20743
231335;202203;6016;15314;5064;13834;91;393;4412;11906;4503;12299
231340;202203;20431;58347;18448;55020;1248;3819;14168;42514;15416;46333
231350;202203;17481;44993;15993;42896;287;1050;14507;38521;14794;39571
231355;202203;4907;13489;4418;12615;203;680;3569;9994;3772;10674
231360;202203;8765;24541;7619;22650;338;1121;6114;17949;6452;19070
231370;202203;2345;6179;1888;5380;48;153;1451;4100;1499;4253
231375;202203;4484;13350;4037;12610;110;481;3391;10464;3501;10945
231380;202203;6444;16534;5792;15656;172;501;4848;13139;5020;13640
231390;202203;3761;10282;3364;9627;119;495;2565;7087;2684;7582
231395;202203;4627;12590;3881;11443;281;852;2699;7848;2980;8700
231400;202203;10623;29055;8900;25941;313;1336;6862;19466;7175;20802
231410;202203;16501;47225;15060;44994;724;2327;12325;36747;13049;39074
240010;202203;2856;7068;2255;6031;299;772;1209;3206;1508;3978
240020;202203;14579;37585;12238;33577;786;2469;8390;22475;9176;24944
240030;202203;3864;7971;3490;7439;112;294;3121;6485;3233;6779
240040;202203;890;2453;752;2204;25;104;512;1428;537;1532
240050;202203;3722;9459;2967;8110;59;192;2287;6113;2346;6305
240060;202203;1593;3967;1297;3433;32;108;1041;2687;1073;2795
240070;202203;2751;7241;2447;6632;181;522;1799;4701;1980;5223
240080;202203;3201;8210;2556;7096;91;322;1901;5195;1992;5517
240090;202203;2458;5744;2014;5022;21;59;1711;4183;1732;4242
240100;202203;12050;26951;9739;23093;215;691;7910;17951;8125;18642
240110;202203;5033;13531;4237;12106;174;661;3191;8827;3365;9488
240120;202203;3783;9990;3161;9220;217;689;2329;6786;2546;7475
240130;202203;4313;8137;3534;7147;39;89;3200;6388;3239;6477
240140;202203;1976;5692;1688;5173;193;654;1105;3338;1298;3992
240145;202203;7453;19601;6113;17382;752;2235;3883;10917;4635;13152
240150;202203;1110;2948;966;2664;55;185;747;1996;802;2181
240160;202203;1609;4509;1344;4024;33;136;1032;3066;1065;3202
240165;202203;1073;2748;901;2436;26;98;755;1988;781;2086
240170;202203;3061;7526;2582;6720;295;751;1702;4397;1997;5148
240180;202203;3351;9439;2722;8198;613;1761;1238;3910;1851;5671
240185;202203;1420;4123;1299;3925;48;201;1057;3103;1105;3304
240190;202203;1220;3215;1039;2939;19;87;873;2462;892;2549
240200;202203;13186;30596;10728;26596;1185;2923;6537;15771;7722;18694
240210;202203;3735;8415;3059;7362;39;179;2646;6118;2685;6297
240220;202203;8062;23211;7234;21935;433;1641;5753;17280;6186;18921
240230;202203;6459;15422;5145;13304;236;591;3983;10355;4219;10946
240240;202203;1939;5372;1311;3997;143;455;451;1230;594;1685
240250;202203;3409;8203;2963;7580;53;199;2597;6520;2650;6719
240260;202203;15305;42960;13249;39623;3468;9815;6589;21187;10057;31002
240270;202203;2599;7262;2252;6684;115;363;1686;5098;1801;5461
240280;202203;1866;4500;1553;3996;68;184;1232;3128;1300;3312
240290;202203;1282;3562;1051;3092;36;159;759;2101;795;2260
240300;202203;2509;6115;1839;4937;105;290;1146;3011;1251;3301
240310;202203;9212;23486;7341;20249;906;2514;3941;10723;4847;13237
240320;202203;2185;5708;1600;4602;76;264;1142;3143;1218;3407
240325;202203;36701;91542;30005;80580;4126;11927;16533;43009;20659;54936
240330;202203;1974;5093;1529;4283;56;203;1085;2911;1141;3114
240340;202203;2296;4775;1872;4166;34;90;1592;3423;1626;3513
240350;202203;2685;6033;2396;5708;36;121;2235;5283;2271;5404
240360;202203;11760;29880;10512;28020;1435;3437;7002;19072;8437;22509
240370;202203;2384;5507;1854;4550;90;238;1346;3144;1436;3382
240375;202203;1029;2465;860;2183;30;104;689;1676;719;1780
240380;202203;2504;6617;1938;5442;192;511;1093;3033;1285;3544
240390;202203;1121;2585;813;2034;30;68;532;1232;562;1300
240400;202203;1651;3797;1260;3158;45;152;899;2104;944;2256
240410;202203;633;1787;519;1570;43;150;334;972;377;1122
240420;202203;5206;16736;4632;15610;423;1787;3083;10031;3506;11818
240430;202203;3943;9389;3286;8295;124;432;2587;6259;2711;6691
240440;202203;2953;6233;2549;5681;168;334;2030;4515;2198;4849
240450;202203;4895;12719;3890;10923;344;1102;2358;6324;2702;7426
240460;202203;3675;9188;3299;8605;245;636;2705;7074;2950;7710
240470;202203;3848;11170;2933;9298;513;1532;1492;4921;2005;6453
240480;202203;643;1656;429;1202;27;73;218;575;245;648
240485;202203;2408;6353;1939;5540;142;414;1323;3786;1465;4200
240490;202203;1774;4231;1386;3559;82;170;998;2577;1080;2747
240500;202203;2283;5983;1972;5460;104;293;1577;4349;1681;4642
240510;202203;1813;4668;1561;4290;73;238;1257;3404;1330;3642
240520;202203;1769;3837;1348;3280;91;194;1037;2565;1128;2759
240530;202203;2653;6611;2379;6181;82;229;2029;5150;2111;5379
240540;202203;2583;5953;2293;5522;52;146;2034;4866;2086;5012
240550;202203;872;2136;781;1978;15;60;689;1702;704;1762
240560;202203;3814;8821;3263;8104;177;420;2642;6525;2819;6945
240570;202203;3019;7606;2068;5613;306;823;762;1964;1068;2787
240580;202203;9203;25190;8137;23341;584;1689;6558;18823;7142;20512
240590;202203;915;2039;797;1859;8;22;655;1488;663;1510
240600;202203;1987;5081;1478;4090;53;167;1015;2673;1068;2840
240610;202203;4962;12128;4285;10967;171;491;3335;8266;3506;8757
240615;202203;1388;3406;1119;2961;99;260;809;2076;908;2336
240620;202203;2018;5297;1737;4832;84;270;1426;3931;1510;4201
240630;202203;2391;6007;2149;5621;266;474;1501;4156;1767;4630
240640;202203;1035;2592;817;2235;27;96;622;1651;649;1747
240650;202203;4516;12145;3828;10802;276;772;2760;7739;3036;8511
240660;202203;3637;8273;3269;7800;52;157;3036;7174;3088;7331
240670;202203;2783;7224;2229;6152;154;465;1525;4056;1679;4521
240680;202203;1749;4292;1409;3726;51;167;1102;2804;1153;2971
240690;202203;1253;2857;983;2411;27;104;805;1874;832;1978
240700;202203;2661;7379;2156;6479;100;337;1629;4850;1729;5187
240710;202203;19203;45363;16398;40887;1528;3856;11621;28329;13149;32185
240720;202203;5778;13591;4963;12457;515;1258;3484;8771;3999;10029
240725;202203;1240;3353;949;2820;48;148;636;1831;684;1979
240730;202203;2528;6574;2018;5630;62;200;1556;4262;1618;4462
240740;202203;2087;5380;1678;4578;63;217;1202;3092;1265;3309
240750;202203;2466;7610;2089;6813;257;906;1217;3986;1474;4892
240760;202203;1877;4006;1364;3249;84;125;1070;2585;1154;2710
240770;202203;3595;9303;3021;8514;120;427;2516;6989;2636;7416
240780;202203;5401;14179;4526;12762;616;1687;2910;8295;3526;9982
240790;202203;992;2604;815;2302;21;90;630;1708;651;1798
240800;202203;58606;129688;46767;112544;5202;12674;28605;66614;33807;79288
240810;202203;104754;252156;90271;229675;7953;21746;64161;158981;72114;180727
240820;202203;6560;18393;5733;16954;677;2030;3740;11170;4417;13200
240830;202203;9547;25855;8400;24159;336;1227;6853;19484;7189;20711
240840;202203;1189;2831;964;2491;37;94;685;1719;722;1813
240850;202203;1580;4068;1123;3138;98;281;639;1701;737;1982
240860;202203;1548;3774;1180;3144;35;114;921;2370;956;2484
240870;202203;1186;2848;899;2374;138;361;503;1355;641;1716
240880;202203;1399;4225;1220;3880;98;388;906;2826;1004;3214
240890;202203;5212;13181;4092;11170;453;1369;2387;6120;2840;7489
240895;202203;3177;9119;2899;8677;258;730;2271;6971;2529;7701
240910;202203;3866;9809;3250;8743;65;234;2670;6995;2735;7229
240920;202203;1118;2668;905;2351;84;158;572;1527;656;1685
240930;202203;4005;8603;3302;7741;220;341;2403;6024;2623;6365
240933;202203;1784;4199;1498;3800;38;153;1314;3256;1352;3409
240940;202203;7386;16675;5875;14235;684;1606;3669;8588;4353;10194
240950;202203;1206;3385;1048;3098;44;180;854;2435;898;2615
240960;202203;732;2111;659;1968;15;57;529;1539;544;1596
240970;202203;2107;5026;1709;4391;66;235;1414;3521;1480;3756
240980;202203;3981;10417;3577;9754;84;362;3068;8116;3152;8478
240990;202203;2983;7628;2642;7025;216;690;1975;5004;2191;5694
241000;202203;1050;2569;814;2155;16;51;623;1578;639;1629
241010;202203;3213;9398;2910;8793;156;580;2268;6697;2424;7277
241020;202203;2349;5912;1788;4840;94;291;1275;3290;1369;3581
241025;202203;1895;5182;1535;4566;50;211;1133;3284;1183;3495
241030;202203;2673;8084;2159;7039;229;703;1401;4589;1630;5292
241040;202203;2355;7087;2053;6580;78;366;1585;5059;1663;5425
241050;202203;1536;4061;1241;3535;37;129;908;2524;945;2653
241060;202203;884;2307;766;2074;39;109;535;1403;574;1512
241070;202203;773;1940;641;1731;17;48;500;1308;517;1356
241080;202203;1236;3353;959;2791;33;110;680;1953;713;2063
241090;202203;2250;6068;1817;5324;80;339;1393;3964;1473;4303
241100;202203;1318;3429;1003;2813;42;107;676;1833;718;1940
241105;202203;1060;3049;862;2689;191;651;375;1164;566;1815
241110;202203;1060;2815;796;2265;53;153;510;1376;563;1529
241120;202203;8143;22119;6856;19955;843;2409;4295;12806;5138;15215
241140;202203;3680;9276;2841;7648;122;379;2109;5493;2231;5872
241142;202203;856;2211;643;1835;29;95;399;1084;428;1179
241150;202203;6474;15801;5717;14648;220;541;4574;11628;4794;12169
241160;202203;1357;3506;1062;2986;163;506;610;1622;773;2128
241170;202203;1486;3614;1252;3216;34;111;1031;2544;1065;2655
241180;202203;1154;2781;850;2228;84;230;449;1118;533;1348
241190;202203;1300;3172;1094;2789;15;55;803;1959;818;2014
241200;202203;24245;57638;21331;53107;2381;6159;14375;34783;16756;40942
241210;202203;1659;4132;1218;3320;104;308;726;1937;830;2245
241220;202203;10301;27810;9094;25872;1736;4918;4811;14000;6547;18918
241230;202203;3171;7944;2805;7391;110;310;2333;6088;2443;6398
241240;202203;1353;3606;867;2592;99;309;300;871;399;1180
241250;202203;6358;16722;5117;14548;185;809;3931;10703;4116;11512
241255;202203;2769;7741;2438;7107;124;466;1865;5275;1989;5741
241260;202203;5440;13360;4373;11652;130;445;3540;9206;3670;9651
241270;202203;1788;4973;1490;4416;125;379;1039;3064;1164;3443
241280;202203;2681;5871;2330;5270;74;180;2003;4446;2077;4626
241290;202203;3615;8387;2668;6910;74;225;2107;5311;2181;5536
241300;202203;1658;4227;1344;3699;36;130;908;2411;944;2541
241310;202203;2477;5567;2144;5108;70;122;1876;4498;1946;4620
241320;202203;1063;3252;914;2974;99;355;581;1878;680;2233
241330;202203;1958;4688;1553;4158;17;72;1369;3640;1386;3712
241335;202203;3890;10113;3419;9298;120;383;2835;7583;2955;7966
241340;202203;1776;4627;1418;3946;191;610;755;1970;946;2580
241350;202203;2396;6125;2080;5575;123;330;1616;4274;1739;4604
241355;202203;1510;3817;1226;3288;36;88;925;2444;961;2532
241360;202203;2263;5541;1696;4448;61;172;1254;3174;1315;3346
241370;202203;1525;3875;1200;3229;79;246;849;2171;928;2417
241380;202203;781;1955;618;1674;68;175;338;896;406;1071
241390;202203;2941;8147;2606;7654;166;503;2039;6015;2205;6518
241400;202203;4057;10562;3589;9886;199;624;2836;7724;3035;8348
241410;202203;2720;7627;2216;6637;236;741;1380;4104;1616;4845
241415;202203;2006;5189;1693;4611;50;188;1347;3530;1397;3718
241420;202203;2956;8268;2634;7735;402;1340;1709;4941;2111;6281
241430;202203;752;1835;497;1338;18;45;333;847;351;892
241440;202203;8902;25489;7992;23936;322;1111;6460;19169;6782;20280
241445;202203;1499;3285;1314;3044;47;77;1169;2749;1216;2826
241450;202203;3166;7164;2658;6374;274;585;1968;4739;2242;5324
241460;202203;4317;10981;3487;9334;218;601;2444;6319;2662;6920
241470;202203;1535;3900;1263;3487;34;113;1060;2913;1094;3026
241475;202203;1363;3513;1074;2995;26;109;816;2158;842;2267
241480;202203;3305;9695;2727;8491;746;2268;1019;3467;1765;5735
241490;202203;810;1734;604;1443;13;35;470;1091;483;1126
241500;202203;824;2228;750;2142;3;10;709;2041;712;2051
250010;202203;2866;8135;2389;7169;65;256;1774;5182;1839;5438
250020;202203;1805;4503;1344;3664;75;148;983;2672;1058;2820
250030;202203;7465;19690;6558;18328;630;1892;4890;13445;5520;15337
250040;202203;4999;13525;4387;12478;462;1361;3133;8754;3595;10115
250050;202203;4024;10103;3630;9607;153;455;3112;8210;3265;8665
250053;202203;1420;3698;1294;3515;104;262;953;2572;1057;2834
250057;202203;775;2398;708;2299;8;44;646;2105;654;2149
250060;202203;6250;15160;5619;14379;309;783;4724;12071;5033;12854
250070;202203;4372;11549;3658;10370;49;207;2968;8200;3017;8407
250073;202203;879;2170;720;1917;12;35;585;1526;597;1561
250077;202203;2791;6498;2176;5552;39;139;1799;4466;1838;4605
250080;202203;5955;13266;5020;12113;56;226;4532;10772;4588;10998
250090;202203;3916;8602;3428;7980;71;196;3017;6882;3088;7078
250100;202203;3821;11055;3441;10401;135;547;2748;8084;2883;8631
250110;202203;5323;14084;4826;13408;288;949;3771;10374;4059;11323
250115;202203;830;1895;627;1592;14;52;498;1231;512;1283
250120;202203;2086;5693;1753;5154;32;157;1420;4111;1452;4268
250130;202203;6399;15552;5437;14246;77;358;4742;12169;4819;12527
250135;202203;1469;3663;1288;3354;32;88;1115;2886;1147;2974
250140;202203;2447;6766;2267;6547;94;344;1981;5715;2075;6059
250150;202203;5178;15226;4662;14395;169;688;3798;11480;3967;12168
250153;202203;1536;3840;1265;3447;47;126;1008;2730;1055;2856
250157;202203;2200;5732;1953;5332;64;229;1600;4273;1664;4502
250160;202203;4287;10033;3443;8906;94;241;2962;7660;3056;7901
250170;202203;2095;5086;1893;4812;32;110;1655;4128;1687;4238
250180;202203;23884;53019;20515;48834;705;2220;16884;38903;17589;41123
250190;202203;4710;11593;3985;10576;337;866;2905;7622;3242;8488
250200;202203;2742;5761;2377;5298;53;135;2127;4636;2180;4771
250205;202203;940;2797;800;2573;15;63;639;2049;654;2112
250210;202203;1621;4688;1452;4430;50;243;1159;3447;1209;3690
250215;202203;1788;4608;1510;4229;103;323;882;2500;985;2823
250220;202203;714;1909;566;1681;31;118;387;1126;418;1244
250230;202203;1831;3957;1298;3192;21;73;1044;2501;1065;2574
250240;202203;2916;7628;2586;7072;35;149;2280;6135;2315;6284
250250;202203;5114;13211;4489;12358;185;465;3724;10477;3909;10942
250260;202203;1805;4846;1522;4349;53;146;1201;3430;1254;3576
250270;202203;1338;3806;1224;3666;75;242;923;2859;998;3101
250280;202203;4240;10011;3807;9431;205;406;3003;7525;3208;7931
250290;202203;1818;4423;1559;4037;19;61;1272;3219;1291;3280
250300;202203;6313;15223;5703;14507;144;625;4960;12196;5104;12821
250310;202203;1306;3456;1083;3099;46;144;809;2298;855;2442
250320;202203;14287;29597;12461;27555;184;525;11479;25009;11663;25534
250330;202203;2854;7096;2419;6511;96;302;2073;5473;2169;5775
250340;202203;1359;3098;1200;2892;11;39;1100;2624;1111;2663
250350;202203;4400;11794;3859;10881;289;656;3043;8805;3332;9461
250355;202203;2372;6309;2122;5994;25;120;1953;5500;1978;5620
250360;202203;2016;5097;1806;4823;38;148;1554;4070;1592;4218
250370;202203;15755;37146;13199;33396;253;850;11401;28250;11654;29100
250375;202203;1443;3270;1186;2969;5;20;1118;2806;1123;2826
250380;202203;1902;4358;1751;4177;30;107;1589;3687;1619;3794
250390;202203;2049;4943;1726;4446;80;195;1404;3597;1484;3792
250400;202203;77983;184668;59281;156579;16581;44659;18724;53165;35305;97824
250403;202203;2212;5374;1965;5100;48;268;1640;4053;1688;4321
250407;202203;1532;3397;1178;2871;128;239;766;2008;894;2247
250410;202203;785;1939;677;1763;9;32;566;1420;575;1452
250415;202203;2054;5405;1797;5021;39;149;1545;4282;1584;4431
250420;202203;1308;3410;1171;3227;17;47;1076;2966;1093;3013
250430;202203;7472;16797;6406;15405;250;593;5303;12474;5553;13067
250435;202203;1759;4695;1409;4121;19;87;1072;3058;1091;3145
250440;202203;5016;12744;4352;11903;83;230;3851;10475;3934;10705
250450;202203;2007;4955;1657;4479;63;155;1330;3663;1393;3818
250460;202203;8064;20671;7132;19385;441;1235;5679;15414;6120;16649
250470;202203;1797;4315;1477;3824;48;136;1187;2981;1235;3117
250480;202203;4270;11188;3608;10386;42;148;3210;9300;3252;9448
250485;202203;782;1694;594;1437;58;106;410;976;468;1082
250490;202203;5585;12561;4962;11862;106;365;4507;10568;4613;10933
250500;202203;2211;5804;1967;5394;56;182;1631;4416;1687;4598
250510;202203;6108;14202;5242;13049;96;207;4562;11433;4658;11640
250520;202203;2106;5296;1806;4900;85;274;1414;3754;1499;4028
250523;202203;2478;5655;2202;5303;149;383;1804;4276;1953;4659
250527;202203;1935;4492;1751;4287;18;53;1596;3885;1614;3938
250530;202203;713;1750;613;1608;21;43;527;1375;548;1418
250535;202203;1494;4109;1340;3843;30;136;1076;2982;1106;3118
250540;202203;3627;7312;3067;6699;237;299;2600;5911;2837;6210
250550;202203;844;2590;752;2418;32;124;539;1711;571;1835
250560;202203;1934;5065;1692;4721;41;157;1422;3872;1463;4029
250570;202203;3012;8331;2594;7598;114;375;2025;5865;2139;6240
250580;202203;1123;2843;990;2660;43;188;842;2178;885;2366
250590;202203;1057;2484;949;2328;30;75;834;2005;864;2080
250600;202203;8651;22083;7193;20114;253;826;5711;15804;5964;16630
250610;202203;3227;8687;2894;8205;104;386;2426;6828;2530;7214
250620;202203;974;2296;836;2071;38;105;631;1524;669;1629
250625;202203;2609;7162;2338;6745;46;216;2017;5695;2063;5911
250630;202203;12127;30573;10126;27314;938;2736;6977;18235;7915;20971
250640;202203;4027;10050;3607;9514;82;348;3207;8323;3289;8671
250650;202203;1165;2559;964;2298;15;58;849;1972;864;2030
250660;202203;1757;4131;1408;3661;31;107;1165;2927;1196;3034
250670;202203;2576;7558;2339;7150;56;233;2036;6109;2092;6342
250680;202203;6531;14365;5881;13635;49;190;5538;12649;5587;12839
250690;202203;7995;16648;6825;15248;101;248;6115;13485;6216;13733
250700;202203;5016;13349;4395;12422;694;1873;2791;8059;3485;9932
250710;202203;4722;13092;4137;12275;276;901;3122;9238;3398;10139
250720;202203;3096;7868;2768;7421;41;184;2504;6642;2545;6826
250730;202203;4940;11828;4360;11060;150;506;3724;9188;3874;9694
250740;202203;2225;5192;1840;4695;111;270;1430;3670;1541;3940
250750;202203;123808;287120;106350;263239;7520;20425;79975;193588;87495;214013
250760;202203;3036;6520;2703;6012;39;146;2433;5244;2472;5390
250770;202203;4351;12472;3891;11861;367;1137;2896;8967;3263;10104
250780;202203;2006;5002;1694;4462;56;173;1382;3558;1438;3731
250790;202203;2815;7749;2450;7224;90;373;1915;5502;2005;5875
250800;202203;2704;6728;2366;6191;107;218;1936;5090;2043;5308
250810;202203;1536;3628;1291;3297;76;133;1056;2771;1132;2904
250820;202203;2134;5675;1963;5486;39;156;1786;4948;1825;5104
250830;202203;6739;18888;5561;16577;231;858;3903;11141;4134;11999
250840;202203;824;2502;717;2298;31;114;540;1750;571;1864
250850;202203;1934;5406;1726;5049;37;184;1441;4112;1478;4296
250855;202203;1167;3045;1023;2833;47;153;826;2253;873;2406
250860;202203;3797;10383;3175;9378;458;1346;1828;5408;2286;6754
250870;202203;1145;2964;973;2693;29;106;793;2157;822;2263
250880;202203;1834;4393;1518;3931;112;282;1151;2980;1263;3262
250890;202203;12016;27650;10621;25897;325;1318;9063;21004;9388;22322
250900;202203;3332;8325;2913;7634;67;220;2523;6466;2590;6686
250905;202203;2705;7160;2498;6884;43;154;2277;6264;2320;6418
250910;202203;7373;16311;6210;15025;81;274;5583;13431;5664;13705
250915;202203;2462;5279;1792;4565;25;59;1603;4117;1628;4176
250920;202203;4060;9551;3617;8913;216;476;2978;7242;3194;7718
250930;202203;2594;6533;2340;6214;48;196;2047;5327;2095;5523
250933;202203;1400;3781;1228;3480;40;164;982;2696;1022;2860
250937;202203;811;2083;675;1868;25;80;544;1514;569;1594
250939;202203;2176;5152;1903;4810;57;142;1556;3870;1613;4012
250940;202203;4428;11032;3897;10354;25;78;3537;9385;3562;9463
250950;202203;1896;4665;1525;4179;38;143;1230;3312;1268;3455
250960;202203;1223;3431;1069;3173;32;153;880;2538;912;2691
250970;202203;9182;22584;8072;20826;198;649;6752;16964;6950;17613
250980;202203;2680;6616;2436;6275;21;102;2158;5411;2179;5513
250990;202203;2343;6646;1985;6047;75;317;1532;4560;1607;4877
251000;202203;2219;5955;1800;5245;52;201;1453;4211;1505;4412
251010;202203;2879;7588;2601;7161;33;134;2323;6385;2356;6519
251020;202203;1748;4620;1573;4354;30;129;1375;3733;1405;3862
251030;202203;1135;2871;934;2518;57;145;631;1685;688;1830
251040;202203;2069;5332;1766;4845;35;152;1495;4033;1530;4185
251050;202203;1123;3015;941;2672;51;186;692;1884;743;2070
251060;202203;1195;2433;909;2073;23;57;697;1576;720;1633
251065;202203;529;1380;396;1132;11;44;285;771;296;815
251070;202203;835;2011;700;1821;17;60;599;1521;616;1581
251080;202203;22335;52245;18359;46480;2883;7035;10910;28291;13793;35326
251090;202203;3174;8576;2709;7789;74;232;2177;6198;2251;6430
251100;202203;884;2693;780;2498;29;134;612;1876;641;2010
251110;202203;1987;4948;1669;4381;97;222;1244;3239;1341;3461
251120;202203;8528;21962;7195;20357;377;1222;5613;15853;5990;17075
251130;202203;4897;9414;4344;8808;46;117;4039;8062;4085;8179
251140;202203;4595;12294;4074;11569;69;263;3361;9460;3430;9723
251150;202203;2981;8169;2735;7775;65;311;2371;6580;2436;6891
251160;202203;2437;6624;2109;6143;33;169;1844;5265;1877;5434
251170;202203;1888;4620;1658;4333;22;81;1519;3917;1541;3998
251180;202203;2957;7339;2441;6635;163;403;1788;4881;1951;5284
251190;202203;4945;12097;4459;11560;52;251;4061;10325;4113;10576
251200;202203;4837;13175;4258;12449;81;308;3744;10955;3825;11263
251203;202203;1080;3288;984;3069;42;153;730;2234;772;2387
251207;202203;1251;3192;943;2688;22;89;656;1817;678;1906
251210;202203;8927;20870;7320;18702;444;941;5401;14201;5845;15142
251220;202203;1420;3175;1075;2724;82;168;797;2094;879;2262
251230;202203;5172;13726;4463;12483;125;434;3574;9705;3699;10139
251240;202203;4057;10782;3435;9733;215;555;2488;7009;2703;7564
251250;202203;12568;31006;11074;28522;582;1628;8632;21508;9214;23136
251260;202203;579;1428;520;1340;17;79;419;1027;436;1106
251270;202203;4780;13970;4270;13268;207;642;3382;10855;3589;11497
251272;202203;1430;3724;1314;3575;60;224;1112;2941;1172;3165
251274;202203;987;2629;803;2309;54;183;541;1490;595;1673
251275;202203;1530;3745;1290;3358;56;183;1025;2573;1081;2756
251276;202203;1485;3817;1296;3563;35;155;1051;2792;1086;2947
251278;202203;688;1736;616;1625;36;103;494;1298;530;1401
251280;202203;2924;6668;2680;6328;57;179;2372;5439;2429;5618
251290;202203;7633;15513;7020;14806;219;554;6313;13039;6532;13593
251300;202203;968;2681;869;2535;16;71;742;2148;758;2219
251310;202203;3139;8247;2745;7664;63;303;2297;6246;2360;6549
251315;202203;2035;5868;1838;5498;118;359;1436;4273;1554;4632
251320;202203;1807;4538;1350;3749;38;135;1031;2793;1069;2928
251330;202203;2377;5158;1945;4648;34;95;1713;4097;1747;4192
251335;202203;1225;3218;1101;3037;24;107;989;2670;1013;2777
251340;202203;4238;9379;3385;8285;142;363;2683;6524;2825;6887
251350;202203;1172;3178;1071;3020;31;105;894;2483;925;2588
251360;202203;2075;5328;1674;4765;33;114;1360;3818;1393;3932
251365;202203;855;2130;661;1773;10;36;529;1385;539;1421
251370;202203;27047;68282;23217;62989;3208;8250;14493;40191;17701;48441
251380;202203;1540;3779;1326;3448;20;96;1161;2919;1181;3015
251385;202203;860;2101;671;1767;30;65;471;1212;501;1277
251390;202203;7142;19585;6317;18320;556;1682;4427;12802;4983;14484
251392;202203;1136;2909;960;2633;39;116;756;2064;795;2180
251394;202203;744;1974;596;1719;57;166;400;1126;457;1292
251396;202203;730;1900;618;1711;28;77;419;1130;447;1207
251398;202203;1131;2751;808;2198;21;72;602;1581;623;1653
251400;202203;1523;3273;1222;2876;28;103;1012;2279;1040;2382
251410;202203;1759;3797;1419;3322;13;46;1221;2747;1234;2793
251420;202203;2270;5432;1876;4981;41;143;1516;3933;1557;4076
251430;202203;1706;4850;1543;4576;46;182;1339;3932;1385;4114
251440;202203;1187;3141;965;2737;56;129;726;2113;782;2242
251445;202203;1777;4613;1640;4428;30;121;1437;3797;1467;3918
251450;202203;4885;13520;4371;12737;84;377;3693;10717;3777;11094
251455;202203;959;2744;880;2601;19;83;725;2094;744;2177
251460;202203;1049;2763;883;2509;53;172;678;1901;731;2073
251465;202203;510;1395;432;1251;11;48;332;924;343;972
251470;202203;1315;3463;989;2819;115;347;524;1414;639;1761
251480;202203;1132;2793;900;2406;24;95;692;1765;716;1860
251490;202203;2184;5376;1769;4821;77;222;1351;3679;1428;3901
251500;202203;2241;5854;2051;5612;36;133;1842;5009;1878;5142
251510;202203;2939;8307;2447;7356;99;377;1727;5005;1826;5382
251520;202203;1176;2847;900;2373;76;166;592;1529;668;1695
251530;202203;15968;36108;12920;32362;139;700;11525;28305;11664;29005
251540;202203;3403;9024;3049;8413;62;237;2624;7096;2686;7333
251550;202203;4614;9632;3748;8600;142;241;3077;7169;3219;7410
251560;202203;608;1786;547;1699;40;163;402;1189;442;1352
251570;202203;1052;2815;872;2463;21;107;709;1933;730;2040
251580;202203;2255;5054;2017;4712;34;131;1757;3942;1791;4073
251590;202203;1838;4156;1565;3836;56;144;1352;3248;1408;3392
251593;202203;1035;2913;925;2720;83;267;627;1801;710;2068
251597;202203;2306;6021;2069;5709;15;75;1884;5139;1899;5214
251600;202203;6923;17864;6049;16552;249;744;4989;13474;5238;14218
251610;202203;3490;9359;3055;8605;233;644;2207;6216;2440;6860
251615;202203;1452;3378;1159;2944;24;69;947;2336;971;2405
251620;202203;22000;46133;17145;40272;161;436;15103;35450;15264;35886
251630;202203;5612;12108;4534;10623;236;497;3509;8022;3745;8519
251640;202203;2454;6220;2192;5824;25;119;1984;5178;2009;5297
251650;202203;4854;11338;4229;10558;125;367;3715;9170;3840;9537
251660;202203;3942;11072;3483;10296;69;319;2934;8524;3003;8843
251670;202203;4755;12129;4232;11429;67;251;3831;10255;3898;10506
251675;202203;920;2114;834;2007;68;152;667;1607;735;1759
251680;202203;2956;7091;2500;6507;67;159;2105;5486;2172;5645
251690;202203;3585;9419;3077;8568;107;307;2364;6538;2471;6845
251700;202203;2400;6384;1977;5816;44;188;1664;4780;1708;4968
251710;202203;875;2148;630;1682;45;137;376;932;421;1069
251720;202203;1454;3889;1162;3398;21;89;904;2555;925;2644
251740;202203;665;1789;537;1562;35;116;388;1089;423;1205
260005;202203;33390;67364;27948;60571;1710;3734;22126;46797;23836;50531
260010;202203;11386;28318;9411;25191;633;1719;5732;15279;6365;16998
260020;202203;7695;16561;6420;14779;83;360;5575;12549;5658;12909
260030;202203;7730;18303;6530;16611;114;430;5483;13650;5597;14080
260040;202203;8393;20000;7140;18311;522;1223;5284;13834;5806;15057
260050;202203;15082;37133;12628;34431;216;732;11712;31942;11928;32674
260060;202203;4784;10703;4134;9710;360;660;3114;7542;3474;8202
260070;202203;12361;28274;10740;26006;283;1025;9020;21130;9303;22155
260080;202203;7297;15561;6345;14346;113;335;5453;12066;5566;12401
260090;202203;5581;13225;4949;12391;280;729;3965;9921;4245;10650
260100;202203;3250;8294;2743;7569;51;245;2340;6355;2391;6600
260105;202203;5464;14224;4920;13508;125;506;4262;11470;4387;11976
260110;202203;24668;64642;22027;60884;909;3017;18496;50261;19405;53278
260120;202203;16569;40494;14106;37024;1470;3659;9803;25856;11273;29515
260130;202203;3713;8399;3263;7776;128;313;2653;6161;2781;6474
260140;202203;14295;29956;12416;27777;398;1048;10880;23911;11278;24959
260150;202203;4111;8696;3606;8086;90;205;3249;7243;3339;7448
260160;202203;7573;17570;6499;16288;87;295;6002;15032;6089;15327
260170;202203;23897;51851;20576;47494;979;2303;16878;38378;17857;40681
260180;202203;3887;9651;3355;8936;81;285;2923;7668;3004;7953
260190;202203;21900;39929;18716;36263;184;498;17032;32274;17216;32772
260200;202203;12409;27722;10759;25634;498;1055;9331;22369;9829;23424
260210;202203;12560;33371;10626;30312;371;1259;8597;24346;8968;25605
260220;202203;13301;27316;12362;26179;412;749;10980;23152;11392;23901
260230;202203;13084;28252;11434;26153;285;702;9745;22028;10030;22730
260240;202203;3085;8672;2685;7920;86;353;2113;6124;2199;6477
260250;202203;2600;6142;2263;5649;100;243;1866;4600;1966;4843
260260;202203;14798;35080;13196;32760;670;1747;10562;25998;11232;27745
260270;202203;5388;11249;4788;10569;89;328;4266;9172;4355;9500
260280;202203;13563;38566;12253;36735;366;1680;10673;31346;11039;33026
260290;202203;45961;109490;39825;101064;3665;9402;28566;71997;32231;81399
260300;202203;11072;27311;9604;25319;248;847;8255;21590;8503;22437
260310;202203;6747;14999;6034;14133;433;746;4767;11479;5200;12225
260320;202203;8457;23126;7206;21078;189;685;6010;17447;6199;18132
260330;202203;2788;8040;2423;7296;65;245;1951;5715;2016;5960
260340;202203;2373;5849;2069;5411;33;142;1847;4701;1880;4843
260345;202203;29773;71384;25175;65043;3028;8285;15405;38583;18433;46868
260350;202203;6586;13821;5731;12869;40;133;5273;11702;5313;11835
260360;202203;2785;6806;2498;6300;66;201;1837;4558;1903;4759
260370;202203;6104;16377;5261;14980;204;693;4172;11649;4376;12342
260380;202203;5552;15230;4748;13947;187;632;3701;10725;3888;11357
260390;202203;5146;14598;4233;12817;214;681;2854;8438;3068;9119
260392;202203;4042;11452;3677;11002;88;500;3164;9384;3252;9884
260400;202203;22451;47052;19543;43297;427;1232;16260;34329;16687;35561
260410;202203;85715;195427;68724;172475;12549;32115;33535;86216;46084;118331
260415;202203;4958;12078;4286;11055;59;240;3672;9260;3731;9500
260420;202203;14259;27336;12240;25130;72;253;11582;23507;11654;23760
260430;202203;3058;9018;2602;8141;163;560;1783;5517;1946;6077
260440;202203;4499;10243;3998;9572;47;173;3580;8412;3627;8585
260450;202203;6197;14756;5551;13923;263;545;4742;12003;5005;12548
260460;202203;5928;16188;5055;14726;441;1449;3312;9411;3753;10860
260470;202203;5349;13081;4548;12174;68;201;4204;11320;4272;11521
260480;202203;4431;10854;3757;9935;303;825;2693;7188;2996;8013
260490;202203;6124;12856;5415;11881;40;146;4974;10730;5014;10876
260500;202203;6717;15711;5779;14408;444;1022;4202;10529;4646;11551
260510;202203;11421;25797;9664;23376;106;407;8695;20687;8801;21094
260515;202203;4974;12315;3945;10492;149;467;2870;7225;3019;7692
260520;202203;17905;39739;15628;36920;556;1466;13300;30912;13856;32378
260530;202203;10879;29052;9271;26655;129;631;8154;23053;8283;23684
260540;202203;8281;16472;7376;15360;82;236;6829;14023;6911;14259
260545;202203;95;273;64;201;7;27;24;69;31;96
260550;202203;3533;9028;2871;7949;161;525;2038;5464;2199;5989
260560;202203;6283;15552;5288;14104;131;481;4490;11779;4621;12260
260570;202203;9093;21896;8064;20552;265;794;6914;17354;7179;18148
260580;202203;5182;11257;4682;10613;29;100;4349;9772;4378;9872
260590;202203;8140;16334;6967;15056;141;343;6272;13465;6413;13808
260600;202203;36269;86785;30044;77693;1060;3284;23774;59684;24834;62968
260610;202203;8275;20284;7355;19098;416;1141;5623;14504;6039;15645
260620;202203;20504;47736;18231;44671;1210;3436;14309;33999;15519;37435
260630;202203;2621;6700;2145;5976;54;180;1777;4847;1831;5027
260640;202203;26293;53752;22419;49377;701;1587;19219;41756;19920;43343
260650;202203;6866;16605;5538;14995;530;935;4477;12563;5007;13498
260660;202203;7951;19027;6949;17770;279;844;6083;15315;6362;16159
260670;202203;2487;6204;2029;5496;59;151;1504;3960;1563;4111
260680;202203;32780;73600;27876;66945;1935;4847;20373;47808;22308;52655
260690;202203;3810;9457;3169;8473;70;243;2529;6694;2599;6937
260700;202203;7817;18336;7272;17734;33;157;7065;17192;7098;17349
260710;202203;1528;3722;1302;3397;58;191;1040;2673;1098;2864
260720;202203;30160;66866;25969;61749;1918;4548;20000;47725;21918;52273
260730;202203;8791;23560;7661;22024;205;801;6626;18745;6831;19546
260740;202203;1467;3942;1219;3558;22;80;973;2882;995;2962
260750;202203;8471;20401;6745;18285;150;376;5974;16516;6124;16892
260760;202203;7046;14799;6167;13791;113;327;5488;12150;5601;12477
260765;202203;9449;24835;8293;23296;491;1723;6123;16773;6614;18496
260770;202203;4313;10294;3571;9111;104;333;2892;7230;2996;7563
260775;202203;6164;15032;5436;13991;170;590;4474;11076;4644;11666
260780;202203;4110;11412;3681;10742;343;1243;2477;6955;2820;8198
260790;202203;142186;299352;119668;271362;14778;32644;82308;184773;97086;217417
260795;202203;3487;8016;3019;7428;92;269;2541;6197;2633;6466
260800;202203;6717;13545;6131;12777;226;455;5384;11002;5610;11457
260805;202203;4087;10672;3486;9682;178;586;2667;7222;2845;7808
260810;202203;7302;18324;6411;16734;349;908;5035;12794;5384;13702
260820;202203;4970;10808;4415;10182;78;273;3788;8587;3866;8860
260825;202203;3338;9200;2943;8532;116;377;2292;6552;2408;6929
260830;202203;4874;13016;4096;11694;462;1138;2760;8074;3222;9212
260840;202203;5111;11590;4614;10941;218;501;4001;9406;4219;9907
260845;202203;4995;12323;4442;11433;221;623;3437;8609;3658;9232
260850;202203;5653;14362;4756;12745;350;1027;3212;8223;3562;9250
260860;202203;3769;10119;3245;9240;82;321;2661;7359;2743;7680
260870;202203;5056;11055;4338;10187;102;299;3895;9054;3997;9353
260875;202203;8988;19484;7436;17276;615;1312;5355;12603;5970;13915
260880;202203;10958;28583;9607;26400;302;959;7987;21624;8289;22583
260890;202203;14885;35067;12907;32201;830;2143;9386;22968;10216;25111
260900;202203;6180;16128;5139;14681;343;1093;3604;10167;3947;11260
260910;202203;3670;9214;3221;8571;116;360;2589;6798;2705;7158
260915;202203;5617;15065;4979;14344;54;259;4617;13270;4671;13529
260920;202203;3860;8456;3323;7891;70;161;2977;7051;3047;7212
260930;202203;4589;12611;3963;11546;167;649;3153;8864;3320;9513
260940;202203;16850;37238;14722;34351;1013;2416;11417;26134;12430;28550
260950;202203;8062;20060;6559;17625;326;1160;4520;11423;4846;12583
260960;202203;86344;176629;71549;158468;6459;14310;50968;110209;57427;124519
260970;202203;6349;15447;5630;14479;419;800;4235;11187;4654;11987
260980;202203;5124;13895;4496;13118;55;178;4131;12148;4186;12326
260990;202203;19986;50772;16947;46688;732;2337;13615;36918;14347;39255
261000;202203;18891;40645;16024;37111;487;1333;13300;30065;13787;31398
261010;202203;2515;6217;2180;5784;87;227;1874;4986;1961;5213
261020;202203;7404;18010;6489;16543;299;838;5368;13332;5667;14170
261030;202203;4555;12325;4028;11435;128;489;3254;8948;3382;9437
261040;202203;6048;16125;4967;14197;183;634;3892;10800;4075;11434
261050;202203;8918;20964;8093;19798;228;518;6826;16517;7054;17035
261060;202203;16079;37468;14019;35055;293;916;11960;29496;12253;30412
261070;202203;75433;156469;63235;140895;4361;9399;47733;104512;52094;113911
261080;202203;7616;16882;6907;16035;116;248;6467;14959;6583;15207
261090;202203;21894;48379;19525;45321;401;1262;17317;39392;17718;40654
261100;202203;9639;24292;8445;22592;614;1583;6426;17168;7040;18751
261110;202203;77929;203972;66027;183098;7996;23688;41777;113769;49773;137457
261120;202203;4092;9543;3565;8821;87;216;3102;7621;3189;7837
261130;202203;8080;18489;7109;17230;113;368;6312;15099;6425;15467
261140;202203;4111;8965;3680;8395;214;502;2936;6607;3150;7109
261150;202203;6081;14621;5391;13642;156;394;4656;11702;4812;12096
261153;202203;2128;6039;1772;5375;78;252;1225;3713;1303;3965
261160;202203;251393;545862;208655;489702;46288;106855;103316;246587;149604;353442
261170;202203;8178;17197;7217;15984;245;499;6259;13621;6504;14120
261180;202203;10365;24456;9080;22829;484;1076;6894;17476;7378;18552
261190;202203;5167;13909;4662;13132;169;754;3843;10478;4012;11232
261200;202203;3846;8169;3400;7591;131;332;2914;6365;3045;6697
261210;202203;2093;4842;1793;4424;56;149;1522;3686;1578;3835
261220;202203;16204;41120;13845;37124;1415;3958;9230;24088;10645;28046
261230;202203;4421;11798;3671;10832;50;192;3121;9256;3171;9448
261240;202203;6584;14459;5838;13373;282;649;4910;11082;5192;11731
261245;202203;4195;10919;3475;9682;72;340;2831;7586;2903;7926
261247;202203;3465;9486;2883;8476;248;670;1966;5864;2214;6534
261250;202203;29264;60058;25859;56167;4095;7830;17881;40672;21976;48502
261255;202203;4516;12466;3700;10928;164;624;2852;8202;3016;8826
261260;202203;16967;37065;15098;34724;263;975;13872;31158;14135;32133
261270;202203;5646;11730;5014;10986;159;371;4413;9491;4572;9862
261280;202203;2756;7291;2411;6740;78;278;1941;5296;2019;5574
261290;202203;3217;7824;2690;7234;87;285;2229;6015;2316;6300
261300;202203;14646;36859;12609;33648;419;1589;10067;25907;10486;27496
261310;202203;10828;24783;9383;22887;664;1712;7180;17158;7844;18870
261320;202203;6792;17788;5877;16345;73;337;5040;13786;5113;14123
261330;202203;6728;14745;6099;13960;101;370;5475;12192;5576;12562
261340;202203;5041;12580;4436;11827;102;414;3912;10254;4014;10668
261350;202203;9524;26674;8371;24751;176;664;6832;20012;7008;20676
261360;202203;9512;20751;8081;18764;281;732;6654;14958;6935;15690
261370;202203;26926;63331;22837;57988;2171;5411;15709;39836;17880;45247
261380;202203;4665;12640;4075;11667;415;1262;2845;8088;3260;9350
261390;202203;18690;50097;15789;45647;1127;3706;10993;31230;12120;34936
261400;202203;5380;15203;4736;13931;262;882;3644;10410;3906;11292
261410;202203;10935;25188;9059;22425;306;970;7572;18158;7878;19128
261420;202203;8187;22786;7396;21859;557;2010;5763;16889;6320;18899
261430;202203;4183;10326;3601;9465;65;301;3142;7998;3207;8299
261440;202203;1579;4493;1315;3996;55;250;964;2797;1019;3047
261450;202203;16079;40894;14209;38135;358;1086;11640;31288;11998;32374
261460;202203;8847;21990;7704;20265;241;737;6426;16669;6667;17406
261470;202203;4412;10519;3805;9688;42;177;3275;8264;3317;8441
261480;202203;6072;16797;5230;15423;261;935;4144;11949;4405;12884
261485;202203;5734;15051;5046;14050;359;1162;3846;10529;4205;11691
261500;202203;7186;16718;6278;15505;571;1138;4393;11368;4964;12506
261510;202203;2022;5692;1755;5260;80;287;1356;4067;1436;4354
261520;202203;2583;7382;2329;6890;88;306;1783;5186;1871;5492
261530;202203;13714;36898;11294;32800;868;3154;6709;18201;7577;21355
261540;202203;10416;26704;9514;25471;2108;5043;5066;14903;7174;19946
261550;202203;4105;10248;3589;9470;221;682;2710;6953;2931;7635
261560;202203;9657;24860;8453;23139;368;1173;6888;18682;7256;19855
261570;202203;3866;9913;3066;8605;200;629;2119;5825;2319;6454
261580;202203;7609;18701;6599;17338;87;418;6035;15645;6122;16063
261590;202203;3066;7232;2509;6446;96;302;1954;4916;2050;5218
261600;202203;6361;13997;5447;12732;235;532;4336;9921;4571;10453
261610;202203;2352;6554;1898;5733;156;509;1258;3778;1414;4287
261618;202203;2983;6545;2634;6067;113;310;2224;4955;2337;5265
261620;202203;4916;12813;4507;12222;653;1580;3197;8994;3850;10574
261630;202203;6618;17939;5641;16124;444;1439;3747;10285;4191;11724
261640;202203;42608;88255;36604;81083;1977;3553;29176;65552;31153;69105
261650;202203;4908;10790;4202;9924;284;568;3246;7700;3530;8268
270010;202203;4764;15150;4104;14040;165;851;3340;11143;3505;11994
270020;202203;4544;10240;4002;9581;117;438;3536;8166;3653;8604
270030;202203;36848;96502;31030;87433;2459;7276;22916;63904;25375;71180
270040;202203;11952;29493;10312;27573;456;1334;8717;23308;9173;24642
270050;202203;5931;13199;5054;12224;244;492;4470;10900;4714;11392
270060;202203;2428;5973;2056;5535;127;338;1656;4467;1783;4805
270070;202203;5359;13690;4691;12780;106;472;4086;10804;4192;11276
270080;202203;1632;4153;1388;3771;60;164;1088;2880;1148;3044
270090;202203;1927;5565;1749;5235;48;208;1490;4360;1538;4568
270100;202203;6900;15321;6038;14142;176;478;5285;12118;5461;12596
270110;202203;3626;7930;2952;7158;186;324;2379;6045;2565;6369
270120;202203;2790;7352;2429;6874;75;297;2048;5674;2123;5971
270130;202203;5562;13725;4819;12841;183;538;4126;10976;4309;11514
270135;202203;2185;5016;1857;4654;26;115;1725;4282;1751;4397
270140;202203;10214;23236;8246;20582;350;1116;6498;15473;6848;16589
270150;202203;3102;8397;2842;8045;16;84;2706;7610;2722;7694
270160;202203;6187;16397;5302;15354;179;556;4794;13894;4973;14450
270170;202203;3594;10060;3038;9300;190;870;2311;6786;2501;7656
270180;202203;2481;7290;2279;7035;40;211;2078;6351;2118;6562
270190;202203;2286;5472;2074;5225;21;102;1936;4818;1957;4920
270200;202203;2838;7992;2469;7469;208;587;1766;5460;1974;6047
270210;202203;6321;13979;5397;12932;53;216;5043;11922;5096;12138
270220;202203;1837;4476;1490;3984;139;418;1051;2716;1190;3134
270230;202203;10685;27417;8994;24920;786;2190;6663;18367;7449;20557
270235;202203;6477;19017;5647;17726;181;687;4757;14807;4938;15494
270240;202203;13001;32564;10878;29749;930;2594;8217;22547;9147;25141
270250;202203;3179;7301;2823;6805;162;380;2399;5759;2561;6139
270255;202203;4940;13303;3925;11559;121;473;3081;8856;3202;9329
270260;202203;5768;16741;5235;15865;96;512;4595;13662;4691;14174
270270;202203;1153;2836;964;2609;102;252;730;1981;832;2233
270280;202203;4300;9728;3452;8697;221;518;2689;6883;2910;7401
270290;202203;8664;25579;7836;24307;146;718;7031;21540;7177;22258
270300;202203;4614;11436;3609;10345;164;439;2895;8449;3059;8888
270310;202203;7685;20321;6613;18733;119;548;5805;16100;5924;16648
270320;202203;5971;16913;5184;15457;283;989;3898;11231;4181;12220
270330;202203;4568;13666;4050;12913;223;956;3312;10450;3535;11406
270340;202203;1807;4498;1535;4134;77;156;1307;3522;1384;3678
270350;202203;2068;4519;1679;4071;119;292;1271;3076;1390;3368
270360;202203;3214;7153;2904;6809;48;142;2773;6464;2821;6606
270370;202203;1543;4456;1418;4234;35;171;1225;3598;1260;3769
270375;202203;3698;7854;3161;7272;17;57;3018;6932;3035;6989
270380;202203;6145;15717;5238;14605;542;1369;3908;11206;4450;12575
270390;202203;1346;3192;1082;2885;15;71;932;2488;947;2559
270400;202203;7344;17678;6208;16061;193;527;5160;13163;5353;13690
270410;202203;5161;14044;4488;13052;121;452;3851;11132;3972;11584
270420;202203;6606;17875;5976;16976;136;617;5316;14774;5452;15391
270430;202203;157704;353250;124569;311659;19810;50684;68833;173845;88643;224529
270440;202203;5156;13198;4502;12393;118;431;4007;10940;4125;11371
270450;202203;8209;20374;7261;19237;307;794;6200;16630;6507;17424
270460;202203;4177;8754;3578;8031;130;266;3264;7322;3394;7588
270470;202203;12631;32688;11046;30513;550;1712;8962;24626;9512;26338
270480;202203;3302;8188;2802;7507;148;472;2313;6081;2461;6553
270490;202203;1011;2624;880;2465;39;137;733;2015;772;2152
270500;202203;5424;15377;4841;14413;209;798;4015;11720;4224;12518
270510;202203;6602;15888;5552;14593;330;1082;4423;11240;4753;12322
270520;202203;4553;12054;3655;10632;735;2228;1696;5049;2431;7277
270530;202203;1437;3975;1230;3653;68;173;879;2658;947;2831
270540;202203;2501;6496;2123;6007;60;227;1847;5178;1907;5405
270550;202203;7417;18011;5909;16358;503;1352;4557;12824;5060;14176
270560;202203;3270;7998;2764;7321;139;447;2263;5884;2402;6331
270570;202203;5350;12961;4659;11984;324;783;3811;9743;4135;10526
270580;202203;2566;6724;2320;6387;117;329;2010;5517;2127;5846
270590;202203;1673;4889;1541;4707;14;79;1465;4455;1479;4534
270600;202203;3087;8878;2803;8455;62;286;2516;7485;2578;7771
270610;202203;4058;10026;3555;9372;69;215;3207;8350;3276;8565
270620;202203;1372;3897;1263;3699;30;126;1098;3118;1128;3244
270630;202203;19418;44752;16817;41263;701;2062;14350;34508;15051;36570
270640;202203;6016;16112;5266;14960;181;699;4449;12385;4630;13084
270642;202203;2744;8397;2418;7908;155;671;1896;6063;2051;6734
270644;202203;4236;9797;3532;8905;274;620;2809;7118;3083;7738
270650;202203;3697;9878;3250;9292;222;761;2669;7561;2891;8322
270660;202203;2147;5242;1851;4846;86;300;1459;3710;1545;4010
270670;202203;19802;41560;16777;37936;413;1169;14767;32490;15180;33659
270680;202203;6629;13881;5980;13182;284;361;5441;12317;5725;12678
270690;202203;10761;24955;9033;22761;318;918;7504;18632;7822;19550
270700;202203;594;1713;524;1609;48;166;386;1159;434;1325
270710;202203;6246;17421;5523;16333;334;1093;4442;13041;4776;14134
270720;202203;4186;11006;3737;10281;80;329;3357;9057;3437;9386
270730;202203;9034;18713;7907;17531;926;1097;6310;15440;7236;16537
270740;202203;2525;6429;2228;6085;94;296;1878;5082;1972;5378
270750;202203;6262;15418;5491;14459;104;408;4930;12845;5034;13253
270760;202203;3649;9632;3075;8856;61;278;2604;7405;2665;7683
270770;202203;24134;56902;19686;51377;2977;7145;12483;33764;15460;40909
270780;202203;2125;5197;1972;4999;50;170;1801;4497;1851;4667
270790;202203;1931;4777;1638;4387;120;322;1285;3426;1405;3748
270800;202203;12541;31338;11359;29697;478;1430;9731;25272;10209;26702
270810;202203;3742;9749;2996;8608;192;652;2197;6162;2389;6814
270820;202203;1756;4979;1496;4570;50;231;1217;3652;1267;3883
270830;202203;5809;13070;4744;11792;125;495;4036;9750;4161;10245
270840;202203;9172;26017;8090;24457;233;1053;7054;20905;7287;21958
270850;202203;9815;21718;8696;20421;496;1380;7529;17414;8025;18794
270860;202203;16126;33839;12948;30286;610;1398;10682;24811;11292;26209
270870;202203;2502;6675;2052;5947;215;568;1417;4227;1632;4795
270880;202203;8558;24554;7676;23254;215;937;6482;19270;6697;20207
270890;202203;3545;9126;3016;8390;269;753;2042;5675;2311;6428
270895;202203;3907;10354;3547;9903;60;324;3238;8839;3298;9163
270900;202203;1876;4632;1442;3951;28;103;1154;3112;1182;3215
270910;202203;4490;12212;3882;11307;124;413;3279;9430;3403;9843
270915;202203;10611;28347;8655;25280;719;2480;6114;17335;6833;19815
270920;202203;6789;17838;6116;16863;89;463;5435;14560;5524;15023
270930;202203;19544;42491;15320;37639;1800;3607;10937;28362;12737;31969
270940;202203;6969;17518;5873;16236;191;875;4786;12772;4977;13647
280010;202203;691;1905;555;1628;21;96;400;1090;421;1186
280020;202203;5515;13098;4676;11840;348;873;3497;8716;3845;9589
280030;202203;93627;203584;76916;180752;13154;30336;43007;101941;56161;132277
280040;202203;3392;8511;2977;7920;264;739;2178;5705;2442;6444
280050;202203;4587;12347;3898;11272;737;2131;2117;6137;2854;8268
280060;202203;7523;17787;6092;15727;962;2601;3428;8948;4390;11549
280067;202203;8032;18049;6887;16323;410;832;5157;12096;5567;12928
280070;202203;1956;5681;1812;5460;118;367;1518;4537;1636;4904
280100;202203;4609;11207;3897;10131;439;1062;2640;6987;3079;8049
280110;202203;1717;3988;1496;3675;19;78;1374;3298;1393;3376
280120;202203;8596;22571;7626;21056;870;2171;5582;15690;6452;17861
280130;202203;9898;21915;8694;20303;443;1118;7129;16539;7572;17657
280140;202203;6534;14043;5804;13055;484;936;4577;10478;5061;11414
280150;202203;4554;10923;3981;10143;420;975;3027;7777;3447;8752
280160;202203;1365;3641;1163;3322;116;393;809;2208;925;2601
280170;202203;5993;14206;5390;13455;231;611;4533;11236;4764;11847
280190;202203;1586;3099;1422;2891;39;104;1268;2516;1307;2620
280200;202203;1416;3559;1180;3234;75;216;887;2376;962;2592
280210;202203;19409;44177;16934;40748;1784;4206;11543;27542;13327;31748
280220;202203;1801;4582;1518;4218;56;187;1258;3459;1314;3646
280230;202203;4764;11313;3949;10102;283;633;2828;7242;3111;7875
280240;202203;3628;9108;3222;8511;46;233;2824;7271;2870;7504
280250;202203;1005;2262;846;2036;53;151;645;1498;698;1649
280260;202203;2615;5682;2305;5302;43;109;2129;4888;2172;4997
280270;202203;2658;6830;2349;6383;142;423;1955;5271;2097;5694
280280;202203;4320;12313;3843;11622;466;1202;2770;8693;3236;9895
280290;202203;21934;52332;19005;48309;1653;4308;13046;33214;14699;37522
280300;202203;14005;30145;12298;28313;1574;2105;8957;22898;10531;25003
280310;202203;1522;3748;1275;3354;41;124;989;2535;1030;2659
280320;202203;9536;24217;8267;22354;866;2403;5864;15593;6730;17996
280330;202203;5163;12096;4344;10959;297;731;3295;8241;3592;8972
280340;202203;5990;11951;5015;10880;221;368;4423;9703;4644;10071
280350;202203;30874;65685;27316;61063;1034;2624;22685;49432;23719;52056
280360;202203;6067;16172;5351;15051;600;1854;3507;9850;4107;11704
280370;202203;2585;5637;2126;4895;98;167;1672;3806;1770;3973
280380;202203;1146;2826;966;2595;81;186;685;1869;766;2055
280390;202203;4380;9595;3727;8621;207;437;3047;6966;3254;7403
280400;202203;4450;10174;3897;9462;486;987;2769;6930;3255;7917
280410;202203;2954;7381;2487;6688;223;622;1609;4191;1832;4813
280420;202203;4874;11911;4455;11399;76;260;4128;10490;4204;10750
280430;202203;2422;5391;2139;5026;72;213;1812;4138;1884;4351
280440;202203;4723;11719;4180;10921;135;490;3598;9146;3733;9636
280445;202203;2527;6228;2268;5804;53;173;1793;4420;1846;4593
280450;202203;11026;25261;9605;23365;2364;5550;4516;11660;6880;17210
280460;202203;7882;17183;7165;16229;380;822;6177;13837;6557;14659
280470;202203;1859;4957;1575;4432;111;314;1142;3181;1253;3495
280480;202203;51997;115841;45390;106857;4131;10002;32841;75558;36972;85560
280490;202203;4009;11009;3386;9942;141;556;2567;7250;2708;7806
280500;202203;1189;2561;1013;2337;25;72;846;1943;871;2015
280510;202203;3228;6927;2814;6387;78;230;2376;5188;2454;5418
280520;202203;1953;4457;1706;4117;103;222;1375;3290;1478;3512
280530;202203;2587;6233;2268;5797;141;357;1787;4546;1928;4903
280540;202203;9388;24067;8505;22840;297;937;7450;19808;7747;20745
280550;202203;7477;16130;6279;14483;129;471;5387;11962;5516;12433
280560;202203;8352;21020;7846;20297;140;512;7085;18005;7225;18517
280570;202203;7022;16154;5707;14566;326;848;4281;10962;4607;11810
280580;202203;6433;15467;5651;14363;466;1051;4409;11235;4875;12286
280590;202203;3092;6846;2652;6326;144;438;2098;4783;2242;5221
280600;202203;4366;10422;3879;9737;186;490;3012;7435;3198;7925
280610;202203;3030;6615;2712;6217;118;287;2323;5199;2441;5486
280620;202203;6375;14225;5501;13101;431;843;4133;10115;4564;10958
280630;202203;4360;11093;4014;10637;213;595;3338;8827;3551;9422
280640;202203;2681;6553;2347;6183;63;166;2130;5634;2193;5800
280650;202203;1320;3329;1093;2997;98;283;782;2068;880;2351
280660;202203;4148;8489;3598;7864;158;272;3130;6879;3288;7151
280670;202203;21883;47924;18975;44194;1541;3626;14439;33371;15980;36997
280680;202203;3203;7078;2771;6471;269;480;1931;4682;2200;5162
280690;202203;1088;2464;920;2254;38;116;771;1822;809;1938
280700;202203;1311;3001;1130;2748;39;109;914;2172;953;2281
280710;202203;17257;35973;14718;33124;1040;1612;12443;28742;13483;30354
280720;202203;2926;6320;2431;5744;85;214;1894;4585;1979;4799
280730;202203;1169;2871;1011;2635;79;236;751;1876;830;2112
280740;202203;17999;37378;15650;33981;965;2175;12288;25820;13253;27995
280750;202203;3883;10287;3366;9411;226;651;2449;6745;2675;7396
280760;202203;7572;18131;6571;16725;725;1588;4428;11649;5153;13237
290010;202203;3469;6888;2312;5153;12;36;1949;4157;1961;4193
290020;202203;6610;14938;6093;14316;440;763;5196;12537;5636;13300
290030;202203;5183;10940;4237;9922;190;386;3610;8570;3800;8956
290035;202203;5803;11688;4758;10358;290;512;3768;8324;4058;8836
290040;202203;5344;11170;4576;10267;486;692;3547;8474;4033;9166
290050;202203;2253;6898;1914;6214;114;425;1352;4280;1466;4705
290060;202203;1568;3393;1171;2828;165;373;756;1816;921;2189
290070;202203;45123;90424;39307;83353;2261;4726;31547;65717;33808;70443
290080;202203;6323;16808;5529;15654;475;1427;4101;11592;4576;13019
290090;202203;2400;4329;1718;3598;20;56;1573;3265;1593;3321
290100;202203;11319;26957;9230;24007;1510;3572;5132;14031;6642;17603
290110;202203;6090;14752;5367;13655;621;1479;3576;9150;4197;10629
290115;202203;4443;12377;3803;11286;274;834;2989;8855;3263;9689
290120;202203;7218;16819;6050;15212;190;600;5145;12736;5335;13336
290130;202203;5140;11766;4018;10306;207;516;3040;7904;3247;8420
290135;202203;4946;10813;4060;9397;159;408;3289;7325;3448;7733
290140;202203;4954;12182;3879;10800;153;490;3284;9168;3437;9658
290150;202203;3038;6887;2619;6406;132;316;2133;5198;2265;5514
290160;202203;3964;8207;3530;7626;180;354;2986;6386;3166;6740
290170;202203;3901;8910;3481;8464;96;229;3183;7764;3279;7993
290180;202203;3335;8497;2778;7621;73;284;2352;6347;2425;6631
290190;202203;5262;12465;4693;11726;160;468;3899;9730;4059;10198
290195;202203;2704;6172;2173;5493;55;216;1888;4701;1943;4917
290200;202203;4577;12020;3647;10445;142;468;2783;7851;2925;8319
290205;202203;3939;9413;3519;8815;182;535;2855;6984;3037;7519
290210;202203;14649;36920;13010;34456;901;2234;10459;27759;11360;29993
290220;202203;3417;7404;3017;6913;97;258;2601;5880;2698;6138
290225;202203;3572;7020;2756;6175;73;155;2483;5533;2556;5688
290230;202203;3135;7027;2879;6726;71;141;2566;6026;2637;6167
290240;202203;4465;9898;3623;8894;67;247;3175;7683;3242;7930
290250;202203;4333;11824;3602;10765;120;364;3016;9152;3136;9516
290260;202203;6073;13851;5158;12556;267;713;4337;10332;4604;11045
290265;202203;3832;10595;3125;9311;210;666;2205;6502;2415;7168
290270;202203;11643;37918;10750;36425;632;2612;8636;29107;9268;31719
290280;202203;6779;19292;5873;17516;377;1265;4254;12478;4631;13743
290290;202203;10825;30113;8863;26639;808;2672;6021;17814;6829;20486
290300;202203;4729;11983;3484;9701;216;636;2482;6807;2698;7443
290310;202203;2202;4416;1798;3951;31;111;1630;3493;1661;3604
290320;202203;29697;71787;24120;63713;4442;11063;13484;36912;17926;47975
290323;202203;4267;10772;3655;9826;115;318;2859;7700;2974;8018
290327;202203;4734;12625;4063;11414;363;907;2880;8079;3243;8986
290330;202203;2744;5063;2202;4487;28;45;2022;4148;2050;4193
290340;202203;6772;15315;5238;13499;506;1149;3952;10411;4458;11560
290350;202203;5197;13832;4319;12350;285;812;3068;8777;3353;9589
290360;202203;5850;13559;5176;12698;107;302;4600;11213;4707;11515
290370;202203;5605;12949;4142;11032;152;435;3044;8093;3196;8528
290380;202203;6410;15509;5344;14090;146;355;4643;12310;4789;12665
290390;202203;16561;44213;13729;39728;1371;3968;9375;27329;10746;31297
290395;202203;3314;8720;2649;7617;74;325;2065;5805;2139;6130
290400;202203;4276;10766;3459;9470;156;486;2664;7128;2820;7614
290405;202203;5102;13927;4340;12633;348;1017;3047;8966;3395;9983
290410;202203;6186;15833;4742;13604;161;614;3641;10238;3802;10852
290420;202203;3537;8902;2919;7956;94;289;2365;6374;2459;6663
290430;202203;3892;9271;3237;8300;167;528;2493;6125;2660;6653
290440;202203;3119;7327;2236;5964;149;345;1599;4358;1748;4703
290450;202203;4171;9308;3325;8093;134;336;2757;6556;2891;6892
290460;202203;13797;36789;11595;32819;2314;6588;5121;14548;7435;21136
290470;202203;5302;11670;3975;9873;460;1134;2471;6187;2931;7321
290475;202203;7329;19895;6161;17935;96;484;5218;14925;5314;15409
290480;202203;2051;4791;1687;4283;69;236;1266;3045;1335;3281
290485;202203;5067;13878;4449;13022;130;573;3787;10930;3917;11503
290490;202203;10283;22431;9317;21155;334;870;7814;17613;8148;18483
290500;202203;4637;13076;3701;11212;599;1874;1631;4857;2230;6731
290510;202203;4008;9115;3371;8305;77;236;3021;7372;3098;7608
290515;202203;3906;10449;3402;9753;40;127;3091;8974;3131;9101
290520;202203;13383;35478;10513;30119;680;2107;6722;18597;7402;20704
290530;202203;5344;14663;4506;13336;111;470;3821;11200;3932;11670
290540;202203;3967;9570;3597;9171;43;143;3382;8595;3425;8738
290550;202203;4607;11510;4014;10816;35;118;3699;10066;3734;10184
290560;202203;6955;17065;5340;14764;397;1339;3690;9846;4087;11185
290570;202203;48848;115492;43337;108705;1956;5310;36012;89289;37968;94599
290580;202203;9216;24246;7966;22496;819;2013;5811;17114;6630;19127
290590;202203;7548;22362;6372;20312;195;745;5194;16666;5389;17411
290600;202203;20936;55326;18169;50948;931;2566;14583;40910;15514;43476
290610;202203;2761;8193;2186;7058;103;383;1545;4946;1648;5329
290620;202203;6672;18233;5787;16799;305;835;4788;13956;5093;14791
290630;202203;10593;23406;8556;20845;718;1639;6613;16294;7331;17933
290640;202203;3047;7243;2350;6273;211;427;1637;4615;1848;5042
290650;202203;15510;35483;13899;33690;1521;3480;11050;27119;12571;30599
290660;202203;4135;10104;3351;8881;115;341;2508;6656;2623;6997
290670;202203;8605;19970;7451;18267;298;807;6274;15240;6572;16047
290680;202203;12307;31612;10295;28725;273;1178;8664;23687;8937;24865
290682;202203;5736;13129;5023;12213;310;521;3986;10180;4296;10701
290685;202203;3904;8314;2868;6867;424;819;1607;4183;2031;5002
290687;202203;7488;18638;6163;16542;728;1811;4147;11302;4875;13113
290689;202203;3108;8174;2389;6914;245;767;1582;4595;1827;5362
290690;202203;6042;14860;4938;13360;249;823;3772;9978;4021;10801
290700;202203;3337;7561;2996;7145;48;186;2747;6453;2795;6639
290710;202203;9544;24411;8148;22524;252;794;6986;19263;7238;20057
290720;202203;21217;53581;19217;50578;1023;2920;15678;40599;16701;43519
290730;202203;7603;17328;6518;16071;306;624;5214;12928;5520;13552
290740;202203;1182;2930;945;2573;18;72;832;2223;850;2295
290750;202203;13920;31039;12154;28337;532;1377;9783;21882;10315;23259
290755;202203;2226;5994;1788;5236;129;354;1230;3630;1359;3984
290760;202203;4130;11408;3409;10114;238;614;2362;7156;2600;7770
290770;202203;2988;8487;2737;8187;87;228;2343;7132;2430;7360
290780;202203;8621;20629;7434;19088;329;703;5833;15256;6162;15959
290790;202203;5653;14097;4915;13038;249;618;4081;10912;4330;11530
290800;202203;7866;14903;5632;12360;289;528;4348;9615;4637;10143
290810;202203;5997;14320;4869;12723;207;463;3707;9926;3914;10389
290820;202203;5797;14157;5214;13346;370;821;3821;9907;4191;10728
290830;202203;4834;10954;4279;10169;66;235;3627;8258;3693;8493
290840;202203;19447;48415;16613;44159;1821;4073;11589;31964;13410;36037
290850;202203;8476;17983;7479;16924;346;606;6476;14819;6822;15425
290860;202203;6810;17906;5912;16877;327;838;4954;14479;5281;15317
290870;202203;5293;13712;4036;11385;298;809;2719;7641;3017;8450
290880;202203;1580;3638;1276;3254;169;373;763;2116;932;2489
290890;202203;10007;19524;8948;18359;138;331;8390;17094;8528;17425
290900;202203;2649;6636;2061;5633;142;395;1305;3499;1447;3894
290910;202203;5697;12735;4353;10750;48;142;3760;9183;3808;9325
290920;202203;6001;13681;5306;12864;148;205;4818;12062;4966;12267
290930;202203;8127;21725;6553;19024;248;951;5081;14364;5329;15315
290940;202203;3846;10393;3242;9515;164;579;2638;7685;2802;8264
290950;202203;1576;3783;1283;3351;102;270;887;2323;989;2593
290960;202203;6513;15332;5827;14509;261;577;4933;12283;5194;12860
290970;202203;3415;9842;2790;8705;116;442;2182;6765;2298;7207
290980;202203;14742;32761;12575;29639;848;2016;8605;19561;9453;21577
290990;202203;10388;26481;9219;24676;300;1171;7809;20198;8109;21369
291000;202203;3691;8970;2840;7910;123;358;2336;6567;2459;6925
291005;202203;17828;41255;15840;38789;971;2335;13202;32061;14173;34396
291010;202203;3319;9706;2675;8338;164;566;1743;5277;1907;5843
291020;202203;1414;3283;1143;2834;33;102;833;1929;866;2031
291030;202203;2752;6298;1986;5054;135;314;1290;3184;1425;3498
291040;202203;5937;15289;4880;13806;212;694;3854;10900;4066;11594
291050;202203;10498;23641;9200;21921;986;2250;6892;16256;7878;18506
291060;202203;8447;21123;7365;19727;490;1447;5822;15455;6312;16902
291070;202203;18717;45714;15772;41165;413;1429;13270;33981;13683;35410
291072;202203;30326;70120;22900;58326;3286;8725;12566;31095;15852;39820
291075;202203;6070;14032;5482;13138;100;275;4687;10923;4787;11198
291077;202203;1829;4610;1422;3910;65;127;1002;2766;1067;2893
291080;202203;136123;310193;109904;275153;25412;60079;46761;123169;72173;183248
291085;202203;6100;14691;4979;13011;172;505;4195;10841;4367;11346
291090;202203;2389;4206;1806;3562;33;64;1574;3058;1607;3122
291100;202203;3654;7364;2567;6099;101;254;2028;4764;2129;5018
291110;202203;6550;18585;5539;16894;253;1040;4405;13011;4658;14051
291120;202203;8925;19875;7626;18266;341;891;6114;14484;6455;15375
291125;202203;2553;4209;1954;3546;69;112;1680;3026;1749;3138
291130;202203;3548;9610;2667;7957;76;356;2042;5850;2118;6206
291140;202203;5318;13430;3907;10991;505;1248;2410;6783;2915;8031
291150;202203;2962;5825;2327;5127;9;27;2227;4886;2236;4913
291160;202203;5547;14472;4652;13225;441;1319;3162;8917;3603;10236
291165;202203;2318;6129;1714;4955;35;150;1227;3413;1262;3563
291170;202203;23916;57186;20005;50747;1238;3295;13632;33497;14870;36792
291180;202203;7726;15763;5889;13379;179;472;5041;11238;5220;11710
291185;202203;3565;8581;3169;7992;172;423;2518;6340;2690;6763
291190;202203;8516;19593;7092;17822;219;634;5827;14659;6046;15293
291200;202203;3051;7962;2262;6484;81;288;1510;4126;1591;4414
291210;202203;8219;16207;6132;13852;325;666;4677;10572;5002;11238
291220;202203;5145;12918;4647;12215;363;941;3530;9281;3893;10222
291230;202203;5177;10115;4004;8840;59;100;3675;8142;3734;8242
291240;202203;4544;11140;3844;9996;74;226;3301;8476;3375;8702
291250;202203;3628;10193;2831;8766;192;593;1811;5638;2003;6231
291260;202203;1616;3557;1335;3202;27;72;1122;2688;1149;2760
291270;202203;6165;14571;4871;12779;383;905;3688;9829;4071;10734
291280;202203;3101;7025;2340;5966;188;436;1571;3910;1759;4346
291290;202203;6163;15563;4731;13390;405;1242;3201;8928;3606;10170
291300;202203;4265;10779;3400;9394;121;410;2658;7120;2779;7530
291310;202203;5625;14205;4830;12833;151;427;4112;10811;4263;11238
291320;202203;7224;18250;5694;15643;1119;2848;3077;8786;4196;11634
291330;202203;2096;4994;1749;4434;61;178;1366;3360;1427;3538
291340;202203;4701;11448;3779;9925;156;390;2737;7160;2893;7550
291345;202203;3154;8777;2838;8309;109;376;2389;6967;2498;7343
291350;202203;7852;17705;6140;15668;102;263;5390;13817;5492;14080
291360;202203;44413;92767;35623;82556;3789;8129;24315;57854;28104;65983
291370;202203;8945;23099;7918;21552;560;1670;6029;16010;6589;17680
291380;202203;4544;10341;4064;9706;145;406;3544;8354;3689;8760
291390;202203;14302;29002;10942;25332;396;918;9276;21359;9672;22277
291400;202203;17391;38680;14631;34727;1494;3214;10188;24685;11682;27899
291410;202203;3288;8221;2577;7027;59;198;1938;5179;1997;5377
291420;202203;2102;4862;1638;4293;26;105;1459;3801;1485;3906
291430;202203;2938;7808;2531;7135;103;399;2005;5487;2108;5886
291440;202203;7077;19044;6117;17541;359;1055;4724;13691;5083;14746
291450;202203;11712;24440;9767;22242;230;315;8739;20284;8969;20599
291460;202203;18199;44216;15997;41058;743;2198;12568;31565;13311;33763
291465;202203;9764;22938;7679;20561;172;698;6661;17663;6833;18361
291470;202203;21197;42698;17982;39043;1036;2078;13985;30642;15021;32720
291480;202203;51187;104635;39315;89174;3590;8214;25010;54948;28600;63162
291490;202203;6715;15208;5897;14301;127;387;5426;13046;5553;13433
291500;202203;5809;12760;4893;11585;85;229;4551;10770;4636;10999
291510;202203;4892;11094;3645;9526;50;249;3153;8113;3203;8362
291520;202203;5004;10708;3830;9209;287;659;2972;7136;3259;7795
291530;202203;2637;5608;1935;4729;195;429;1350;3409;1545;3838
291535;202203;3913;10638;3340;9626;192;492;2625;7708;2817;8200
291540;202203;2431;5111;1714;4265;65;164;1448;3582;1513;3746
291550;202203;7047;14306;5479;12388;508;987;3893;8871;4401;9858
291560;202203;19897;45241;14695;38523;2005;4745;8628;23547;10633;28292
291570;202203;2601;5723;2002;5036;110;203;1663;4326;1773;4529
291580;202203;7194;17170;5690;15209;316;945;4324;11342;4640;12287
291590;202203;2567;5635;2265;5295;65;209;2055;4730;2120;4939
291600;202203;6171;13285;4798;11267;415;1018;3347;7620;3762;8638
291610;202203;6649;15549;5970;14810;86;267;5456;13498;5542;13765
291620;202203;3396;7206;2579;6322;167;370;1995;5004;2162;5374
291630;202203;3906;7771;2986;6637;168;364;2441;5372;2609;5736
291640;202203;18961;42573;14610;36532;1498;3820;8475;20676;9973;24496
291650;202203;10291;23418;9107;22033;579;1058;7752;19103;8331;20161
291660;202203;2194;5137;1611;4270;109;393;1104;2739;1213;3132
291670;202203;2182;5517;1829;5008;148;371;1334;3714;1482;4085
291680;202203;4602;10391;3753;9210;409;974;2507;6279;2916;7253
291685;202203;5254;12159;4216;10755;215;459;3295;8529;3510;8988
291690;202203;4458;9242;3150;7413;297;562;2408;5717;2705;6279
291700;202203;9868;26180;8719;24272;304;1123;7354;19967;7658;21090
291710;202203;6002;13076;4578;11150;328;813;3401;8126;3729;8939
291720;202203;4788;13687;3981;12142;776;2357;2187;6715;2963;9072
291730;202203;7451;16669;6464;15404;362;848;5422;12907;5784;13755
291733;202203;3202;7649;2710;7000;132;277;2040;5506;2172;5783
291735;202203;3082;7964;2438;6857;77;191;1855;5213;1932;5404
291740;202203;4322;10680;3154;8535;119;251;2202;5922;2321;6173
291750;202203;23369;51484;19341;45657;2426;4957;12691;30834;15117;35791
291760;202203;12149;32166;9637;28350;2868;9440;2979;8634;5847;18074
291770;202203;8221;20667;6887;18402;313;1035;5352;13739;5665;14774
291780;202203;5578;14087;5024;13345;106;359;4391;11516;4497;11875
291790;202203;3206;7907;2928;7565;249;550;2316;6102;2565;6652
291800;202203;36390;83491;28418;72359;4285;10374;15958;40715;20243;51089
291810;202203;11647;25941;9876;23819;521;1056;8151;20020;8672;21076
291820;202203;4217;10507;3676;9812;119;348;2983;7949;3102;8297
291830;202203;5079;10953;4141;9713;194;362;3346;7865;3540;8227
291835;202203;7193;20370;5786;17814;517;1605;3980;12427;4497;14032
291840;202203;52506;136519;45975;126700;3999;11850;34170;93499;38169;105349
291845;202203;3329;7365;2738;6659;110;263;2356;5782;2466;6045
291850;202203;4777;12234;4008;11023;130;329;3354;9257;3484;9586
291855;202203;2529;4520;2008;3949;29;61;1867;3656;1896;3717
291860;202203;2399;6071;1640;4644;36;109;1099;3013;1135;3122
291870;202203;1403;3368;962;2607;35;114;682;1800;717;1914
291875;202203;3221;9276;2770;8362;74;317;2074;6047;2148;6364
291880;202203;6018;16071;5181;14742;263;684;3922;11305;4185;11989
291890;202203;1841;3564;1223;2846;182;391;751;1762;933;2153
291900;202203;1476;3292;1129;2784;32;91;894;2145;926;2236
291905;202203;2624;6426;2177;5760;101;321;1690;4325;1791;4646
291910;202203;4025;8253;3490;7624;71;166;3159;6930;3230;7096
291915;202203;7988;21469;6526;19048;242;734;4918;14561;5160;15295
291920;202203;32991;78184;28536;72399;1830;5553;22074;54375;23904;59928
291930;202203;2790;6775;2404;6241;215;537;1803;4733;2018;5270
291940;202203;4263;10230;2915;8043;265;678;1764;4843;2029;5521
291950;202203;9966;29051;8375;26143;376;1378;5847;18075;6223;19453
291955;202203;18608;43436;16702;41040;1123;2911;13734;33580;14857;36491
291960;202203;4038;8863;3411;8065;223;401;2738;6641;2961;7042
291970;202203;5228;12010;4408;11008;165;510;3467;8554;3632;9064
291980;202203;11198;29449;9082;25979;908;2303;6198;18122;7106;20425
291990;202203;2604;6205;2152;5660;28;106;2000;5241;2028;5347
291992;202203;4618;10265;3854;9319;257;522;3140;7720;3397;8242
291995;202203;2462;6098;2025;5427;78;273;1624;4218;1702;4491
292000;202203;2917;6456;2393;5834;70;215;1986;4813;2056;5028
292010;202203;6377;13943;5210;12283;99;360;4461;10230;4560;10590
292020;202203;5271;13763;4462;12435;167;620;3594;9665;3761;10285
292030;202203;2232;6185;1966;5722;144;439;1282;3653;1426;4092
292040;202203;5109;11813;4040;10282;199;480;3232;8254;3431;8734
292045;202203;4739;10892;3645;9327;30;98;3337;8586;3367;8684
292050;202203;7229;18833;5895;16616;308;1023;3958;10952;4266;11975
292060;202203;13241;27895;12309;26752;338;749;11107;23758;11445;24507
292070;202203;6410;15341;5604;14395;340;837;4834;12400;5174;13237
292080;202203;3964;8423;3321;7615;48;150;3074;6976;3122;7126
292090;202203;5008;10260;3591;8546;173;470;2887;6785;3060;7255
292100;202203;14186;31641;12207;29229;1978;4390;7358;18422;9336;22812
292105;202203;3890;9205;3387;8533;51;192;2892;7234;2943;7426
292110;202203;6973;15359;5043;12557;765;1910;3070;7544;3835;9454
292120;202203;7978;18971;6597;16682;502;1144;4833;12139;5335;13283
292130;202203;3790;8547;3149;7769;184;497;2434;5950;2618;6447
292140;202203;6276;13013;5366;11773;172;359;4743;10299;4915;10658
292145;202203;2894;7360;2436;6614;123;270;1916;5270;2039;5540
292150;202203;16838;41243;14602;37754;374;1317;12318;31146;12692;32463
292160;202203;3336;7504;2553;6516;41;118;2021;5502;2062;5620
292170;202203;9801;24173;8265;21776;397;1294;6474;16571;6871;17865
292180;202203;3219;8302;2404;6832;159;467;1542;4273;1701;4740
292190;202203;3241;7996;2763;7313;248;631;1969;5335;2217;5966
292200;202203;10174;23356;7720;19977;1459;3681;3959;10679;5418;14360
292205;202203;4235;10939;3687;10145;100;332;3167;8733;3267;9065
292210;202203;7304;15517;5967;13867;79;285;5484;12617;5563;12902
292220;202203;2480;5368;2152;4893;86;194;1695;3718;1781;3912
292225;202203;3554;9705;3126;9083;66;303;2761;7881;2827;8184
292230;202203;9716;21667;8705;20409;197;601;7608;17518;7805;18119
292240;202203;5248;14384;4595;13242;281;789;3321;9537;3602;10326
292250;202203;6621;15828;5944;14879;255;720;4820;11846;5075;12566
292260;202203;3554;8983;3152;8476;65;207;2777;7447;2842;7654
292265;202203;3999;9918;3310;8869;68;297;2759;7173;2827;7470
292270;202203;4950;10291;3977;9147;176;341;3290;7601;3466;7942
292273;202203;3167;6334;2543;5589;141;208;1839;4307;1980;4515
292275;202203;1915;4603;1550;4125;57;173;1235;3272;1292;3445
292280;202203;2978;6496;2418;5854;113;194;2055;5110;2168;5304
292285;202203;2890;6430;2299;5655;80;176;1918;4738;1998;4914
292290;202203;8357;20168;6602;17739;186;527;5514;14773;5700;15300
292300;202203;11618;27279;9251;24183;982;2639;6354;16762;7336;19401
292303;202203;3392;8768;2947;8091;109;247;2510;6962;2619;7209
292305;202203;2494;6392;2276;6101;53;203;2043;5397;2096;5600
292310;202203;7713;17722;6710;16512;99;365;6027;14571;6126;14936
292320;202203;6581;16874;5256;14566;186;651;4046;10921;4232;11572
292330;202203;3232;6310;2671;5696;176;280;2096;4680;2272;4960
292335;202203;5412;13268;4798;12380;215;475;4082;10646;4297;11121
292340;202203;5881;15930;4863;14022;259;737;3571;10206;3830;10943
292350;202203;2899;7243;2447;6651;123;358;2016;5457;2139;5815
292360;202203;5500;13843;4591;12359;219;620;3371;8938;3590;9558
292370;202203;11699;25570;10099;23505;110;388;9488;21782;9598;22170
292380;202203;7499;19904;6707;18530;407;1184;5205;14216;5612;15400
292390;202203;5595;9470;4296;8002;75;141;3955;7281;4030;7422
292400;202203;24864;66318;21502;61218;1948;5609;15234;43541;17182;49150
292405;202203;5088;11480;4277;10264;127;322;3543;8424;3670;8746
292410;202203;2530;5458;2152;4984;58;150;1944;4482;2002;4632
292420;202203;4907;11358;4415;10676;78;318;4003;9405;4081;9723
292430;202203;5436;15303;4168;13024;316;1112;2827;8744;3143;9856
292440;202203;9542;28135;8777;27036;140;713;7923;24226;8063;24939
292450;202203;4528;12024;3532;10176;111;378;2762;7864;2873;8242
292460;202203;6394;14871;5375;13312;205;521;4471;10869;4676;11390
292465;202203;2922;7000;2486;6457;172;316;1667;4739;1839;5055
292467;202203;2240;5700;1989;5374;290;638;1384;3989;1674;4627
292470;202203;3214;7843;2458;6681;95;215;1844;5046;1939;5261
292480;202203;7151;15336;5877;13817;92;265;5390;12538;5482;12803
292490;202203;2950;6229;2506;5636;88;174;2118;4689;2206;4863
292500;202203;7835;19176;6280;16664;339;984;4535;11808;4874;12792
292510;202203;15217;37358;11907;32345;707;2103;8646;23297;9353;25400
292520;202203;8037;18939;7114;17597;318;906;5849;14193;6167;15099
292525;202203;7175;15366;5902;13931;106;255;5324;12638;5430;12893
292530;202203;35019;86305;28028;75279;5161;14357;14868;39606;20029;53963
292540;202203;5070;8622;4076;7572;109;180;3744;6962;3853;7142
292550;202203;8819;21948;6774;19535;500;1343;4922;15019;5422;16362
292560;202203;4879;11671;4120;10636;169;510;3129;7937;3298;8447
292570;202203;4117;10114;3442;8952;65;249;2932;7389;2997;7638
292575;202203;7494;20347;6878;19549;656;1734;5277;15241;5933;16975
292580;202203;8316;19600;6878;17540;124;396;5960;14946;6084;15342
292590;202203;7952;20330;6656;18069;333;1039;5367;14293;5700;15332
292593;202203;3089;7415;2557;6525;72;202;2153;5424;2225;5626
292595;202203;6011;15009;5178;13988;162;541;4473;11987;4635;12528
292600;202203;12556;31193;10894;28785;556;1366;8782;23267;9338;24633
292610;202203;5014;11678;4298;10521;143;319;3470;8433;3613;8752
292620;202203;7389;18332;6107;16799;141;349;5594;15576;5735;15925
292630;202203;10069;22694;8155;19743;917;2038;5323;12966;6240;15004
292640;202203;8922;24478;7686;22514;334;1095;5571;16389;5905;17484
292650;202203;4723;11337;4202;10661;67;260;3870;9669;3937;9929
292660;202203;12220;31620;10385;28953;667;1771;7799;21977;8466;23748
292665;202203;2291;6467;1962;6039;68;206;1616;5071;1684;5277
292670;202203;3852;10103;3006;8554;176;558;2049;5685;2225;6243
292680;202203;4446;10906;3539;9371;137;368;2732;7017;2869;7385
292690;202203;2861;7078;1977;5657;217;543;1242;3678;1459;4221
292700;202203;11308;28507;9859;26323;738;1683;7191;19537;7929;21220
292710;202203;3127;8313;2914;8046;49;155;2716;7499;2765;7654
292720;202203;10076;22156;8536;20391;434;884;6771;16644;7205;17528
292730;202203;5704;12098;5197;11364;343;541;4275;9603;4618;10144
292740;202203;381717;854144;335184;791113;38498;90967;231866;540760;270364;631727
292750;202203;7269;17286;6420;16139;215;571;5406;13598;5621;14169
292760;202203;4387;11584;3822;10634;188;610;2953;8046;3141;8656
292770;202203;7653;18174;6286;16350;792;2011;4406;11672;5198;13683
292780;202203;2373;4349;1790;3670;59;135;1489;2908;1548;3043
292790;202203;4315;8641;3276;7520;174;375;2734;6300;2908;6675
292800;202203;12355;29548;10574;26877;459;1212;8777;22096;9236;23308
292805;202203;4140;9122;3282;8058;119;304;2693;6546;2812;6850
292810;202203;13479;30079;10960;26297;657;1595;8665;20141;9322;21736
292820;202203;7818;20729;5746;17259;393;1394;4080;12016;4473;13410
292830;202203;3205;7152;2725;6586;102;235;2325;5695;2427;5930
292840;202203;10191;24220;8683;22235;151;562;7792;19610;7943;20172
292850;202203;2935;7069;2502;6468;242;568;1745;4533;1987;5101
292860;202203;19397;39207;17591;37135;626;1266;15380;32197;16006;33463
292870;202203;22724;50891;19831;46978;1263;2876;14520;33674;15783;36550
292880;202203;12659;32572;10862;29905;389;1387;8568;22799;8957;24186
292890;202203;8504;21129;7539;19789;151;549;6765;17568;6916;18117
292895;202203;3768;7166;2895;5907;191;312;2284;4695;2475;5007
292900;202203;3000;7484;2726;7100;53;227;2317;5860;2370;6087
292905;202203;4983;11744;3994;10296;112;351;3179;7998;3291;8349
292910;202203;5304;13561;4831;12921;166;467;3891;10246;4057;10713
292920;202203;10816;28033;10060;27052;254;953;8897;23580;9151;24533
292925;202203;5761;15709;4813;13987;312;906;3473;10046;3785;10952
292930;202203;7209;19785;6293;18181;630;1990;4046;11478;4676;13468
292935;202203;2971;6346;2385;5704;21;79;2171;5193;2192;5272
292937;202203;3055;7380;2627;6842;167;410;1968;5219;2135;5629
292940;202203;3323;7802;2665;6836;300;649;1785;4768;2085;5417
292950;202203;10408;25308;9098;23475;457;1134;7073;18028;7530;19162
292960;202203;5892;13387;4946;12078;163;346;3989;9688;4152;10034
292970;202203;4243;11270;3762;10589;95;346;3184;9004;3279;9350
292975;202203;4871;9931;4353;9363;117;229;3989;8594;4106;8823
292980;202203;4167;8728;3447;7723;71;213;3022;6619;3093;6832
292990;202203;12844;33174;10784;29724;449;1423;8404;22522;8853;23945
293000;202203;3039;6839;2618;6198;87;246;2097;4912;2184;5158
293010;202203;20633;49202;16759;43468;1847;4837;11164;28798;13011;33635
293015;202203;9651;27523;7677;23814;597;1844;5315;16747;5912;18591
293020;202203;10820;29481;9772;28016;166;636;8843;25349;9009;25985
293030;202203;5726;14297;4425;12315;234;550;3044;8751;3278;9301
293040;202203;4871;11750;4040;10613;78;269;3563;9280;3641;9549
293050;202203;26561;58434;23433;53962;1441;3147;18059;41090;19500;44237
293060;202203;4155;10328;3356;8863;205;580;2460;6282;2665;6862
293070;202203;30055;66613;26827;62678;1934;4631;21213;49056;23147;53687
293075;202203;4108;11723;3573;10862;93;456;3063;9235;3156;9691
293076;202203;3895;8906;3542;8497;93;186;3154;7655;3247;7841
293077;202203;7133;18495;5786;16438;645;1794;3613;10826;4258;12620
293080;202203;5191;14370;4403;13016;102;470;3627;10505;3729;10975
293090;202203;3471;9736;2691;8417;214;655;1868;5865;2082;6520
293100;202203;6417;15983;5317;14092;251;611;4234;11199;4485;11810
293105;202203;4217;12584;3647;11457;230;739;2585;8092;2815;8831
293110;202203;2713;6199;2272;5592;70;208;1898;4558;1968;4766
293120;202203;5474;12888;4972;12170;348;566;4086;10324;4434;10890
293130;202203;4013;10507;3470;9827;89;357;3058;8567;3147;8924
293135;202203;34826;77553;25961;65912;4479;11805;11801;30417;16280;42222
293140;202203;2978;5695;2631;5289;77;123;2341;4651;2418;4774
293150;202203;5675;16306;4698;14540;346;1170;3290;10113;3636;11283
293160;202203;4685;10075;4113;9449;456;641;3234;8104;3690;8745
293170;202203;5898;10821;5186;9978;76;186;4731;8992;4807;9178
293180;202203;4959;12968;4121;11481;91;365;3356;9107;3447;9472
293190;202203;17064;40566;15004;37719;134;583;13627;33768;13761;34351
293200;202203;9922;22219;8115;19445;224;614;6851;16153;7075;16767
293210;202203;5756;14105;4881;12827;377;911;3721;9847;4098;10758
293220;202203;6176;14202;4647;11775;727;1770;2725;6884;3452;8654
293230;202203;4686;10608;3512;9071;266;619;2589;6784;2855;7403
293240;202203;5082;12223;4115;10723;185;307;3081;8445;3266;8752
293245;202203;4324;10926;3916;10344;132;408;3387;8793;3519;9201
293250;202203;6524;14558;5317;12981;261;660;4284;10374;4545;11034
293260;202203;5332;12914;4391;11488;186;378;3163;8389;3349;8767
293270;202203;8344;16856;6662;15069;604;772;5275;12844;5879;13616
293280;202203;4982;12187;4360;11322;278;626;3397;8945;3675;9571
293290;202203;18290;47099;16292;44099;1550;4245;11843;31967;13393;36212
293300;202203;6964;15298;6062;14011;424;936;4636;10576;5060;11512
293305;202203;4782;10624;4101;9771;41;104;3770;8963;3811;9067
293310;202203;2427;5768;2061;5212;37;126;1702;4207;1739;4333
293315;202203;4944;10483;4115;9309;321;505;3354;7701;3675;8206
293317;202203;3214;6785;2861;6294;261;413;2174;4835;2435;5248
293320;202203;14069;30964;12552;29319;158;517;11592;26760;11750;27277
293325;202203;1991;4633;1585;4120;203;510;1057;2767;1260;3277
293330;202203;77271;194437;64361;173354;8673;25164;37190;96164;45863;121328
293340;202203;2389;6368;1951;5605;149;464;1324;3765;1473;4229
293345;202203;4108;10244;3299;9036;350;684;2225;6608;2575;7292
293350;202203;6729;18315;5756;17140;88;327;5189;15628;5277;15955
293360;202203;17589;40033;15238;36965;263;1013;13832;32927;14095;33940
310010;202203;1084;2341;733;1881;79;219;303;732;382;951
310020;202203;3199;8091;2461;6842;455;1312;923;2435;1378;3747
310030;202203;2110;5653;1638;4844;216;701;1090;3142;1306;3843
310040;202203;926;2300;734;1982;71;239;407;976;478;1215
310050;202203;1694;4681;1450;4306;98;378;1020;2939;1118;3317
310060;202203;3588;9329;3089;8678;136;440;2504;7050;2640;7490
310070;202203;362;812;266;677;10;26;200;505;210;531
310080;202203;797;2079;586;1704;74;233;304;846;378;1079
310090;202203;5459;12962;4540;11535;197;617;3635;8983;3832;9600
310100;202203;4068;10067;3455;9120;101;390;2952;7563;3053;7953
310110;202203;5245;12996;4095;11093;602;1858;2361;6090;2963;7948
310120;202203;708;1621;469;1257;58;186;267;640;325;826
310130;202203;427;1043;368;957;20;66;296;749;316;815
310140;202203;333;889;250;774;49;175;119;336;168;511
310150;202203;6725;16186;5132;13438;478;1501;2863;6947;3341;8448
310160;202203;10455;24429;8004;20638;1167;3269;3800;9475;4967;12744
310163;202203;1258;3545;1002;3049;202;676;338;932;540;1608
310170;202203;10693;25105;8694;22139;787;1961;6209;15790;6996;17751
310180;202203;2197;5000;1616;4101;143;448;1079;2599;1222;3047
310190;202203;3023;8263;2501;7377;615;1963;563;1584;1178;3547
310200;202203;2309;6257;1758;5294;233;809;916;2637;1149;3446
310205;202203;1254;3242;1016;2875;126;371;640;1839;766;2210
310210;202203;2720;7018;2224;6134;114;350;1599;4250;1713;4600
310220;202203;1334;3461;1027;2878;80;243;677;1823;757;2066
310230;202203;2465;6434;2010;5612;223;713;1305;3426;1528;4139
310240;202203;1119;3110;965;2864;62;221;673;1919;735;2140
310250;202203;1222;2950;1009;2628;39;109;790;1999;829;2108
310260;202203;3764;9275;2583;7187;653;2131;967;2229;1620;4360
310270;202203;3157;6954;2566;6186;85;234;2185;5246;2270;5480
310280;202203;2873;6213;2333;5478;155;444;1669;3705;1824;4149
310285;202203;2033;6104;1706;5521;157;592;1103;3512;1260;4104
310290;202203;1542;3837;1319;3471;150;482;852;2048;1002;2530
310300;202203;1821;4855;1528;4372;159;557;916;2442;1075;2999
310310;202203;364;827;249;639;38;106;137;329;175;435
310320;202203;566;1349;403;1101;16;63;249;642;265;705
310330;202203;547;1250;332;872;45;126;146;347;191;473
310340;202203;9133;22382;7316;19335;907;2348;4081;10757;4988;13105
310350;202203;14753;34283;10580;27747;1597;4541;5543;13884;7140;18425
310360;202203;647;1381;526;1232;24;66;361;818;385;884
310370;202203;1357;4043;1179;3735;204;711;391;1333;595;2044
310375;202203;948;2255;694;1891;118;332;378;1036;496;1368
310380;202203;421;943;240;668;25;71;128;335;153;406
310390;202203;572;1614;455;1396;77;267;189;522;266;789
310400;202203;13063;30520;9851;25758;650;2093;6645;16600;7295;18693
310410;202203;1179;3301;678;2224;76;276;266;793;342;1069
310420;202203;5202;12888;3884;10592;502;1534;1981;4974;2483;6508
310430;202203;1895;4897;1322;3889;215;651;575;1499;790;2150
310440;202203;730;1823;517;1449;48;170;275;713;323;883
310445;202203;1506;4030;1130;3322;89;257;786;2249;875;2506
310450;202203;4999;11862;3858;10101;161;568;3035;7708;3196;8276
310460;202203;1965;5004;1531;4248;207;645;653;1641;860;2286
310470;202203;3994;8540;3115;7400;325;668;2145;5265;2470;5933
310480;202203;1112;2731;859;2326;93;298;529;1347;622;1645
310490;202203;3195;8250;2554;7236;304;1023;1482;3915;1786;4938
310500;202203;1575;4020;1215;3451;185;591;707;1922;892;2513
310510;202203;2463;6143;1760;4886;261;777;843;2250;1104;3027
310520;202203;1278;3158;941;2554;152;416;485;1319;637;1735
310530;202203;859;2102;615;1696;100;328;232;525;332;853
310540;202203;3374;9141;2793;8095;443;1453;1457;3885;1900;5338
310550;202203;1416;3336;1033;2715;71;249;650;1565;721;1814
310560;202203;17977;44782;13104;36167;1577;4834;6359;15802;7936;20636
310570;202203;1166;2890;932;2565;46;162;744;2006;790;2168
310590;202203;4786;11864;3846;10172;224;717;2434;6007;2658;6724
310600;202203;1518;4226;1258;3701;155;513;693;1905;848;2418
310610;202203;529;1401;354;1121;114;385;79;240;193;625
310620;202203;225797;542868;172458;449909;18562;57621;98778;234236;117340;291857
310630;202203;5181;13505;4061;11361;442;1306;2485;6751;2927;8057
310640;202203;1498;3913;1239;3439;142;478;751;1917;893;2395
310650;202203;2708;7021;2023;5776;145;507;1319;3571;1464;4078
310660;202203;1559;3866;1295;3507;34;100;1133;3036;1167;3136
310665;202203;1573;3720;1307;3371;23;70;1069;2779;1092;2849
310670;202203;68903;166508;58606;149840;4555;13609;42080;102151;46635;115760
310680;202203;873;1918;725;1717;28;101;608;1372;636;1473
310690;202203;2478;5795;1837;4818;131;430;1233;3021;1364;3451
310700;202203;544;1116;424;972;7;21;332;731;339;752
310710;202203;6831;18162;5013;15441;1036;3780;1037;2916;2073;6696
310720;202203;1213;2676;962;2368;31;113;746;1759;777;1872
310730;202203;11461;28173;9842;25732;361;1245;7612;19260;7973;20505
310740;202203;7342;19087;5503;15546;694;2275;2528;6454;3222;8729
310750;202203;1459;3284;1135;2831;76;233;724;1658;800;1891
310760;202203;770;1852;556;1525;43;122;345;929;388;1051
310770;202203;1180;3074;833;2548;86;321;430;1210;516;1531
310780;202203;4747;10535;3943;9480;167;424;3085;7392;3252;7816
310790;202203;1997;6062;1728;5488;389;1392;357;958;746;2350
310800;202203;2604;7399;1925;6079;484;1742;149;419;633;2161
310810;202203;1489;3445;1245;3060;46;135;941;2201;987;2336
310820;202203;1300;3185;819;2402;167;500;226;674;393;1174
310825;202203;2965;7970;2390;7064;66;339;1995;5691;2061;6030
310830;202203;2228;5861;1703;4913;315;1054;781;2089;1096;3143
310840;202203;2440;6299;1852;5330;378;1280;603;1501;981;2781
310850;202203;1502;3995;1248;3624;46;224;969;2705;1015;2929
310855;202203;3473;8649;2717;7462;168;509;1998;5363;2166;5872
310860;202203;7556;20604;6192;18123;629;1773;3927;11590;4556;13363
310870;202203;1034;2375;828;2092;57;162;612;1507;669;1669
310880;202203;1046;3005;845;2614;102;323;498;1520;600;1843
310890;202203;2475;6823;1644;5171;324;1100;283;783;607;1883
310900;202203;4405;11790;3236;9404;500;1624;1482;3931;1982;5555
310910;202203;2439;5678;1734;4598;246;705;444;1086;690;1791
310920;202203;2109;5205;1626;4505;138;432;1087;2920;1225;3352
310925;202203;1162;2804;942;2482;46;158;732;1833;778;1991
310930;202203;6223;15322;4476;12589;817;2290;2213;6489;3030;8779
310940;202203;7737;16697;6348;14752;214;601;5166;11643;5380;12244
310945;202203;1456;3553;1153;3065;147;448;689;1739;836;2187
310950;202203;2081;5932;1403;4456;244;871;440;1190;684;2061
310960;202203;794;2035;476;1397;79;263;123;338;202;601
310970;202203;1283;3673;945;2996;230;756;200;616;430;1372
310980;202203;374;834;205;549;16;42;104;268;120;310
310990;202203;1518;3883;1224;3402;137;432;747;1973;884;2405
311000;202203;4356;11446;3274;9742;618;2029;1669;4722;2287;6751
311010;202203;1104;2813;910;2488;194;560;493;1325;687;1885
311020;202203;1271;3120;847;2388;46;148;478;1290;524;1438
311030;202203;2019;4788;1480;3923;307;946;676;1663;983;2609
311040;202203;327;973;272;860;78;270;83;248;161;518
311050;202203;3387;8087;2591;6931;366;1110;1396;3592;1762;4702
311060;202203;3740;9129;2839;7571;382;1148;1279;3143;1661;4291
311070;202203;2718;6312;1968;5188;211;722;1122;2695;1333;3417
311080;202203;1272;2751;1030;2386;47;157;817;1781;864;1938
311090;202203;2589;7625;2123;6788;428;1496;783;2456;1211;3952
311100;202203;2696;7267;1705;5349;341;1195;439;1205;780;2400
311110;202203;4198;8360;2392;5816;495;1209;729;1805;1224;3014
311115;202203;1551;3211;1303;2891;46;103;1098;2388;1144;2491
311120;202203;7758;19444;6023;16438;855;2648;2493;6013;3348;8661
311130;202203;2070;5224;1582;4573;118;418;963;2706;1081;3124
311140;202203;1686;3986;1323;3493;108;311;928;2414;1036;2725
311150;202203;1625;4909;1297;4303;167;637;708;2263;875;2900
311160;202203;4433;12031;3266;9954;624;2159;1337;3835;1961;5994
311170;202203;1008;2477;826;2241;42;122;527;1521;569;1643
311180;202203;1560;3338;1034;2584;172;435;546;1337;718;1772
311190;202203;941;2532;714;2100;113;375;293;739;406;1114
311200;202203;2465;6310;1823;5110;299;929;758;1899;1057;2828
311205;202203;1008;2738;841;2444;38;143;573;1558;611;1701
311210;202203;1159;3172;1026;2993;115;298;749;2268;864;2566
311220;202203;908;2279;778;2050;27;101;581;1422;608;1523
311230;202203;8857;24961;6814;21007;1108;3535;2829;8789;3937;12324
311240;202203;1195;2930;938;2575;156;461;484;1298;640;1759
311250;202203;1402;3749;1108;3230;193;618;483;1312;676;1930
311260;202203;3041;7105;1998;5352;260;808;977;2306;1237;3114
311265;202203;1464;3512;1089;2920;51;177;794;2067;845;2244
311270;202203;3282;9250;2855;8577;155;692;2113;6080;2268;6772
311280;202203;1231;3140;681;2067;126;432;151;410;277;842
311290;202203;2066;5911;1872;5538;115;388;1305;3804;1420;4192
311300;202203;5200;13411;4317;11968;210;734;3506;9506;3716;10240
311310;202203;630;1660;537;1498;30;89;367;989;397;1078
311320;202203;3580;10354;3125;9394;276;1051;1741;4754;2017;5805
311330;202203;6689;15559;5365;13558;485;1350;3268;8131;3753;9481
311340;202203;11962;31435;9605;27451;2081;6526;3460;9317;5541;15843
311350;202203;2670;6167;1978;4989;173;491;1140;2596;1313;3087
311360;202203;1212;2843;837;2326;228;671;323;930;551;1601
311370;202203;5291;12167;3956;10127;303;958;2518;6028;2821;6986
311380;202203;423;1245;315;1029;56;184;154;503;210;687
311390;202203;1905;5551;1526;5051;632;2346;451;1347;1083;3693
311400;202203;1788;4639;1320;3791;229;677;399;991;628;1668
311410;202203;2098;5828;1698;5203;228;824;1001;2933;1229;3757
311420;202203;1748;4869;1316;4061;275;991;437;1119;712;2110
311430;202203;4910;12340;3374;9429;475;1406;1454;3839;1929;5245
311440;202203;3368;8850;2603;7616;661;2208;677;1900;1338;4108
311450;202203;2185;6200;1547;4973;397;1451;374;999;771;2450
311455;202203;1155;2512;817;2031;108;259;462;1140;570;1399
311460;202203;614;1782;419;1373;80;300;98;263;178;563
311470;202203;569;1656;398;1289;103;369;63;211;166;580
311480;202203;1237;2870;1022;2555;76;189;792;1967;868;2156
311490;202203;284;804;223;704;35;137;99;278;134;415
311500;202203;528;1244;412;1074;27;83;273;687;300;770
311510;202203;3723;9000;2664;7266;289;914;1310;3284;1599;4198
311520;202203;710;1864;625;1708;56;182;389;1049;445;1231
311530;202203;9798;21891;6665;17103;1309;3832;2443;5919;3752;9751
311535;202203;926;2403;658;1867;97;296;288;762;385;1058
311540;202203;549;1614;488;1504;55;202;365;1100;420;1302
311545;202203;2181;5939;1889;5500;96;342;1486;4266;1582;4608
311547;202203;1800;4002;1584;3694;50;101;1286;2936;1336;3037
311550;202203;3294;8495;2694;7474;384;1181;1258;3262;1642;4443
311560;202203;347;709;215;502;40;99;77;150;117;249
311570;202203;1681;3760;1187;3083;40;110;910;2403;950;2513
311580;202203;2459;4530;1712;3640;142;279;1222;2555;1364;2834
311590;202203;603;1522;495;1369;66;201;307;831;373;1032
311600;202203;1763;3987;1467;3596;129;363;1127;2691;1256;3054
311610;202203;2539;7380;2121;6604;138;523;1403;4209;1541;4732
311615;202203;3752;9676;3047;8556;121;448;2491;6830;2612;7278
311620;202203;572;1461;457;1307;61;197;273;739;334;936
311630;202203;1464;3824;1224;3362;144;403;763;2069;907;2472
311640;202203;823;2124;663;1877;71;250;364;957;435;1207
311650;202203;2142;5072;1737;4465;189;515;1086;2715;1275;3230
311660;202203;3279;8984;2475;7448;392;1337;707;1705;1099;3042
311670;202203;1780;4319;1334;3542;149;452;681;1762;830;2214
311680;202203;2490;6483;1925;5522;129;373;1390;4001;1519;4374
311690;202203;676;1376;521;1184;27;57;399;928;426;985
311700;202203;2332;5324;1817;4598;25;114;1533;3768;1558;3882
311710;202203;1734;4739;1282;3975;295;970;487;1505;782;2475
311720;202203;467;1308;380;1157;45;151;205;626;250;777
311730;202203;4518;10988;3132;8372;761;2133;1224;3100;1985;5233
311740;202203;1074;2640;902;2406;70;154;746;2045;816;2199
311750;202203;4437;12293;3627;10930;331;1204;2440;6988;2771;8192
311760;202203;744;1986;602;1754;90;315;262;643;352;958
311770;202203;2470;6634;1948;5732;327;1031;877;2452;1204;3483
311780;202203;1559;4251;1181;3564;211;706;437;1168;648;1874
311783;202203;2543;6375;2087;5648;60;249;1715;4471;1775;4720
311787;202203;916;2527;731;2130;101;323;331;840;432;1163
311790;202203;1676;4432;1139;3448;218;744;386;1079;604;1823
311800;202203;5722;16332;4628;14063;967;3020;853;2115;1820;5135
311810;202203;1031;2896;825;2543;53;177;557;1698;610;1875
311820;202203;958;2189;752;1892;48;163;518;1212;566;1375
311830;202203;9428;25624;6893;20397;1983;6080;1313;3792;3296;9872
311840;202203;4219;9929;3413;8812;225;591;2608;6719;2833;7310
311850;202203;392;972;313;835;15;54;219;553;234;607
311860;202203;74994;178069;59472;152422;6401;18580;37751;91198;44152;109778
311870;202203;2070;5294;1485;4303;267;937;650;1716;917;2653
311880;202203;7121;17273;5980;15704;356;876;4516;12041;4872;12917
311890;202203;1954;4368;1539;3815;58;203;1180;2744;1238;2947
311900;202203;817;1975;623;1717;90;238;369;1049;459;1287
311910;202203;4652;11172;3592;9796;648;1797;1860;5156;2508;6953
311920;202203;2377;5823;1926;5191;121;297;1325;3595;1446;3892
311930;202203;4778;10429;3559;8806;754;2049;1681;3868;2435;5917
311940;202203;17684;43756;13179;35658;1701;5100;6325;15865;8026;20965
311950;202203;2617;6505;2000;5452;165;483;1290;3494;1455;3977
311960;202203;541;1285;432;1125;47;146;233;543;280;689
311970;202203;477;1470;360;1188;76;294;98;278;174;572
311980;202203;512;1309;275;853;30;105;108;307;138;412
311990;202203;585;1348;386;1052;60;201;171;414;231;615
311995;202203;1051;2843;559;1719;33;125;80;152;113;277
312000;202203;891;2017;670;1696;40;115;488;1225;528;1340
312010;202203;1169;2925;937;2571;38;150;688;1793;726;1943
312015;202203;1519;4091;1351;3830;61;249;1095;3014;1156;3263
312020;202203;1961;5727;1420;4532;262;903;340;961;602;1864
312030;202203;2328;5157;2024;4822;14;67;1919;4540;1933;4607
312040;202203;918;2599;667;2109;100;325;305;930;405;1255
312050;202203;1343;3906;1107;3487;236;931;431;1211;667;2142
312060;202203;1052;2465;702;1998;151;440;347;968;498;1408
312070;202203;1004;2697;733;2179;41;152;445;1224;486;1376
312080;202203;3103;7290;2409;6281;127;390;1687;4157;1814;4547
312083;202203;1039;2488;808;2145;50;177;620;1582;670;1759
312087;202203;2838;6749;2317;5965;78;207;1907;4900;1985;5107
312090;202203;12240;30325;9764;26473;1082;3429;5708;14598;6790;18027
312100;202203;1801;4761;1421;4119;85;354;954;2598;1039;2952
312110;202203;1100;3257;914;2887;169;638;403;1159;572;1797
312120;202203;1119;2949;807;2426;189;666;270;692;459;1358
312125;202203;2070;4926;1771;4527;90;273;1434;3559;1524;3832
312130;202203;1246;2861;928;2338;87;255;467;1052;554;1307
312140;202203;774;2177;648;1929;98;315;329;924;427;1239
312150;202203;531;1386;455;1247;27;86;308;787;335;873
312160;202203;10281;26143;8110;22463;900;2899;4309;11266;5209;14165
312170;202203;997;2476;769;2068;46;146;517;1339;563;1485
312180;202203;1537;3892;1261;3417;135;402;740;1923;875;2325
312190;202203;823;2125;631;1796;66;217;328;879;394;1096
312200;202203;5203;13212;4150;11556;604;1675;2371;6503;2975;8178
312210;202203;1516;3203;1141;2695;49;164;898;2057;947;2221
312220;202203;1784;5148;1547;4733;112;397;1049;3186;1161;3583
312230;202203;18467;45058;13369;36298;2720;8396;4368;10168;7088;18564
312235;202203;2285;5336;1830;4708;148;390;1312;3288;1460;3678
312240;202203;859;2616;668;2228;147;510;224;740;371;1250
312245;202203;3165;7141;2663;6419;41;123;2358;5579;2399;5702
312247;202203;1187;2554;866;2110;86;224;590;1395;676;1619
312250;202203;1017;2622;654;1933;97;304;233;668;330;972
312260;202203;1090;2696;876;2378;45;170;704;1824;749;1994
312270;202203;784;2106;607;1763;36;144;342;903;378;1047
312280;202203;468;1311;371;1138;81;273;109;304;190;577
312290;202203;970;2654;809;2390;149;495;300;816;449;1311
312300;202203;1178;3408;843;2622;187;650;192;486;379;1136
312310;202203;1059;2997;859;2613;114;410;464;1344;578;1754
312320;202203;2304;5580;1700;4585;342;932;459;1209;801;2141
312330;202203;1007;2696;843;2382;88;277;532;1434;620;1711
312340;202203;274;673;197;554;28;107;114;281;142;388
312350;202203;297;587;207;487;13;34;140;301;153;335
312352;202203;1665;4846;1471;4483;212;657;780;2569;992;3226
312360;202203;3536;9639;2705;8155;463;1596;1154;3204;1617;4800
312370;202203;2167;5283;1811;4732;173;548;1192;2942;1365;3490
312380;202203;2427;5186;2022;4680;6;20;1810;4111;1816;4131
312385;202203;1379;3514;1077;2989;310;885;304;895;614;1780
312390;202203;2144;5795;1604;4805;245;831;488;1293;733;2124
312400;202203;3340;8983;2852;8201;789;2447;1026;2990;1815;5437
312410;202203;14672;37303;12173;33376;1515;4572;7829;20711;9344;25283
312420;202203;4444;11089;3678;9896;693;2014;1977;5145;2670;7159
312430;202203;9279;22570;7634;19785;277;907;5802;14504;6079;15411
312440;202203;1090;3326;913;2969;418;1409;189;619;607;2028
312450;202203;1454;3996;1126;3428;245;791;505;1533;750;2324
312460;202203;521;1248;383;1045;38;119;240;642;278;761
312470;202203;518;1248;332;919;47;144;105;244;152;388
312480;202203;1142;2747;826;2286;73;257;481;1251;554;1508
312490;202203;2667;5765;2159;5083;162;427;1401;3184;1563;3611
312500;202203;1171;2671;983;2424;34;122;763;1856;797;1978
312510;202203;4740;12145;3533;9960;810;2256;1138;3052;1948;5308
312520;202203;352;844;282;741;43;143;168;418;211;561
312530;202203;759;1683;642;1546;31;73;495;1228;526;1301
312540;202203;1747;4539;1214;3553;132;399;698;1981;830;2380
312550;202203;898;2255;698;1882;48;158;472;1174;520;1332
312560;202203;2025;5143;1615;4507;104;309;1151;3204;1255;3513
312570;202203;2846;6297;2164;5461;421;978;1165;3040;1586;4018
312580;202203;671;1746;479;1365;56;195;225;580;281;775
312590;202203;1712;4651;1338;3928;123;431;803;2142;926;2573
312595;202203;2276;6174;1887;5571;249;642;1197;3741;1446;4383
312600;202203;1361;3170;896;2254;125;383;243;647;368;1030
312610;202203;7965;19378;5509;14980;756;2327;2160;5227;2916;7554
312620;202203;2741;6679;2076;5754;65;254;1668;4644;1733;4898
312630;202203;355;944;254;766;43;158;110;308;153;466
312640;202203;584;1548;435;1310;40;149;235;675;275;824
312650;202203;2311;5436;1657;4267;62;195;1215;2931;1277;3126
312660;202203;1468;3341;1136;2803;102;254;785;1850;887;2104
312670;202203;6046;14246;5076;12773;151;633;4038;9575;4189;10208
312675;202203;1374;3348;1126;2997;43;139;935;2440;978;2579
312680;202203;1697;4186;1505;3909;49;193;1309;3287;1358;3480
312690;202203;3205;6571;2446;5646;100;198;1997;4616;2097;4814
312695;202203;1143;2782;971;2510;40;83;794;2029;834;2112
312700;202203;2273;5792;1706;4808;160;523;1004;2691;1164;3214
312705;202203;1714;3635;1505;3344;12;46;1409;3099;1421;3145
312707;202203;1566;4227;1165;3535;70;307;779;2232;849;2539
312710;202203;7620;16889;4896;12807;1145;2932;1707;4648;2852;7580
312720;202203;1195;2972;904;2522;94;305;600;1587;694;1892
312730;202203;1752;3981;1254;3310;103;309;794;2035;897;2344
312733;202203;1476;3748;1119;3093;45;157;768;1991;813;2148
312735;202203;851;2105;681;1792;60;163;436;1068;496;1231
312737;202203;885;1869;643;1534;56;151;457;1055;513;1206
312738;202203;838;1992;607;1603;50;152;388;954;438;1106
312740;202203;478;1183;299;888;61;203;88;199;149;402
312750;202203;1670;4551;1247;3780;163;556;608;1727;771;2283
312760;202203;1999;5595;1466;4532;227;728;593;1772;820;2500
312770;202203;49723;114991;32572;86277;5479;15804;13075;33056;18554;48860
312780;202203;2808;7642;2388;6957;248;763;1592;4572;1840;5335
312790;202203;263;605;139;406;4;18;36;71;40;89
312800;202203;5887;15379;4629;13102;626;2034;2490;6640;3116;8674
312810;202203;1732;4462;1176;3551;273;888;450;1263;723;2151
312820;202203;1926;4871;1569;4270;86;249;1148;3073;1234;3322
312825;202203;1612;3405;1390;3126;23;65;1221;2687;1244;2752
312830;202203;3065;8232;1992;6141;417;1396;578;1691;995;3087
312840;202203;1618;4009;1281;3470;101;342;775;1983;876;2325
312850;202203;1142;2507;830;2068;25;100;567;1298;592;1398
312860;202203;1202;2985;838;2435;192;599;265;696;457;1295
312870;202203;6691;17205;4356;12901;705;2236;1295;3481;2000;5717
312880;202203;1611;3869;1271;3323;73;193;767;1994;840;2187
312890;202203;2532;5924;1895;4913;122;274;1100;2809;1222;3083
312900;202203;1445;3497;1191;3162;116;357;724;1950;840;2307
312910;202203;1641;2954;947;2066;150;306;467;979;617;1285
312920;202203;1054;2726;751;2249;119;424;297;786;416;1210
312930;202203;2657;6157;2038;5248;361;956;1047;2742;1408;3698
312940;202203;1127;2889;910;2594;72;276;543;1460;615;1736
312950;202203;3476;8099;2412;6454;392;1184;1194;3023;1586;4207
312960;202203;2012;4977;1700;4516;104;244;1272;3483;1376;3727
312965;202203;1814;4608;1508;4142;128;367;1031;2813;1159;3180
312970;202203;1689;4485;1376;4001;146;515;891;2450;1037;2965
312980;202203;28148;73431;23102;64664;3932;12044;11794;31067;15726;43111
312990;202203;592;1387;418;1102;61;188;229;551;290;739
313000;202203;516;1407;392;1193;24;107;252;720;276;827
313005;202203;2773;7551;2337;6840;125;389;1736;4954;1861;5343
313010;202203;6081;15633;4909;13770;681;2154;3083;8412;3764;10566
313020;202203;1223;3558;921;2915;152;550;230;639;382;1189
313030;202203;1273;2741;891;2218;53;178;637;1505;690;1683
313040;202203;931;2741;779;2449;39;173;500;1506;539;1679
313050;202203;2007;5264;1428;4399;231;854;449;1263;680;2117
313055;202203;2134;5340;1883;4979;322;841;1343;3545;1665;4386
313060;202203;1117;2624;836;2148;179;542;218;508;397;1050
313065;202203;1805;5023;1594;4677;52;229;1290;3665;1342;3894
313070;202203;1016;2583;799;2238;75;220;468;1281;543;1501
313080;202203;421;1140;318;954;59;198;122;315;181;513
313090;202203;5921;14496;5032;13134;328;907;3516;9121;3844;10028
313100;202203;1464;3626;1160;3191;39;144;875;2345;914;2489
313110;202203;1651;4151;1205;3398;105;354;657;1676;762;2030
313115;202203;3158;8440;2569;7373;266;945;1486;3906;1752;4851
313120;202203;4187;9569;3100;8153;207;547;2121;5632;2328;6179
313130;202203;35965;87696;27696;73232;2587;7997;16450;40672;19037;48669
313140;202203;782;1616;524;1269;26;68;409;978;435;1046
313150;202203;1532;4149;1162;3504;372;1256;237;637;609;1893
313160;202203;1434;3418;1125;2968;24;86;866;2208;890;2294
313170;202203;12701;34124;9614;28489;1590;5203;3818;10239;5408;15442
313180;202203;2644;6626;1963;5249;218;572;1240;3225;1458;3797
313190;202203;4866;13345;3659;11015;631;2075;1395;3840;2026;5915
313200;202203;1273;3220;1097;2915;16;70;942;2431;958;2501
313210;202203;4412;11555;3677;10361;417;1334;2349;6369;2766;7703
313220;202203;1993;5010;1375;3831;167;519;647;1604;814;2123
313230;202203;3098;8293;2528;7581;68;217;2064;6346;2132;6563
313240;202203;11839;27792;8247;22280;942;3022;4477;11272;5419;14294
313250;202203;6908;19308;5350;16031;934;2823;2564;7382;3498;10205
313260;202203;838;2030;612;1667;83;309;333;788;416;1097
313270;202203;6792;15365;5593;13776;473;1068;4281;10718;4754;11786
313280;202203;516;1344;351;1025;45;154;157;433;202;587
313290;202203;1122;3370;867;2913;192;729;350;1151;542;1880
313300;202203;1959;5047;1512;4301;331;1018;530;1365;861;2383
313310;202203;1480;4182;1197;3614;204;729;427;1073;631;1802
313320;202203;2244;5702;1624;4722;309;955;646;1941;955;2896
313330;202203;4597;11349;3528;9790;224;691;2379;6533;2603;7224
313340;202203;1669;3583;1248;3007;78;223;937;2203;1015;2426
313350;202203;3322;8814;2299;6628;233;805;1006;2515;1239;3320
313360;202203;1740;4092;1219;3287;184;616;670;1662;854;2278
313370;202203;1755;4607;1414;3965;252;759;589;1500;841;2259
313375;202203;2072;5223;1380;3992;237;792;396;1019;633;1811
313380;202203;7331;17530;5529;14369;770;2354;2974;6872;3744;9226
313390;202203;873;2637;759;2436;53;233;529;1627;582;1860
313400;202203;4152;9605;3224;8293;147;435;2476;6226;2623;6661
313410;202203;1544;3775;1151;3103;169;495;691;1781;860;2276
313420;202203;17329;37488;9783;25268;2400;6675;1692;4325;4092;11000
313430;202203;1208;3080;989;2680;90;346;642;1538;732;1884
313440;202203;7217;14699;5128;12073;212;564;3860;8895;4072;9459
313450;202203;825;2088;601;1688;104;319;226;540;330;859
313460;202203;2445;6565;1963;5814;358;1189;994;2838;1352;4027
313470;202203;3097;7521;2472;6609;145;462;1882;4955;2027;5417
313480;202203;1170;3203;733;2276;73;255;272;768;345;1023
313490;202203;3381;8136;1894;5489;334;1068;588;1600;922;2668
313500;202203;638;1637;473;1308;39;112;213;541;252;653
313505;202203;11133;27843;9489;25608;332;1068;7733;20819;8065;21887
313507;202203;1553;3815;1248;3358;42;161;1007;2638;1049;2799
313510;202203;16328;42322;12835;35621;1315;3921;6947;18263;8262;22184
313520;202203;16877;42979;13634;37650;663;2215;10566;28362;11229;30577
313530;202203;638;1807;482;1482;60;218;200;529;260;747
313535;202203;2576;6838;2116;5982;225;609;1340;3759;1565;4368
313540;202203;928;2566;746;2150;108;334;367;963;475;1297
313545;202203;1249;3901;1067;3561;109;440;614;1961;723;2401
313550;202203;2239;6142;1880;5324;198;640;1254;3436;1452;4076
313560;202203;3124;5634;2363;4728;40;79;2088;4140;2128;4219
313570;202203;1110;3020;925;2701;171;510;458;1318;629;1828
313580;202203;6624;15554;5243;13345;415;1145;3519;8725;3934;9870
313590;202203;1261;3191;1031;2871;198;558;566;1660;764;2218
313600;202203;4731;11299;3979;10180;79;304;3521;8812;3600;9116
313610;202203;1148;2721;938;2370;68;199;642;1538;710;1737
313620;202203;6115;15382;4963;13361;455;1462;3197;8273;3652;9735
313630;202203;9904;22892;7146;18812;669;2095;4499;11421;5168;13516
313640;202203;1398;2828;910;2209;89;244;614;1464;703;1708
313650;202203;1807;5198;1427;4569;108;408;923;2987;1031;3395
313652;202203;935;2573;844;2419;61;219;639;1746;700;1965
313655;202203;1277;2982;997;2636;74;203;718;1896;792;2099
313657;202203;1273;3177;1008;2767;37;134;763;1964;800;2098
313660;202203;1185;3037;990;2708;65;250;720;1857;785;2107
313665;202203;6034;14923;4870;12948;358;1120;3346;8393;3704;9513
313670;202203;58745;138149;40166;107724;4993;15050;20301;51228;25294;66278
313680;202203;1198;2938;998;2619;49;141;702;1769;751;1910
313690;202203;1045;2976;759;2415;150;526;242;710;392;1236
313695;202203;2018;5058;1523;4251;115;312;1023;2926;1138;3238
313700;202203;3100;9215;2689;8685;224;787;2145;6958;2369;7745
313710;202203;1627;3516;1184;2946;87;227;824;2051;911;2278
313720;202203;6802;17729;4984;14095;678;2076;2226;5706;2904;7782
313730;202203;1585;3221;1191;2720;89;176;797;1820;886;1996
313740;202203;1828;6299;1554;5628;346;1446;387;1247;733;2693
313750;202203;2397;5929;1922;5153;289;890;1104;2722;1393;3612
313753;202203;2404;5639;1620;4379;172;527;852;2224;1024;2751
313760;202203;6432;16877;5118;14461;823;2587;2621;6834;3444;9421
313770;202203;4519;11981;3594;10562;198;557;2742;8181;2940;8738
313780;202203;4528;11265;3403;9514;447;1188;1183;3434;1630;4622
313790;202203;617;1707;543;1571;66;208;343;960;409;1168
313800;202203;1534;3258;1129;2711;95;267;668;1509;763;1776
313810;202203;1883;4406;1530;3919;54;200;1251;3111;1305;3311
313820;202203;19622;48336;13074;34808;2099;5776;3901;9785;6000;15561
313830;202203;450;1252;332;1003;58;191;140;393;198;584
313835;202203;980;2704;813;2422;73;285;473;1309;546;1594
313840;202203;8731;21725;6922;18854;1463;4231;2061;5649;3524;9880
313850;202203;1091;2531;871;2234;126;376;472;1122;598;1498
313860;202203;3038;7573;2347;6364;304;997;1207;2958;1511;3955
313862;202203;1349;2798;696;1871;39;120;343;938;382;1058
313865;202203;2874;7120;2380;6350;79;254;1836;4734;1915;4988
313867;202203;1562;4497;1293;4013;229;718;691;2233;920;2951
313868;202203;1893;5361;1549;4736;53;227;1208;3550;1261;3777
313870;202203;1150;2822;782;2174;89;259;352;885;441;1144
313880;202203;2177;5402;1651;4528;173;562;946;2380;1119;2942
313890;202203;2489;4853;1886;4083;43;116;1489;3121;1532;3237
313900;202203;5597;15051;4040;11869;878;2868;1244;3221;2122;6089
313910;202203;818;2296;628;1920;121;389;158;473;279;862
313920;202203;3184;9012;2680;8035;433;1389;1475;4383;1908;5772
313925;202203;1812;4273;1476;3719;134;333;1015;2534;1149;2867
313930;202203;5442;14674;4429;12951;270;961;3134;8932;3404;9893
313940;202203;10604;29050;8224;25134;1357;4440;2282;7607;3639;12047
313950;202203;6165;12665;4808;11014;262;695;3493;7934;3755;8629
313960;202203;6419;14713;4334;11281;753;2222;1569;3658;2322;5880
313970;202203;1725;4342;1473;3936;54;158;1002;2595;1056;2753
313980;202203;1473;3710;1026;3037;177;595;463;1309;640;1904
313990;202203;2188;6496;1683;5432;281;1093;836;2419;1117;3512
314000;202203;11441;27258;9431;23983;650;2056;6384;15926;7034;17982
314010;202203;1555;3548;1233;3114;41;143;954;2314;995;2457
314015;202203;2367;6114;1886;5312;190;636;1138;3033;1328;3669
314020;202203;580;1487;396;1179;105;365;70;224;175;589
314030;202203;900;2438;712;2096;102;310;351;1015;453;1325
314040;202203;681;1789;571;1591;74;251;321;853;395;1104
314050;202203;2135;5349;1602;4409;120;415;983;2500;1103;2915
314053;202203;2255;6180;1819;5336;272;751;1098;3316;1370;4067
314055;202203;2509;6058;2131;5512;66;202;1777;4582;1843;4784
314060;202203;1462;3675;1112;3127;35;118;799;2210;834;2328
314070;202203;5434;13855;4394;12098;663;1897;2358;6335;3021;8232
314080;202203;2268;5671;1658;4694;155;516;807;2093;962;2609
314085;202203;2594;6639;2108;5949;194;568;1362;3839;1556;4407
314090;202203;5649;13785;4908;12743;385;998;3376;9058;3761;10056
314100;202203;3283;7652;2551;6647;52;163;1901;4988;1953;5151
314110;202203;5562;14775;4600;13045;468;1494;2669;6978;3137;8472
314120;202203;776;1728;362;997;71;225;121;292;192;517
314130;202203;734;1860;494;1421;27;93;308;857;335;950
314140;202203;5079;13157;4085;11394;408;1252;2400;6445;2808;7697
314150;202203;1620;3897;1192;3179;76;226;816;2123;892;2349
314160;202203;2582;6255;1924;5130;209;595;961;2500;1170;3095
314170;202203;1028;2724;841;2366;42;173;577;1496;619;1669
314180;202203;6155;15856;4969;14015;425;1258;3033;8545;3458;9803
314190;202203;692;1655;521;1415;63;203;316;803;379;1006
314200;202203;3274;8722;2726;7834;189;579;1891;5334;2080;5913
314210;202203;2296;5657;1844;4888;289;806;791;2013;1080;2819
314220;202203;1750;4542;1389;3964;214;726;670;1762;884;2488
314225;202203;1190;3275;981;2904;94;265;674;1957;768;2222
314230;202203;959;2376;784;2140;79;222;531;1456;610;1678
314240;202203;1210;3118;949;2736;193;596;433;1226;626;1822
314250;202203;501;1393;333;1042;36;122;137;383;173;505
314260;202203;1243;3043;990;2710;196;546;513;1362;709;1908
314270;202203;3694;9769;3063;8801;105;394;2307;6539;2412;6933
314280;202203;3950;8782;2792;7073;264;763;1735;4117;1999;4880
314290;202203;5007;12170;4210;10823;276;753;3009;7533;3285;8286
314300;202203;2248;6099;1473;4486;277;924;521;1420;798;2344
314310;202203;4262;10864;2957;8709;866;2854;471;1249;1337;4103
314315;202203;1064;3166;902;2842;54;223;656;2018;710;2241
314320;202203;3581;9200;2442;7135;391;1296;1034;2815;1425;4111
314330;202203;58289;156175;45372;134114;10560;32429;13151;39196;23711;71625
314340;202203;2847;6864;1890;5215;363;1146;624;1484;987;2630
314345;202203;1633;4434;1347;3941;101;319;962;2730;1063;3049
314350;202203;913;2406;618;1886;141;474;153;364;294;838
314360;202203;605;1686;415;1298;57;192;132;370;189;562
314370;202203;824;2069;671;1843;46;158;464;1214;510;1372
314380;202203;1260;3282;871;2637;207;700;254;738;461;1438
314390;202203;16377;39183;11590;31062;1615;4888;4843;11481;6458;16369
314400;202203;4392;12588;3423;10717;854;2774;1384;4521;2238;7295
314410;202203;3255;8786;2308;6976;387;1340;619;1865;1006;3205
314420;202203;892;2099;666;1752;28;96;453;1127;481;1223
314430;202203;8947;20256;6458;16356;876;2372;3334;8043;4210;10415
314435;202203;2068;5303;1618;4597;221;669;964;2681;1185;3350
314437;202203;985;2386;713;1950;62;176;423;1149;485;1325
314440;202203;667;1845;483;1490;139;475;118;313;257;788
314450;202203;1636;4071;1356;3628;155;461;788;2006;943;2467
314460;202203;3662;10506;2802;8836;681;2289;930;2731;1611;5020
314465;202203;2524;6744;2132;6044;52;221;1678;4562;1730;4783
314467;202203;1056;2611;889;2339;43;122;672;1716;715;1838
314470;202203;2509;6818;2090;6029;297;942;1080;2939;1377;3881
314480;202203;8673;22936;6754;19106;992;3124;2997;7595;3989;10719
314490;202203;1182;2929;872;2337;63;201;592;1519;655;1720
314500;202203;1939;4443;1413;3770;311;808;595;1620;906;2428
314505;202203;2384;5304;1953;4716;102;265;1517;3550;1619;3815
314510;202203;2233;5608;1624;4709;339;1070;730;2083;1069;3153
314520;202203;6220;17939;4947;15518;1106;3833;1117;3185;2223;7018
314530;202203;5992;17679;5381;16599;288;1180;4131;12338;4419;13518
314535;202203;2954;7015;2384;6205;111;343;1872;4863;1983;5206
314537;202203;1307;3473;1013;3008;56;170;744;2171;800;2341
314540;202203;475;1120;349;922;16;41;215;538;231;579
314545;202203;2180;4804;1966;4561;36;84;1733;4094;1769;4178
314550;202203;837;1915;584;1526;41;138;348;823;389;961
314560;202203;5252;14633;4000;12047;519;1904;1743;4586;2262;6490
314570;202203;341;921;244;744;21;76;130;401;151;477
314580;202203;516;1478;415;1285;91;279;169;508;260;787
314585;202203;729;2108;574;1784;50;190;287;842;337;1032
314587;202203;2493;6278;1951;5433;378;936;1129;3206;1507;4142
314590;202203;4726;12086;3656;10205;416;1345;1858;4796;2274;6141
314600;202203;2052;5381;1324;4043;330;1044;180;515;510;1559
314610;202203;10348;24719;8016;21222;970;3102;4070;11122;5040;14224
314620;202203;2635;5687;2150;5088;92;221;1816;4285;1908;4506
314625;202203;1699;4320;1458;3986;29;156;1270;3402;1299;3558
314630;202203;5861;13897;4774;12422;164;514;3962;10235;4126;10749
314640;202203;835;1813;636;1506;49;149;441;960;490;1109
314650;202203;928;2072;615;1590;61;195;373;866;434;1061
314655;202203;1690;4448;1226;3655;164;488;637;1917;801;2405
314660;202203;377;810;274;638;13;32;192;426;205;458
314670;202203;1821;3904;1279;3163;27;84;899;2143;926;2227
314675;202203;1875;4560;1597;4117;85;233;1257;3170;1342;3403
314690;202203;2234;5852;1697;5061;401;1222;716;2129;1117;3351
314700;202203;12627;33046;8815;26150;1442;4695;3888;10967;5330;15662
314710;202203;9194;24573;6908;19900;976;3165;2865;7277;3841;10442
314720;202203;2509;7139;1814;5751;351;1209;428;1214;779;2423
314730;202203;2721;6790;1965;5463;324;995;772;1950;1096;2945
314740;202203;3488;9250;2785;8042;399;1241;1510;4197;1909;5438
314750;202203;318;816;249;675;26;81;152;366;178;447
314760;202203;2113;5979;1428;4508;234;873;407;1025;641;1898
314770;202203;1165;3252;713;2195;90;280;227;657;317;937
314780;202203;400;966;291;799;29;100;166;415;195;515
314790;202203;13307;33829;9772;27559;1427;4666;4526;12059;5953;16725
314795;202203;1681;4163;1437;3771;36;154;1163;2921;1199;3075
314800;202203;12379;30407;8269;23151;1396;4304;2744;6829;4140;11133
314810;202203;10691;26912;8085;22609;1948;5784;3134;8485;5082;14269
314820;202203;1456;3298;1150;2855;75;241;751;1773;826;2014
314830;202203;1891;5141;1584;4623;164;523;944;2654;1108;3177
314840;202203;953;2822;751;2465;47;226;548;1710;595;1936
314850;202203;2594;5247;2109;4656;44;132;1887;4125;1931;4257
314860;202203;3627;9832;3051;8838;158;619;2242;6269;2400;6888
314870;202203;7403;16200;5716;14135;261;636;4405;11053;4666;11689
314875;202203;2094;5863;1861;5561;165;437;1466;4474;1631;4911
314880;202203;905;2115;703;1806;41;118;452;1131;493;1249
314890;202203;504;1422;392;1211;57;195;192;541;249;736
314900;202203;937;2278;726;1925;90;266;367;946;457;1212
314910;202203;1872;5036;1406;4288;203;739;742;2119;945;2858
314915;202203;2328;6507;1940;5830;137;487;1316;3865;1453;4352
314920;202203;561;1399;391;1157;17;56;273;816;290;872
314930;202203;6529;17512;5122;14950;803;2684;2326;6206;3129;8890
314940;202203;449;1031;374;912;26;63;267;617;293;680
314950;202203;651;1550;460;1264;40;147;264;659;304;806
314960;202203;1006;2219;791;1882;50;133;585;1330;635;1463
314970;202203;1192;3376;928;2864;141;470;434;1240;575;1710
314980;202203;1895;4628;1473;4015;190;602;904;2381;1094;2983
314990;202203;2967;8191;2197;6542;365;1156;603;1617;968;2773
314995;202203;1854;4861;1488;4227;46;188;1006;2688;1052;2876
315000;202203;1234;2999;908;2496;85;267;589;1574;674;1841
315010;202203;431;1122;342;981;39;145;201;540;240;685
315015;202203;2659;6948;2328;6408;219;717;1619;4331;1838;5048
315020;202203;866;2420;637;1951;69;273;320;903;389;1176
315030;202203;700;1765;494;1402;145;398;125;317;270;715
315040;202203;1062;2668;895;2410;135;373;574;1472;709;1845
315050;202203;1330;3244;1003;2757;73;234;556;1477;629;1711
315053;202203;1313;3219;996;2693;72;248;605;1540;677;1788
315057;202203;1964;5424;1584;4807;154;405;1045;3352;1199;3757
315060;202203;733;2083;548;1718;111;368;151;443;262;811
315070;202203;725;1709;554;1432;104;298;270;610;374;908
315080;202203;3566;9159;2776;7791;142;486;2002;5338;2144;5824
315090;202203;891;2561;689;2212;92;316;312;945;404;1261
315100;202203;1520;4255;1048;3222;136;509;507;1360;643;1869
315110;202203;2358;5302;1746;4415;153;371;1003;2525;1156;2896
315120;202203;14144;31297;10633;26174;1128;2617;6551;16291;7679;18908
315130;202203;1873;4886;1599;4433;164;543;759;1939;923;2482
315140;202203;3360;8850;2695;7722;515;1631;1436;3868;1951;5499
315150;202203;4849;11530;3536;9475;481;1472;1759;4631;2240;6103
315160;202203;2088;4855;1445;3860;242;685;743;1937;985;2622
315170;202203;1505;4580;1099;3640;225;798;332;1054;557;1852
315180;202203;19528;45987;11766;32292;1555;4853;4427;10721;5982;15574
315190;202203;2398;5080;1890;4427;165;390;1435;3375;1600;3765
315200;202203;4735;12551;3607;10672;962;3026;1204;3421;2166;6447
315210;202203;9942;24535;7139;19028;663;2003;3744;8920;4407;10923
315213;202203;1183;3021;1029;2808;22;91;852;2268;874;2359
315217;202203;3063;8316;2342;7118;113;486;1631;4744;1744;5230
315220;202203;9534;24621;7605;21406;672;1797;4418;12526;5090;14323
315230;202203;3219;7068;2653;6319;177;355;1862;4663;2039;5018
315240;202203;2705;7413;2263;6663;455;1393;1156;3406;1611;4799
315250;202203;15935;41025;11991;33893;1723;5380;5577;14752;7300;20132
315260;202203;1002;2607;592;1793;136;401;61;167;197;568
315270;202203;1021;2804;769;2329;129;426;298;800;427;1226
315280;202203;3277;7904;2179;6024;575;1662;498;1369;1073;3031
315290;202203;1311;3093;814;2321;187;582;309;853;496;1435
315300;202203;744;1754;545;1455;33;104;377;993;410;1097
315310;202203;1391;3491;1088;2968;81;267;716;1793;797;2060
315320;202203;699;1989;498;1597;67;258;205;609;272;867
315330;202203;843;2614;507;1789;62;249;200;625;262;874
315340;202203;3281;7696;2289;6207;399;1134;1073;2851;1472;3985
315350;202203;1981;4856;1654;4364;132;406;1196;3052;1328;3458
315360;202203;1933;5366;1534;4612;210;648;709;1997;919;2645
315370;202203;618;1634;503;1425;69;200;265;718;334;918
315380;202203;283;758;201;593;37;105;27;59;64;164
315390;202203;1337;3599;1099;3191;101;376;639;1703;740;2079
315400;202203;4578;11632;3666;10067;385;1217;2315;6008;2700;7225
315410;202203;2689;5844;1998;4849;379;1018;486;1203;865;2221
315415;202203;1609;4181;1315;3722;270;885;468;1289;738;2174
315420;202203;1662;4447;1192;3599;236;755;321;878;557;1633
315430;202203;4027;9426;2858;7701;442;1349;1439;3743;1881;5092
315440;202203;1138;2869;906;2506;74;249;542;1399;616;1648
315445;202203;2225;4901;1657;4110;74;246;1342;3243;1416;3489
315450;202203;2516;6498;2067;5783;209;572;1377;3808;1586;4380
315460;202203;46958;120916;39638;108581;4189;13810;25348;64823;29537;78633
315470;202203;750;2003;542;1518;43;132;292;769;335;901
315480;202203;1362;3705;998;2964;151;480;423;1189;574;1669
315490;202203;3220;7745;2280;6253;277;846;999;2549;1276;3395
315500;202203;580;1489;375;1076;28;103;215;543;243;646
315510;202203;1472;3506;1250;3199;11;54;1109;2760;1120;2814
315520;202203;1178;2913;989;2626;43;134;810;2092;853;2226
315530;202203;760;1902;626;1674;70;215;440;1110;510;1325
315540;202203;1826;4624;1261;3581;109;376;573;1527;682;1903
315550;202203;2026;5256;1416;4139;255;874;445;1302;700;2176
315560;202203;7186;20058;6192;18334;378;1125;4463;13190;4841;14315
315570;202203;2675;6573;1986;5413;254;843;1050;2606;1304;3449
315580;202203;3532;7825;2786;6681;422;1074;1174;2654;1596;3728
315590;202203;1138;2574;909;2237;40;159;669;1518;709;1677
315600;202203;2780;8035;1986;6528;371;1109;971;3420;1342;4529
315610;202203;1081;2600;817;2153;112;381;412;939;524;1320
315620;202203;576;1474;446;1279;52;161;241;695;293;856
315630;202203;1166;2990;888;2493;122;408;451;1131;573;1539
315640;202203;400;950;303;832;32;111;194;505;226;616
315645;202203;1097;2698;776;2201;148;458;236;643;384;1101
315650;202203;1909;4221;1549;3723;61;154;1242;2930;1303;3084
315660;202203;2418;5921;1860;4945;138;384;1249;3232;1387;3616
315670;202203;16710;42748;13147;36497;2090;6287;6757;17657;8847;23944
315680;202203;3476;9387;2633;7875;313;1054;1447;4154;1760;5208
315690;202203;4169;9782;2569;7119;481;1292;802;2350;1283;3642
315700;202203;9547;24530;7364;20396;784;2455;3957;10203;4741;12658
315710;202203;2045;4760;1480;3941;71;230;1034;2677;1105;2907
315720;202203;4841;12756;4016;11327;196;806;2903;7807;3099;8613
315725;202203;2509;6091;1976;5260;192;493;1300;3583;1492;4076
315727;202203;642;1573;487;1314;62;195;244;619;306;814
315730;202203;668;1916;584;1760;132;438;225;605;357;1043
315733;202203;1539;3698;1191;3156;167;491;535;1294;702;1785
315737;202203;1314;3424;990;2819;34;132;707;1921;741;2053
315740;202203;900;2431;730;2092;65;240;501;1341;566;1581
315750;202203;1398;3437;1119;3017;81;228;760;2055;841;2283
315760;202203;1295;2879;1118;2647;37;121;952;2178;989;2299
315765;202203;2171;5220;1786;4730;27;103;1604;4227;1631;4330
315770;202203;1189;3142;948;2821;347;1113;261;743;608;1856
315780;202203;34501;89163;29168;79969;1765;6093;20244;52534;22009;58627
315790;202203;3924;11408;3359;10365;306;959;2099;6723;2405;7682
315800;202203;1449;4591;1121;3847;143;599;458;1365;601;1964
315810;202203;1495;3464;1257;3076;64;191;1001;2361;1065;2552
315820;202203;3138;7452;2538;6660;231;618;1840;4832;2071;5450
315830;202203;1353;3839;942;2948;102;355;301;788;403;1143
315840;202203;980;2264;705;1803;56;174;382;885;438;1059
315850;202203;1312;3581;1054;3166;151;481;584;1676;735;2157
315860;202203;565;1510;411;1248;88;305;145;370;233;675
315870;202203;511;1335;405;1163;25;81;290;797;315;878
315880;202203;1245;2986;897;2393;120;358;357;850;477;1208
315890;202203;1980;5234;1630;4773;390;1174;829;2503;1219;3677
315895;202203;7092;18308;5413;15167;536;1749;2872;7435;3408;9184
315900;202203;842;2127;717;1950;57;192;537;1399;594;1591
315910;202203;600;1528;512;1401;56;166;381;1027;437;1193
315920;202203;1567;3845;927;2668;147;498;337;869;484;1367
315930;202203;1258;2660;869;2126;95;232;463;1089;558;1321
315935;202203;1102;3121;896;2733;176;545;380;1148;556;1693
315940;202203;689;1745;551;1552;76;228;305;819;381;1047
315950;202203;1298;3395;1088;3069;100;308;842;2340;942;2648
315960;202203;6261;16781;4469;13296;1045;3476;1096;2566;2141;6042
315970;202203;632;1620;511;1460;58;177;349;1019;407;1196
315980;202203;4751;9873;2768;6758;478;1243;1280;2835;1758;4078
315990;202203;3850;9543;3057;8216;304;885;1779;4577;2083;5462
316000;202203;794;1777;626;1540;55;163;399;929;454;1092
316010;202203;836;2250;624;1873;69;234;299;778;368;1012
316020;202203;1030;2849;827;2465;104;355;496;1393;600;1748
316030;202203;3037;7959;2341;6731;268;760;1532;4493;1800;5253
316040;202203;2944;8095;2187;6674;381;1339;649;1705;1030;3044
316045;202203;2441;5595;2254;5367;77;142;2033;4886;2110;5028
316050;202203;427;1142;335;992;38;116;191;520;229;636
316060;202203;784;1807;583;1545;24;82;435;1113;459;1195
316070;202203;6169;16150;5078;14140;735;2108;2654;7119;3389;9227
316080;202203;853;2550;678;2204;184;641;127;369;311;1010
316090;202203;504;1311;413;1147;47;169;243;588;290;757
316095;202203;1439;4222;1126;3465;262;888;474;1356;736;2244
316100;202203;2702;7435;2040;6108;319;1111;854;2294;1173;3405
316105;202203;898;2210;729;1950;46;123;470;1312;516;1435
316110;202203;15415;40820;12928;36788;886;2974;9357;25984;10243;28958
316120;202203;1367;3574;909;2612;152;467;329;753;481;1220
316130;202203;1407;3050;949;2321;74;223;595;1380;669;1603
316140;202203;1323;3387;850;2489;116;367;347;1000;463;1367
316150;202203;2408;5212;1919;4505;151;440;1059;2337;1210;2777
316160;202203;1103;2810;889;2431;42;149;648;1726;690;1875
316165;202203;1002;2257;807;1973;84;229;538;1255;622;1484
316170;202203;1423;3224;1107;2775;53;192;813;1906;866;2098
316180;202203;1666;4493;1200;3609;215;711;330;893;545;1604
316190;202203;2941;8021;1799;5390;247;789;766;2035;1013;2824
316200;202203;3852;10389;3034;9023;521;1775;1298;3670;1819;5445
316210;202203;5639;15931;4063;12300;1414;4711;389;999;1803;5710
316220;202203;746;2186;525;1746;109;377;86;311;195;688
316225;202203;1753;3794;1334;3170;48;177;1027;2232;1075;2409
316230;202203;528;1333;412;1143;76;230;210;566;286;796
316240;202203;6167;16870;5394;15520;405;1302;4077;11523;4482;12825
316245;202203;3542;10471;3216;9947;155;758;2584;7639;2739;8397
316250;202203;12157;27946;9304;23418;1669;4500;3850;9653;5519;14153
316255;202203;3340;8746;2906;8067;160;397;2141;6074;2301;6471
316257;202203;1574;3538;1169;2885;70;188;818;1920;888;2108
316260;202203;2591;5887;2053;5055;207;487;1237;3045;1444;3532
316265;202203;1231;3185;975;2756;18;73;735;1999;753;2072
316270;202203;4116;11888;3537;10698;391;1282;2039;5849;2430;7131
316280;202203;3330;8712;2829;7820;335;1051;1665;4415;2000;5466
316290;202203;4079;10714;3305;9266;418;1312;1362;3636;1780;4948
316292;202203;6285;15640;5100;13794;544;1611;3431;8975;3975;10586
316294;202203;968;2764;745;2395;118;471;229;657;347;1128
316295;202203;3746;10044;3109;8980;184;693;2180;5997;2364;6690
316300;202203;1119;3003;888;2647;41;142;630;1849;671;1991
316310;202203;881;2284;607;1806;145;495;173;466;318;961
316320;202203;746;1990;589;1746;124;426;167;450;291;876
316330;202203;1187;2944;909;2479;51;149;686;1838;737;1987
316340;202203;1075;2805;815;2351;74;289;493;1336;567;1625
316350;202203;1489;3905;1251;3504;155;443;834;2295;989;2738
316360;202203;722;1785;611;1615;45;118;487;1296;532;1414
316370;202203;6353;15348;4961;13029;557;1743;2719;6383;3276;8126
316380;202203;1915;4334;1525;3793;93;200;1079;2671;1172;2871
316390;202203;835;2180;617;1813;249;823;118;305;367;1128
316400;202203;1317;3557;888;2737;102;336;338;932;440;1268
316410;202203;1273;3260;1070;2961;31;112;917;2463;948;2575
316420;202203;2160;5579;1864;5185;38;164;1559;4226;1597;4390
316430;202203;965;2407;675;1943;96;328;301;789;397;1117
316440;202203;940;2770;767;2464;139;522;224;649;363;1171
316443;202203;618;1635;452;1332;105;356;125;348;230;704
316447;202203;2358;5734;2040;5263;34;99;1801;4580;1835;4679
316450;202203;2340;6579;1816;5532;212;724;1135;3323;1347;4047
316460;202203;1402;3504;1152;3110;106;314;788;2024;894;2338
316470;202203;8087;22002;6115;18101;846;2897;2813;7489;3659;10386
316480;202203;224;569;191;528;33;104;118;304;151;408
316490;202203;362;962;268;794;48;165;94;236;142;401
316500;202203;1430;4170;1000;3191;207;736;265;765;472;1501
316510;202203;880;2728;715;2412;113;398;384;1285;497;1683
316520;202203;1512;3522;1186;2975;172;504;582;1318;754;1822
316530;202203;1226;3081;910;2530;101;381;476;1192;577;1573
316540;202203;1107;2670;909;2393;113;361;502;1202;615;1563
316550;202203;1527;4135;1293;3722;52;185;1041;2966;1093;3151
316553;202203;5116;14220;3853;11381;477;1606;1784;4619;2261;6225
316555;202203;3003;8350;2703;7954;81;314;2341;6798;2422;7112
316556;202203;571;1334;443;1114;32;99;274;602;306;701
316557;202203;1265;3613;1091;3353;343;1151;441;1304;784;2455
316560;202203;382;1027;284;881;42;153;137;396;179;549
316570;202203;1559;4165;1318;3761;308;825;479;1478;787;2303
316580;202203;424;870;279;643;36;92;148;321;184;413
316590;202203;1459;3545;1020;2731;137;342;582;1496;719;1838
316600;202203;1057;2984;919;2728;149;435;535;1579;684;2014
316610;202203;686;1965;558;1768;50;205;345;1047;395;1252
316620;202203;2453;5889;2165;5481;110;289;1775;4461;1885;4750
316630;202203;1739;4896;1466;4399;367;1049;594;2046;961;3095
316640;202203;175;460;146;419;31;104;57;133;88;237
316650;202203;1205;3384;975;3035;67;250;680;2041;747;2291
316660;202203;210;489;99;264;15;43;29;58;44;101
316670;202203;1889;4559;1439;3860;358;986;508;1315;866;2301
316680;202203;2544;6284;1928;5150;150;460;1384;3573;1534;4033
316690;202203;1543;4174;1170;3506;196;653;497;1419;693;2072
316695;202203;1095;3051;916;2736;24;97;636;1854;660;1951
316700;202203;487;986;410;904;9;27;356;756;365;783
316710;202203;3699;11102;2957;9653;448;1652;1578;4926;2026;6578
316720;202203;23094;60279;17835;50701;2646;8189;8685;23277;11331;31466
316730;202203;576;1367;471;1195;55;142;256;602;311;744
316740;202203;894;2405;781;2229;104;329;533;1505;637;1834
316750;202203;440;1215;340;1043;61;199;158;464;219;663
316760;202203;4137;12143;3581;11142;1182;4033;1395;4285;2577;8318
316770;202203;1774;3770;1357;3228;38;93;1096;2663;1134;2756
316780;202203;623;1741;505;1539;168;558;144;406;312;964
316790;202203;815;2102;609;1709;83;252;198;522;281;774
316800;202203;7221;19173;5813;16714;695;2196;2995;8325;3690;10521
316805;202203;1234;2472;1005;2217;43;109;851;1859;894;1968
316810;202203;734;1911;551;1577;66;217;361;994;427;1211
316820;202203;373;846;219;589;19;63;116;292;135;355
316830;202203;937;2329;738;2015;79;222;467;1267;546;1489
316840;202203;3150;7579;2543;6632;140;458;1948;4873;2088;5331
316850;202203;2358;5614;1793;4679;169;530;1096;2623;1265;3153
316860;202203;23479;56419;17764;47965;2273;7179;9324;24086;11597;31265
316870;202203;9322;23759;7221;19950;863;2761;3798;9665;4661;12426
316880;202203;1133;2866;958;2626;116;371;592;1523;708;1894
316890;202203;1275;2781;795;2159;79;277;524;1343;603;1620
316900;202203;2684;6809;2167;5880;395;1097;875;2244;1270;3341
316905;202203;540;1545;442;1360;99;313;201;645;300;958
316910;202203;1090;2684;739;2095;214;656;167;437;381;1093
316920;202203;2054;4647;1514;3871;191;575;956;2278;1147;2853
316930;202203;9646;25859;7576;22332;1527;4924;3002;8098;4529;13022
316935;202203;4763;12169;3611;10121;585;1835;1662;4291;2247;6126
316940;202203;7055;19780;5620;17019;711;2491;2726;7627;3437;10118
316950;202203;2152;4707;1681;4082;41;116;1439;3452;1480;3568
316960;202203;5740;12245;4199;10225;296;803;3063;7281;3359;8084
316970;202203;4422;11540;3796;10473;483;1407;1854;4809;2337;6216
316980;202203;793;2270;623;1958;209;724;149;460;358;1184
316990;202203;14111;36171;10784;29760;2405;7053;2294;5825;4699;12878
317000;202203;2821;7688;2494;7240;212;539;1901;5593;2113;6132
317005;202203;2883;7602;2277;6413;315;962;1315;3568;1630;4530
317010;202203;28434;64865;19132;50876;3176;9139;9019;23826;12195;32965
317020;202203;74473;172415;47215;126214;8127;23727;17660;43499;25787;67226
317030;202203;759;1904;606;1694;13;47;467;1282;480;1329
317040;202203;12523;30292;8936;24328;1926;5531;3275;9268;5201;14799
317043;202203;1010;2121;746;1771;44;114;571;1314;615;1428
317047;202203;1290;2944;910;2343;52;164;641;1587;693;1751
317050;202203;1346;3997;988;3202;134;508;405;1115;539;1623
317052;202203;2721;6947;2200;6137;191;574;1549;4267;1740;4841
317057;202203;2254;4797;1697;3983;38;109;1283;2892;1321;3001
317060;202203;568;1471;353;1036;52;159;144;382;196;541
317065;202203;1218;3453;1002;3042;61;232;654;1851;715;2083
317070;202203;8368;22552;6408;18869;989;3291;2673;7320;3662;10611
317075;202203;1094;2696;834;2270;96;302;475;1214;571;1516
317080;202203;7154;15932;5455;13299;1096;2835;2514;5949;3610;8784
317090;202203;5331;14366;4722;13412;274;779;3622;10258;3896;11037
317100;202203;2892;6661;1939;5130;380;1032;838;2165;1218;3197
317103;202203;2519;6050;2156;5555;66;284;1774;4404;1840;4688
317107;202203;1661;4079;1268;3373;64;229;833;1975;897;2204
317110;202203;721;1677;403;1174;77;263;149;433;226;696
317115;202203;1223;3332;1024;2972;99;313;662;1904;761;2217
317120;202203;19650;49431;16364;44291;1071;3659;11176;28537;12247;32196
317130;202203;12837;28802;8941;22484;1232;3361;3530;8835;4762;12196
317140;202203;1058;2414;831;2063;57;138;586;1471;643;1609
317150;202203;1048;2418;822;2131;36;118;669;1698;705;1816
317160;202203;3922;8992;2631;6980;233;576;1457;4011;1690;4587
317170;202203;2138;5123;1641;4259;109;353;1039;2446;1148;2799
317180;202203;2152;6381;1609;5115;322;1092;482;1398;804;2490
317190;202203;1254;3286;952;2799;136;426;531;1532;667;1958
317200;202203;7030;17825;5296;14451;985;2885;1648;4048;2633;6933
317210;202203;1331;3067;1036;2673;38;133;759;1977;797;2110
317220;202203;326;918;285;848;51;158;155;450;206;608
320010;202203;5153;14444;4054;12250;412;1422;2481;7241;2893;8663
320013;202203;2346;6040;1693;4813;253;723;810;2400;1063;3123
320016;202203;3206;7887;2535;6875;203;547;1778;4826;1981;5373
320020;202203;4792;11858;3676;9953;569;1730;1745;4714;2314;6444
320030;202203;1957;5220;1317;3981;217;713;503;1445;720;2158
320035;202203;2166;5531;1794;4934;337;1023;1001;2671;1338;3694
320040;202203;4894;13248;4125;11926;508;1599;2406;6647;2914;8246
320050;202203;2036;4433;1779;4070;208;563;1130;2435;1338;2998
320060;202203;15696;40957;11950;33680;1766;5413;5715;14869;7481;20282
320070;202203;1985;5122;1480;4176;232;761;698;1740;930;2501
320080;202203;6296;15570;4547;12206;799;2263;1953;4917;2752;7180
320090;202203;9573;24470;6539;18463;1341;4061;2615;6864;3956;10925
320100;202203;3627;9226;2982;8133;401;1191;1748;4693;2149;5884
320110;202203;2481;5486;1811;4459;188;571;1107;2512;1295;3083
320115;202203;2422;7155;2103;6657;663;2161;909;2996;1572;5157
320120;202203;28530;69449;20860;56264;2654;7900;10705;26999;13359;34899
320130;202203;59663;154057;49796;137045;5520;16905;31091;82098;36611;99003
320140;202203;4339;11372;3073;8924;394;1353;1463;4021;1857;5374
320150;202203;16198;40141;11902;32398;2803;8467;2177;5326;4980;13793
320160;202203;7113;18811;5376;15650;672;2220;2650;7469;3322;9689
320170;202203;2009;5513;1464;4450;364;1104;583;1863;947;2967
320180;202203;825;2462;672;2172;225;790;190;575;415;1365
320190;202203;3333;10121;2628;8615;652;2358;649;1953;1301;4311
320200;202203;1485;3887;1052;3133;230;735;332;1001;562;1736
320210;202203;5065;12346;3959;10500;597;1728;2193;5481;2790;7209
320220;202203;3817;9357;2992;8047;487;1375;1556;3982;2043;5357
320225;202203;1652;4848;1167;3767;345;1225;303;949;648;2174
320230;202203;6038;15676;4631;13359;995;3047;1713;4951;2708;7998
320240;202203;19394;46969;14676;39668;3555;10240;4798;12833;8353;23073
320245;202203;3601;10136;2744;8367;871;2818;529;1562;1400;4380
320250;202203;3136;7992;2162;5888;387;1222;964;2272;1351;3494
320255;202203;2302;6615;2016;6113;405;1294;1151;3523;1556;4817
320260;202203;1638;4443;1063;3242;219;727;286;734;505;1461
320265;202203;2649;7880;2124;6839;883;3045;362;1132;1245;4177
320270;202203;2510;6877;1967;5810;457;1500;744;2178;1201;3678
320280;202203;8869;22075;7299;19521;1100;3329;4403;11233;5503;14562
320290;202203;1520;4334;1001;3135;244;836;263;785;507;1621
320300;202203;4700;13168;3829;11501;987;3285;1394;3971;2381;7256
320305;202203;5925;15801;4610;13337;837;2624;2273;6349;3110;8973
320310;202203;2520;6562;1808;5141;314;974;815;2151;1129;3125
320313;202203;2819;6677;1958;5147;371;1080;662;1532;1033;2612
320316;202203;1824;4868;1408;4188;215;640;774;2307;989;2947
320320;202203;25460;63749;18623;52348;4029;11815;7319;20525;11348;32340
320330;202203;3235;8351;2539;7143;388;1131;1441;4067;1829;5198
320332;202203;9501;24193;7610;20823;1457;4310;3713;9845;5170;14155
320334;202203;2089;5645;1469;4394;294;1058;384;880;678;1938
320335;202203;1778;5016;1261;3845;241;856;405;1139;646;1995
320340;202203;5994;13709;5029;12352;450;1235;3307;8034;3757;9269
320350;202203;6099;14215;4389;11272;423;1260;2551;6100;2974;7360
320360;202203;1582;3876;1187;3171;144;388;585;1500;729;1888
320370;202203;3105;8915;2379;7400;659;2241;846;2504;1505;4745
320380;202203;3184;7832;2648;6972;256;783;1744;4384;2000;5167
320390;202203;8751;22164;6562;17962;1275;3742;2828;7288;4103;11030
320400;202203;3709;10014;2810;8143;717;2232;1050;2899;1767;5131
320405;202203;6041;14901;4643;12554;588;1731;2583;6706;3171;8437
320410;202203;5507;13511;4246;11533;711;1956;2189;6052;2900;8008
320420;202203;4224;10116;3311;8692;706;2001;1228;3059;1934;5060
320425;202203;2439;5607;1893;4718;170;441;1204;2896;1374;3337
320430;202203;3626;8804;2910;7595;370;1020;1812;4571;2182;5591
320435;202203;2567;7601;2022;6474;553;1900;804;2607;1357;4507
320440;202203;1739;4617;1318;3838;208;680;614;1668;822;2348
320450;202203;2149;5757;1714;4981;296;1030;892;2366;1188;3396
320455;202203;5066;14733;3522;11212;831;2947;955;2720;1786;5667
320460;202203;2356;6680;1735;5418;432;1508;526;1531;958;3039
320465;202203;1661;4429;1224;3596;242;743;589;1737;831;2480
320470;202203;4444;11429;3393;9346;665;2065;1215;2988;1880;5053
320480;202203;2449;5834;2019;5128;255;645;1343;3346;1598;3991
320490;202203;27560;66500;21143;55795;3358;9183;10107;26311;13465;35494
320495;202203;1583;4145;1177;3366;278;924;312;786;590;1710
320500;202203;66773;167611;54510;147390;6198;18931;34131;87626;40329;106557
320501;202203;5463;15116;4168;12781;1121;3823;1332;4038;2453;7861
320503;202203;2685;7396;1810;5634;498;1676;510;1523;1008;3199
320506;202203;3042;8806;2311;7254;689;2332;286;896;975;3228
320510;202203;12864;32682;10592;28952;874;2831;6960;18161;7834;20992
320515;202203;2023;5361;1584;4482;393;1206;578;1565;971;2771
320517;202203;2477;6999;2005;6036;564;1805;742;2188;1306;3993
320520;202203;45571;112168;35201;95205;5235;15778;16885;43550;22120;59328
320530;202203;39447;98039;31759;85075;2494;8124;20712;52000;23206;60124
330010;202203;28795;69679;24370;62840;2079;6178;17988;44658;20067;50836
330015;202203;1661;3816;1337;3355;176;518;866;2065;1042;2583
330020;202203;22738;54001;19292;49169;2126;5864;14124;35458;16250;41322
330022;202203;2211;5680;1761;4968;277;787;916;2600;1193;3387
330023;202203;7178;16143;5598;13816;734;2002;3631;8649;4365;10651
330025;202203;8031;17690;5254;13266;1025;2893;1840;4332;2865;7225
330030;202203;12146;30163;9600;26271;679;2420;6669;17185;7348;19605
330040;202203;18463;45168;15278;40104;843;2787;11303;28183;12146;30970
330045;202203;106700;230311;90247;210178;4314;10936;76639;175646;80953;186582
330050;202203;3300;8159;2580;7027;408;1265;1467;3747;1875;5012
330060;202203;6481;15658;5164;13434;898;2708;2430;5761;3328;8469
330070;202203;29889;69460;24916;62636;2885;7937;16851;41597;19736;49534
330080;202203;11183;25554;9602;23388;1028;2678;6757;16335;7785;19013
330090;202203;3860;7650;2820;6254;173;374;2090;4633;2263;5007
330093;202203;3134;7097;2387;6109;114;320;1880;4734;1994;5054
330095;202203;1675;4323;1326;3706;128;403;789;2078;917;2481
330100;202203;84418;206380;73482;191042;2996;9957;59440;151296;62436;161253
330110;202203;2518;6487;2038;5752;243;778;1313;3537;1556;4315
330115;202203;3171;7108;2294;5776;360;986;1290;3074;1650;4060
330120;202203;4182;8483;3247;7339;169;461;2571;5565;2740;6026
330130;202203;5209;13094;4333;11850;463;1359;2963;7949;3426;9308
330140;202203;4596;10698;3788;9628;265;859;2917;7129;3182;7988
330150;202203;2870;7015;2310;6151;358;1015;1365;3451;1723;4466
330160;202203;1652;4215;1269;3573;248;746;693;1840;941;2586
330170;202203;148105;331972;123866;300329;13512;32178;91896;222294;105408;254472
330180;202203;2317;5171;1838;4529;96;298;1379;3274;1475;3572
330185;202203;12551;28327;10654;25797;408;1287;9071;21350;9479;22637
330187;202203;5923;13593;4776;11805;571;1493;3136;7491;3707;8984
330190;202203;48366;103804;42016;95408;1867;4963;35393;78413;37260;83376
330200;202203;19886;46555;16530;42493;2286;5684;11872;30714;14158;36398
330205;202203;2579;6015;1990;5089;138;405;1370;3324;1508;3729
330210;202203;3866;8988;2920;7449;346;914;1653;3992;1999;4906
330220;202203;15444;35732;11564;29481;1887;5340;5361;12657;7248;17997
330225;202203;4625;10956;3619;9493;192;638;2707;6893;2899;7531
330227;202203;20374;45869;17302;42245;526;1515;15225;36610;15751;38125
330230;202203;2336;4990;1570;4013;146;410;820;2096;966;2506
330240;202203;28593;68972;24298;62705;1752;5255;18347;45967;20099;51222
330245;202203;2010;4719;1291;3508;255;708;546;1393;801;2101
330250;202203;48640;113572;41046;102773;4826;12973;28727;70660;33553;83633
330260;202203;5720;12862;4415;11138;269;841;3446;8412;3715;9253
330270;202203;37885;83759;24344;61926;3366;9302;11228;26965;14594;36267
330280;202203;2946;6975;2324;5977;171;569;1591;3805;1762;4374
330285;202203;31874;69518;26021;61401;1310;3748;20904;47592;22214;51340
330290;202203;5113;11154;4213;10007;283;876;3327;7515;3610;8391
330300;202203;6709;14692;5072;12445;352;964;3731;8839;4083;9803
330310;202203;3191;7202;2397;5970;140;375;1748;4196;1888;4571
330320;202203;20467;44789;16159;39500;1640;3499;12218;30044;13858;33543
330330;202203;52634;108394;42154;94670;2879;7176;32171;70155;35050;77331
330340;202203;21274;47870;15845;39773;2053;5976;8918;20855;10971;26831
330350;202203;179917;382508;151640;348909;6176;15451;131702;299064;137878;314515
330360;202203;8597;19461;7403;18019;264;654;6383;15424;6647;16078
330370;202203;5967;15825;4760;13863;874;2720;2434;6993;3308;9713
330380;202203;7069;17226;5570;14644;636;2050;3597;8871;4233;10921
330385;202203;4784;12526;3963;11378;656;2125;2296;6343;2952;8468
330390;202203;34027;84091;26928;72632;2823;9096;17627;44689;20450;53785
330395;202203;3881;8842;3195;7991;133;429;2522;6133;2655;6562
330400;202203;4076;9974;3510;9133;164;587;2751;6724;2915;7311
330410;202203;3974;9596;2950;7934;443;1389;1679;4207;2122;5596
330411;202203;3280;8442;2607;7280;164;585;1854;4911;2018;5496
330412;202203;1937;5048;1613;4521;119;419;1132;2991;1251;3410
330414;202203;27372;64933;22636;58641;1237;3761;18021;45732;19258;49493
330415;202203;5604;14061;4215;11708;401;1250;2517;6702;2918;7952
330420;202203;14810;34939;11060;29059;1096;3426;6544;15974;7640;19400
330430;202203;12735;26443;11000;24207;225;761;9591;20392;9816;21153
330440;202203;3363;8180;2629;6997;258;852;1795;4494;2053;5346
330450;202203;1716;4455;1399;3943;130;406;881;2372;1011;2778
330452;202203;21947;51973;17965;46095;1784;5325;12576;31007;14360;36332
330455;202203;717940;1566901;584322;1383632;58443;148910;423876;978372;482319;1127282
330460;202203;1366;3489;1064;3070;165;518;618;1758;783;2276
330470;202203;6511;14907;4819;12398;1087;2970;1919;4853;3006;7823
330475;202203;11327;26882;9281;24315;1073;3310;6511;16517;7584;19827
330480;202203;6851;16559;5839;15132;442;1268;4214;10554;4656;11822
330490;202203;131176;284973;108087;254756;9386;23376;81517;189016;90903;212392
330500;202203;9439;21351;8006;19487;513;1426;6195;14750;6708;16176
330510;202203;49645;114588;38204;99058;4322;12107;26483;67284;30805;79391
330513;202203;1523;3635;1245;3266;166;471;789;2062;955;2533
330515;202203;2995;7494;2470;6781;327;1037;1581;4129;1908;5166
330520;202203;14518;35218;12204;31816;1020;3120;8715;21912;9735;25032
330530;202203;1950;4456;1460;3748;251;698;760;1928;1011;2626
330540;202203;3387;8372;2657;7177;603;1717;1159;3079;1762;4796
330550;202203;13007;29221;10345;25837;1912;5089;6025;14804;7937;19893
330555;202203;23092;44574;19574;40541;629;1438;16963;35273;17592;36711
330560;202203;4708;11527;3847;10190;510;1410;2533;6491;3043;7901
330570;202203;3338;8322;2919;7734;393;1115;2077;5427;2470;6542
330575;202203;6974;16424;6094;15022;290;828;5050;12001;5340;12829
330580;202203;23609;57798;19414;50624;2496;7253;11575;28313;14071;35566
330590;202203;1711;4271;1444;3936;198;518;972;2726;1170;3244
330600;202203;14899;36302;12315;32300;783;2542;8675;21788;9458;24330
330610;202203;11500;28153;9473;25077;837;2465;6565;16820;7402;19285
330615;202203;2533;6292;2067;5671;333;844;1404;3947;1737;4791
330620;202203;4815;12786;3877;11236;761;2417;1818;5051;2579;7468
330630;202203;31911;74347;25585;64725;1218;4015;19181;46272;20399;50287
350010;202203;2475;6313;1525;4370;310;949;404;919;714;1868
350020;202203;805;1996;500;1436;63;189;173;470;236;659
350030;202203;4027;10634;3146;9171;626;2104;1659;4486;2285;6590
350040;202203;863;2369;532;1689;72;293;180;440;252;733
350050;202203;1629;3844;1125;3020;199;627;456;1026;655;1653
350055;202203;1059;2626;858;2327;114;315;519;1331;633;1646
350060;202203;284;689;163;438;25;82;65;163;90;245
350070;202203;3722;9446;2548;7388;448;1495;1023;2626;1471;4121
350075;202203;691;1906;534;1614;192;605;107;327;299;932
350080;202203;747;1880;526;1511;55;187;240;624;295;811
350090;202203;664;1499;423;1106;69;200;216;520;285;720
350100;202203;2809;7027;2017;5714;124;462;1323;3488;1447;3950
350110;202203;556;1327;410;1080;17;58;274;694;291;752
350115;202203;1368;3812;1130;3354;166;569;607;1634;773;2203
350120;202203;729;1675;444;1185;42;142;244;597;286;739
350130;202203;3662;9359;2917;8021;445;1292;1547;3928;1992;5220
350140;202203;836;2211;604;1797;44;159;342;929;386;1088
350150;202203;576;1665;480;1497;98;336;167;460;265;796
350160;202203;13236;32781;9324;25610;1131;3574;5668;14635;6799;18209
350170;202203;2815;7530;2380;6639;323;1027;1359;3459;1682;4486
350180;202203;1145;2666;682;1852;108;313;303;750;411;1063
350190;202203;3478;9636;2475;7441;368;1310;1181;3071;1549;4381
350200;202203;507;1377;395;1168;19;75;270;752;289;827
350210;202203;6805;15256;4803;12197;406;1219;3193;7666;3599;8885
350220;202203;3332;8794;2375;6984;438;1377;963;2564;1401;3941
350230;202203;1169;2824;957;2537;160;466;578;1464;738;1930
350240;202203;690;1920;472;1434;94;295;128;348;222;643
350250;202203;3752;9860;2848;8409;670;2110;1038;2957;1708;5067
350260;202203;971;2170;637;1628;62;168;399;959;461;1127
350270;202203;5142;12971;4143;11201;525;1611;2426;6084;2951;7695
350275;202203;2921;7450;2370;6646;232;789;1657;4411;1889;5200
350280;202203;21031;46711;13742;35198;2112;5678;6431;15574;8543;21252
350290;202203;3660;9745;2615;7664;470;1506;1176;3208;1646;4714
350300;202203;770;1934;599;1631;72;217;360;918;432;1135
350310;202203;1070;2892;828;2439;105;358;395;1069;500;1427
350315;202203;692;1634;492;1324;29;104;290;683;319;787
350320;202203;18199;45029;13891;37644;2403;7264;6543;16382;8946;23646
350330;202203;15702;37168;11628;29798;1016;2982;7809;18825;8825;21807
350335;202203;423;1153;334;989;41;132;157;444;198;576
350340;202203;1416;3535;894;2578;114;391;422;1098;536;1489
350350;202203;834;2010;651;1811;76;233;413;1134;489;1367
350360;202203;1189;3378;943;2908;173;563;422;1281;595;1844
350370;202203;773;1844;562;1468;168;407;216;537;384;944
350380;202203;5180;13732;3839;10996;927;2732;1375;3793;2302;6525
350390;202203;12554;31237;10060;27277;1462;4242;5885;15157;7347;19399
350395;202203;492;1223;264;791;35;108;91;256;126;364
350400;202203;9540;22623;6864;18374;1672;4689;2205;5839;3877;10528
350410;202203;11882;31779;9064;26624;1647;5335;4038;11047;5685;16382
350420;202203;1117;2814;802;2198;141;381;257;605;398;986
350430;202203;772;1938;611;1698;71;226;364;932;435;1158
350440;202203;2377;5580;1947;4957;116;354;1337;3242;1453;3596
350450;202203;7512;19993;5922;17310;1183;3874;2741;7483;3924;11357
350460;202203;2281;5716;1404;4024;205;624;583;1519;788;2143
350470;202203;281;682;226;599;11;37;167;424;178;461
350480;202203;1123;2673;773;2111;173;530;210;496;383;1026
350490;202203;2198;5467;1607;4547;283;902;649;1627;932;2529
350500;202203;728;1879;536;1551;59;192;231;632;290;824
350510;202203;1366;3317;1050;2781;87;262;680;1697;767;1959
350520;202203;2608;7429;2085;6476;323;1161;969;2714;1292;3875
350530;202203;3399;8294;2621;6853;243;747;1604;3879;1847;4626
350535;202203;1696;4374;1447;4021;184;581;943;2531;1127;3112
350540;202203;2264;4935;1731;4187;146;373;1243;2850;1389;3223
350550;202203;9341;22356;6612;17919;624;2106;4004;9968;4628;12074
350560;202203;4411;11581;3617;10308;250;866;2549;6961;2799;7827
350570;202203;31258;82570;26037;73220;3907;12170;14731;39549;18638;51719
350580;202203;2379;6078;1556;4495;389;1270;483;1149;872;2419
350590;202203;5535;14436;4169;11529;476;1510;2568;6551;3044;8061
350600;202203;38436;86935;25036;64514;3363;9907;12533;29670;15896;39577
350610;202203;8072;21030;5926;16979;776;2589;3219;8572;3995;11161
350620;202203;479;1201;303;920;33;111;168;478;201;589
350630;202203;1799;4218;1357;3495;85;272;935;2215;1020;2487
350635;202203;11303;26234;8638;22180;937;2702;5709;14042;6646;16744
350640;202203;1037;2707;592;1759;106;318;181;455;287;773
350650;202203;9873;25287;7064;20020;1164;3635;3109;8154;4273;11789
350660;202203;5264;12962;4168;11236;520;1427;2561;6778;3081;8205
350670;202203;1917;5012;1572;4514;202;613;1025;2945;1227;3558
350680;202203;1256;3282;880;2605;142;428;393;1109;535;1537
350690;202203;1506;3739;1091;3044;147;446;611;1653;758;2099
350700;202203;5558;13404;4288;11522;732;2194;2328;5937;3060;8131
350710;202203;3343;8596;2851;7780;505;1575;1598;4036;2103;5611
350715;202203;860;2354;735;2156;127;450;397;1042;524;1492
350720;202203;184;455;135;383;23;70;52;124;75;194
350730;202203;695;1886;587;1698;39;132;398;1090;437;1222
350740;202203;1930;4848;1382;3818;228;691;552;1366;780;2057
350745;202203;677;1660;406;1167;28;112;196;504;224;616
350750;202203;11747;29687;9429;25809;1526;4970;4934;12266;6460;17236
350760;202203;18007;42419;13579;35111;2186;6553;7226;16755;9412;23308
350770;202203;1194;2826;743;2063;60;180;441;1179;501;1359
350775;202203;796;1771;566;1444;72;176;311;787;383;963
350780;202203;2699;6294;1995;5331;563;1380;733;2293;1296;3673
350790;202203;2358;6135;1562;4669;298;925;487;1252;785;2177
350800;202203;4036;10958;3476;10040;247;857;2497;6967;2744;7824
350810;202203;3302;7586;2534;6482;446;1107;1299;3292;1745;4399
350820;202203;1053;2395;641;1676;66;203;341;818;407;1021
350830;202203;955;2536;576;1743;101;327;177;447;278;774
350840;202203;3840;10865;2996;9370;538;1901;1465;4226;2003;6127
350850;202203;9197;24130;7407;21013;1154;3585;4188;11189;5342;14774
350860;202203;4074;10274;3533;9558;135;494;2802;7476;2937;7970
350870;202203;3038;8017;2317;6886;234;793;1444;4170;1678;4963
350880;202203;1582;4259;1288;3710;364;1073;372;1017;736;2090
350890;202203;559;1428;373;1051;51;160;138;332;189;492
350900;202203;9907;25221;7064;19560;1149;3503;3510;8838;4659;12341
350910;202203;1053;2409;902;2193;85;221;704;1663;789;1884
350920;202203;13825;32754;11837;29702;388;1298;9907;23962;10295;25260
350925;202203;4613;12011;3386;9929;532;1783;1780;4811;2312;6594
350930;202203;1637;4167;1172;3280;83;266;707;1920;790;2186
350940;202203;2676;6650;2130;5792;200;654;1448;3702;1648;4356
350945;202203;1010;2713;792;2310;121;375;416;1135;537;1510
350950;202203;105083;258546;82810;218253;9174;26729;53695;134747;62869;161476
350960;202203;7276;18931;5742;16147;713;2289;3438;9194;4151;11483
350970;202203;3992;10676;2944;8792;836;2740;894;2277;1730;5017
350980;202203;778;2004;644;1771;137;393;328;873;465;1266
350990;202203;2169;5626;1673;4845;359;1177;705;1942;1064;3119
350995;202203;934;2729;854;2579;72;262;593;1719;665;1981
351000;202203;3347;8546;2331;6638;514;1512;827;2259;1341;3771
351010;202203;421;1011;273;759;39;117;128;344;167;461
351015;202203;1051;2998;879;2666;137;446;430;1186;567;1632
351020;202203;9630;25087;7413;21408;1470;4454;3726;10368;5196;14822
351030;202203;3274;9263;2658;8065;348;1205;1541;4501;1889;5706
351040;202203;5861;13743;4963;12443;170;555;4189;10181;4359;10736
351050;202203;19422;45454;14744;38589;2313;6407;8015;20419;10328;26826
351060;202203;56301;135380;43976;114960;3637;10756;30933;77870;34570;88626
351070;202203;1541;3686;909;2650;257;762;171;480;428;1242
351080;202203;3138;7247;2325;6298;239;761;1610;4142;1849;4903
351090;202203;361;992;281;855;54;169;102;306;156;475
351100;202203;3122;8057;2127;6139;450;1425;707;1982;1157;3407
351110;202203;7087;17593;4983;13870;723;2272;2465;6437;3188;8709
351120;202203;825;2095;584;1679;105;293;225;619;330;912
351130;202203;1259;3253;607;1816;102;329;169;437;271;766
351140;202203;2545;6764;1946;5688;403;1321;925;2411;1328;3732
351150;202203;3221;8849;2280;6903;325;1129;887;2383;1212;3512
351160;202203;1241;3688;930;2998;191;667;236;634;427;1301
351170;202203;1617;4202;1407;3844;120;374;997;2596;1117;2970
351190;202203;1135;3052;809;2415;172;497;292;832;464;1329
351200;202203;1810;4158;1378;3560;93;276;995;2435;1088;2711
351210;202203;1720;4071;1137;3048;79;289;684;1660;763;1949
351220;202203;3970;10283;3450;9479;286;852;2499;6689;2785;7541
351230;202203;2278;5755;1778;4925;304;927;936;2364;1240;3291
351240;202203;2707;6721;1745;4820;410;1150;611;1531;1021;2681
351250;202203;1207;3125;739;2182;77;252;281;813;358;1065
351260;202203;1012;2433;748;1971;143;400;306;755;449;1155
351270;202203;583;1516;414;1193;43;150;209;510;252;660
351280;202203;4353;11037;3415;9383;656;1892;1566;4094;2222;5986
351290;202203;1481;3497;1080;2827;121;353;715;1785;836;2138
351300;202203;22469;57941;16412;46908;2714;8502;8158;22071;10872;30573
351310;202203;3966;9327;3067;7957;137;498;2343;5765;2480;6263
351320;202203;995;2798;732;2281;132;450;243;664;375;1114
351330;202203;543;1311;429;1086;27;98;299;676;326;774
351340;202203;7692;19940;6410;17792;1251;3706;3520;9387;4771;13093
351350;202203;13912;33260;11636;29693;776;2244;9054;22251;9830;24495
351360;202203;4347;10972;3602;9907;707;2200;1837;4632;2544;6832
351370;202203;2309;6192;1588;4765;366;1209;502;1317;868;2526
351380;202203;52259;121760;38025;98091;3975;11311;23767;58344;27742;69655
351385;202203;440;1093;189;565;27;80;70;189;97;269
351390;202203;1497;3517;968;2760;104;343;638;1743;742;2086
351400;202203;1137;2995;945;2635;88;261;644;1718;732;1979
351410;202203;2940;7824;2194;6435;373;1095;948;2682;1321;3777
351420;202203;549;1292;332;924;35;110;200;500;235;610
351430;202203;1097;2773;908;2483;54;155;682;1808;736;1963
351440;202203;3909;9927;2689;7535;518;1524;836;2020;1354;3544
351450;202203;1910;4880;1331;3871;262;876;319;720;581;1596
351460;202203;1042;2580;844;2282;117;350;541;1415;658;1765
351470;202203;1370;3316;1097;2888;70;236;766;1893;836;2129
351480;202203;2713;7568;2158;6690;345;1262;1059;3007;1404;4269
351490;202203;2316;6219;2020;5708;68;290;1676;4596;1744;4886
351492;202203;380;990;328;883;5;18;254;668;259;686
351495;202203;234;591;187;508;17;41;114;302;131;343
351500;202203;45924;106765;36011;91156;4281;11459;23720;57511;28001;68970
351510;202203;14595;34106;10937;28128;1111;3280;7334;17982;8445;21262
351512;202203;541;1384;402;1092;77;215;159;403;236;618
351515;202203;3693;8153;2412;6124;473;1289;687;1839;1160;3128
351518;202203;2779;6768;1888;5240;246;791;987;2427;1233;3218
351519;202203;692;1840;443;1374;80;258;90;244;170;502
351520;202203;1408;3424;683;2000;69;237;333;872;402;1109
351530;202203;387;982;237;679;35;109;113;269;148;378
351535;202203;1959;4675;1440;3808;214;614;744;1880;958;2494
351540;202203;3013;7159;2070;5540;224;714;1043;2458;1267;3172
351550;202203;8276;19854;5865;15662;559;1711;3416;8421;3975;10132
351560;202203;551;1509;445;1310;113;368;138;376;251;744
351565;202203;283;764;228;668;50;172;69;170;119;342
351570;202203;24990;63168;19713;53261;1755;5307;13103;33794;14858;39101
351580;202203;249;614;145;440;13;39;68;201;81;240
351590;202203;539;1203;281;751;25;80;163;398;188;478
351600;202203;1480;3869;1156;3267;158;488;652;1714;810;2202
351610;202203;809;1867;529;1387;37;111;309;763;346;874
351620;202203;26565;67769;19937;56988;2923;9742;9880;25865;12803;35607
351630;202203;32271;79978;26377;70466;2482;7693;18481;47099;20963;54792
351640;202203;20627;50825;16529;43916;1183;3894;11887;29888;13070;33782
351650;202203;415;1096;219;675;28;99;63;174;91;273
351660;202203;777;2098;527;1598;89;277;124;317;213;594
351670;202203;6945;18014;4685;13255;934;2580;2024;5350;2958;7930
351680;202203;488;1298;341;995;61;188;93;215;154;403
351685;202203;493;1344;403;1204;91;274;163;444;254;718
351690;202203;1310;3238;777;2233;91;311;366;966;457;1277
351700;202203;1494;3570;1109;2939;193;566;592;1451;785;2017
351710;202203;891;2253;683;1889;61;203;412;1035;473;1238
351720;202203;1676;4151;1183;3324;180;558;553;1437;733;1995
351730;202203;1097;2680;911;2390;71;227;592;1445;663;1672
351740;202203;3789;9183;3097;7934;456;1291;1739;4076;2195;5367
351750;202203;1817;4514;1108;3274;166;514;527;1496;693;2010
351760;202203;3717;9868;2842;8246;543;1755;1336;3544;1879;5299
351770;202203;2143;5857;1774;5203;261;857;1103;3092;1364;3949
351780;202203;1335;3252;817;2328;107;352;341;897;448;1249
351790;202203;1613;3700;1278;3248;156;408;853;2117;1009;2525
351800;202203;563;1267;313;823;33;103;129;291;162;394
351810;202203;1223;3116;1022;2823;104;267;664;1758;768;2025
351820;202203;3147;8317;2329;6808;545;1777;742;1944;1287;3721
351830;202203;5229;13187;4040;11198;341;1124;2639;6896;2980;8020
351840;202203;10107;26367;7837;22390;871;2883;4687;12399;5558;15282
351850;202203;1671;4454;1129;3409;187;635;407;1015;594;1650
351860;202203;2949;8131;2292;6975;270;915;1390;4204;1660;5119
351870;202203;27946;68043;21473;57696;4614;12694;10010;26878;14624;39572
351880;202203;166166;401554;129724;341824;20428;60696;76653;190395;97081;251091
351885;202203;1054;2654;848;2334;51;191;601;1588;652;1779
351890;202203;958;2425;634;1897;123;424;152;390;275;814
351900;202203;1352;3425;1041;2972;104;285;670;1886;774;2171
351905;202203;536;1432;395;1171;41;144;202;526;243;670
351907;202203;24454;61629;19465;53150;1870;5924;13172;34254;15042;40178
351910;202203;1887;4657;1383;3655;106;323;819;1925;925;2248
351920;202203;991;2569;774;2159;117;363;346;878;463;1241
351925;202203;1042;2664;823;2291;108;367;489;1253;597;1620
351930;202203;3772;9936;3411;9295;302;938;2688;7148;2990;8086
351940;202203;1175;2933;853;2382;129;420;433;1192;562;1612
351950;202203;1891;4049;1467;3456;68;200;1082;2437;1150;2637
351960;202203;5802;14069;4389;11689;945;2681;2044;5164;2989;7845
351970;202203;9324;25202;7564;22330;1080;3707;4608;12941;5688;16648
351980;202203;1173;2707;792;2098;87;291;481;1164;568;1455
351990;202203;1650;3760;1216;3136;62;222;647;1463;709;1685
352000;202203;2988;8082;2618;7358;234;789;1816;4797;2050;5586
352010;202203;2618;6591;2145;5849;605;1725;588;1634;1193;3359
352020;202203;1654;4307;1301;3720;212;672;671;1801;883;2473
352030;202203;6661;16614;5358;14560;730;2279;3270;8443;4000;10722
352040;202203;4719;11408;3431;9049;548;1576;1319;3122;1867;4698
352042;202203;3677;8494;2571;6792;333;1025;1481;3779;1814;4804
352044;202203;2397;6148;1495;4477;251;829;354;926;605;1755
352050;202203;14946;38350;10303;29461;2568;7974;2648;6519;5216;14493
352060;202203;849;2200;657;1857;112;354;294;755;406;1109
352070;202203;1032;2029;697;1592;42;117;430;907;472;1024
352080;202203;515;1291;326;935;41;109;108;290;149;399
352090;202203;1739;4913;1475;4428;166;583;752;2058;918;2641
352100;202203;4055;10831;3269;9402;557;1790;1623;4427;2180;6217
352110;202203;761;2112;580;1778;116;361;250;732;366;1093
352115;202203;615;1604;509;1445;88;262;299;829;387;1091
352120;202203;976;2700;794;2357;76;249;491;1342;567;1591
352130;202203;2267;6106;1511;4320;217;623;651;1745;868;2368
352140;202203;1315;3486;968;2812;163;490;458;1314;621;1804
352150;202203;1030;2578;785;2176;77;240;539;1441;616;1681
352160;202203;1086;2592;802;2138;78;255;438;1106;516;1361
352170;202203;3360;8613;2714;7415;296;946;1713;4367;2009;5313
352180;202203;2767;7157;2150;6097;463;1415;876;2296;1339;3711
352190;202203;1552;3948;1255;3502;169;504;753;2067;922;2571
352200;202203;352;1049;260;876;38;123;100;334;138;457
352210;202203;23396;52003;18625;45705;883;2631;15003;35857;15886;38488
352215;202203;745;1850;614;1652;103;296;333;868;436;1164
352220;202203;27726;64195;20731;52658;2909;8333;12216;28547;15125;36880
352230;202203;17423;47205;13843;40844;3162;10216;5643;15358;8805;25574
352240;202203;11681;28801;9143;24744;1729;5075;4564;11540;6293;16615
352250;202203;25859;69307;21445;62027;2368;7556;14723;41569;17091;49125
352260;202203;5655;13609;3957;10424;506;1553;2391;5663;2897;7216
352265;202203;1025;2788;918;2640;135;426;581;1618;716;2044
352270;202203;1877;5320;1465;4463;288;986;582;1622;870;2608
352280;202203;2588;6245;1981;5401;211;683;1195;3022;1406;3705
352290;202203;1568;4203;1276;3664;164;513;706;1836;870;2349
352300;202203;1040;2641;718;2008;78;257;398;1043;476;1300
352310;202203;45455;116497;34849;99032;6115;18186;19045;53378;25160;71564
352320;202203;7554;18535;5991;15781;766;2280;3559;8464;4325;10744
352330;202203;2692;6591;2107;5790;263;904;1387;3564;1650;4468
352340;202203;7535;19237;5792;16099;876;2731;3113;7944;3989;10675
352350;202203;2630;7036;2083;5885;144;506;1403;3755;1547;4261
352360;202203;1504;3836;1223;3347;85;277;923;2427;1008;2704
352370;202203;1183;3190;1028;2949;29;117;835;2353;864;2470
352380;202203;976;2512;747;2126;154;445;312;854;466;1299
352390;202203;16725;39952;11718;31303;1691;5056;6724;16846;8415;21902
352400;202203;3995;10829;3289;9539;840;2665;1562;4307;2402;6972
352410;202203;3855;9497;3015;8156;229;728;1935;4997;2164;5725
352420;202203;945;2314;648;1845;145;430;206;583;351;1013
352430;202203;9531;22363;7172;18441;1024;2979;4051;9833;5075;12812
352440;202203;21294;55933;16462;46936;3585;10805;6768;18507;10353;29312
352450;202203;889;2107;494;1456;76;235;193;529;269;764
352460;202203;3451;8943;2506;7335;446;1375;1169;3221;1615;4596
352470;202203;3708;9256;2887;7946;251;813;1891;4898;2142;5711
352480;202203;4808;11056;3324;8503;421;1279;1712;3920;2133;5199
352490;202203;910;2488;731;2182;118;398;357;1011;475;1409
352500;202203;12066;30045;8457;23564;3262;10472;1708;3063;4970;13535
352510;202203;4499;11868;3491;10104;540;1715;1967;5439;2507;7154
352520;202203;3278;8189;2569;7038;358;1134;1588;3970;1946;5104
352530;202203;12909;31739;9230;25113;1669;5095;3679;8622;5348;13717
352540;202203;625;1778;481;1490;77;239;189;538;266;777
352550;202203;1091;2885;770;2325;126;433;297;806;423;1239
352560;202203;687;1786;559;1565;60;218;363;924;423;1142
352570;202203;2627;7170;1777;5471;421;1414;261;593;682;2007
352580;202203;729;1833;624;1646;67;194;391;1002;458;1196
352585;202203;391;1041;290;865;30;112;170;473;200;585
352590;202203;14897;37911;10898;30653;2118;6580;5843;15271;7961;21851
352600;202203;2198;5655;1769;4927;136;446;1192;3099;1328;3545
352610;202203;3055;8082;2329;6878;380;1353;1146;3157;1526;4510
352620;202203;6394;15351;4930;13300;1130;3069;2430;6509;3560;9578
352630;202203;966;2299;733;1979;96;292;393;1019;489;1311
352640;202203;3441;8451;2565;6926;244;723;1538;3945;1782;4668
352650;202203;657;1793;466;1405;64;215;191;546;255;761
352660;202203;1201;3365;1020;3021;105;385;669;1852;774;2237
352670;202203;11492;29305;8282;23253;1614;5089;3707;9380;5321;14469
352680;202203;3632;10191;2652;8064;408;1433;1297;3477;1705;4910
352690;202203;30179;73228;24103;63493;1142;3770;17853;45086;18995;48856
352700;202203;793;1939;596;1647;120;338;270;744;390;1082
352710;202203;6112;15131;4496;12315;984;2941;2028;5186;3012;8127
352720;202203;9944;25185;8050;21860;1604;4674;3913;10021;5517;14695
352725;202203;612;1411;359;971;24;73;203;508;227;581
352730;202203;5861;16782;5324;15612;668;2190;2627;6664;3295;8854
352740;202203;2647;6155;2035;5260;180;548;1258;3070;1438;3618
352750;202203;487;1189;317;895;41;139;150;368;191;507
352760;202203;1902;5056;1524;4363;163;438;854;2403;1017;2841
352770;202203;1032;2646;747;2126;106;314;374;998;480;1312
352780;202203;735;1999;535;1585;109;304;163;488;272;792
352790;202203;480;1215;371;1016;42;112;168;408;210;520
352800;202203;1541;4441;1105;3491;295;964;237;596;532;1560
352810;202203;1344;3062;891;2289;120;301;545;1343;665;1644
352820;202203;512;1393;379;1157;80;255;103;284;183;539
352830;202203;636;1560;328;951;32;103;106;258;138;361
352840;202203;4480;12078;3697;10722;931;2948;1684;4700;2615;7648
352850;202203;12782;29803;9258;24345;1964;5725;4267;10211;6231;15936
352860;202203;1202;3230;939;2767;152;488;383;1059;535;1547
352870;202203;964;2356;685;1811;57;175;443;1116;500;1291
352880;202203;1888;4400;1350;3480;209;587;612;1479;821;2066
352885;202203;367;945;288;816;30;97;181;490;211;587
352890;202203;783;1807;549;1345;34;106;349;743;383;849
352900;202203;20951;52538;14388;39970;2185;6457;6482;16828;8667;23285
352910;202203;436;1115;264;775;18;56;106;259;124;315
352920;202203;3080;7530;2352;6340;113;366;1707;4399;1820;4765
352930;202203;6687;17265;5175;14411;856;2710;2632;6819;3488;9529
352940;202203;26893;68830;20766;56768;3258;9776;11572;29764;14830;39540
352950;202203;633;1629;403;1206;87;277;115;298;202;575
352960;202203;826;2099;502;1443;74;229;166;372;240;601
352965;202203;277;755;190;592;43;142;54;154;97;296
352970;202203;3337;7622;2632;6504;159;429;1974;4732;2133;5161
352980;202203;1522;3762;1210;3322;254;727;685;1852;939;2579
352990;202203;4940;12679;3769;10787;630;1973;2088;5791;2718;7764
353000;202203;531;1417;325;959;54;182;94;225;148;407
353010;202203;2996;7172;2072;5518;351;1097;996;2406;1347;3503
353020;202203;3817;9605;2371;6743;351;1076;932;2488;1283;3564
353030;202203;5250;12808;3694;10188;829;2458;1173;3082;2002;5540
353040;202203;748;1656;539;1349;93;226;295;724;388;950
353050;202203;5878;16004;4300;12879;694;2271;2180;6201;2874;8472
353060;202203;54708;133946;45690;120082;2826;9006;35242;89315;38068;98321
353070;202203;11629;31518;8692;25387;1343;4414;4195;11163;5538;15577
353080;202203;5232;13558;3618;10543;667;2204;1522;3854;2189;6058
353090;202203;685;1942;576;1741;37;138;384;1115;421;1253
353100;202203;331;846;164;495;32;104;50;117;82;221
353110;202203;8582;21290;6943;19051;1559;4162;3608;10371;5167;14533
353120;202203;472;1159;364;983;44;155;187;434;231;589
353130;202203;3038;6933;2018;5208;478;1324;824;1883;1302;3207
353140;202203;3190;7478;2430;6276;122;393;1783;4394;1905;4787
353150;202203;1738;4186;1272;3443;242;705;591;1509;833;2214
353160;202203;728;1838;531;1519;74;238;252;654;326;892
353170;202203;600;1548;462;1359;76;236;231;688;307;924
353180;202203;11662;27569;9255;23744;1705;4606;5432;13450;7137;18056
353190;202203;3776;9783;3009;8286;374;1151;1822;4695;2196;5846
353200;202203;1978;5135;1232;3698;174;615;442;1187;616;1802
353205;202203;491;1424;421;1270;48;160;236;681;284;841
353210;202203;1016;2194;680;1667;26;75;502;1181;528;1256
353215;202203;439;1119;353;979;48;167;177;442;225;609
353220;202203;834;2190;592;1718;127;360;147;393;274;753
353230;202203;881;2338;699;2057;166;571;270;716;436;1287
353240;202203;2621;6801;2217;6180;274;872;1417;3802;1691;4674
353250;202203;1318;2920;855;2191;97;272;486;1201;583;1473
353260;202203;1281;2893;749;2037;115;344;356;896;471;1240
353270;202203;832;2030;699;1808;64;197;491;1192;555;1389
353280;202203;791;2024;580;1678;137;394;190;547;327;941
353282;202203;2012;5451;1702;4921;157;545;1105;3015;1262;3560
353284;202203;417;949;242;635;23;79;118;264;141;343
353286;202203;195;467;123;353;25;67;32;74;57;141
353290;202203;1612;4130;1022;2982;155;468;366;957;521;1425
353300;202203;2403;6157;1791;5009;301;958;860;2125;1161;3083
353310;202203;447;1045;338;865;20;68;228;542;248;610
353320;202203;775;1884;666;1735;15;52;531;1347;546;1399
353325;202203;783;2170;578;1737;103;303;245;705;348;1008
353330;202203;699;1709;476;1309;70;218;250;627;320;845
353340;202203;3510;9208;2735;7739;453;1467;1473;3825;1926;5292
353350;202203;4309;10402;3216;8422;698;1849;1189;2832;1887;4681
353360;202203;736;1989;591;1720;57;205;362;993;419;1198
353370;202203;637;1746;531;1581;45;163;377;1081;422;1244
353380;202203;339;951;277;839;35;119;135;367;170;486
353390;202203;7152;17124;5452;14419;421;1291;3521;8845;3942;10136
353400;202203;571;1471;442;1240;75;235;195;454;270;689
353410;202203;575;1485;438;1243;58;168;264;733;322;901
353420;202203;520;1306;350;970;71;189;60;140;131;329
353430;202203;2595;6807;2081;5900;366;1106;1107;2990;1473;4096
353440;202203;77627;199661;59040;164543;7979;24788;35111;92155;43090;116943
353450;202203;421;1041;295;832;42;148;153;389;195;537
353460;202203;3742;9700;2822;8061;503;1537;842;2232;1345;3769
353470;202203;9804;24896;7276;20272;1145;3629;3537;9040;4682;12669
353475;202203;1871;4522;1300;3466;149;452;717;1735;866;2187
353480;202203;1777;4514;1469;4025;67;240;1087;2864;1154;3104
353490;202203;1212;3064;879;2467;121;357;404;1059;525;1416
353500;202203;1205;2788;881;2292;162;435;532;1342;694;1777
353510;202203;1002;2802;746;2242;182;613;258;672;440;1285
353520;202203;1145;2862;764;2221;76;246;382;995;458;1241
353530;202203;2787;7018;2255;6084;250;807;1313;3286;1563;4093
353540;202203;2357;6083;1930;5438;257;782;1188;3234;1445;4016
353550;202203;6769;16480;5550;14577;698;1978;3515;8801;4213;10779
353560;202203;2556;6535;1983;5706;484;1522;764;1999;1248;3521
353570;202203;753;1907;518;1491;86;291;235;610;321;901
353580;202203;2506;6333;1954;5294;367;997;993;2586;1360;3583
353590;202203;803;1964;579;1592;57;164;349;927;406;1091
353600;202203;1842;4473;1425;3769;159;467;820;2096;979;2563
353610;202203;790;2209;584;1799;106;372;241;685;347;1057
353620;202203;3221;8057;2358;6649;453;1368;923;2369;1376;3737
353625;202203;656;1589;411;1158;45;153;227;606;272;759
353630;202203;1645;4690;1423;4270;243;798;739;2049;982;2847
353640;202203;1429;3602;1152;3183;160;456;700;1897;860;2353
353650;202203;8518;22070;6697;18839;746;2345;3960;10466;4706;12811
353657;202203;409;1044;311;897;26;90;150;398;176;488
353660;202203;1480;3025;1060;2472;182;432;631;1436;813;1868
353670;202203;4677;12396;3688;10573;646;2112;1861;4878;2507;6990
353680;202203;787;1972;589;1694;71;238;369;992;440;1230
353690;202203;503;1309;250;751;31;95;63;170;94;265
353700;202203;2320;5764;1935;5166;130;435;1426;3645;1556;4080
353710;202203;5867;13017;3612;9063;364;947;1922;4258;2286;5205
353715;202203;485;1250;295;878;15;61;118;323;133;384
353720;202203;2244;5664;1759;4952;270;815;981;2688;1251;3503
353730;202203;4965;12557;3905;10758;475;1556;2345;5952;2820;7508
353740;202203;2271;5759;1654;4703;338;1111;666;1714;1004;2825
353750;202203;1031;2977;779;2516;188;635;237;734;425;1369
353760;202203;15256;33060;11957;28816;2183;5420;7017;16614;9200;22034
353770;202203;685;1937;443;1423;82;296;75;209;157;505
353780;202203;6912;17430;5718;15364;909;2805;3454;8656;4363;11461
353790;202203;3182;9126;2400;7526;568;1968;597;1635;1165;3603
353800;202203;21034;52771;16968;46501;2427;6633;9966;26911;12393;33544
353810;202203;1375;3570;946;2699;144;451;438;1196;582;1647
353820;202203;1969;5095;1367;3969;296;964;428;1129;724;2093
353830;202203;705;1697;528;1426;77;234;258;660;335;894
353850;202203;1764;4665;1386;3983;256;748;610;1680;866;2428
353860;202203;2999;7761;2327;6692;493;1633;1160;3009;1653;4642
353870;202203;33977;85712;25274;69718;3097;9606;13723;34721;16820;44327
353880;202203;3443;9120;2780;7922;203;712;1798;4852;2001;5564
353890;202203;3390;6964;2510;5731;139;381;1843;3863;1982;4244
353900;202203;818;2192;622;1833;85;282;273;737;358;1019
353910;202203;3012;7883;2571;7214;205;669;1883;5161;2088;5830
353920;202203;2242;5867;1653;4808;413;1318;411;988;824;2306
353930;202203;5238;13369;3717;10554;633;2091;1722;4296;2355;6387
353940;202203;1351;3761;982;3056;149;508;369;1018;518;1526
353950;202203;3723;9618;2913;8168;622;1879;1394;3670;2016;5549
353960;202203;896;2247;647;1807;152;413;215;568;367;981
353970;202203;714;1631;547;1390;45;138;399;981;444;1119
353980;202203;18092;43926;14377;37834;750;2433;10748;26994;11498;29427
353990;202203;1031;2430;659;1786;109;324;330;844;439;1168
354000;202203;2875;6706;1696;4520;392;1071;396;950;788;2021
354010;202203;362;920;263;767;45;141;146;414;191;555
354020;202203;4153;10787;3370;9277;593;1785;1732;4398;2325;6183
354025;202203;805;2137;557;1676;79;265;179;499;258;764
354030;202203;544;1143;306;777;60;147;146;352;206;499
354040;202203;891;1997;596;1553;30;91;446;1112;476;1203
354050;202203;1062;2909;765;2385;151;532;315;937;466;1469
354060;202203;3965;10761;2911;8596;515;1715;1339;3535;1854;5250
354070;202203;4431;11035;3104;8525;487;1532;1518;3702;2005;5234
354075;202203;3211;8603;2612;7585;292;934;1688;4703;1980;5637
354080;202203;1610;4267;1132;3357;200;622;414;1093;614;1715
354085;202203;491;959;395;841;0;0;315;624;315;624
354090;202203;1833;4949;1577;4438;89;269;1227;3347;1316;3616
354100;202203;22873;58830;16530;48298;3462;10626;7505;21379;10967;32005
354105;202203;1560;3789;1149;3086;139;448;575;1419;714;1867
354110;202203;479;1316;359;1096;64;222;136;389;200;611
354120;202203;1525;3966;1092;3081;217;675;397;982;614;1657
354130;202203;6280;15995;4311;12247;1215;3612;554;1232;1769;4844
354140;202203;22172;53242;15902;42077;2324;6872;7825;18863;10149;25735
354150;202203;3161;7301;2492;6296;557;1418;1040;2607;1597;4025
354160;202203;3188;8815;2505;7515;621;2046;956;2636;1577;4682
354165;202203;756;2141;597;1840;90;340;328;937;418;1277
354170;202203;2145;5688;1776;5026;127;420;1081;2890;1208;3310
354180;202203;446;1210;346;1016;41;121;190;520;231;641
354190;202203;1754;4772;1276;3795;81;287;685;1921;766;2208
354200;202203;1004;2328;773;1982;59;182;535;1281;594;1463
354210;202203;1075;2723;894;2450;49;167;657;1683;706;1850
354220;202203;3472;8970;2688;7513;391;1198;1484;3928;1875;5126
354230;202203;907;2145;749;1961;28;107;582;1464;610;1571
354240;202203;1974;5307;1366;4097;243;802;484;1288;727;2090
354250;202203;684;1619;446;1223;93;248;149;379;242;627
354260;202203;9123;22722;7122;19384;1074;3257;3889;10000;4963;13257
354270;202203;1140;3238;958;2912;166;543;446;1251;612;1794
354280;202203;920;2150;797;1978;57;170;582;1344;639;1514
354290;202203;1036;3138;883;2840;152;516;467;1515;619;2031
354300;202203;3906;10968;3330;9938;788;2411;1566;4591;2354;7002
354310;202203;797;2284;673;2061;150;489;293;842;443;1331
354320;202203;1081;2536;718;1953;98;296;337;818;435;1114
354323;202203;536;1239;341;888;43;104;155;372;198;476
354325;202203;1634;4729;1148;3646;209;692;311;937;520;1629
354330;202203;10840;26200;7753;20254;753;2251;5018;12172;5771;14423
354340;202203;39222;94826;28184;76347;3368;10435;17052;43958;20420;54393
354350;202203;1333;3263;1074;2859;137;415;654;1634;791;2049
354360;202203;682;1671;435;1278;104;318;135;380;239;698
354370;202203;1113;3044;912;2728;125;411;585;1694;710;2105
354380;202203;730;1874;548;1589;100;375;182;423;282;798
354390;202203;16088;37511;11149;29172;1619;4676;5962;14541;7581;19217
354400;202203;1771;5438;1429;4672;274;949;541;1728;815;2677
354410;202203;7322;18336;5733;15452;852;2557;3233;8108;4085;10665
354420;202203;1686;4215;1264;3467;151;473;775;1972;926;2445
354425;202203;3090;7293;2275;5922;437;1198;1057;2709;1494;3907
354430;202203;1699;4326;1357;3829;107;347;883;2369;990;2716
354440;202203;676;1688;457;1279;59;180;233;595;292;775
354450;202203;515;1334;317;969;43;142;105;265;148;407
354460;202203;931;2309;648;1833;106;321;304;813;410;1134
354470;202203;501;1227;352;959;17;56;179;422;196;478
354480;202203;1464;3215;972;2453;81;233;632;1486;713;1719
354490;202203;890;2517;663;2038;118;379;316;890;434;1269
354500;202203;2430;6513;1969;5806;567;1721;596;1769;1163;3490
354510;202203;815;2181;670;1914;46;157;417;1084;463;1241
354515;202203;430;1178;311;943;44;148;125;361;169;509
354520;202203;8008;20961;5863;16616;695;2325;3435;8976;4130;11301
354530;202203;5244;14068;4198;12123;924;2679;1711;5008;2635;7687
354540;202203;1500;3763;1116;3098;213;605;480;1295;693;1900
354550;202203;661;1720;537;1504;72;234;301;782;373;1016
354560;202203;2505;5886;1426;3888;168;472;773;1917;941;2389
354570;202203;1344;3291;575;1596;125;351;80;207;205;558
354580;202203;9455;24288;6488;18717;955;3061;3417;9341;4372;12402
354600;202203;2290;5710;1838;4948;256;725;1161;2978;1417;3703
354610;202203;510;1289;298;855;33;100;139;368;172;468
354620;202203;530;1413;335;1046;38;152;148;413;186;565
354625;202203;337;894;207;650;36;132;56;140;92;272
354630;202203;2545;7122;2106;6303;615;1891;582;1681;1197;3572
354640;202203;3951;10736;3070;9071;402;1399;1472;3954;1874;5353
354650;202203;965;2483;780;2185;104;289;449;1232;553;1521
354660;202203;3935;8983;2233;6259;221;766;1034;2619;1255;3385
354670;202203;1204;3243;867;2583;169;556;362;995;531;1551
354680;202203;6115;15189;4721;12994;852;2483;2673;7376;3525;9859
354690;202203;573;1708;424;1398;86;295;148;457;234;752
354700;202203;1018;2635;737;2104;80;269;406;1061;486;1330
354710;202203;557;1453;394;1139;45;135;181;461;226;596
354720;202203;335;776;161;453;64;165;36;110;100;275
354730;202203;11435;31178;8995;26671;1091;3618;5484;15532;6575;19150
354740;202203;352;937;162;507;25;90;30;78;55;168
354750;202203;3146;7789;2093;5852;290;906;937;2303;1227;3209
354760;202203;2419;6228;1784;5112;361;1151;704;1824;1065;2975
354765;202203;393;1032;177;544;16;65;59;161;75;226
354770;202203;2810;6711;2104;5494;367;967;989;2462;1356;3429
354780;202203;66065;158950;51916;132278;3806;11613;36456;86614;40262;98227
354790;202203;1132;2989;892;2604;71;251;574;1600;645;1851
354800;202203;2942;7356;2291;6334;457;1353;1115;2864;1572;4217
354805;202203;1530;3407;1112;2815;108;275;725;1706;833;1981
354810;202203;695;1991;438;1457;74;283;141;432;215;715
354820;202203;1081;2950;784;2415;143;503;252;625;395;1128
354830;202203;558;1326;353;957;79;230;122;292;201;522
354840;202203;1004;2466;646;1745;59;175;368;910;427;1085
354850;202203;23775;58758;17299;47829;1704;5455;11159;29144;12863;34599
354860;202203;1906;5038;1249;3727;205;677;472;1297;677;1974
354870;202203;69824;169649;55292;143761;4619;13933;37675;92097;42294;106030
354880;202203;6613;15848;3492;9492;401;1291;1483;3296;1884;4587
354890;202203;18315;44423;14514;38149;1888;5645;8555;21745;10443;27390
354900;202203;442;1066;296;824;62;196;113;252;175;448
354910;202203;6633;17024;4287;12875;945;3042;1120;3065;2065;6107
354920;202203;565;1465;295;933;41;143;73;192;114;335
354925;202203;317;870;192;604;24;81;52;148;76;229
354930;202203;419;1001;295;788;37;102;145;363;182;465
354940;202203;2678;7617;2027;6272;639;2079;620;1717;1259;3796
354950;202203;1753;4219;1421;3798;69;236;1085;2769;1154;3005
354960;202203;976;2505;736;2146;74;257;396;1090;470;1347
354970;202203;4686;12480;3731;10920;356;1283;2526;7127;2882;8410
354980;202203;38149;87990;26891;69160;2512;7766;17341;41546;19853;49312
354990;202203;82173;196897;61559;160877;4189;13286;42509;103944;46698;117230
354995;202203;3418;7163;2663;6210;128;380;2133;4788;2261;5168
355000;202203;1752;4161;1338;3569;193;610;711;1743;904;2353
355010;202203;4566;11867;3033;8697;960;2693;671;1890;1631;4583
355020;202203;4007;10651;3031;9002;568;1896;1388;3857;1956;5753
355030;202203;1549781;3698134;1168702;2989587;151857;431849;655868;1552273;807725;1984122
355040;202203;3425;7995;2679;7052;191;560;2080;5432;2271;5992
355050;202203;1208;2592;911;2196;220;567;429;940;649;1507
355060;202203;7103;18298;5340;15150;820;2686;2934;7617;3754;10303
355070;202203;11207;27327;9282;24351;998;3083;6204;15298;7202;18381
355080;202203;1066;2940;694;2276;157;562;118;324;275;886
355090;202203;1405;3749;1138;3323;195;639;599;1617;794;2256
355100;202203;24965;62662;19770;55159;2572;7719;12839;35144;15411;42863
355110;202203;1009;2680;762;2322;217;751;110;306;327;1057
355120;202203;821;2078;597;1757;67;213;277;787;344;1000
355130;202203;920;2011;509;1282;28;83;333;771;361;854
355140;202203;2357;4870;2012;4408;91;240;1732;3692;1823;3932
355150;202203;4987;12535;4052;10965;447;1324;2659;6898;3106;8222
355160;202203;2537;6662;1857;5494;385;1226;561;1537;946;2763
355170;202203;12894;31060;10305;26913;1625;4578;5881;14874;7506;19452
355180;202203;3179;8038;2339;6717;416;1365;1135;2986;1551;4351
355190;202203;2083;5325;1661;4654;429;1155;821;2495;1250;3650
355200;202203;891;2632;763;2440;188;654;367;1126;555;1780
355210;202203;3392;8884;2634;7326;466;1423;1334;3497;1800;4920
355220;202203;55017;138867;44891;120150;7279;21361;23886;59190;31165;80551
355230;202203;1322;3261;756;2175;126;373;272;712;398;1085
355240;202203;28097;71995;20548;57623;2112;6689;12208;32066;14320;38755
355250;202203;43094;110230;33037;91550;7048;20319;15289;40343;22337;60662
355255;202203;715;1733;397;1163;46;133;150;433;196;566
355260;202203;1767;4009;1302;3293;102;340;882;2067;984;2407
355270;202203;1281;3623;1019;3114;210;681;468;1325;678;2006
355280;202203;35325;86193;26234;70051;3021;9066;15048;37626;18069;46692
355290;202203;1042;2683;815;2316;135;389;386;1039;521;1428
355300;202203;1521;4276;1264;3809;246;778;536;1501;782;2279
355310;202203;1013;2713;769;2305;96;313;456;1354;552;1667
355320;202203;597;1541;462;1297;97;323;199;458;296;781
355330;202203;3329;8126;2621;6923;103;355;2029;5112;2132;5467
355340;202203;4568;9925;3524;8567;507;1212;2168;5381;2675;6593
355350;202203;1528;4170;1183;3514;209;686;525;1474;734;2160
355360;202203;1330;3205;1040;2772;100;287;673;1736;773;2023
355365;202203;398;991;217;686;52;156;40;130;92;286
355370;202203;5866;14615;4608;12650;966;2442;2245;6611;3211;9053
355380;202203;3205;8230;2488;6954;449;1404;1006;2472;1455;3876
355385;202203;1618;4026;1350;3659;107;387;906;2242;1013;2629
355390;202203;906;2418;665;1918;114;365;300;786;414;1151
355395;202203;2153;5763;1594;4688;252;812;648;1678;900;2490
355400;202203;10418;28606;8451;24870;1785;5989;3675;9817;5460;15806
355410;202203;26489;70374;17387;52000;3425;11193;5806;16699;9231;27892
355420;202203;695;2111;583;1908;150;551;195;609;345;1160
355430;202203;4133;10103;3200;8476;569;1604;1599;4117;2168;5721
355440;202203;842;2213;551;1623;106;310;136;362;242;672
355450;202203;3767;9400;2620;7235;376;1164;1254;3106;1630;4270
355460;202203;558;1344;359;1011;35;126;171;442;206;568
355465;202203;503;1243;409;1097;53;152;257;669;310;821
355470;202203;1252;3091;753;2123;171;557;260;659;431;1216
355475;202203;388;874;326;797;10;26;258;615;268;641
355480;202203;4484;11910;3646;10662;428;1454;2478;7091;2906;8545
355490;202203;1026;2675;599;1829;56;203;290;814;346;1017
355495;202203;945;2526;713;2152;102;368;291;781;393;1149
355500;202203;7725;19111;5021;14064;718;2198;2072;5280;2790;7478
355510;202203;1567;3714;1042;2854;179;527;441;1094;620;1621
355520;202203;410;934;214;614;43;109;64;187;107;296
355530;202203;365;836;149;425;7;20;71;188;78;208
355535;202203;602;1592;476;1396;114;350;218;619;332;969
355540;202203;12541;29806;10510;27043;1037;3070;7685;19079;8722;22149
355550;202203;680;1946;575;1760;60;219;316;883;376;1102
355560;202203;1278;3205;760;2219;181;587;45;142;226;729
355570;202203;320;844;182;554;33;101;48;130;81;231
355580;202203;1346;3125;861;2331;148;461;323;787;471;1248
355590;202203;183;467;142;405;11;33;87;239;98;272
355600;202203;1717;4125;1148;3171;186;552;391;1062;577;1614
355610;202203;2091;4975;1441;3881;146;424;816;2032;962;2456
355620;202203;5680;14540;4346;12007;467;1580;2520;6349;2987;7929
355630;202203;2859;7359;2109;6041;277;838;1237;3366;1514;4204
355635;202203;1020;2865;762;2368;127;424;265;769;392;1193
355640;202203;3852;10183;2731;8058;616;1809;805;2371;1421;4180
355645;202203;4524;12186;3367;10206;476;1601;1890;5505;2366;7106
355650;202203;7277;19068;5760;16369;1314;3861;2447;6507;3761;10368
355660;202203;1583;3954;1100;3118;202;524;344;928;546;1452
355670;202203;4389;11356;3139;8654;394;1328;1667;3997;2061;5325
355680;202203;3213;8563;1626;4947;413;1387;134;402;547;1789
355690;202203;856;2420;588;1918;166;588;17;44;183;632
355695;202203;286;776;176;534;17;60;33;75;50;135
355700;202203;8479;23192;7131;20376;929;2974;4301;11603;5230;14577
355710;202203;10627;24403;7358;18581;993;2944;3948;8744;4941;11688
355715;202203;525;1395;295;882;67;200;58;163;125;363
355720;202203;1601;4313;1297;3806;173;563;755;2065;928;2628
355730;202203;1044;2756;867;2451;111;366;498;1316;609;1682
410010;202203;1344;3650;1047;3054;219;698;272;734;491;1432
410020;202203;1178;3341;908;2770;248;723;269;781;517;1504
410030;202203;1746;4561;1505;4199;197;596;887;2499;1084;3095
410040;202203;14805;39328;11136;32676;2282;7294;4011;10908;6293;18202
410045;202203;870;2287;638;1840;114;365;238;609;352;974
410050;202203;2498;6090;1764;4864;259;800;731;1882;990;2682
410060;202203;2301;6230;1842;5389;416;1290;590;1648;1006;2938
410070;202203;2155;5291;1633;4410;286;850;633;1542;919;2392
410080;202203;1452;3777;1062;3116;255;782;230;645;485;1427
410090;202203;1243;2973;1052;2705;93;238;609;1638;702;1876
410100;202203;2231;6152;1564;4653;285;915;165;458;450;1373
410105;202203;543;1338;325;928;30;90;128;347;158;437
410110;202203;3623;8743;2634;7003;332;957;1315;3267;1647;4224
410115;202203;622;1560;462;1284;63;196;190;472;253;668
410120;202203;3192;8178;2786;7585;407;1144;1787;4787;2194;5931
410130;202203;1438;3670;1259;3347;172;502;739;1890;911;2392
410140;202203;18748;44345;12824;34128;2272;6590;3996;9778;6268;16368
410150;202203;18224;42006;9959;26434;1728;4924;2820;6701;4548;11625
410160;202203;3328;8911;2717;7883;593;1863;1053;2965;1646;4828
410165;202203;716;1864;574;1573;69;224;322;823;391;1047
410170;202203;3231;8075;2140;5847;445;1327;246;626;691;1953
410180;202203;17679;47509;13910;40245;2087;6585;7181;19147;9268;25732
410185;202203;502;1400;381;1104;51;172;141;349;192;521
410190;202203;2451;5941;1806;4828;378;1037;538;1327;916;2364
410200;202203;6488;14281;3696;9654;700;1901;565;1427;1265;3328
410210;202203;3541;8609;2304;6470;355;1155;809;1956;1164;3111
410220;202203;592;1486;403;1151;66;206;123;317;189;523
410230;202203;2014;5278;1546;4379;239;769;682;1727;921;2496
410240;202203;5751;14638;4059;11440;836;2636;682;1745;1518;4381
410250;202203;2647;6239;1974;5183;153;499;999;2536;1152;3035
410260;202203;2064;5005;1311;3618;174;516;664;1759;838;2275
410270;202203;541;1407;401;1155;54;190;162;425;216;615
410275;202203;670;1811;475;1399;80;274;189;490;269;764
410280;202203;2596;6631;1792;5127;227;743;787;2044;1014;2787
410290;202203;3641;9895;2566;7725;658;1958;761;2271;1419;4229
410300;202203;779;1846;614;1597;64;197;312;724;376;921
410302;202203;377;945;231;678;24;84;117;330;141;414
410304;202203;1484;3558;1276;3190;121;324;889;2108;1010;2432
410305;202203;1857;4308;1324;3561;100;317;884;2293;984;2610
410310;202203;3050;7985;2523;7061;258;883;1559;4175;1817;5058
410315;202203;729;1645;471;1243;153;416;144;383;297;799
410320;202203;1107;3011;760;2352;103;337;129;365;232;702
410322;202203;712;1831;374;1069;48;149;159;393;207;542
410330;202203;1672;3968;1175;3072;188;502;400;1015;588;1517
410335;202203;921;2394;705;2002;105;330;312;816;417;1146
410337;202203;898;2167;640;1678;94;257;235;552;329;809
410340;202203;538;1484;370;1090;28;102;155;356;183;458
410345;202203;2806;7186;1660;4799;318;996;546;1397;864;2393
410347;202203;845;2123;618;1735;70;211;204;581;274;792
410350;202203;1804;4299;1330;3551;147;459;681;1657;828;2116
410360;202203;4499;11002;3445;9202;589;1673;1408;3628;1997;5301
410370;202203;15582;40617;10329;28657;1205;3699;4441;10698;5646;14397
410380;202203;1905;4558;1407;3718;237;712;491;1135;728;1847
410390;202203;3047;7316;2108;5736;430;1341;835;1992;1265;3333
410395;202203;1019;2797;821;2413;142;423;349;1032;491;1455
410400;202203;7981;19770;6111;16376;746;2243;3486;8727;4232;10970
410405;202203;954;2149;676;1739;79;233;359;854;438;1087
410410;202203;1556;3931;1452;3788;146;434;1031;2743;1177;3177
410420;202203;12762;33269;9835;27708;1408;4418;4530;11499;5938;15917
410425;202203;3858;10316;2755;8124;471;1504;1076;2864;1547;4368
410430;202203;14493;35273;10482;28244;1548;4625;4154;10352;5702;14977
410440;202203;2563;7219;2196;6560;338;1117;1186;3465;1524;4582
410442;202203;2716;7738;2205;6679;571;1816;657;1887;1228;3703
410445;202203;2469;6817;1804;5563;410;1406;299;988;709;2394
410450;202203;1645;3918;1261;3340;227;627;538;1327;765;1954
410460;202203;2541;6097;1881;4990;263;762;915;2257;1178;3019
410465;202203;3166;8758;2501;7569;456;1431;911;2556;1367;3987
410470;202203;2483;6567;1771;5327;453;1503;269;897;722;2400
410480;202203;43155;101135;25151;70405;3829;11944;6959;16798;10788;28742
410490;202203;12880;34115;9487;27431;1519;4722;4181;11166;5700;15888
410500;202203;2075;5217;1409;3993;274;844;364;870;638;1714
410510;202203;1982;4788;1385;3761;277;712;460;1242;737;1954
410520;202203;3318;9964;2940;9257;869;2878;1059;3391;1928;6269
410530;202203;1766;4186;871;2403;107;320;233;515;340;835
410540;202203;3104;8089;2177;6264;333;1058;967;2634;1300;3692
410550;202203;8532;22023;5888;16588;1029;3191;1756;4216;2785;7407
410560;202203;1726;4328;1280;3470;251;738;467;1079;718;1817
410570;202203;2913;7549;2140;6258;662;2238;264;812;926;3050
410580;202203;30825;76757;23303;63616;3523;10794;11728;29746;15251;40540
410590;202203;1787;4842;1296;3757;194;598;404;983;598;1581
410600;202203;1981;5040;1569;4257;327;874;554;1529;881;2403
410610;202203;787;1963;598;1633;66;209;290;733;356;942
410620;202203;2900;7795;2070;5983;499;1487;427;1189;926;2676
410630;202203;2835;7077;1910;5315;343;1155;494;1130;837;2285
410640;202203;5362;12241;3813;9595;851;2405;616;1573;1467;3978
410645;202203;1248;3320;1032;3057;198;620;643;1900;841;2520
410650;202203;2707;7136;1898;5529;329;1021;783;2092;1112;3113
410655;202203;975;2285;704;1834;45;112;364;895;409;1007
410657;202203;670;1791;410;1235;64;204;128;323;192;527
410660;202203;3971;9666;2474;6560;406;1148;895;2117;1301;3265
410670;202203;1114;2707;697;1945;123;331;242;619;365;950
410680;202203;2686;7829;1877;5877;522;1693;381;1186;903;2879
410685;202203;577;1439;437;1204;91;271;182;481;273;752
410690;202203;153598;361106;107800;280035;16233;47431;47540;109998;63773;157429
410700;202203;2708;6685;2262;6014;418;1154;1088;2766;1506;3920
410710;202203;992;2429;641;1783;111;335;291;740;402;1075
410712;202203;714;1909;593;1694;96;307;324;888;420;1195
410715;202203;945;2621;601;1864;65;214;263;762;328;976
410720;202203;3853;9470;3177;8318;502;1570;1091;2751;1593;4321
410725;202203;1258;2981;768;2107;176;523;150;351;326;874
410730;202203;833;2125;654;1819;132;409;160;446;292;855
410740;202203;947;2573;712;2136;72;259;325;960;397;1219
410750;202203;2055;4873;1668;4209;273;726;866;2067;1139;2793
410752;202203;422;1002;233;649;37;105;115;289;152;394
410753;202203;387;1105;280;871;41;147;69;194;110;341
410754;202203;1184;2945;986;2657;66;171;691;1938;757;2109
410755;202203;623;1571;461;1277;53;149;215;544;268;693
410760;202203;4040;10198;2951;8258;684;2218;851;2225;1535;4443
410765;202203;17468;46398;13962;39848;2843;8971;4152;10324;6995;19295
410770;202203;1156;2676;818;2114;86;195;426;1120;512;1315
410773;202203;1414;3586;1237;3325;111;343;855;2245;966;2588
410775;202203;1731;4011;1511;3697;51;135;1091;2573;1142;2708
410780;202203;702;1687;480;1282;84;245;151;369;235;614
410785;202203;785;1976;597;1670;96;324;207;558;303;882
410790;202203;1075;2981;890;2630;209;644;127;294;336;938
410800;202203;3771;8131;3039;7111;83;251;2021;4562;2104;4813
410810;202203;493;1284;376;1065;46;153;156;391;202;544
410820;202203;1080;2976;588;1729;116;364;119;293;235;657
410830;202203;46714;108156;33642;86875;6082;17475;14639;35482;20721;52957
410832;202203;1163;2957;946;2591;91;305;598;1515;689;1820
410840;202203;9877;23997;6014;16908;1225;3657;1767;4469;2992;8126
410845;202203;1259;3019;981;2600;144;411;473;1186;617;1597
410850;202203;2385;6522;2094;6024;336;1070;1029;2873;1365;3943
410855;202203;837;2033;545;1475;62;171;267;646;329;817
410860;202203;5054;11797;4031;10197;214;701;2732;6530;2946;7231
410865;202203;1597;4424;1371;4016;135;445;824;2468;959;2913
410870;202203;1345;3497;1097;3075;97;301;715;1966;812;2267
410880;202203;5195;13335;3703;10699;715;2194;745;2142;1460;4336
410890;202203;1165;3123;924;2683;161;519;367;997;528;1516
410895;202203;1107;3367;946;3044;302;1053;270;827;572;1880
410900;202203;930;2411;663;1927;109;353;173;417;282;770
410910;202203;463;1050;294;740;11;40;159;359;170;399
410920;202203;971;2288;729;1922;95;270;372;963;467;1233
410930;202203;1912;4705;1341;3747;349;1080;254;694;603;1774
410940;202203;26350;68694;19559;56899;3651;11616;7379;20672;11030;32288
410950;202203;2149;5964;1941;5643;99;331;1569;4503;1668;4834
410960;202203;8811;20820;6275;16766;1409;4131;2731;7163;4140;11294
410965;202203;1304;3145;915;2469;70;207;602;1566;672;1773
410970;202203;4586;11958;3283;9474;812;2693;543;1321;1355;4014
410975;202203;1566;3654;1204;3109;172;511;600;1486;772;1997
410980;202203;8482;20470;5691;15687;639;1976;2672;6669;3311;8645
410990;202203;1584;3652;1097;2913;183;551;498;1300;681;1851
411000;202203;757;1970;553;1608;101;320;177;452;278;772
411005;202203;504;1216;307;816;45;134;111;258;156;392
411007;202203;2760;7198;2089;6001;396;1285;837;2283;1233;3568
411010;202203;4720;13601;3784;11823;982;3304;488;1413;1470;4717
411020;202203;2598;7021;2159;6286;545;1679;720;2022;1265;3701
411030;202203;827;1997;586;1516;59;176;287;646;346;822
411040;202203;1116;2731;606;1675;98;264;169;392;267;656
411050;202203;2198;6572;1821;5809;420;1488;358;978;778;2466
411060;202203;2375;6121;1596;4559;324;987;439;1185;763;2172
411065;202203;455;1130;288;806;25;81;122;322;147;403
411070;202203;8403;20448;6750;17833;772;2320;3754;9479;4526;11799
411080;202203;2087;5386;1731;4793;408;1304;492;1325;900;2629
411090;202203;892;2306;589;1717;80;235;152;393;232;628
411095;202203;2902;6646;1677;4509;265;728;369;886;634;1614
411100;202203;1342;3374;960;2715;114;361;360;971;474;1332
411110;202203;715;1800;353;1037;43;125;28;59;71;184
411120;202203;1546;4017;1295;3603;316;1030;462;1129;778;2159
411125;202203;5927;16544;5313;15461;1062;3113;2698;8045;3760;11158
411130;202203;793;2029;570;1624;132;328;194;624;326;952
411140;202203;2486;7271;2074;6441;540;1762;679;2127;1219;3889
411150;202203;4467;10916;3087;8267;657;1873;332;721;989;2594
411155;202203;1132;2804;742;2099;106;329;351;900;457;1229
411160;202203;413;931;283;733;40;113;77;192;117;305
411170;202203;863;2399;680;2019;133;442;292;816;425;1258
411180;202203;6424;16261;5104;14101;721;2239;2680;6887;3401;9126
411190;202203;2134;5322;1611;4413;212;657;693;1671;905;2328
411200;202203;5419;14098;4074;11722;902;2959;1244;3124;2146;6083
411210;202203;3749;8191;2684;6511;401;1128;1189;2699;1590;3827
411220;202203;992;2443;706;1929;156;443;228;593;384;1036
411230;202203;955;2461;712;2011;154;488;243;627;397;1115
411240;202203;1786;4103;1252;3215;160;454;597;1441;757;1895
411250;202203;2498;6364;1838;5211;363;1165;609;1626;972;2791
411260;202203;359;888;237;655;24;78;98;235;122;313
411270;202203;2194;5651;1660;4615;255;743;815;2089;1070;2832
411275;202203;1685;3726;1193;2959;139;424;654;1502;793;1926
411280;202203;1502;3926;1071;3131;268;833;227;603;495;1436
411290;202203;912;2310;591;1695;67;216;314;862;381;1078
411295;202203;1377;3377;1003;2699;131;386;471;1175;602;1561
411300;202203;1122;2749;748;2050;76;232;332;786;408;1018
411310;202203;992;2206;779;1923;120;305;362;855;482;1160
411320;202203;6038;14978;4510;12389;663;1952;2095;5188;2758;7140
411325;202203;1606;4319;1333;3816;250;713;688;2037;938;2750
411330;202203;3593;9348;2669;7730;562;1773;883;2558;1445;4331
411340;202203;920;2461;561;1682;89;288;175;477;264;765
411342;202203;1176;2777;647;1728;107;307;228;554;335;861
411345;202203;1268;3097;974;2629;60;192;712;1914;772;2106
411350;202203;3233;8380;2185;6365;574;1762;446;1173;1020;2935
411360;202203;845;1934;637;1621;64;197;346;785;410;982
411370;202203;66688;160050;49524;131725;3790;12037;29765;73308;33555;85345
411373;202203;1594;3858;1289;3415;138;397;686;1834;824;2231
411375;202203;1246;3022;894;2378;121;324;380;971;501;1295
411380;202203;1255;2846;881;2166;49;132;565;1280;614;1412
411390;202203;1678;4453;1341;3765;194;605;542;1323;736;1928
411400;202203;2622;6244;2009;5163;165;505;1148;2780;1313;3285
411410;202203;3045;8244;2314;6772;497;1558;590;1593;1087;3151
411420;202203;4789;11350;2707;7561;414;1257;563;1214;977;2471
411430;202203;4198;10781;3226;9032;669;2080;1152;2908;1821;4988
411435;202203;477;1268;305;928;60;192;95;254;155;446
411440;202203;2806;7494;2262;6506;456;1471;779;2100;1235;3571
411450;202203;2723;6980;2093;5968;238;732;1249;3546;1487;4278
411460;202203;4890;12281;3171;9065;514;1628;726;1798;1240;3426
411470;202203;912;2234;685;1845;127;362;276;663;403;1025
411480;202203;5955;15105;4350;12176;699;2322;1675;4254;2374;6576
411490;202203;1816;4482;1391;3821;164;535;636;1558;800;2093
411500;202203;1462;3772;1025;2894;181;566;234;539;415;1105
411510;202203;2564;6144;2040;5318;321;962;688;1840;1009;2802
411520;202203;38369;91657;23667;63564;2819;8751;9875;23566;12694;32317
411530;202203;1040;2605;638;1874;111;344;116;306;227;650
411535;202203;550;1550;376;1164;50;172;117;325;167;497
411540;202203;2927;6946;2049;5409;94;308;1223;3144;1317;3452
411545;202203;983;2755;827;2484;63;218;551;1644;614;1862
411550;202203;770;1876;588;1552;84;230;181;445;265;675
411560;202203;2190;5855;1248;3859;194;645;101;255;295;900
411570;202203;7933;17917;5585;14472;1294;3598;1427;3606;2721;7204
411573;202203;846;2213;698;1952;134;407;316;827;450;1234
411575;202203;2172;5692;1644;4689;298;908;506;1364;804;2272
411580;202203;5352;12208;3373;9205;558;1702;675;1672;1233;3374
411585;202203;658;1903;333;1056;62;192;63;181;125;373
411590;202203;473;1260;362;1051;37;126;194;521;231;647
411600;202203;374;902;236;682;41;129;91;244;132;373
411605;202203;1725;3892;1120;2963;173;494;566;1517;739;2011
411610;202203;3027;6710;2192;5288;58;207;1601;3578;1659;3785
411620;202203;3152;7986;2672;7273;397;1127;1496;4081;1893;5208
411630;202203;912;2242;591;1678;72;250;227;569;299;819
411640;202203;521;1300;367;980;50;132;133;303;183;435
411650;202203;220;615;144;452;30;98;31;70;61;168
411660;202203;1015;2504;729;1969;73;218;293;721;366;939
411670;202203;1623;3736;1121;2836;109;301;617;1426;726;1727
411680;202203;1565;4052;1195;3355;243;748;465;1255;708;2003
411690;202203;4367;10726;3292;8887;657;1730;1039;2968;1696;4698
411695;202203;701;2016;500;1510;53;178;211;591;264;769
411700;202203;1860;4640;1261;3533;284;838;247;652;531;1490
411705;202203;2533;7096;2162;6472;351;998;1325;4194;1676;5192
411710;202203;2239;5537;1560;4291;352;995;445;1137;797;2132
411720;202203;1190;2746;859;2184;137;352;353;861;490;1213
411721;202203;1116;2681;841;2192;136;357;307;771;443;1128
411722;202203;1027;2740;577;1724;91;305;187;438;278;743
411725;202203;1369;3717;924;2852;204;689;230;671;434;1360
411727;202203;1632;4371;1091;3241;260;790;139;377;399;1167
411729;202203;675;1616;381;1049;55;189;131;293;186;482
411730;202203;5944;15028;4685;12684;693;2044;2482;6488;3175;8532
411740;202203;563;1433;312;907;77;211;63;149;140;360
411745;202203;900;2500;649;1962;71;269;185;423;256;692
411750;202203;6494;16467;4859;13402;602;1825;2440;6292;3042;8117
411760;202203;7851;19979;6140;17220;1879;5349;1520;4648;3399;9997
411770;202203;3534;9801;2635;7918;590;1895;593;1609;1183;3504
411780;202203;2893;7865;2528;7226;631;1892;1017;2952;1648;4844
411790;202203;3249;7574;1991;5415;366;1142;599;1389;965;2531
411800;202203;1265;3511;916;2675;183;569;212;535;395;1104
411810;202203;1744;4367;1334;3592;224;630;561;1402;785;2032
411820;202203;14358;38386;11982;34442;2556;7861;6085;16952;8641;24813
411830;202203;578;1386;439;1151;132;315;68;197;200;512
411840;202203;13861;35613;9804;27540;1600;4899;3185;7999;4785;12898
411845;202203;688;1906;424;1311;76;265;106;281;182;546
411850;202203;8573;21001;6033;16701;1407;4177;1396;3563;2803;7740
411860;202203;772;2084;579;1705;88;278;141;371;229;649
411870;202203;645;1812;460;1416;124;396;106;306;230;702
411880;202203;2571;6058;1857;4943;237;723;815;2018;1052;2741
411885;202203;1224;3107;891;2507;123;401;263;626;386;1027
411890;202203;1584;4088;1154;3352;217;701;148;408;365;1109
411900;202203;927;2420;589;1731;118;354;149;430;267;784
411910;202203;1207;3410;898;2801;163;610;328;926;491;1536
411915;202203;17203;41274;12244;32526;1697;5027;5464;13185;7161;18212
411920;202203;1314;3607;1094;3204;208;691;445;1232;653;1923
411925;202203;537;1372;387;1108;68;207;179;477;247;684
411930;202203;5532;15847;4686;14360;1969;6392;623;2187;2592;8579
411940;202203;3673;10202;2925;8708;666;2088;1111;2995;1777;5083
411950;202203;16335;42405;13694;38200;1507;4861;8665;23106;10172;27967
411960;202203;6670;17004;5354;14528;896;2520;2340;6048;3236;8568
411965;202203;548;1449;402;1160;52;173;196;528;248;701
411970;202203;1287;2805;1004;2434;189;410;478;1327;667;1737
411980;202203;1683;3872;1235;3184;245;644;566;1385;811;2029
411990;202203;42778;108053;28716;83518;4890;15654;11584;31913;16474;47567
411995;202203;4727;11120;3704;9577;1011;2888;1189;2925;2200;5813
412000;202203;2025;4558;1434;3591;42;139;1018;2371;1060;2510
412010;202203;687;2030;519;1671;74;266;143;396;217;662
412015;202203;585;1586;475;1388;62;169;277;817;339;986
412020;202203;489;1349;322;1006;54;196;134;392;188;588
412030;202203;662;1834;500;1540;73;247;207;604;280;851
412033;202203;1024;2632;740;2088;78;229;276;673;354;902
412035;202203;777;2052;505;1557;61;203;272;801;333;1004
412040;202203;776;2025;459;1384;61;173;75;203;136;376
412050;202203;1717;4152;1180;3198;258;774;295;794;553;1568
412060;202203;8137;22447;6743;19743;1705;5597;2075;5863;3780;11460
412065;202203;688;1852;515;1511;102;342;155;427;257;769
412070;202203;1393;3482;1090;2921;123;386;470;1124;593;1510
412080;202203;2633;6836;1906;5472;270;869;761;1882;1031;2751
412085;202203;359;855;132;395;14;51;35;86;49;137
412090;202203;7001;17228;5207;14066;1006;2864;2263;6122;3269;8986
412100;202203;1989;5046;1489;4178;451;1379;407;1176;858;2555
412110;202203;1020;2615;682;1946;83;259;242;636;325;895
412120;202203;2466;6609;1926;5657;439;1427;587;1498;1026;2925
412125;202203;738;2013;493;1500;94;295;120;343;214;638
412130;202203;888;2142;618;1661;125;336;167;435;292;771
412135;202203;657;1709;328;970;49;162;110;282;159;444
412140;202203;2032;4766;1464;3795;224;656;376;945;600;1601
412150;202203;3090;7675;2583;6777;472;1366;1305;3157;1777;4523
412160;202203;993;2988;570;1854;63;240;53;116;116;356
412170;202203;4921;12909;4171;11744;706;2222;2008;5247;2714;7469
412175;202203;1443;3950;1214;3566;263;787;534;1564;797;2351
412180;202203;1870;4982;1404;4158;175;604;637;1736;812;2340
412190;202203;3705;8993;2715;7246;326;964;1157;2985;1483;3949
412200;202203;2113;5831;1432;4344;350;1146;290;802;640;1948
412210;202203;728;1676;462;1247;63;195;196;474;259;669
412215;202203;3563;9289;2677;7578;631;1764;1152;3374;1783;5138
412217;202203;1090;2729;914;2434;31;95;674;1698;705;1793
412220;202203;6510;17900;5343;15811;1278;3779;1819;5394;3097;9173
412230;202203;2969;8331;2361;7258;426;1470;579;1575;1005;3045
412240;202203;8531;21517;5664;16050;951;2923;1800;4559;2751;7482
412250;202203;2193;5481;1621;4434;366;1070;389;964;755;2034
412260;202203;1453;3690;1112;3037;181;543;397;1004;578;1547
412265;202203;1077;2733;870;2394;137;418;481;1225;618;1643
412270;202203;1103;2957;741;2217;94;317;295;814;389;1131
412280;202203;439;1152;347;997;70;206;101;271;171;477
412290;202203;1136;2792;813;2233;141;437;314;801;455;1238
412300;202203;1858;4697;1351;3853;259;767;352;975;611;1742
412310;202203;783;2182;600;1821;101;364;193;531;294;895
412320;202203;848;2104;529;1473;55;179;152;396;207;575
412330;202203;1736;4441;1212;3506;215;661;453;1324;668;1985
412340;202203;1248;3334;920;2674;139;446;131;362;270;808
412350;202203;3363;8610;2251;6475;446;1355;532;1397;978;2752
412360;202203;298;784;227;641;5;21;152;405;157;426
412370;202203;921;2538;655;2001;133;418;124;377;257;795
412380;202203;1696;4527;1220;3605;358;1144;129;400;487;1544
412382;202203;536;1275;357;978;42;148;181;404;223;552
412385;202203;2500;6473;2047;5647;552;1484;845;2416;1397;3900
412390;202203;2753;6394;2229;5608;377;1023;861;2133;1238;3156
412395;202203;800;2152;584;1681;80;214;282;784;362;998
412400;202203;997;2524;732;2048;137;395;236;618;373;1013
412402;202203;2601;6198;1837;4982;434;1158;439;1212;873;2370
412405;202203;3410;8735;2291;6759;639;1945;265;753;904;2698
412410;202203;6946;17515;5187;14716;843;2808;1763;4705;2606;7513
412420;202203;611;1473;416;1099;34;103;210;484;244;587
412430;202203;619;1541;341;966;39;111;141;373;180;484
412440;202203;3167;8038;2222;6379;518;1514;661;1862;1179;3376
412450;202203;548;1544;381;1132;71;204;41;87;112;291
412460;202203;1229;3032;965;2602;148;448;476;1231;624;1679
412470;202203;1733;5189;1447;4576;358;1225;372;1135;730;2360
412480;202203;1266;3159;876;2394;143;423;358;859;501;1282
412490;202203;1489;3484;1151;2919;102;281;667;1567;769;1848
412500;202203;2240;5423;1712;4500;295;843;599;1402;894;2245
412510;202203;2156;6305;1556;4867;420;1396;264;713;684;2109
412520;202203;1459;3582;872;2422;192;531;167;431;359;962
412530;202203;746;1938;544;1549;79;239;117;314;196;553
412535;202203;866;2224;604;1732;125;393;104;239;229;632
412540;202203;1250;3085;918;2523;135;463;275;765;410;1228
412545;202203;755;1898;541;1491;93;277;181;468;274;745
412550;202203;39146;100202;28916;80735;4248;13043;13117;33168;17365;46211
412555;202203;324;817;228;621;25;81;79;171;104;252
412560;202203;5631;15385;4325;12567;827;2635;1305;3673;2132;6308
412570;202203;4910;11958;2998;8430;580;1832;507;1344;1087;3176
412575;202203;1178;2837;964;2496;154;412;526;1284;680;1696
412580;202203;1665;4130;1205;3312;92;285;685;1761;777;2046
412590;202203;451;1168;259;776;48;166;33;82;81;248
412600;202203;1821;4605;1409;3846;142;459;773;1919;915;2378
412610;202203;938;2452;684;1933;103;312;319;796;422;1108
412620;202203;1417;3550;1102;3080;232;703;407;1057;639;1760
412625;202203;9652;24855;6281;18382;1163;3625;537;1479;1700;5104
412627;202203;1214;3327;831;2560;146;492;266;807;412;1299
412630;202203;3062;8680;2240;6961;415;1380;662;1863;1077;3243
412635;202203;478;1255;327;959;43;129;112;273;155;402
412640;202203;1121;2878;683;2005;92;266;176;447;268;713
412650;202203;1865;4886;1485;4135;243;768;596;1464;839;2232
412660;202203;2889;7164;2160;5855;261;787;850;2064;1111;2851
412665;202203;436;1054;337;884;60;182;155;382;215;564
412667;202203;1963;4985;1457;4003;208;618;653;1721;861;2339
412670;202203;938;2148;638;1675;125;340;191;469;316;809
412680;202203;2308;5921;1622;4677;202;698;592;1478;794;2176
412690;202203;1284;3258;905;2538;178;533;308;790;486;1323
412700;202203;2136;5368;1811;4872;224;677;1038;2715;1262;3392
412710;202203;6400;17936;4849;14788;922;3117;1389;3676;2311;6793
412720;202203;1330;3695;1067;3161;158;526;323;774;481;1300
412730;202203;2869;7239;2074;5760;342;1056;847;2177;1189;3233
412740;202203;2138;5760;1516;4567;302;1013;225;647;527;1660
412750;202203;4408;11095;3632;9999;303;992;2370;6214;2673;7206
412760;202203;3213;8428;2703;7609;466;1484;1553;4136;2019;5620
412770;202203;12121;30661;6955;20794;928;3000;1535;3849;2463;6849
412780;202203;1309;3358;1011;2828;230;712;392;1009;622;1721
412785;202203;2389;5423;1695;4295;182;475;1136;2826;1318;3301
412788;202203;1567;4263;1286;3779;305;903;545;1547;850;2450
412790;202203;1492;3828;920;2717;153;498;312;785;465;1283
412795;202203;1339;3380;753;2222;125;392;144;402;269;794
412796;202203;2532;6921;2130;6227;453;1432;745;2004;1198;3436
412800;202203;4180;9763;3013;7681;343;1044;1503;3390;1846;4434
412810;202203;13763;34315;9378;25772;1095;3539;4016;9847;5111;13386
412820;202203;6904;18283;4981;14533;1087;3377;1679;4816;2766;8193
412830;202203;364;1010;279;839;32;92;74;208;106;300
412840;202203;2073;4912;1510;3892;153;448;810;1887;963;2335
412850;202203;3024;7665;2274;6451;274;863;1114;2958;1388;3821
412853;202203;1702;4131;1433;3695;190;560;789;1778;979;2338
412855;202203;1503;3778;868;2480;112;373;222;528;334;901
412860;202203;816;1987;562;1579;81;252;282;724;363;976
412862;202203;725;1757;493;1382;94;264;196;534;290;798
412863;202203;1389;3955;1235;3683;310;996;496;1399;806;2395
412865;202203;761;2017;564;1633;138;415;169;488;307;903
412870;202203;963;2408;713;2015;183;568;222;666;405;1234
412880;202203;981;2587;700;2057;134;428;201;536;335;964
420005;202203;451;1284;275;879;22;63;136;437;158;500
420010;202203;3637;8614;2443;6613;162;474;1839;4993;2001;5467
420020;202203;498;1479;338;1091;60;234;96;242;156;476
420030;202203;117;409;79;309;25;100;21;89;46;189
420040;202203;609;1783;371;1261;92;357;36;105;128;462
420050;202203;782;1744;533;1315;114;301;302;676;416;977
420055;202203;174;518;98;329;19;75;33;101;52;176
420060;202203;127;355;84;252;13;39;20;52;33;91
420070;202203;838;2414;632;1995;131;436;284;871;415;1307
420075;202203;86;220;49;148;7;21;12;20;19;41
420080;202203;440;1197;348;990;69;232;154;409;223;641
420090;202203;459;1386;297;1017;72;268;70;206;142;474
420100;202203;1473;3542;1237;3206;59;172;1006;2565;1065;2737
420110;202203;297;913;259;832;39;147;147;460;186;607
420120;202203;654;1728;464;1332;53;178;256;660;309;838
420125;202203;396;1150;279;894;64;237;101;300;165;537
420127;202203;336;867;146;440;22;78;59;171;81;249
420130;202203;4456;11851;3442;10214;585;2009;1566;4254;2151;6263
420140;202203;4346;11268;3322;9583;922;2907;843;2360;1765;5267
420150;202203;726;1792;524;1467;45;161;321;861;366;1022
420160;202203;203;480;82;249;12;43;24;69;36;112
420165;202203;178;501;118;373;24;71;46;129;70;200
420170;202203;287;875;201;668;35;124;64;185;99;309
420180;202203;182;575;117;410;18;83;30;94;48;177
420190;202203;225;648;134;422;32;104;54;161;86;265
420195;202203;1835;4577;1427;3964;381;1247;528;1316;909;2563
420200;202203;6195;14666;4103;10910;529;1660;1958;4529;2487;6189
420205;202203;2168;5596;1505;4282;239;744;808;2249;1047;2993
420207;202203;2223;5527;1443;4100;232;753;614;1594;846;2347
420208;202203;358;981;215;701;71;235;61;182;132;417
420209;202203;179;547;120;373;15;56;60;163;75;219
420210;202203;3909;9723;2818;7954;399;1363;1555;4148;1954;5511
420213;202203;876;2537;736;2262;136;462;319;943;455;1405
420215;202203;238;703;170;546;41;151;49;153;90;304
420220;202203;340;990;227;756;33;131;99;302;132;433
420230;202203;6032;15625;4742;13302;556;1786;2734;7243;3290;9029
420240;202203;16265;43985;10859;31782;1272;4404;5377;13741;6649;18145
420243;202203;438;1147;369;1022;47;149;249;668;296;817
420245;202203;1750;4350;1335;3635;106;345;876;2253;982;2598
420250;202203;525;1380;457;1275;41;142;324;856;365;998
420253;202203;499;1176;364;992;29;88;218;591;247;679
420257;202203;168;424;109;322;16;48;63;187;79;235
420260;202203;1278;3161;973;2762;89;304;738;2053;827;2357
420270;202203;608;1563;330;950;47;142;131;346;178;488
420280;202203;1500;4226;1219;3676;187;648;574;1637;761;2285
420285;202203;117;307;84;240;14;54;29;51;43;105
420287;202203;498;1110;361;927;74;198;170;440;244;638
420290;202203;5566;15335;4404;12835;563;1900;2659;7209;3222;9109
420300;202203;8243;22604;5049;15216;897;2983;1768;4760;2665;7743
420310;202203;923;2044;521;1353;50;154;320;757;370;911
420315;202203;852;2281;601;1872;81;286;318;954;399;1240
420320;202203;6143;15840;4551;13333;1278;4121;1473;4107;2751;8228
420325;202203;371;1021;269;827;38;119;116;342;154;461
420330;202203;1058;2997;703;2277;127;478;232;680;359;1158
420340;202203;1124;2966;864;2510;187;592;284;729;471;1321
420350;202203;1316;3257;994;2709;94;309;692;1846;786;2155
420360;202203;3247;8598;1846;5663;382;1261;182;563;564;1824
420370;202203;1430;3590;1166;3149;82;288;857;2186;939;2474
420380;202203;4906;12400;3414;9767;624;1991;1509;4032;2133;6023
420390;202203;1136;2727;810;2101;142;430;336;647;478;1077
420395;202203;1307;3598;941;2881;174;610;179;399;353;1009
420400;202203;1167;3113;832;2462;105;356;426;1201;531;1557
420410;202203;622;1583;490;1321;29;87;363;960;392;1047
420415;202203;340;942;257;771;56;188;110;343;166;531
420417;202203;666;1881;529;1617;117;365;263;814;380;1179
420419;202203;153;532;118;448;51;207;13;52;64;259
420420;202203;13796;35111;9599;27507;2409;7769;3400;9013;5809;16782
420425;202203;685;1819;484;1405;42;141;252;704;294;845
420430;202203;3414;8889;2133;6191;406;1359;852;2218;1258;3577
420435;202203;300;758;162;503;28;96;80;236;108;332
420440;202203;801;2074;517;1482;112;313;204;570;316;883
420445;202203;281;663;186;498;27;84;77;169;104;253
420450;202203;853;2449;628;1958;107;413;239;633;346;1046
420455;202203;2264;5219;1705;4420;325;872;843;2160;1168;3032
420460;202203;10378;26718;8033;22537;1055;3388;4430;11794;5485;15182
420470;202203;677;1726;368;1081;73;246;104;261;177;507
420475;202203;75;199;36;112;7;29;6;13;13;42
420480;202203;5766;13794;3758;10591;605;1893;1629;4513;2234;6406
420490;202203;424;1155;303;901;50;163;139;391;189;554
420500;202203;1481;3872;999;3027;156;550;492;1435;648;1985
420510;202203;173;480;95;313;23;83;26;74;49;157
420515;202203;98;266;65;195;10;38;20;60;30;98
420517;202203;799;2128;679;1911;74;218;430;1208;504;1426
420519;202203;341;842;252;704;25;76;143;399;168;475
420520;202203;296;780;161;521;27;90;13;38;40;128
420530;202203;878;2496;622;1970;97;363;248;666;345;1029
420535;202203;240;680;111;352;14;48;39;109;53;157
420540;202203;43583;102476;30513;81031;4125;12510;12260;28610;16385;41120
420543;202203;240;698;193;598;27;88;90;253;117;341
420545;202203;1420;4144;1092;3441;233;793;399;1157;632;1950
420550;202203;4069;10360;2749;8187;416;1405;1326;4007;1742;5412
420555;202203;338;935;245;745;24;88;149;428;173;516
420560;202203;424;1024;291;830;42;116;189;548;231;664
420570;202203;2903;7362;2246;6188;362;1114;1158;3042;1520;4156
420580;202203;1920;4953;1373;4093;281;884;465;1338;746;2222
420590;202203;3023;7977;1940;5674;336;1119;569;1347;905;2466
420600;202203;1196;3286;960;2865;94;368;598;1686;692;2054
420610;202203;466;1307;321;1009;66;217;140;431;206;648
420620;202203;870;2087;620;1693;132;384;266;707;398;1091
420630;202203;1026;3034;771;2428;98;336;442;1313;540;1649
420640;202203;539;1435;292;939;94;310;64;191;158;501
420650;202203;4043;10361;2696;7672;398;1261;1191;2976;1589;4237
420660;202203;464;1162;303;827;75;224;77;187;152;411
420665;202203;751;1904;506;1501;72;243;238;634;310;877
420670;202203;1363;3701;882;2711;127;453;281;730;408;1183
420675;202203;195;509;119;368;14;56;69;204;83;260
420680;202203;320;709;172;506;25;95;92;248;117;343
420690;202203;932;2649;624;1952;83;306;187;484;270;790
420700;202203;3049;7750;2391;6685;186;596;1625;4409;1811;5005
420710;202203;1202;3296;974;2820;115;437;590;1515;705;1952
420720;202203;1381;3676;1032;3073;158;525;609;1695;767;2220
420730;202203;3551;8986;2715;7651;419;1334;1531;4103;1950;5437
420740;202203;527;1534;303;1048;74;270;24;87;98;357
420750;202203;2206;6209;1498;4619;250;923;606;1677;856;2600
420757;202203;99;239;47;142;5;14;24;73;29;87
420760;202203;350;985;207;620;33;106;68;176;101;282
420765;202203;522;1441;274;849;30;99;155;462;185;561
420768;202203;1460;3922;1278;3632;111;332;1011;2855;1122;3187
420770;202203;433;1184;203;714;22;95;56;177;78;272
420775;202203;303;849;210;652;39;139;85;226;124;365
420780;202203;1044;2898;638;1971;115;364;99;279;214;643
420785;202203;220;565;162;448;18;67;81;178;99;245
420790;202203;1158;3302;886;2761;148;550;538;1581;686;2131
420800;202203;754;1800;441;1219;79;250;233;615;312;865
420810;202203;1596;4706;1339;4237;308;1165;649;1801;957;2966
420820;202203;14394;35222;10688;29380;1682;5167;5469;14043;7151;19210
420830;202203;5139;13057;3918;10954;612;1914;1804;4785;2416;6699
420840;202203;529;1580;277;1009;74;263;39;136;113;399
420845;202203;2918;7271;1957;5595;362;1245;867;2344;1229;3589
420850;202203;1217;3742;805;2697;155;576;203;614;358;1190
420860;202203;416;1079;245;766;46;161;71;195;117;356
420870;202203;862;2363;640;1925;144;468;235;662;379;1130
420880;202203;1208;3524;959;3024;204;725;413;1214;617;1939
420890;202203;8866;23612;5783;17362;815;2718;2151;5764;2966;8482
420895;202203;185;520;124;369;21;68;51;149;72;217
420900;202203;1680;4062;1054;3001;153;544;501;1234;654;1778
420910;202203;36203;93394;24394;71526;3506;11918;10791;28044;14297;39962
420915;202203;553;1908;420;1544;51;212;240;875;291;1087
420917;202203;494;1237;239;648;33;87;129;349;162;436
420920;202203;94;242;47;143;5;17;12;38;17;55
420930;202203;18432;46200;13598;38022;2100;6597;6844;18088;8944;24685
420940;202203;3571;8506;2258;6340;502;1587;570;1328;1072;2915
420945;202203;163;471;118;359;22;86;50;138;72;224
420950;202203;390;1085;245;757;39;127;70;198;109;325
420960;202203;1196;2886;877;2374;125;385;439;1091;564;1476
420970;202203;2616;6877;1816;5442;415;1293;638;1914;1053;3207
420980;202203;290;973;251;887;96;350;81;292;177;642
420985;202203;371;1036;216;723;51;192;65;197;116;389
420990;202203;362;1082;217;738;35;129;54;169;89;298
421000;202203;598;1730;451;1435;108;376;114;292;222;668
421003;202203;492;1170;182;522;14;39;18;44;32;83
421005;202203;89;247;63;201;18;60;24;79;42;139
421010;202203;3794;9906;2786;8128;516;1678;963;2463;1479;4141
421020;202203;417;1265;335;1114;47;184;176;558;223;742
421030;202203;964;2676;760;2300;173;586;329;929;502;1515
421040;202203;712;1680;449;1282;39;116;280;780;319;896
421050;202203;1189;3134;829;2372;135;419;350;896;485;1315
421055;202203;179;480;106;317;17;59;61;166;78;225
421060;202203;744;2106;537;1672;88;320;267;763;355;1083
421070;202203;739;2139;462;1448;66;224;198;566;264;790
421080;202203;567;1612;462;1415;72;264;236;684;308;948
421085;202203;395;1097;181;600;20;65;31;77;51;142
421090;202203;288;736;169;473;18;62;59;140;77;202
421100;202203;897;1969;419;1202;93;296;133;330;226;626
421105;202203;1742;4541;1252;3649;176;569;636;1756;812;2325
421110;202203;1316;3329;1085;2993;87;293;711;2001;798;2294
421120;202203;1160;3394;832;2690;132;461;242;689;374;1150
421125;202203;328;816;241;665;69;209;107;277;176;486
421130;202203;5790;16235;4803;14300;843;2759;2678;7596;3521;10355
421140;202203;377;986;255;742;40;127;109;279;149;406
421145;202203;467;1238;314;928;74;239;98;252;172;491
421150;202203;779;2121;540;1637;108;372;235;636;343;1008
421160;202203;576;1563;444;1317;61;240;281;770;342;1010
421165;202203;242;682;153;472;24;77;70;204;94;281
421170;202203;1198;3181;1017;2897;98;287;716;2051;814;2338
421175;202203;1029;2495;626;1876;100;371;306;861;406;1232
421180;202203;430;1121;251;772;38;143;122;334;160;477
421185;202203;338;844;240;658;24;80;135;346;159;426
421187;202203;289;877;188;623;36;115;69;223;105;338
421189;202203;422;1177;332;1000;50;169;140;390;190;559
421190;202203;13505;35203;9768;28328;1690;5552;4135;10904;5825;16456
421200;202203;782;2108;639;1872;89;327;379;1053;468;1380
421205;202203;221;572;164;482;29;95;77;218;106;313
421210;202203;1199;2915;697;2072;137;411;261;765;398;1176
421220;202203;1508;4300;1210;3718;299;1028;441;1240;740;2268
421223;202203;373;944;246;724;44;152;154;431;198;583
421225;202203;953;2660;819;2449;103;360;537;1592;640;1952
421227;202203;788;2160;523;1610;87;278;249;784;336;1062
421230;202203;624;1594;412;1203;80;257;161;450;241;707
421240;202203;312;885;158;537;21;90;30;80;51;170
421250;202203;2338;5745;1695;4735;213;640;1031;2793;1244;3433
421260;202203;232;724;62;219;14;59;7;22;21;81
421265;202203;842;2053;731;1908;36;101;630;1622;666;1723
421270;202203;394;1049;195;639;46;151;77;237;123;388
421280;202203;2301;5892;1751;5000;233;804;1035;2790;1268;3594
421290;202203;1117;3035;584;1753;103;318;146;396;249;714
421300;202203;310;797;159;506;22;88;26;78;48;166
421310;202203;226;636;160;507;33;102;85;271;118;373
421315;202203;271;678;186;511;43;107;70;199;113;306
421320;202203;666;2060;381;1260;47;154;42;72;89;226
421330;202203;668;1906;493;1552;102;354;147;414;249;768
421335;202203;398;1176;326;1054;52;191;161;515;213;706
421340;202203;1567;4157;1122;3384;161;568;586;1667;747;2235
421350;202203;1735;4312;1159;3360;197;656;483;1338;680;1994
421360;202203;2449;6303;1499;4452;303;985;583;1530;886;2515
421370;202203;825;2546;551;1853;99;369;187;522;286;891
421380;202203;932;2331;809;2146;85;276;525;1329;610;1605
421390;202203;173;448;71;228;19;59;24;65;43;124
421400;202203;546;1455;358;1087;52;181;196;542;248;723
421410;202203;195;504;97;321;21;67;31;105;52;172
421415;202203;213;565;154;420;24;79;65;154;89;233
421420;202203;618;1613;495;1383;41;131;307;836;348;967
421430;202203;104;320;76;250;10;29;17;48;27;77
421440;202203;705;1844;428;1317;84;262;185;554;269;816
421450;202203;516;1493;315;1044;45;160;43;143;88;303
421460;202203;390;1182;216;786;15;55;18;57;33;112
421470;202203;346;927;235;708;38;124;84;256;122;380
421480;202203;3065;7968;2135;6156;340;1163;962;2543;1302;3706
421490;202203;123;413;74;280;13;56;14;46;27;102
421500;202203;2361;6711;1666;5280;387;1457;475;1335;862;2792
421505;202203;325;859;274;787;25;93;193;533;218;626
421507;202203;464;1249;277;853;52;173;119;349;171;522
421510;202203;408;1086;284;808;35;120;148;361;183;481
421520;202203;513;1337;328;924;45;126;160;406;205;532
421530;202203;316;918;181;620;26;122;37;102;63;224
421535;202203;428;1082;264;771;40;134;138;376;178;510
421540;202203;350;789;196;559;30;104;71;185;101;289
421545;202203;682;1975;532;1717;98;376;272;817;370;1193
421550;202203;2297;5924;1846;5230;269;850;1108;3063;1377;3913
421555;202203;173;524;74;263;7;24;12;24;19;48
421560;202203;91;302;63;234;9;37;24;78;33;115
421565;202203;987;2449;691;2003;166;534;278;769;444;1303
421567;202203;529;1578;394;1230;110;390;120;351;230;741
421568;202203;351;1000;235;727;41;152;92;256;133;408
421569;202203;159;445;79;251;7;26;49;152;56;178
421570;202203;1541;4142;1134;3304;224;734;446;1152;670;1886
421575;202203;336;930;254;715;35;104;140;375;175;479
421580;202203;4891;12851;3254;9594;448;1590;1315;3313;1763;4903
421590;202203;186;542;139;440;26;97;59;178;85;275
421600;202203;611;1581;429;1214;81;264;171;419;252;683
421605;202203;736;1903;544;1605;95;275;270;830;365;1105
421610;202203;1111;2896;756;2233;152;475;248;718;400;1193
421620;202203;4286;11046;2786;8418;552;1858;1026;2926;1578;4784
421625;202203;150;424;80;261;14;48;22;62;36;110
421630;202203;2969;7575;1973;5740;332;1090;761;1915;1093;3005
421635;202203;359;945;232;701;22;102;138;365;160;467
421640;202203;742;1930;552;1659;118;376;260;764;378;1140
421650;202203;2719;7217;1907;5779;424;1509;692;1886;1116;3395
421660;202203;12066;32370;8804;26150;1207;4197;4348;11792;5555;15989
421670;202203;851;2345;637;1853;97;338;321;871;418;1209
421680;202203;1527;3537;1247;3098;100;359;972;2221;1072;2580
421690;202203;1535;4246;1079;3323;220;734;356;1037;576;1771
421700;202203;636;1825;473;1478;103;358;153;434;256;792
421710;202203;221;670;117;373;16;58;44;122;60;180
421715;202203;142;360;107;289;18;57;72;184;90;241
421720;202203;2257;5928;1380;4108;309;1019;428;1112;737;2131
421725;202203;288;690;167;485;25;87;78;195;103;282
421730;202203;491;1360;316;902;49;160;168;426;217;586
421740;202203;880;2418;605;1854;105;354;232;632;337;986
421750;202203;941;2172;470;1323;93;292;190;494;283;786
421755;202203;183;492;105;318;16;57;42;111;58;168
421760;202203;1122;2837;774;2231;150;496;289;725;439;1221
421770;202203;2670;6829;1941;5616;405;1161;827;2397;1232;3558
421775;202203;227;580;143;422;16;54;69;186;85;240
421780;202203;943;2646;626;1990;120;433;291;850;411;1283
421790;202203;936;2488;545;1748;106;363;235;722;341;1085
421795;202203;188;530;134;400;27;88;46;129;73;217
421800;202203;3208;8244;2422;6845;295;955;1487;3976;1782;4931
421810;202203;661;1768;462;1413;48;163;260;780;308;943
421820;202203;1102;3148;730;2267;131;457;271;719;402;1176
421825;202203;1554;3990;1389;3757;90;307;1097;2883;1187;3190
421830;202203;1944;5393;1560;4696;334;1096;518;1480;852;2576
421835;202203;259;620;179;495;34;125;85;208;119;333
421840;202203;216;682;160;565;27;110;43;133;70;243
421850;202203;411;1147;247;831;52;195;58;160;110;355
421860;202203;336;925;203;655;28;101;74;211;102;312
421870;202203;5121;12509;3885;10271;448;1449;2286;5431;2734;6880
421875;202203;334;965;149;461;23;75;36;94;59;169
421880;202203;722;1994;491;1487;95;316;150;432;245;748
421885;202203;269;722;179;530;30;88;84;230;114;318
421890;202203;975;2746;733;2276;111;438;445;1287;556;1725
421895;202203;443;1090;384;1009;41;87;278;773;319;860
421900;202203;1144;3017;895;2505;113;386;452;1135;565;1521
421910;202203;344;990;226;710;38;142;54;136;92;278
421915;202203;435;1211;269;823;61;195;64;171;125;366
421917;202203;644;1429;371;1070;116;354;112;342;228;696
421920;202203;427;1259;309;1026;112;372;111;385;223;757
421930;202203;3027;7452;1743;5083;356;1158;689;1779;1045;2937
421935;202203;447;1327;362;1154;61;194;229;732;290;926
421940;202203;404;1141;200;622;29;106;62;160;91;266
421950;202203;3406;8385;2027;5804;404;1273;582;1468;986;2741
421960;202203;190;451;105;298;13;45;39;87;52;132
421970;202203;2114;5295;1410;3901;238;769;636;1567;874;2336
421985;202203;339;909;232;704;31;97;101;290;132;387
422000;202203;2107;5187;1738;4646;123;419;1243;3269;1366;3688
430003;202203;609;1573;409;1220;75;224;198;595;273;819
430005;202203;295;790;205;637;17;58;118;349;135;407
430010;202203;1998;4472;1568;3826;287;677;919;2279;1206;2956
430020;202203;625;1400;467;1190;47;136;307;740;354;876
430030;202203;1097;2463;650;1680;124;319;299;734;423;1053
430040;202203;11316;25700;7242;18945;1872;5042;1714;4418;3586;9460
430045;202203;537;1268;392;1012;33;106;287;709;320;815
430047;202203;260;561;107;286;19;49;36;96;55;145
430050;202203;866;2097;516;1424;98;287;221;578;319;865
430055;202203;293;700;149;408;16;49;77;186;93;235
430057;202203;89;189;36;100;11;32;8;19;19;51
430060;202203;20377;51817;16249;45529;2685;8140;8799;24173;11484;32313
430063;202203;848;2278;708;2012;132;367;417;1180;549;1547
430064;202203;1238;3178;927;2588;147;434;504;1366;651;1800
430066;202203;102;211;73;168;7;22;61;131;68;153
430070;202203;761;1937;158;494;33;109;24;57;57;166
430080;202203;996;2409;616;1664;99;323;320;757;419;1080
430085;202203;1001;2111;621;1521;87;226;308;722;395;948
430087;202203;933;2172;778;1968;62;180;564;1399;626;1579
430090;202203;488;1244;192;609;26;100;46;132;72;232
430100;202203;1051;2456;651;1720;121;358;204;474;325;832
430105;202203;1397;3534;972;2818;132;444;479;1352;611;1796
430107;202203;184;519;98;295;14;38;33;89;47;127
430110;202203;2465;5933;1856;5030;303;887;942;2474;1245;3361
430120;202203;1379;3803;946;2787;163;469;441;1274;604;1743
430130;202203;3875;8440;2898;7103;958;2287;712;2047;1670;4334
430140;202203;1113;2782;805;2238;115;359;451;1190;566;1549
430150;202203;612;1556;345;1036;71;222;99;292;170;514
430155;202203;253;637;131;384;27;86;31;76;58;162
430160;202203;22801;50246;18220;44010;1783;4656;11925;28253;13708;32909
430163;202203;3569;7892;2555;6384;85;303;1952;4734;2037;5037
430165;202203;340;827;122;376;15;41;22;57;37;98
430170;202203;1021;2645;389;1287;69;246;62;162;131;408
430175;202203;836;2164;732;1967;144;359;391;1072;535;1431
430180;202203;709;1690;546;1425;72;173;320;849;392;1022
430185;202203;732;1836;388;1111;107;269;72;211;179;480
430187;202203;882;1809;648;1526;78;173;439;1021;517;1194
430190;202203;1565;3808;1241;3320;228;664;628;1596;856;2260
430192;202203;133;351;55;160;10;28;14;35;24;63
430195;202203;473;1336;88;287;6;18;18;47;24;65
430200;202203;1201;3345;957;2914;300;939;278;890;578;1829
430205;202203;512;1221;463;1132;11;37;424;1020;435;1057
430210;202203;6972;17571;4772;13074;782;2356;1470;3202;2252;5558
430215;202203;360;872;226;615;33;95;101;275;134;370
430220;202203;697;1702;240;773;29;92;62;167;91;259
430222;202203;234;610;166;487;24;76;55;159;79;235
430223;202203;280;701;214;592;20;59;127;342;147;401
430225;202203;16;32;11;26;0;0;7;16;7;16
430230;202203;2136;5577;1777;5050;118;387;1377;3851;1495;4238
430235;202203;432;1165;286;863;52;171;73;182;125;353
430237;202203;563;1271;436;1075;21;66;345;832;366;898
430240;202203;1493;3391;854;2287;95;307;446;1076;541;1383
430245;202203;794;2084;635;1795;113;317;370;1059;483;1376
430250;202203;1035;2372;770;1977;288;780;135;301;423;1081
430258;202203;151;404;111;324;6;22;59;167;65;189
430260;202203;774;1909;542;1494;66;200;323;885;389;1085
430265;202203;251;701;169;552;28;88;69;233;97;321
430270;202203;3338;7688;2679;6711;311;896;1835;4433;2146;5329
430280;202203;5638;12507;4075;9976;708;1765;2006;4782;2714;6547
430290;202203;2448;5390;2021;4903;93;278;1663;3941;1756;4219
430300;202203;11484;27199;8801;22794;1209;3413;5085;12658;6294;16071
430310;202203;14146;33812;10086;26577;1214;3537;5424;13337;6638;16874
430320;202203;1129;2707;648;1790;57;165;403;1100;460;1265
430330;202203;751;1757;469;1227;61;168;207;498;268;666
430340;202203;690;1559;471;1223;61;162;304;757;365;919
430350;202203;9271;21641;7251;18342;698;1953;4793;11495;5491;13448
430355;202203;366;976;144;446;25;78;17;43;42;121
430360;202203;960;2219;646;1687;129;393;248;609;377;1002
430367;202203;376;811;228;572;42;124;118;275;160;399
430370;202203;569;1477;246;707;42;125;69;155;111;280
430380;202203;733;1753;376;1121;75;232;108;310;183;542
430390;202203;3824;8891;2494;6570;557;1581;393;793;950;2374
430400;202203;1119;2313;850;1951;83;217;492;1091;575;1308
430410;202203;595;1347;431;1095;37;107;310;762;347;869
430420;202203;3059;7565;2419;6315;344;1014;1497;3648;1841;4662
430430;202203;617;1521;292;878;61;199;63;179;124;378
430435;202203;1774;4261;1350;3566;207;578;716;1881;923;2459
430440;202203;4345;11281;3512;9948;287;884;2301;6493;2588;7377
430450;202203;7664;17938;6261;15615;1015;2796;3576;8399;4591;11195
430460;202203;39305;95326;30126;80551;4013;11938;17066;43699;21079;55637
430461;202203;241;624;88;260;16;61;38;89;54;150
430462;202203;341;867;186;569;40;132;52;139;92;271
430463;202203;7133;17986;5379;14868;990;3063;2649;7003;3639;10066
430465;202203;500;1221;406;1054;56;160;274;688;330;848
430466;202203;5030;11993;4070;10562;696;1861;2247;5601;2943;7462
430467;202203;530;1248;382;1034;47;155;220;546;267;701
430468;202203;1479;3481;1193;3075;96;304;887;2220;983;2524
430469;202203;660;1789;108;334;15;47;22;44;37;91
430470;202203;6317;15623;4301;12145;1156;3607;1256;3330;2412;6937
430471;202203;671;1800;559;1599;88;260;336;926;424;1186
430480;202203;680;1836;447;1356;65;214;121;310;186;524
430485;202203;182;460;84;241;12;29;23;62;35;91
430490;202203;494;1206;276;795;33;103;133;332;166;435
430495;202203;413;1084;279;841;44;149;129;360;173;509
430500;202203;1072;2666;761;2158;225;707;271;711;496;1418
430510;202203;30889;76866;22619;61764;3602;10973;10905;27386;14507;38359
430511;202203;390;1047;158;506;21;61;20;58;41;119
430512;202203;1118;2394;876;2037;181;423;387;900;568;1323
430513;202203;865;2046;432;1171;68;200;214;523;282;723
430515;202203;418;1116;306;898;40;132;166;480;206;612
430517;202203;1338;3711;1038;3057;145;426;630;1841;775;2267
430520;202203;1500;3612;847;2273;146;413;228;551;374;964
430530;202203;1042;2546;468;1355;70;211;135;374;205;585
430535;202203;3949;9736;2943;7987;418;1165;1546;4030;1964;5195
430537;202203;465;1344;399;1215;30;80;305;935;335;1015
430540;202203;658;1536;387;1080;60;173;210;574;270;747
430543;202203;1122;1917;687;1419;133;233;260;613;393;846
430544;202203;813;2178;562;1648;141;436;202;559;343;995
430545;202203;2691;6472;2047;5543;280;790;1258;3379;1538;4169
430550;202203;387;1058;287;849;57;182;108;291;165;473
430558;202203;168;383;66;182;6;16;24;65;30;81
430560;202203;304;698;162;464;24;74;64;168;88;242
430570;202203;938;2234;680;1786;119;384;332;759;451;1143
430580;202203;900;2175;658;1816;147;408;317;915;464;1323
430583;202203;207;506;48;137;2;4;12;27;14;31
430585;202203;240;583;132;368;26;86;46;108;72;194
430587;202203;219;577;164;485;16;56;69;197;85;253
430590;202203;1474;3433;1207;3033;92;271;934;2296;1026;2567
430593;202203;22;65;16;44;2;4;6;17;8;21
430595;202203;462;1155;130;412;14;44;24;57;38;101
430597;202203;478;1175;262;760;24;80;80;188;104;268
430600;202203;2128;5412;932;2647;150;424;219;559;369;983
430605;202203;1450;3611;1078;2965;134;397;548;1473;682;1870
430607;202203;693;1501;495;1200;30;80;347;814;377;894
430610;202203;6582;14766;4556;11812;1210;3452;1203;3119;2413;6571
430613;202203;298;682;87;251;13;39;22;52;35;91
430620;202203;754;1769;578;1458;105;296;327;739;432;1035
430630;202203;458;1223;145;442;24;79;40;104;64;183
430632;202203;473;1199;217;614;36;96;92;254;128;350
430635;202203;638;1381;477;1116;25;57;372;864;397;921
430637;202203;480;1127;374;977;31;99;266;676;297;775
430640;202203;1209;3161;837;2419;124;391;369;967;493;1358
430642;202203;386;1030;280;804;43;130;132;359;175;489
430645;202203;168;392;76;201;13;39;26;54;39;93
430650;202203;1929;5051;1531;4411;432;1142;714;2248;1146;3390
430655;202203;328;780;201;546;31;94;105;249;136;343
430660;202203;5647;13742;4392;11786;742;2106;2287;6015;3029;8121
430670;202203;687;1595;524;1332;82;214;254;632;336;846
430673;202203;572;1264;263;714;42;120;111;275;153;395
430675;202203;269;773;71;238;13;44;12;34;25;78
430676;202203;5960;14134;4872;12536;595;1654;3166;7965;3761;9619
430680;202203;1177;2981;734;2117;226;648;214;554;440;1202
430690;202203;3313;8375;2654;7246;773;2144;1026;2800;1799;4944
430692;202203;225;669;179;590;9;34;140;471;149;505
430693;202203;1036;2640;654;1921;121;395;193;530;314;925
430695;202203;429;1043;267;725;30;83;147;380;177;463
430697;202203;493;1172;377;1005;62;181;216;595;278;776
430700;202203;8727;20594;5664;15157;1137;3316;1589;3832;2726;7148
430705;202203;417;948;213;592;22;66;97;243;119;309
430710;202203;1870;3765;1323;3052;125;346;876;1938;1001;2284
430720;202203;894;2063;463;1307;47;145;255;675;302;820
430730;202203;1073;2817;761;2232;97;285;388;1094;485;1379
430740;202203;737;1928;395;1219;66;221;115;362;181;583
430745;202203;454;1099;319;834;47;155;162;360;209;515
430750;202203;1680;4004;1170;3126;292;795;494;1276;786;2071
430755;202203;488;1171;333;871;31;91;185;444;216;535
430760;202203;2429;5746;1907;4977;371;1053;966;2401;1337;3454
430770;202203;7625;18280;6062;15980;640;1960;4087;10387;4727;12347
430780;202203;2177;5262;1419;4002;222;689;711;1929;933;2618
430781;202203;528;1383;329;946;87;249;116;283;203;532
430783;202203;371;840;235;635;30;98;139;358;169;456
430786;202203;36;116;23;82;3;13;2;7;5;20
430790;202203;5114;12063;3734;9762;353;1113;2343;5719;2696;6832
430800;202203;876;1890;666;1604;35;89;480;1127;515;1216
430805;202203;398;973;266;713;14;50;188;478;202;528
430807;202203;614;1477;376;1024;48;152;202;492;250;644
430810;202203;815;1907;382;1079;57;191;141;337;198;528
430820;202203;1349;3627;828;2566;124;414;287;807;411;1221
430825;202203;303;720;115;290;16;36;39;98;55;134
430830;202203;1949;5094;1598;4452;151;386;1117;3090;1268;3476
430840;202203;1154;2666;799;2114;113;281;527;1409;640;1690
430843;202203;189;446;93;254;6;14;32;80;38;94
430845;202203;530;1194;357;925;27;82;218;520;245;602
430850;202203;2555;6460;1809;5101;367;1056;676;1993;1043;3049
430860;202203;1045;2439;525;1459;61;200;246;592;307;792
430865;202203;572;1418;380;1079;102;297;88;225;190;522
430870;202203;609;1574;280;853;48;142;73;198;121;340
430880;202203;1639;3590;1170;2888;135;368;748;1760;883;2128
430885;202203;175;467;96;304;13;40;55;172;68;212
430890;202203;1182;2796;784;2146;80;302;142;363;222;665
430900;202203;3390;7019;2426;5693;126;429;1774;3898;1900;4327
430905;202203;990;2394;688;1848;120;347;297;746;417;1093
430910;202203;2407;6270;1875;5221;279;893;949;2363;1228;3256
430912;202203;536;1465;381;1160;29;85;244;753;273;838
430915;202203;541;1565;391;1249;116;388;129;424;245;812
430920;202203;27104;65853;21618;57076;2470;7341;14010;35749;16480;43090
430925;202203;88;191;39;108;4;13;19;50;23;63
430930;202203;12131;27367;8428;21917;1266;3380;4388;11336;5654;14716
430940;202203;1188;2940;774;2145;156;450;284;714;440;1164
430950;202203;921;1947;603;1430;41;132;428;935;469;1067
430955;202203;425;1084;120;334;24;74;40;85;64;159
430957;202203;185;592;166;553;31;104;101;342;132;446
430960;202203;1521;3489;901;2408;183;533;384;948;567;1481
430965;202203;1661;3814;1311;3290;66;155;1007;2572;1073;2727
430970;202203;415;956;234;629;31;88;127;312;158;400
430975;202203;551;1531;430;1266;77;245;194;556;271;801
430980;202203;438;961;259;666;22;72;138;317;160;389
430990;202203;638;1728;443;1304;72;236;196;558;268;794
430995;202203;590;1460;443;1227;61;175;247;660;308;835
431000;202203;1490;3465;675;1937;135;417;56;135;191;552
431010;202203;2675;6839;1937;5597;400;1263;648;1675;1048;2938
431020;202203;8886;18852;5458;13795;975;2822;2297;5156;3272;7978
431030;202203;371;1006;193;637;43;156;30;99;73;255
431033;202203;4332;9853;2929;7671;573;1526;1238;3171;1811;4697
431036;202203;339;734;78;226;7;21;23;50;30;71
431040;202203;976;2362;642;1806;64;231;352;907;416;1138
431041;202203;478;1068;348;872;45;114;196;475;241;589
431043;202203;373;905;226;636;37;128;118;312;155;440
431046;202203;112;284;45;133;7;20;10;25;17;45
431050;202203;1431;3340;1014;2681;182;467;506;1381;688;1848
431053;202203;737;1847;416;1222;74;246;143;360;217;606
431055;202203;656;1521;529;1316;35;90;402;987;437;1077
431057;202203;242;692;146;470;28;101;58;171;86;272
431060;202203;6279;14989;4326;11811;958;2849;1534;3987;2492;6836
431065;202203;437;1053;328;873;43;121;179;467;222;588
431070;202203;445;1160;277;809;66;219;65;174;131;393
431075;202203;253;697;145;453;32;112;47;147;79;259
431080;202203;624;1651;444;1284;76;236;167;449;243;685
431085;202203;844;2113;533;1445;52;153;286;746;338;899
431087;202203;454;1201;365;1024;48;134;218;600;266;734
431090;202203;432;997;180;538;30;96;46;144;76;240
431100;202203;3942;8323;2812;6889;260;712;1789;4275;2049;4987
431110;202203;1545;3411;1092;2633;190;505;550;1200;740;1705
431112;202203;684;1739;568;1542;64;207;380;970;444;1177
431113;202203;459;1173;384;1035;73;203;218;569;291;772
431115;202203;1026;2825;809;2431;67;256;546;1563;613;1819
431120;202203;2957;7325;2085;5717;494;1468;717;1832;1211;3300
431123;202203;388;1022;262;756;54;147;144;416;198;563
431125;202203;1127;2959;878;2503;252;712;431;1275;683;1987
431127;202203;206;555;74;232;8;29;12;34;20;63
431130;202203;3402;8177;2621;6991;323;919;1545;4058;1868;4977
431140;202203;6304;14638;3986;10407;494;1411;1742;3964;2236;5375
431142;202203;595;1443;457;1225;56;147;308;834;364;981
431150;202203;1130;2870;856;2402;146;436;435;1191;581;1627
431160;202203;735;1941;499;1452;109;328;144;406;253;734
431162;202203;609;1491;382;1081;34;118;214;549;248;667
431164;202203;188;440;52;163;5;12;7;21;12;33
431170;202203;500;1312;371;1060;97;283;113;308;210;591
431171;202203;808;1791;687;1647;120;269;469;1120;589;1389
431173;202203;493;1222;361;1035;103;345;136;358;239;703
431175;202203;1420;3191;923;2360;134;344;400;989;534;1333
431177;202203;921;2342;718;2032;111;357;462;1273;573;1630
431179;202203;351;758;108;313;22;68;33;97;55;165
431180;202203;2477;6109;1554;4321;334;978;453;1139;787;2117
431190;202203;644;1597;284;824;38;115;76;181;114;296
431198;202203;436;1229;363;1093;97;306;145;462;242;768
431200;202203;382;940;112;304;24;66;15;34;39;100
431205;202203;240;622;130;384;37;119;39;115;76;234
431210;202203;687;1549;559;1373;132;317;264;694;396;1011
431213;202203;295;744;227;619;14;33;127;338;141;371
431215;202203;670;1570;347;979;33;111;175;453;208;564
431217;202203;180;455;124;345;23;84;61;141;84;225
431220;202203;603;1508;385;1102;44;142;201;525;245;667
431225;202203;1663;3732;1311;3183;111;287;947;2267;1058;2554
431230;202203;744;2006;594;1694;100;321;342;909;442;1230
431235;202203;181;487;24;84;1;1;5;21;6;22
431237;202203;378;1147;305;986;49;187;150;453;199;640
431238;202203;35;99;29;86;5;16;15;38;20;54
431240;202203;5305;12398;4297;10831;428;1279;2862;6835;3290;8114
431242;202203;305;719;268;660;24;73;202;475;226;548
431244;202203;398;967;212;582;26;81;85;206;111;287
431245;202203;1441;3250;953;2428;69;187;536;1293;605;1480
431247;202203;304;729;188;502;28;90;94;217;122;307
431250;202203;1947;4631;1489;4040;323;808;819;2362;1142;3170
431260;202203;315;818;191;583;25;88;75;220;100;308
431261;202203;291;860;239;768;23;97;137;415;160;512
431262;202203;333;917;174;561;18;61;101;330;119;391
431265;202203;1699;3946;762;2150;108;346;238;584;346;930
431267;202203;257;634;168;452;11;34;117;294;128;328
431270;202203;3073;6641;1702;4335;344;903;603;1544;947;2447
431275;202203;147;393;89;262;21;65;33;84;54;149
431280;202203;248;658;93;293;13;42;15;34;28;76
431290;202203;379;1105;254;797;58;200;42;109;100;309
431295;202203;76;184;27;75;6;21;6;12;12;33
431300;202203;322;842;79;246;9;30;28;72;37;102
431301;202203;298;838;78;252;16;55;10;27;26;82
431303;202203;675;1682;434;1205;27;96;195;479;222;575
431306;202203;2492;5775;1591;4296;173;520;731;1792;904;2312
431308;202203;31;85;28;79;8;24;17;49;25;73
431310;202203;592;1533;431;1204;61;180;212;552;273;732
431320;202203;739;1970;436;1342;86;267;128;357;214;624
431330;202203;1932;4422;1027;2840;135;449;466;1148;601;1597
431333;202203;225;581;126;366;13;47;50;123;63;170
431335;202203;38;114;23;82;8;31;2;4;10;35
431337;202203;3286;7974;2612;6966;261;871;1840;4677;2101;5548
431339;202203;479;1187;357;982;77;198;163;453;240;651
431340;202203;20273;47962;14618;38730;2043;6076;7683;19038;9726;25114
431342;202203;453;999;337;816;36;82;250;603;286;685
431344;202203;426;1052;252;738;35;112;114;324;149;436
431346;202203;233;566;94;284;14;45;20;50;34;95
431349;202203;853;2002;565;1417;83;227;300;699;383;926
431350;202203;4903;11805;3804;10032;426;1291;2301;5773;2727;7064
431360;202203;618;1429;323;878;88;260;92;233;180;493
431365;202203;2350;5154;1877;4522;105;310;1500;3538;1605;3848
431370;202203;5295;12080;3968;10044;686;1840;2175;5458;2861;7298
431380;202203;971;2487;788;2188;104;297;500;1391;604;1688
431390;202203;2966;7086;1939;5301;205;688;1051;2513;1256;3201
431395;202203;1689;3767;1301;3204;180;450;825;2003;1005;2453
431400;202203;319;877;187;585;37;121;43;116;80;237
431402;202203;972;2087;730;1726;90;229;512;1171;602;1400
431403;202203;216;583;167;490;32;102;76;207;108;309
431405;202203;5619;14023;4492;12200;704;2179;2343;5949;3047;8128
431406;202203;622;1651;441;1277;95;254;184;563;279;817
431407;202203;573;1454;427;1162;58;167;283;752;341;919
431410;202203;20015;47619;14247;38072;1742;5488;8307;20604;10049;26092
431413;202203;247;681;59;202;7;22;14;45;21;67
431415;202203;764;1821;500;1376;82;257;243;596;325;853
431417;202203;625;1342;415;1009;62;180;236;542;298;722
431420;202203;1802;3859;1391;3319;122;315;898;2068;1020;2383
431430;202203;627;1555;322;966;50;176;111;291;161;467
431440;202203;34651;77493;25166;63390;3960;10845;11829;27787;15789;38632
431442;202203;147;415;78;266;14;55;15;46;29;101
431445;202203;388;1062;116;368;11;31;18;44;29;75
431446;202203;306;842;235;707;31;102;128;376;159;478
431447;202203;828;2073;488;1401;88;252;148;431;236;683
431449;202203;859;2127;568;1572;101;274;250;673;351;947
431450;202203;2534;4909;2007;4174;48;116;1678;3378;1726;3494
431454;202203;41;129;32;107;8;29;15;45;23;74
431455;202203;632;1440;332;849;27;76;173;389;200;465
431460;202203;3179;7290;2236;5680;534;1389;783;1967;1317;3356
431470;202203;1519;4024;1131;3235;204;627;467;1287;671;1914
431475;202203;263;699;65;218;4;18;9;19;13;37
431477;202203;474;1175;291;821;53;141;110;288;163;429
431478;202203;230;602;57;173;10;29;6;15;16;44
431480;202203;3758;9002;3009;7859;673;1797;1533;3983;2206;5780
431490;202203;123168;278347;95625;237402;5749;17805;71690;170044;77439;187849
431500;202203;534;1314;410;1100;56;161;226;584;282;745
431505;202203;278;650;196;531;14;47;140;376;154;423
431507;202203;347;813;152;437;48;150;18;43;66;193
431510;202203;1816;4439;1272;3411;310;862;460;1241;770;2103
431513;202203;239;518;129;331;36;105;35;65;71;170
431514;202203;129;319;100;269;3;8;67;163;70;171
431515;202203;531;1250;403;1037;87;228;236;580;323;808
431517;202203;61;179;53;161;4;15;28;78;32;93
431520;202203;412;992;186;533;20;68;82;197;102;265
431530;202203;5614;11848;3497;8748;607;1519;1584;3869;2191;5388
431531;202203;223;519;152;394;23;59;57;141;80;200
431532;202203;589;1324;379;962;72;203;162;405;234;608
431535;202203;302;768;137;408;25;78;28;81;53;159
431540;202203;1900;5812;1758;5626;74;281;1428;4610;1502;4891
431545;202203;371;931;74;218;6;18;25;69;31;87
431550;202203;2382;5768;1745;4620;268;775;958;2394;1226;3169
431555;202203;712;1573;436;1116;44;129;260;661;304;790
431560;202203;27567;63357;19042;50283;3873;9928;7338;20268;11211;30196
431570;202203;5013;11212;4285;10191;306;848;3400;7784;3706;8632
431575;202203;378;895;317;806;80;163;166;435;246;598
431580;202203;621;1580;407;1169;45;152;225;612;270;764
431590;202203;716;1918;531;1535;119;323;192;551;311;874
431595;202203;402;1042;265;763;51;158;102;263;153;421
431600;202203;1708;3952;1248;3267;230;643;606;1551;836;2194
431610;202203;1558;3748;1061;2875;161;435;520;1452;681;1887
431620;202203;512;1263;266;716;56;164;124;297;180;461
431630;202203;1421;3424;695;1983;116;354;264;708;380;1062
431640;202203;7209;15940;6175;14656;536;1370;4658;11051;5194;12421
431642;202203;683;1525;428;1070;63;139;193;461;256;600
431643;202203;395;948;193;548;23;64;60;160;83;224
431645;202203;2176;4447;1735;3872;46;142;1493;3268;1539;3410
431647;202203;350;816;120;341;13;41;37;95;50;136
431650;202203;133;350;96;294;12;41;38;95;50;136
431660;202203;968;2469;474;1437;82;290;121;326;203;616
431670;202203;1297;2981;778;2060;139;383;366;888;505;1271
431673;202203;246;634;106;337;15;46;26;58;41;104
431675;202203;404;1007;124;400;14;47;25;75;39;122
431680;202203;9578;23004;7257;18913;1360;3741;3601;8954;4961;12695
431690;202203;27746;65197;19826;51586;3084;8876;10341;25896;13425;34772
431695;202203;240;564;138;379;19;74;78;185;97;259
431697;202203;506;1142;394;975;54;130;241;606;295;736
431700;202203;1539;3691;1251;3201;183;421;721;1872;904;2293
431710;202203;15226;34086;11075;28394;1474;3971;6641;16876;8115;20847
431720;202203;7441;17472;4609;12435;1075;3005;1170;2875;2245;5880
431725;202203;39;94;30;79;8;27;15;33;23;60
431730;202203;4581;10415;3029;8100;575;1581;1357;3619;1932;5200
431740;202203;5840;13264;3990;10329;957;2787;1221;2854;2178;5641
431750;202203;8691;21506;6626;18316;1487;4355;2744;7444;4231;11799
431755;202203;340;905;95;307;12;40;22;61;34;101
431760;202203;5850;12752;4109;10051;434;1209;2610;6054;3044;7263
431770;202203;2170;4750;1667;4103;164;396;1220;2984;1384;3380
431775;202203;219;545;123;362;26;80;26;66;52;146
431780;202203;2366;5530;1559;4103;237;654;666;1724;903;2378
431790;202203;819;2095;544;1558;64;180;261;739;325;919
431795;202203;302;740;148;436;28;80;44;123;72;203
431800;202203;9127;20852;5901;15924;1541;4815;728;2004;2269;6819
431805;202203;295;724;69;241;5;13;4;10;9;23
431810;202203;3618;8015;2360;5841;347;901;1233;2888;1580;3789
431820;202203;2354;5973;1839;5174;463;1400;813;2275;1276;3675
431830;202203;9757;20729;7316;17501;2051;5581;1635;4093;3686;9674
431840;202203;2993;7250;2442;6415;264;724;1649;4325;1913;5049
431842;202203;513;1250;184;555;32;118;68;175;100;293
431843;202203;344;894;251;705;39;117;122;324;161;441
431844;202203;199;537;75;247;14;56;20;66;34;122
431845;202203;546;1382;382;1063;31;88;240;656;271;744
431846;202203;302;739;263;683;7;24;236;606;243;630
431848;202203;172;433;95;273;13;49;27;62;40;111
431849;202203;418;1009;93;264;7;19;19;40;26;59
431850;202203;4667;11907;3628;10008;821;2438;1350;3530;2171;5968
431860;202203;685;1579;387;1021;42;121;239;615;281;736
431861;202203;106;275;68;196;12;35;24;64;36;99
431862;202203;512;1558;420;1391;84;324;210;653;294;977
431870;202203;24305;58165;19655;51236;1927;5776;12787;32045;14714;37821
431880;202203;4313;10648;3149;8659;385;1226;1702;4431;2087;5657
431890;202203;5289;12784;3455;9367;1049;2815;825;2358;1874;5173
431900;202203;1083;2647;711;1989;117;354;361;941;478;1295
431910;202203;832;1911;339;908;44;115;109;236;153;351
431912;202203;555;1392;445;1212;67;193;295;795;362;988
431915;202203;1205;2711;954;2330;52;124;713;1710;765;1834
431920;202203;1374;2988;1141;2693;35;88;992;2306;1027;2394
431930;202203;763;1903;524;1483;158;419;214;629;372;1048
431935;202203;90;235;65;187;11;36;20;48;31;84
431936;202203;333;890;205;576;36;103;97;262;133;365
431937;202203;158;396;101;291;16;49;41;107;57;156
431940;202203;3301;7444;2095;5356;151;436;1276;3099;1427;3535
431950;202203;2262;5561;1815;4859;409;1158;825;2153;1234;3311
431960;202203;3294;7694;2567;6451;719;1849;865;2111;1584;3960
431970;202203;416;1018;194;540;48;141;48;121;96;262
431971;202203;85;201;38;112;4;12;8;19;12;31
431973;202203;611;1801;426;1422;43;168;306;1012;349;1180
431975;202203;119;240;33;89;6;21;8;16;14;37
431980;202203;1177;2824;937;2461;120;390;600;1457;720;1847
431990;202203;6539;15134;4823;12738;431;1374;2968;7565;3399;8939
432000;202203;14326;32302;10681;26866;1637;4426;6183;15013;7820;19439
432010;202203;3012;6782;2044;5241;414;1107;860;2065;1274;3172
432020;202203;1873;4778;1179;3342;273;827;353;949;626;1776
432023;202203;583;1353;295;796;36;100;139;329;175;429
432026;202203;1112;2893;859;2418;241;675;330;973;571;1648
432030;202203;469;1054;270;704;17;43;165;394;182;437
432032;202203;357;876;248;659;22;72;140;335;162;407
432035;202203;722;1942;628;1787;167;438;309;939;476;1377
432040;202203;1176;2726;465;1396;60;212;195;524;255;736
432045;202203;184;491;121;365;20;64;54;151;74;215
432050;202203;602;1419;441;1147;65;202;233;589;298;791
432055;202203;750;1835;528;1441;172;461;150;417;322;878
432057;202203;179;471;149;400;8;21;85;208;93;229
432060;202203;466;1123;145;456;22;76;40;118;62;194
432065;202203;235;621;179;508;37;105;74;210;111;315
432067;202203;842;2287;718;2025;60;199;540;1470;600;1669
432070;202203;1863;4502;1331;3555;222;665;657;1621;879;2286
432080;202203;5459;12121;4160;10206;580;1633;2145;5023;2725;6656
432085;202203;424;1109;322;950;59;191;173;495;232;686
432090;202203;2769;6618;1675;4569;290;822;763;1955;1053;2777
432100;202203;1025;2493;519;1535;94;303;119;294;213;597
432110;202203;2340;5812;1726;4773;449;1330;330;858;779;2188
432120;202203;3781;9603;3065;8465;474;1433;1622;4289;2096;5722
432130;202203;2931;6979;2464;6305;403;1047;1453;3736;1856;4783
432132;202203;228;625;121;387;19;64;56;160;75;224
432135;202203;1100;2486;749;1896;73;187;516;1304;589;1491
432140;202203;1912;5263;1500;4491;176;608;1003;2898;1179;3506
432143;202203;1625;4084;1241;3494;75;232;811;2245;886;2477
432145;202203;1926;4923;1278;3661;192;586;443;1064;635;1650
432146;202203;113;307;90;278;31;114;29;81;60;195
432147;202203;536;1398;325;990;108;337;72;216;180;553
432149;202203;489;1156;256;691;34;97;106;256;140;353
432150;202203;3892;9291;2966;7780;526;1463;1453;3662;1979;5125
432160;202203;6392;15505;4789;13080;1161;3286;1848;5121;3009;8407
432162;202203;240;526;40;114;7;19;12;22;19;41
432163;202203;167;390;32;86;2;8;6;8;8;16
432166;202203;693;1858;563;1611;101;335;219;564;320;899
432170;202203;1702;4427;1197;3547;211;679;540;1484;751;2163
432180;202203;3348;7651;1883;5009;286;834;850;1990;1136;2824
432183;202203;410;1142;302;911;56;211;125;343;181;554
432185;202203;876;2224;523;1546;80;248;243;696;323;944
432190;202203;2203;5158;1587;4230;136;431;1028;2571;1164;3002
432195;202203;1026;2539;685;1918;136;366;294;821;430;1187
432200;202203;3926;9281;2949;7820;274;786;1975;5129;2249;5915
432210;202203;429;1093;289;830;55;160;136;361;191;521
432215;202203;700;1869;626;1754;45;102;464;1322;509;1424
432218;202203;263;628;124;342;16;53;45;96;61;149
432220;202203;3952;8924;2874;7205;514;1284;1518;3732;2032;5016
432225;202203;125;325;90;259;10;32;53;150;63;182
432230;202203;844;1945;451;1233;59;178;201;506;260;684
432232;202203;541;1285;358;993;60;193;161;404;221;597
432234;202203;293;717;153;433;30;71;34;83;64;154
432235;202203;45;127;20;61;5;17;6;17;11;34
432237;202203;333;832;298;776;12;33;249;632;261;665
432240;202203;18475;42473;13687;36277;1288;3156;9277;25004;10565;28160
432250;202203;6468;17422;4863;14284;942;2944;2381;6920;3323;9864
432252;202203;512;1188;334;856;41;110;183;436;224;546
432253;202203;986;2756;693;2050;181;578;93;253;274;831
432254;202203;704;1626;220;641;29;73;39;100;68;173
432255;202203;109;281;63;185;9;29;29;79;38;108
432260;202203;5875;14286;4455;11726;991;2753;1974;4932;2965;7685
432270;202203;2338;5941;1923;5206;529;1543;719;1865;1248;3408
432280;202203;1510;3676;831;2405;128;402;293;715;421;1117
432285;202203;149;441;28;84;2;4;6;17;8;21
432290;202203;384;1013;241;706;67;214;69;163;136;377
432300;202203;31089;73564;23729;62269;2464;7589;15691;39326;18155;46915
432310;202203;1013;2482;749;2018;65;194;568;1507;633;1701
432320;202203;204;465;86;256;9;34;28;69;37;103
432330;202203;217;494;74;236;14;41;11;37;25;78
432335;202203;167;485;63;226;9;31;13;43;22;74
432340;202203;344;846;155;494;18;62;48;149;66;211
432345;202203;842;1736;726;1600;10;28;632;1362;642;1390
432350;202203;368;900;200;582;32;98;73;210;105;308
432360;202203;238;690;47;154;5;15;13;35;18;50
432370;202203;366;839;225;600;21;67;133;344;154;411
432375;202203;511;1220;389;987;91;232;184;467;275;699
432377;202203;168;505;42;145;0;0;10;22;10;22
432380;202203;2039;5355;1444;4290;212;669;752;2181;964;2850
500020;202203;3533;8324;2501;6713;210;686;1633;4240;1843;4926
500025;202203;1278;3051;822;2208;103;273;432;1113;535;1386
500060;202203;8939;24191;6254;18709;742;2379;3731;11258;4473;13637
500070;202203;5279;12668;3836;10318;705;2025;1803;4838;2508;6863
500080;202203;1776;4167;1113;2985;185;553;457;1119;642;1672
500085;202203;2234;5390;1608;4308;378;1089;763;1946;1141;3035
500090;202203;2316;5835;1598;4650;264;843;549;1713;813;2556
500100;202203;4143;10036;3195;8543;450;1378;1628;4100;2078;5478
500110;202203;10369;24909;7262;20158;1551;4454;3066;8979;4617;13433
500124;202203;2364;6459;1903;5734;291;885;1119;3444;1410;4329
500150;202203;1612;3430;1107;2754;182;500;594;1374;776;1874
500190;202203;5678;14213;3760;10585;744;2154;1266;3316;2010;5470
500200;202203;3012;6725;2080;5211;198;503;1338;3225;1536;3728
500210;202203;5394;12074;3858;10090;1023;2597;1936;5163;2959;7760
500215;202203;1595;4177;1188;3454;103;334;712;2048;815;2382
500220;202203;3353;8719;2432;7162;384;1231;1189;3345;1573;4576
500230;202203;2257;5035;1760;4366;188;506;1225;2958;1413;3464
500240;202203;4570;12830;3393;10449;529;1750;1517;4733;2046;6483
500260;202203;3642;7524;2410;5898;229;673;1500;3439;1729;4112
500270;202203;159281;363052;103091;272477;14602;43200;44844;108973;59446;152173
500280;202203;1525;3704;1036;2963;162;482;533;1523;695;2005
500290;202203;4062;9539;2525;6922;360;1119;971;2355;1331;3474
500295;202203;4240;9898;2855;7541;473;1422;1289;3028;1762;4450
500310;202203;1108;2160;772;1753;128;258;434;991;562;1249
500315;202203;4440;11284;3587;10062;230;688;2764;7776;2994;8464
500320;202203;22588;57357;15828;46450;3785;11268;6146;19151;9931;30419
500325;202203;6094;13011;4318;10641;452;1139;2743;6714;3195;7853
500330;202203;7446;16242;4993;12801;493;1242;2767;7255;3260;8497
500345;202203;2306;5454;1585;4335;257;730;698;1869;955;2599
500348;202203;2589;6405;1950;5331;218;642;1235;3393;1453;4035
500350;202203;1378;3655;816;2492;104;330;317;921;421;1251
500370;202203;30545;75633;22526;62934;2623;8472;12442;34020;15065;42492
500375;202203;2884;7270;1993;5511;285;860;808;2005;1093;2865
500380;202203;3860;9290;2704;7390;759;2156;596;1700;1355;3856
500390;202203;705;1429;446;1114;62;174;262;647;324;821
500400;202203;1730;4301;1166;3221;221;702;436;1075;657;1777
500410;202203;2651;6126;1864;4988;203;499;1074;3016;1277;3515
500430;202203;3105;7270;2159;5898;316;879;956;2818;1272;3697
500440;202203;1748;4040;971;2729;144;419;372;1099;516;1518
500450;202203;1954;4642;1257;3462;246;672;372;971;618;1643
500460;202203;4115;10482;2542;7449;449;1456;775;2152;1224;3608
500470;202203;2755;7161;1783;5271;463;1483;475;1247;938;2730
500480;202203;2234;6659;1868;6091;147;513;1400;4631;1547;5144
500490;202203;1257;2809;767;2069;144;470;213;585;357;1055
500500;202203;4615;11714;3064;9305;891;2977;426;1387;1317;4364
500510;202203;766;1862;508;1404;36;112;323;844;359;956
500515;202203;1808;4526;1420;3924;194;600;842;2237;1036;2837
500520;202203;3751;10398;2902;8997;620;1944;1483;4780;2103;6724
500525;202203;1063;2937;852;2643;105;349;543;1667;648;2016
500540;202203;5601;14011;3441;10215;993;3295;545;1432;1538;4727
500560;202203;5888;15302;4741;13901;221;682;3963;11764;4184;12446
500568;202203;4944;10429;3088;7704;641;1605;1294;3105;1935;4710
500570;202203;9051;20341;6218;15832;896;2625;3142;7388;4038;10013
500580;202203;3483;8757;2583;7210;575;1659;1206;3375;1781;5034
500600;202203;3998;9615;2980;8028;626;1696;1178;3279;1804;4975
500620;202203;8789;22255;6155;17388;927;2831;2975;7989;3902;10820
500625;202203;594;1558;406;1197;59;193;156;434;215;627
500627;202203;880;2265;553;1698;99;313;180;529;279;842
500630;202203;8305;18022;4848;12560;917;2566;1643;4118;2560;6684
500635;202203;3110;9549;2402;8603;247;791;1691;6578;1938;7369
500640;202203;2000;4145;1333;3279;76;208;894;2115;970;2323
500660;202203;22157;53070;15394;43391;4664;13478;4891;14306;9555;27784
500690;202203;2897;7246;1962;5756;464;1551;824;2287;1288;3838
500710;202203;3508;8942;2647;7495;640;2007;921;2469;1561;4476
500720;202203;5700;13991;3867;11007;779;2373;1396;3926;2175;6299
500730;202203;1206;2859;682;1920;125;356;208;571;333;927
500740;202203;5280;12116;3493;9422;510;1512;1722;4430;2232;5942
500750;202203;1172;2815;828;2254;117;333;360;895;477;1228
500755;202203;1129;2854;702;2067;120;376;198;532;318;908
500769;202203;5801;13840;3325;9315;666;2011;540;1355;1206;3366
500770;202203;1499;3932;1053;3221;206;648;363;1110;569;1758
500780;202203;1329;3133;878;2419;177;570;261;633;438;1203
500790;202203;8021;20566;6032;17089;1165;3565;2605;7359;3770;10924
500793;202203;2271;5518;1673;4537;335;975;702;1773;1037;2748
500795;202203;3064;7194;2420;6352;131;343;1944;5264;2075;5607
500797;202203;872;2178;578;1639;166;483;187;542;353;1025
500800;202203;3891;8542;2470;6457;693;2033;488;1358;1181;3391
500830;202203;20895;50215;14615;39126;3100;8704;5318;13661;8418;22365
500840;202203;1590;3725;1017;2678;118;325;482;1189;600;1514
510010;202203;2028;4378;1428;3624;141;326;1007;2572;1148;2898
510020;202203;4593;11151;2553;7249;471;1452;775;1947;1246;3399
510025;202203;7765;18059;5064;13912;608;1892;2662;6988;3270;8880
510030;202203;3495;7381;2402;5761;252;645;1383;3168;1635;3813
510035;202203;1326;3358;878;2662;191;570;421;1405;612;1975
510040;202203;2651;5665;1999;4849;221;465;1318;3336;1539;3801
510050;202203;2460;4910;1695;3954;224;560;1136;2623;1360;3183
510060;202203;1541;3789;1010;2849;186;553;267;696;453;1249
510080;202203;1635;4100;1137;3329;212;689;556;1548;768;2237
510100;202203;753;1669;548;1363;57;161;336;791;393;952
510120;202203;298;530;169;379;8;19;133;292;141;311
510125;202203;2298;5564;1842;4913;202;648;1049;2636;1251;3284
510130;202203;1723;4185;1218;3409;259;730;522;1494;781;2224
510140;202203;3343;8337;2284;7015;763;2573;882;2811;1645;5384
510160;202203;2007;4799;1538;4208;74;235;1309;3583;1383;3818
510170;202203;5477;13696;4186;11674;786;2400;2044;5583;2830;7983
510180;202203;16511;35302;11157;27927;2086;5480;4963;13094;7049;18574
510185;202203;1900;4818;1233;3854;525;1652;264;1096;789;2748
510190;202203;2450;6674;1604;5299;401;1491;372;1314;773;2805
510250;202203;19379;46577;14556;39456;2281;6644;8166;22442;10447;29086
510260;202203;1927;8046;1632;7551;256;1234;1016;5205;1272;6439
510263;202203;3733;10229;2448;7668;444;1594;536;1486;980;3080
510267;202203;6093;16897;3653;11517;676;2348;662;1784;1338;4132
510268;202203;1420;3531;1039;2903;169;484;460;1240;629;1724
510269;202203;1133;2971;747;2273;150;497;311;892;461;1389
510270;202203;3324;9044;2341;7385;364;1268;1037;3261;1401;4529
510279;202203;2017;5077;1206;3626;173;591;419;1147;592;1738
510285;202203;1222;3112;825;2428;204;648;279;779;483;1427
510300;202203;4217;10156;3209;8855;350;999;2188;6179;2538;7178
510305;202203;1581;4219;1024;3186;207;661;268;889;475;1550
510310;202203;1090;2572;769;2073;185;515;291;814;476;1329
510320;202203;4185;9950;2990;8010;613;1743;932;2417;1545;4160
510325;202203;4650;13218;3375;10887;859;2915;1066;3496;1925;6411
510330;202203;2772;8019;1900;6539;420;1482;688;2727;1108;4209
510335;202203;5357;14955;4110;12937;667;2316;2166;6848;2833;9164
510336;202203;500;1363;370;1170;49;146;208;723;257;869
510337;202203;1597;4464;1075;3558;359;1256;337;1159;696;2415
510340;202203;105143;228145;72049;181973;15169;42207;29285;71230;44454;113437
510343;202203;1291;3118;861;2396;113;373;464;1198;577;1571
510345;202203;1373;3763;1060;3184;167;516;533;1557;700;2073
510350;202203;3385;8241;2321;6540;572;1707;833;2292;1405;3999
510360;202203;2210;4355;1409;3432;59;118;1020;2637;1079;2755
510370;202203;1926;5259;1448;4501;175;601;913;2897;1088;3498
510380;202203;657;1539;390;1102;62;206;177;486;239;692
510385;202203;1292;4201;968;3627;85;368;666;2586;751;2954
510390;202203;1480;3588;1017;3048;318;860;420;1454;738;2314
510395;202203;767;1628;522;1281;36;82;361;910;397;992
510410;202203;5449;14270;4009;11853;707;2116;2226;6800;2933;8916
510420;202203;2767;5468;1904;4346;78;179;1406;3201;1484;3380
510450;202203;621;1471;367;1043;78;232;105;281;183;513
510452;202203;908;2501;681;2083;84;294;425;1269;509;1563
510454;202203;1085;2856;840;2458;97;249;531;1651;628;1900
510455;202203;1057;2717;718;2104;132;449;296;794;428;1243
510460;202203;2133;5213;1579;4403;245;743;862;2244;1107;2987
510480;202203;5458;12749;3752;9721;648;1825;1640;4001;2288;5826
510490;202203;1891;4643;1426;4063;193;571;974;2773;1167;3344
510500;202203;1679;3990;1052;3029;215;658;334;943;549;1601
510510;202203;4235;11373;3040;9419;780;2606;1037;3323;1817;5929
510515;202203;5859;14345;3985;11174;808;2567;1440;3624;2248;6191
510517;202203;1629;3975;1117;3227;359;1113;301;839;660;1952
510520;202203;2498;4924;1404;3562;114;297;672;1841;786;2138
510523;202203;1383;3149;999;2588;122;348;668;1701;790;2049
510525;202203;8529;22495;6427;18547;981;3114;3047;8323;4028;11437
510530;202203;567;1453;417;1242;31;106;276;816;307;922
510550;202203;2764;7673;2096;6582;378;1253;1136;3510;1514;4763
510558;202203;2578;6686;1945;5766;254;691;1006;3225;1260;3916
510560;202203;1844;5107;1171;3808;260;865;314;1080;574;1945
510562;202203;6540;15420;4853;12622;831;2130;2352;6349;3183;8479
510590;202203;3343;8077;2495;6992;173;501;1844;5301;2017;5802
510600;202203;1592;3364;1074;2628;132;329;599;1424;731;1753
510610;202203;2903;6723;2014;5578;321;1001;1132;3093;1453;4094
510615;202203;3131;7383;2213;5976;282;820;1388;3747;1670;4567
510617;202203;1111;3220;889;2881;84;322;656;2157;740;2479
510618;202203;1355;3465;994;2906;195;627;504;1448;699;2075
510619;202203;839;2077;498;1483;85;258;100;248;185;506
510620;202203;1531;3378;775;2187;257;811;65;152;322;963
510621;202203;1746;4484;1052;3207;240;793;307;840;547;1633
510622;202203;5572;14853;3859;11411;1292;4096;687;1856;1979;5952
510623;202203;3081;7355;2268;6096;520;1492;860;2335;1380;3827
510624;202203;1748;4419;933;2941;119;420;214;599;333;1019
510625;202203;3564;8313;2132;5861;374;1147;660;1789;1034;2936
510626;202203;1587;3788;1046;2949;260;825;285;809;545;1634
510627;202203;704;1742;392;1157;86;273;120;372;206;645
510628;202203;1647;3590;1092;2888;255;733;491;1290;746;2023
510629;202203;1871;5020;1336;4080;260;842;445;1380;705;2222
510630;202203;3736;9941;2357;7459;535;1820;558;1908;1093;3728
510631;202203;657;1486;490;1246;20;42;384;1000;404;1042
510637;202203;4082;9231;2924;7624;601;1682;1155;3066;1756;4748
510642;202203;6237;16585;4852;14587;906;3053;2783;8315;3689;11368
510645;202203;1138;2159;713;1646;160;333;360;871;520;1204
510650;202203;7775;18686;6134;16916;863;1553;4356;13439;5219;14992
510665;202203;1971;4207;1279;3125;265;570;520;1413;785;1983
510670;202203;477;993;288;738;38;96;159;412;197;508
510675;202203;6998;18484;4819;14536;1308;4365;1011;2919;2319;7284
510677;202203;2489;6142;1780;5124;256;849;1031;2909;1287;3758
510680;202203;776;1914;460;1365;93;312;124;310;217;622
510682;202203;1769;4837;1315;4131;398;1426;465;1398;863;2824
510685;202203;550;1509;398;1212;43;138;237;725;280;863
510700;202203;4631;10497;3249;8629;253;747;2462;6496;2715;7243
510704;202203;12157;27967;8323;21665;2077;5657;2359;5820;4436;11477
510706;202203;2489;7068;1741;5846;341;1174;758;2824;1099;3998
510710;202203;3254;7719;2114;5596;464;1247;699;1773;1163;3020
510715;202203;677;1421;478;1165;32;91;299;714;331;805
510718;202203;2550;5713;1563;4386;334;909;726;2344;1060;3253
510719;202203;503;1040;307;785;27;83;183;436;210;519
510720;202203;985;2186;666;1737;147;397;312;799;459;1196
510724;202203;961;2557;675;2022;98;327;351;983;449;1310
510726;202203;1087;1959;624;1415;62;141;340;789;402;930
510729;202203;669;1521;320;896;39;119;93;279;132;398
510730;202203;3319;7734;2282;6187;281;853;1250;3219;1531;4072
510735;202203;1269;3367;1002;2999;83;277;788;2335;871;2612
510740;202203;1095;2592;732;1960;71;223;434;1087;505;1310
510757;202203;525;1652;409;1472;139;567;141;472;280;1039
510760;202203;49982;106418;31387;79280;6194;17270;11426;26643;17620;43913
510770;202203;4647;10051;3258;8321;244;525;2303;6151;2547;6676
510774;202203;410;1001;299;832;49;133;174;492;223;625
510775;202203;722;1823;453;1392;108;356;113;324;221;680
510776;202203;726;1760;505;1343;90;280;239;617;329;897
510777;202203;1687;4310;1228;3725;147;520;854;2555;1001;3075
510779;202203;861;2222;655;1906;65;183;410;1245;475;1428
510780;202203;4434;10699;3305;9120;690;1778;1664;5064;2354;6842
510785;202203;2218;5609;1329;4047;341;1071;318;1052;659;2123
510787;202203;3388;9231;2229;6938;668;2150;237;700;905;2850
510788;202203;635;1437;431;1139;65;161;208;624;273;785
510790;202203;21109;52218;14043;40148;3600;11093;2526;6885;6126;17978
510792;202203;10786;28892;6954;21637;1562;5386;1476;4236;3038;9622
510794;202203;1320;3482;965;2926;298;1047;247;665;545;1712
510795;202203;10567;26154;7382;20720;1625;4973;2489;6644;4114;11617
510800;202203;1678;4248;1177;3466;372;1199;182;463;554;1662
510805;202203;1678;4509;1166;3600;246;854;476;1353;722;2207
510810;202203;737;1448;490;1137;152;311;217;551;369;862
510820;202203;873;1602;500;1154;29;62;304;694;333;756
510830;202203;1031;2337;798;2054;62;151;615;1640;677;1791
510835;202203;654;1514;437;1206;52;157;277;745;329;902
510840;202203;65883;134608;46744;111628;7698;17102;26977;67730;34675;84832
510850;202203;2099;5025;1350;3886;569;1821;118;263;687;2084
510860;202203;2822;7073;1841;5532;577;1860;374;1151;951;3011
510880;202203;850;2286;633;1907;147;445;207;640;354;1085
510885;202203;699;1635;467;1298;94;273;127;347;221;620
510890;202203;876;2371;676;2045;140;457;331;1013;471;1470
510895;202203;1494;3699;983;2843;151;521;465;1243;616;1764
520005;202203;3539;8735;2809;7796;826;1997;1258;4042;2084;6039
520010;202203;2988;7811;2188;6331;469;1503;833;2160;1302;3663
520013;202203;3743;9060;2534;6975;574;1576;810;2375;1384;3951
520015;202203;569;1377;423;1166;88;245;182;527;270;772
520017;202203;1362;3282;1005;2762;210;626;447;1142;657;1768
520020;202203;526;1082;409;946;17;48;351;793;368;841
520025;202203;39172;103047;33560;95403;4122;12305;23143;65806;27265;78111
520030;202203;7062;16337;5844;14731;297;798;4668;11639;4965;12437
520050;202203;450;1062;281;763;34;82;162;453;196;535
520055;202203;2030;4772;1312;3387;221;527;596;1517;817;2044
520060;202203;1931;4816;1381;3893;306;976;371;1047;677;2023
520080;202203;2080;5142;1598;4494;280;710;831;2550;1111;3260
520082;202203;1021;2466;749;2016;105;293;361;1034;466;1327
520085;202203;1135;2709;909;2394;164;445;481;1249;645;1694
520090;202203;969;1834;692;1535;44;72;566;1275;610;1347
520110;202203;43230;111009;30742;90668;9070;29747;4357;12214;13427;41961
520120;202203;266;603;150;404;18;58;62;158;80;216
520130;202203;4376;10091;3409;8610;671;1727;1530;3872;2201;5599
520140;202203;51653;131052;36730;106172;12360;37748;5876;17749;18236;55497
520145;202203;670;1493;451;1176;93;255;225;544;318;799
520150;202203;720;1637;538;1415;76;210;285;737;361;947
520160;202203;972;2233;676;1725;127;284;256;701;383;985
520170;202203;5221;10477;3501;8506;215;614;2655;6382;2870;6996
520180;202203;2886;7208;2353;6462;304;990;1501;3974;1805;4964
520215;202203;1956;4541;1429;3761;254;694;734;1887;988;2581
520235;202203;818;1756;553;1386;90;230;294;753;384;983
520250;202203;1678;4106;1218;3379;382;1082;360;1142;742;2224
520260;202203;875;1991;552;1476;93;243;226;611;319;854
520280;202203;946;2061;744;1764;146;329;402;988;548;1317
520310;202203;1125;2321;732;1750;172;448;272;685;444;1133
520320;202203;1993;5106;1561;4442;165;496;946;2749;1111;3245
520330;202203;5347;13287;4104;11262;611;1968;2282;5953;2893;7921
520340;202203;2673;5670;1662;4300;180;393;966;2604;1146;2997
520350;202203;3277;7611;2334;6228;541;1411;1058;2935;1599;4346
520355;202203;2069;5438;1507;4365;449;1379;278;723;727;2102
520357;202203;892;2054;652;1697;32;67;516;1362;548;1429
520360;202203;851;2092;670;1809;126;354;277;742;403;1096
520380;202203;1556;3761;961;2699;151;442;382;1008;533;1450
520390;202203;1255;2778;791;2176;207;600;237;717;444;1317
520393;202203;716;1632;484;1265;65;181;206;518;271;699
520396;202203;979;2393;827;2170;42;112;591;1522;633;1634
520400;202203;1771;4117;1378;3601;106;304;1033;2694;1139;2998
520410;202203;2351;4912;1586;3798;217;588;910;2048;1127;2636
520420;202203;433;956;338;815;17;48;258;594;275;642
520425;202203;1714;4073;971;2672;266;788;182;469;448;1257
520430;202203;2658;5921;1619;4303;410;1192;203;488;613;1680
520440;202203;3264;7636;1892;5211;395;1213;479;1256;874;2469
520450;202203;14448;33037;10149;26778;3001;8022;2903;8074;5904;16096
520455;202203;816;2129;592;1787;158;478;187;598;345;1076
520460;202203;1165;2604;914;2285;81;170;716;1842;797;2012
520465;202203;980;2310;811;2083;65;209;638;1584;703;1793
520470;202203;2457;5830;1905;5125;487;1259;916;2674;1403;3933
520480;202203;988;2619;707;2147;164;539;267;792;431;1331
520485;202203;1700;4816;1379;4346;201;691;807;2446;1008;3137
520490;202203;4610;11899;3523;10229;700;2074;1889;5651;2589;7725
520495;202203;1783;3693;1372;3153;87;198;1053;2461;1140;2659
520500;202203;1790;4346;1342;3574;195;569;726;1883;921;2452
520505;202203;963;1980;736;1702;48;114;563;1276;611;1390
520510;202203;8978;21393;6435;17614;1162;3544;2758;7458;3920;11002
520520;202203;1339;3202;1029;2743;219;624;457;1221;676;1845
520530;202203;2776;7125;2074;5929;352;1037;1066;3174;1418;4211
520540;202203;3413;8626;2290;6495;435;1278;674;1804;1109;3082
520545;202203;1398;3328;1107;2894;235;616;555;1453;790;2069
520547;202203;1292;3225;1005;2724;203;561;531;1440;734;2001
520549;202203;16622;41740;13933;38003;1612;4813;9757;26134;11369;30947
520551;202203;5261;13289;4440;12130;423;1336;3253;8677;3676;10013
520552;202203;1030;2514;808;2196;165;443;430;1237;595;1680
520570;202203;608;1323;407;1018;86;188;174;442;260;630
520580;202203;2473;5316;1863;4613;226;567;1224;3041;1450;3608
520590;202203;1483;3491;1025;2767;248;682;366;973;614;1655
520620;202203;9508;24140;7626;21438;1554;4523;4086;11552;5640;16075
520630;202203;967;2291;692;1848;77;198;326;852;403;1050
520640;202203;2651;6184;2025;5144;411;1039;923;2411;1334;3450
520650;202203;1156;2448;825;1995;161;347;428;1103;589;1450
520660;202203;594;1421;327;947;50;153;96;288;146;441
520670;202203;1068;2752;902;2514;74;213;642;1773;716;1986
520680;202203;919;2090;730;1810;128;267;436;1112;564;1379
520690;202203;354;820;241;646;80;204;76;205;156;409
520710;202203;479;1110;335;872;16;41;223;556;239;597
520725;202203;1580;3655;1086;2830;138;419;641;1623;779;2042
520735;202203;986;2235;681;1754;162;369;266;725;428;1094
520740;202203;2789;6004;2118;5182;444;971;1105;2901;1549;3872
520750;202203;789;1780;565;1450;84;238;297;717;381;955
520753;202203;1446;3693;1089;3058;208;635;469;1244;677;1879
520760;202203;1553;3210;1319;2934;27;54;1213;2724;1240;2778
520780;202203;1666;3797;1205;3152;160;400;663;1720;823;2120
520790;202203;3729;8579;2642;6863;381;939;1448;3938;1829;4877
520800;202203;19221;46768;15160;40971;2020;5431;9547;26394;11567;31825
520810;202203;1420;2868;1092;2503;207;432;666;1693;873;2125
520815;202203;647;1929;487;1578;98;339;151;493;249;832
520830;202203;2049;4253;1470;3579;98;258;1164;2805;1262;3063
520840;202203;3156;7956;2561;7192;828;2545;916;2671;1744;5216
520850;202203;829;1882;638;1611;146;437;288;713;434;1150
520860;202203;9083;23063;6870;19423;1458;4352;2965;8194;4423;12546
520870;202203;140609;315185;100637;255852;18492;49320;45313;111371;63805;160691
520880;202203;9320;25441;7422;22052;1513;4745;3110;9098;4623;13843
520890;202203;4985;11055;3513;8844;528;1469;1785;4392;2313;5861
520910;202203;5184;12439;3415;9528;717;2182;1047;2812;1764;4994
520915;202203;829;2158;539;1564;114;357;189;509;303;866
520920;202203;5061;10777;3695;9120;694;1458;2009;5324;2703;6782
520929;202203;757;1732;590;1500;95;193;307;851;402;1044
520940;202203;1089;2788;843;2424;54;174;631;1791;685;1965
520945;202203;541;1161;382;950;25;68;249;606;274;674
520960;202203;1258;2768;980;2370;267;582;453;1224;720;1806
520970;202203;3449;8713;2644;7452;766;2304;597;1840;1363;4144
520980;202203;863;1953;639;1659;106;266;302;765;408;1031
520990;202203;3379;8208;2738;7416;342;854;1933;5349;2275;6203
520993;202203;1351;3154;907;2386;136;400;467;1190;603;1590
520995;202203;2752;6638;2108;5760;333;875;847;2449;1180;3324
521000;202203;10282;25892;6930;19774;1164;3543;2171;6019;3335;9562
521010;202203;4077;10197;3050;8442;383;1085;1655;4512;2038;5597
521015;202203;886;2115;627;1666;44;134;412;1041;456;1175
521020;202203;4351;10591;2670;7444;701;2038;502;1415;1203;3453
521030;202203;710;1428;543;1187;35;78;426;914;461;992
521040;202203;8930;20992;6720;17674;1403;3660;2831;7968;4234;11628
521056;202203;1066;2700;809;2306;228;613;269;829;497;1442
521060;202203;1160;2935;841;2342;180;503;309;865;489;1368
521080;202203;1220;2531;661;1696;97;269;318;750;415;1019
521090;202203;3444;8940;2343;6719;587;1836;309;893;896;2729
521100;202203;2132;4564;1601;3841;198;473;1071;2601;1269;3074
521120;202203;5452;12396;4152;10787;608;1279;1890;5865;2498;7144
521130;202203;1111;2476;564;1496;49;103;282;785;331;888
521140;202203;1625;3972;1230;3286;139;375;712;1850;851;2225
521150;202203;14200;30273;9150;23160;1696;4619;4296;11013;5992;15632
521160;202203;804;1606;552;1251;62;121;348;769;410;890
521170;202203;1205;2708;897;2250;98;281;512;1220;610;1501
521180;202203;8980;22937;7308;20178;1233;3723;3869;10361;5102;14084
521190;202203;12182;29073;7664;21841;1898;5709;2145;6135;4043;11844
521200;202203;783;1807;555;1463;58;151;329;847;387;998
521205;202203;713;1659;556;1425;21;63;440;1078;461;1141
521210;202203;835;2122;482;1392;85;263;129;297;214;560
521220;202203;4216;9637;2915;7710;536;1538;1384;3673;1920;5211
521225;202203;443;904;328;777;48;109;222;532;270;641
521230;202203;1559;3775;1353;3519;517;1330;556;1555;1073;2885
521250;202203;38617;94016;31179;83644;8687;23552;14639;39914;23326;63466
521260;202203;592;1324;460;1135;74;192;269;644;343;836
521270;202203;2208;5015;1927;4690;146;313;1475;3713;1621;4026
521280;202203;2013;5171;1522;4387;323;983;674;1986;997;2969
521290;202203;604;1315;421;1087;44;135;274;683;318;818
521295;202203;1344;2855;1066;2544;137;266;789;1953;926;2219
521300;202203;2093;4948;1638;4304;303;753;986;2655;1289;3408
521305;202203;754;1704;536;1407;56;166;337;872;393;1038
521308;202203;5356;13492;3776;10665;342;1077;2340;6366;2682;7443
521310;202203;10561;25777;7455;20445;1296;3947;3608;9436;4904;13383
521340;202203;445;977;320;799;29;70;206;514;235;584
521350;202203;2220;5460;1705;4685;146;464;1229;3281;1375;3745
521370;202203;1382;3421;871;2578;268;867;149;467;417;1334
521375;202203;1550;3794;1071;3025;212;606;346;1074;558;1680
521377;202203;1622;3330;1201;2813;110;184;930;2317;1040;2501
521380;202203;6874;17628;4471;13254;692;2007;1034;3302;1726;5309
521385;202203;778;1778;592;1528;83;185;327;919;410;1104
521390;202203;759;1839;540;1491;151;461;109;317;260;778
521400;202203;3228;7231;2629;6523;254;601;1918;4831;2172;5432
521405;202203;1592;3935;1099;3040;137;392;622;1673;759;2065
521410;202203;989;2352;786;2039;156;372;430;1145;586;1517
521440;202203;1538;3589;1186;3080;360;923;491;1304;851;2227
521450;202203;4493;12651;3333;10444;873;2751;832;2757;1705;5508
521460;202203;6617;16319;4852;13281;1313;3716;1792;4864;3105;8580
521470;202203;822;2036;568;1583;61;181;276;705;337;886
521480;202203;517;1195;350;911;70;173;140;341;210;514
521483;202203;2609;6025;1858;4934;358;936;881;2396;1239;3332
521486;202203;1992;4591;1512;3913;129;246;1013;2662;1142;2908
521487;202203;451;1044;320;868;60;147;188;537;248;684
521490;202203;989;2544;741;2136;40;145;521;1441;561;1586
521500;202203;2356;5680;1813;4918;148;542;1245;3223;1393;3765
521520;202203;867;1926;659;1634;101;208;351;907;452;1115
521523;202203;14139;40059;11688;36331;3173;10219;4293;13585;7466;23804
521525;202203;1220;2727;942;2341;67;204;675;1625;742;1829
521530;202203;2553;6374;1611;4522;342;969;429;1153;771;2122
521540;202203;920;2286;651;1851;130;405;281;803;411;1208
521550;202203;1830;4467;1020;2877;190;558;286;827;476;1385
521560;202203;5794;14053;4170;11870;1063;2777;1928;6031;2991;8808
521565;202203;754;1764;542;1425;80;217;265;693;345;910
521570;202203;4015;10518;2819;8285;601;2055;190;571;791;2626
521580;202203;557;1290;352;943;48;144;147;365;195;509
521590;202203;863;1843;635;1532;85;209;373;868;458;1077
521600;202203;477;1212;314;913;40;106;153;439;193;545
521630;202203;1884;3946;1205;2995;296;724;416;1039;712;1763
521640;202203;2157;4877;1446;3843;304;851;500;1290;804;2141
521645;202203;599;1482;372;1080;107;290;88;256;195;546
521680;202203;1458;3960;1135;3413;320;1006;331;990;651;1996
521690;202203;606;1437;507;1308;74;208;326;835;400;1043
521710;202203;3844;9040;2536;6917;461;1402;820;1981;1281;3383
521720;202203;2666;5799;1770;4504;241;624;1022;2610;1263;3234
521730;202203;4208;11008;3279;9510;887;2977;973;2449;1860;5426
521740;202203;4593;11424;3549;9894;1102;3163;980;2856;2082;6019
521760;202203;16875;43239;13362;38187;2927;8483;6001;18505;8928;26988
521770;202203;3639;8216;2481;6444;619;1659;672;1812;1291;3471
521800;202203;7528;19057;5535;15825;1389;3946;2218;6967;3607;10913
521805;202203;1089;2215;787;1846;171;372;430;1068;601;1440
521810;202203;757;1724;552;1442;101;248;327;890;428;1138
521830;202203;6328;16474;5107;14614;318;1131;3826;10690;4144;11821
521839;202203;983;2169;750;1805;79;225;518;1156;597;1381
521850;202203;7291;16045;4595;12044;1224;3125;845;2257;2069;5382
521860;202203;1783;4652;1244;3674;208;679;415;1136;623;1815
521870;202203;771;2061;559;1662;112;382;171;427;283;809
521878;202203;863;2105;617;1650;71;238;369;916;440;1154
521880;202203;22105;52546;15753;42838;3675;10329;6571;17670;10246;27999
521890;202203;3830;9350;2639;7323;705;1995;722;1888;1427;3883
521900;202203;1533;3498;808;2257;254;686;49;141;303;827
521910;202203;1591;3271;1147;2741;166;364;625;1555;791;1919
521920;202203;580;1465;427;1217;46;153;248;678;294;831
521925;202203;857;2161;638;1835;125;406;321;899;446;1305
521930;202203;6109;14108;4137;11213;1035;2359;1830;5479;2865;7838
521935;202203;1186;2718;824;2108;69;192;482;1164;551;1356
521940;202203;1468;3061;957;2366;169;445;487;1167;656;1612
521945;202203;741;1835;542;1498;88;242;293;829;381;1071
521950;202203;839;1929;596;1556;113;289;281;745;394;1034
521960;202203;782;1942;540;1501;59;196;307;783;366;979
521970;202203;3226;7036;2463;6129;254;523;1773;4666;2027;5189
521971;202203;833;1936;589;1565;153;387;180;466;333;853
521973;202203;1640;4064;1371;3714;58;141;1144;3109;1202;3250
521975;202203;14022;35148;11573;31800;1837;5213;7240;19945;9077;25158
521980;202203;2703;6031;2081;5235;140;334;1604;4127;1744;4461
521990;202203;1355;3437;1113;3062;235;694;568;1564;803;2258
522000;202203;3061;7623;2416;6791;482;1384;1339;3968;1821;5352
522005;202203;379;874;274;717;40;113;135;356;175;469
522010;202203;4777;11333;3510;9353;705;2023;1420;3644;2125;5667
522015;202203;1172;2908;882;2480;236;658;370;1064;606;1722
522020;202203;6073;13839;4043;10754;821;2124;1764;4923;2585;7047
522026;202203;898;2257;586;1743;105;363;176;453;281;816
522028;202203;555;1330;390;1056;96;290;148;380;244;670
522040;202203;3834;8060;2770;6662;276;708;1962;4618;2238;5326
522045;202203;20807;54438;15842;46247;3409;10674;5316;15021;8725;25695
522050;202203;1334;3256;931;2576;178;570;403;1000;581;1570
522060;202203;3337;8378;2416;6920;341;933;1301;3800;1642;4733
522068;202203;2086;4915;1676;4434;91;208;1399;3752;1490;3960
522070;202203;852;1847;697;1632;22;48;604;1386;626;1434
522100;202203;910;2229;631;1756;74;209;331;888;405;1097
522108;202203;1231;2722;979;2372;46;145;811;1922;857;2067
522119;202203;2061;4677;1637;4140;267;637;919;2491;1186;3128
522130;202203;530;1264;402;1094;33;86;302;840;335;926
522140;202203;25253;62215;18371;50404;4125;12035;6367;16547;10492;28582
522145;202203;902;2099;644;1725;132;369;329;876;461;1245
522150;202203;1199;2777;832;2208;201;535;272;729;473;1264
522155;202203;1135;2779;889;2426;151;357;533;1518;684;1875
522157;202203;791;1663;652;1500;34;75;537;1255;571;1330
522160;202203;6559;16135;4279;12152;1203;3638;536;1671;1739;5309
522170;202203;3002;7410;2326;6431;279;776;1468;4118;1747;4894
522180;202203;655;1540;445;1145;87;225;126;332;213;557
522185;202203;24472;57275;18111;48773;6443;18482;4676;13731;11119;32213
522190;202203;881;1953;617;1530;126;321;284;677;410;998
522200;202203;2047;5451;1486;4458;378;1135;375;1148;753;2283
522205;202203;1864;4310;1402;3676;240;610;744;1985;984;2595
522220;202203;1408;3251;1049;2756;108;282;702;1888;810;2170
522230;202203;1411;3345;1145;2961;180;535;660;1698;840;2233
530010;202203;213372;555121;178433;504926;22044;68950;115275;318553;137319;387503
110001;202202;4408;11842;2992;9255;639;2132;1180;3703;1819;5835
110002;202202;15008;37221;11113;30870;2732;8021;3499;9861;6231;17882
110003;202202;717;2052;561;1733;150;487;207;601;357;1088
110004;202202;13940;34603;9623;27286;1817;5580;3386;9519;5203;15099
110005;202202;2751;6892;1965;5634;380;1084;658;2018;1038;3102
110006;202202;1804;4923;1135;3524;201;669;253;747;454;1416
110007;202202;1437;3582;944;2757;248;720;324;1104;572;1824
110008;202202;3870;9597;2851;8177;321;796;1885;5920;2206;6716
110009;202202;4945;13175;3205;10077;619;2128;1304;4052;1923;6180
110010;202202;8723;25780;6614;21983;1216;3910;3518;12739;4734;16649
110011;202202;8136;20720;5654;16436;1740;5247;1214;3647;2954;8894
110012;202202;17562;42330;11180;31726;2771;8282;1712;5030;4483;13312
110013;202202;6088;16657;4317;13280;1668;5373;749;2482;2417;7855
110014;202202;4263;10821;2952;8368;440;1369;1492;4110;1932;5479
110015;202202;6368;15741;4049;11481;767;2422;1294;3317;2061;5739
110018;202202;4280;10442;2620;7658;521;1620;739;2188;1260;3808
110020;202202;87784;198806;65547;169421;14091;34906;31199;87068;45290;121974
110025;202202;5787;13476;3944;10400;615;1746;2084;5413;2699;7159
110026;202202;604;1497;444;1263;93;285;182;566;275;851
110028;202202;7962;19400;5044;14329;1245;3926;803;2294;2048;6220
110029;202202;1735;4141;1051;2979;196;557;446;1289;642;1846
110030;202202;14699;33034;9317;25150;2280;6809;1528;4586;3808;11395
110032;202202;3857;10331;2401;7359;688;2103;573;1857;1261;3960
110033;202202;4128;12246;3180;10525;1001;3392;1032;3700;2033;7092
110034;202202;3544;8080;2409;6537;722;2125;803;2502;1525;4627
110037;202202;1796;5119;1314;4249;279;910;596;1981;875;2891
110040;202202;3330;8815;2454;7268;555;1786;892;2571;1447;4357
110045;202202;5257;14535;3846;12031;939;3097;1461;4759;2400;7856
110050;202202;1925;5016;1327;3995;414;1424;232;643;646;2067
110060;202202;978;2796;677;2102;170;563;187;566;357;1129
110070;202202;1734;5158;1257;4126;356;1275;318;972;674;2247
110080;202202;7181;16128;5487;14108;941;2291;3327;9142;4268;11433
110090;202202;644;1712;450;1369;89;297;144;438;233;735
110092;202202;1412;3894;993;3115;173;535;509;1687;682;2222
110094;202202;3155;8887;2361;7404;953;3160;361;1216;1314;4376
110100;202202;1901;5304;1496;4569;420;1336;625;1972;1045;3308
110110;202202;1969;5089;1430;4265;441;1369;389;1281;830;2650
110120;202202;1425;3923;1088;3301;250;798;400;1214;650;2012
110130;202202;3112;7453;1902;5284;272;739;213;526;485;1265
110140;202202;2476;6895;1794;5591;361;1214;683;2113;1044;3327
110143;202202;1506;3947;1089;3171;302;935;294;844;596;1779
110145;202202;1076;2694;638;1880;136;405;259;803;395;1208
110146;202202;549;1386;389;1134;68;158;198;630;266;788
110147;202202;840;2111;557;1582;85;270;250;638;335;908
110148;202202;1060;2798;537;1687;143;502;77;246;220;748
110149;202202;3657;9312;2482;7480;748;2357;698;2288;1446;4645
110150;202202;3013;7302;1986;5758;512;1619;598;2003;1110;3622
110155;202202;850;2381;614;1847;116;394;252;692;368;1086
110160;202202;1576;4578;1182;3738;326;1066;326;1075;652;2141
110170;202202;2310;5712;1502;4257;201;642;875;2344;1076;2986
110175;202202;2278;6287;1555;4725;269;828;620;1902;889;2730
110180;202202;1591;4120;1139;3259;138;403;622;1761;760;2164
120001;202202;3696;10204;3015;9190;448;1477;1977;6120;2425;7597
120005;202202;2111;7652;1927;7398;156;656;1552;6085;1708;6741
120010;202202;5944;16361;5110;15179;401;1179;3988;12064;4389;13243
120013;202202;2576;8151;2276;7786;486;1584;1397;5199;1883;6783
120017;202202;2965;8469;2573;7889;353;1080;1728;5577;2081;6657
120020;202202;16443;59023;15166;56712;952;4188;12470;46761;13422;50949
120025;202202;3687;9359;3022;8582;293;820;2322;6712;2615;7532
120030;202202;6848;25977;6362;25139;422;2155;5029;20107;5451;22262
120032;202202;1927;8048;1841;7893;100;620;1604;6758;1704;7378
120033;202202;4581;15797;4282;15264;111;625;3774;13313;3885;13938
120034;202202;3093;10256;2678;9576;112;622;2275;8004;2387;8626
120035;202202;4203;15216;3949;14791;219;1078;3382;12530;3601;13608
120038;202202;3174;9282;2730;8591;384;1304;1831;5771;2215;7075
120039;202202;2172;8927;2037;8676;118;679;1671;7113;1789;7792
120040;202202;55017;155107;47633;143992;5704;18639;32238;97846;37942;116485
120042;202202;3733;12835;3464;12368;153;767;2945;10407;3098;11174
120043;202202;1640;6183;1448;5918;35;210;1329;5447;1364;5657
120045;202202;6662;16334;5725;15267;317;959;4871;12968;5188;13927
120050;202202;10525;35070;9687;33867;461;1977;8216;28892;8677;30869
120060;202202;10781;38713;9912;37480;435;2248;8730;32905;9165;35153
120070;202202;3727;10899;3246;10264;362;1033;2321;7703;2683;8736
120080;202202;5139;14488;4602;13727;462;1382;3568;10826;4030;12208
130002;202202;3545;12665;3177;12157;203;646;2759;10874;2962;11520
130006;202202;2813;9529;2350;8774;292;1081;1599;6444;1891;7525
130008;202202;3004;9775;2645;9279;110;462;2216;7903;2326;8365
130010;202202;4239;11910;3584;11176;103;285;3232;10224;3335;10509
130014;202202;3929;10693;3071;9375;434;1351;1984;6238;2418;7589
130020;202202;3258;12163;2902;11641;140;765;2436;9785;2576;10550
130030;202202;13493;36256;12386;34999;277;732;11478;32589;11755;33321
130040;202202;4539;12681;3782;11716;395;1092;2939;9421;3334;10513
130050;202202;8237;28445;6933;26788;213;874;6289;24693;6502;25567
130060;202202;8305;31495;7107;29961;374;2194;6048;25279;6422;27473
130063;202202;7105;22268;6333;21429;168;764;5834;19782;6002;20546
130068;202202;4209;13473;3572;12637;177;959;2844;9966;3021;10925
130070;202202;8207;21859;6729;20270;370;944;5607;17446;5977;18390
130080;202202;8275;27312;7260;26178;441;1470;6336;23279;6777;24749
130083;202202;3001;9348;2667;8944;199;649;2204;7640;2403;8289
130090;202202;4066;11743;3620;11219;72;194;3323;10462;3395;10656
130100;202202;8488;24846;7163;23466;155;304;6708;22492;6863;22796
130110;202202;9019;24480;7333;22414;912;2429;5479;17753;6391;20182
130115;202202;5509;16796;4740;15928;139;423;4196;14383;4335;14806
130120;202202;14499;49930;12780;47680;941;3930;10539;39812;11480;43742
130130;202202;6354;18192;4919;16342;440;1422;3725;12794;4165;14216
130140;202202;7784;25911;6783;24776;313;1434;5835;21498;6148;22932
130150;202202;4109;14209;3869;13939;79;442;3604;13005;3683;13447
130160;202202;6422;19696;5555;18634;303;925;4862;16626;5165;17551
130165;202202;3504;12672;3294;12437;126;540;2992;11416;3118;11956
130170;202202;13182;35668;10722;32891;579;1993;9180;28459;9759;30452
130180;202202;4741;14872;4509;14617;41;236;4364;14118;4405;14354
130185;202202;21180;48804;17462;44838;1278;1792;14974;40584;16252;42376
130190;202202;20953;65402;16955;59690;1425;5197;13023;47018;14448;52215
130195;202202;2707;9309;2231;8699;99;454;1888;7416;1987;7870
130200;202202;3115;7925;2567;7226;86;318;2250;6297;2336;6615
130210;202202;1479;5342;1332;5164;107;571;1100;4185;1207;4756
130220;202202;2633;8208;2207;7696;80;286;1959;6958;2039;7244
130230;202202;5409;20433;4724;19509;202;1141;4168;17241;4370;18382
130240;202202;14670;38997;12108;35767;182;931;11191;32882;11373;33813
130250;202202;28737;81566;24678;76978;1281;3796;20849;66851;22130;70647
130255;202202;5288;16114;4558;14868;166;690;3768;12276;3934;12966
130260;202202;294630;764589;242486;694282;57373;160184;133017;400466;190390;560650
130270;202202;10775;35547;8937;32791;1402;4848;5909;22798;7311;27646
130280;202202;3851;14701;3537;14348;106;440;3295;13536;3401;13976
130290;202202;15398;46954;13555;44728;723;2404;11894;39814;12617;42218
130300;202202;5392;17213;4845;16500;197;923;4236;14440;4433;15363
130310;202202;7768;22639;6807;21472;357;1224;5799;18569;6156;19793
130320;202202;3761;11901;3150;11114;367;1248;2397;8755;2764;10003
130330;202202;5073;15249;4089;14096;196;827;3519;12189;3715;13016
130340;202202;27360;76629;23635;72480;941;3058;20859;64863;21800;67921
130350;202202;4338;14910;3916;14390;130;715;3510;12812;3640;13527
130353;202202;8661;21934;7045;19931;778;2021;5275;15548;6053;17569
130356;202202;5936;17725;5002;16319;775;2380;3244;11183;4019;13563
130360;202202;3336;10359;2770;9650;67;293;2532;8837;2599;9130
130370;202202;5937;23427;5080;22242;451;2390;3919;17258;4370;19648
130380;202202;7972;32951;7428;32162;518;2839;6289;27135;6807;29974
130390;202202;6826;26678;6102;25557;470;2183;5142;21732;5612;23915
130395;202202;2704;8203;2324;7614;192;626;1857;6126;2049;6752
130400;202202;3092;9015;2654;8443;88;265;2409;7777;2497;8042
130406;202202;11549;38583;9732;36410;1262;4720;7291;28232;8553;32952
130410;202202;4803;15962;4142;14931;1076;4013;2224;8330;3300;12343
130420;202202;15745;51369;13219;48266;931;4218;10589;38833;11520;43051
130423;202202;4878;14520;4288;13849;168;733;3855;12353;4023;13086
130426;202202;2998;11341;2767;11065;55;264;2585;10451;2640;10715
130430;202202;4885;12699;4189;11825;171;541;3713;10461;3884;11002
130440;202202;5600;16364;4722;15334;93;375;4417;14437;4510;14812
140002;202202;2534;7210;2213;6827;107;350;1900;5956;2007;6306
140005;202202;3488;9454;3034;8931;339;928;2400;7332;2739;8260
140010;202202;58103;151232;47147;135528;10915;32876;21999;64955;32914;97831
140015;202202;4358;11936;3716;11183;270;766;3165;9833;3435;10599
140017;202202;5871;14444;5208;13624;304;766;4460;11862;4764;12628
140020;202202;5630;15461;4859;14503;247;964;4076;12107;4323;13071
140023;202202;2791;7822;2290;7125;211;651;1769;5661;1980;6312
140028;202202;2109;5300;1792;4914;90;282;1463;4033;1553;4315
140030;202202;5717;14019;5076;13289;205;371;4646;12404;4851;12775
140040;202202;2832;10566;2626;10303;93;528;2423;9425;2516;9953
140045;202202;2738;9860;2265;9226;375;1234;1530;6855;1905;8089
140047;202202;6805;18518;5713;16968;570;1828;4256;12803;4826;14631
140050;202202;1625;4652;1390;4322;174;496;1029;3319;1203;3815
140060;202202;1996;4901;1740;4552;124;312;1455;3868;1579;4180
140070;202202;2053;10294;1988;10188;123;822;1732;8788;1855;9610
150010;202202;51026;121326;46231;115259;948;2418;41858;104027;42806;106445
150013;202202;2201;5200;1871;4842;92;210;1593;4270;1685;4480
150020;202202;15245;43976;14059;42436;1268;3196;11698;36390;12966;39586
150030;202202;8974;33312;8120;32304;374;1688;7283;29184;7657;30872
150034;202202;4773;10900;3902;9849;215;488;3329;8559;3544;9047
150040;202202;17744;43420;15571;41055;1301;1572;13665;38301;14966;39873
150050;202202;8019;25308;7343;24442;136;534;6830;22947;6966;23481
150060;202202;24321;63222;19754;56537;2393;7031;13797;40105;16190;47136
150070;202202;9529;28627;8511;27440;173;780;8012;25731;8185;26511
150080;202202;101125;220819;83735;197750;21470;50754;26975;76578;48445;127332
150085;202202;9163;24276;8321;23300;110;382;7841;22101;7951;22483
150090;202202;11789;37616;11108;36408;596;2154;9548;31175;10144;33329
150095;202202;7011;17692;6194;16713;209;432;5648;15425;5857;15857
150100;202202;3070;10261;2713;9679;210;716;2160;7882;2370;8598
150110;202202;4491;17873;4172;17519;126;628;3912;16519;4038;17147
150120;202202;8719;25925;8194;25312;307;635;7420;23439;7727;24074
150125;202202;884;2140;655;1842;96;307;431;1209;527;1516
150130;202202;24722;67460;21317;62406;3658;9403;13846;43379;17504;52782
150140;202202;300609;649864;255999;591725;33308;69984;163256;387642;196564;457626
150145;202202;4636;13868;3886;12709;1074;3266;1901;7063;2975;10329
150150;202202;19314;45252;16795;42175;977;2395;13786;34829;14763;37224
150157;202202;4022;10372;3219;9337;317;897;2301;6926;2618;7823
150160;202202;3844;9628;3583;9262;361;908;2780;7175;3141;8083
150170;202202;28191;83193;25048;78146;3670;10393;16810;55447;20480;65840
150172;202202;5729;14529;4649;13078;284;696;3618;10480;3902;11176
150175;202202;1856;5406;1540;4866;210;702;1011;3203;1221;3905
150178;202202;11752;29309;9613;26890;457;844;8360;24207;8817;25051
150180;202202;26927;82411;24507;79722;1354;3415;21417;72369;22771;75784
150190;202202;7585;22862;7055;22234;180;764;6497;20398;6677;21162
150195;202202;5842;17151;5483;16627;204;692;4957;15031;5161;15723
150200;202202;6396;17870;5829;17245;28;123;5559;16498;5587;16621
150210;202202;30229;95938;28377;93651;1343;4207;24761;83476;26104;87683
150215;202202;9856;26621;8582;24693;1373;3909;5357;15850;6730;19759
150220;202202;14173;37315;12449;34964;950;2550;9245;26261;10195;28811
150230;202202;14359;38138;12759;36012;1222;2777;9216;27267;10438;30044
150240;202202;36894;96363;31120;87101;6484;18773;14504;40018;20988;58791
150250;202202;4631;16622;4321;16279;458;1734;3629;13927;4087;15661
150260;202202;2843;8687;2556;8273;103;360;2137;6964;2240;7324
150270;202202;10051;27111;7208;22128;2004;6443;2213;7143;4217;13586
150275;202202;7589;22366;6924;21472;174;730;6154;18942;6328;19672
150276;202202;2583;6550;2227;6112;281;638;1549;4725;1830;5363
150277;202202;5768;13959;4621;12649;460;1246;3430;9869;3890;11115
150280;202202;7743;28776;7466;28350;333;1362;6659;25528;6992;26890
150285;202202;3600;12013;3158;11328;209;831;2449;8914;2658;9745
150290;202202;12133;30431;11000;29229;478;732;9987;27249;10465;27981
150293;202202;10515;24432;8282;21568;1070;2549;5486;14882;6556;17431
150295;202202;8196;20878;5933;17794;1847;5542;2299;7997;4146;13539
150300;202202;2668;7352;2415;7049;28;104;2259;6613;2287;6717
150304;202202;4819;13267;4036;12079;566;1462;2781;8799;3347;10261
150307;202202;6412;19461;5863;18578;324;1051;4728;15128;5052;16179
150309;202202;7199;19751;5847;17570;740;2175;3801;11768;4541;13943
150310;202202;8054;30148;7610;29627;223;1125;6810;26832;7033;27957
150320;202202;9891;25815;9003;24560;404;1308;7197;19437;7601;20745
150330;202202;14957;45038;13885;43513;1274;3489;10588;34748;11862;38237
150340;202202;2700;7607;2392;7174;249;694;1777;5440;2026;6134
150345;202202;9568;25258;8559;23948;330;1052;7593;21202;7923;22254
150350;202202;9822;23658;8991;22622;541;1118;7757;19761;8298;20879
150360;202202;26338;68730;21073;62251;2313;4871;15593;49081;17906;53952
150370;202202;12459;34842;10182;31801;1132;3020;7499;25083;8631;28103
150375;202202;4079;15832;3715;15337;184;832;3307;13788;3491;14620
150380;202202;12026;28932;9878;26154;149;544;8774;23159;8923;23703
150390;202202;7977;30892;7130;29613;803;3020;5507;23829;6310;26849
150400;202202;7259;24381;6945;23860;156;634;6280;21560;6436;22194
150405;202202;9997;24812;8695;23282;511;1027;7201;19832;7712;20859
150410;202202;2167;6278;1858;5785;192;552;1314;4201;1506;4753
150420;202202;45957;119466;35711;104807;8261;23957;15831;52207;24092;76164
150430;202202;9044;24941;8219;23910;653;1525;6854;20452;7507;21977
150440;202202;6374;18428;5779;17646;684;1806;4327;13759;5011;15565
150442;202202;31677;69232;26495;63114;2231;4879;19981;48002;22212;52881
150445;202202;7442;20749;6559;19481;171;564;5846;17363;6017;17927
150450;202202;5725;22482;5299;21926;356;1776;4630;19108;4986;20884
150460;202202;9441;28733;8634;27733;382;1068;7444;24783;7826;25851
150470;202202;23432;58037;21062;55342;242;898;20103;52586;20345;53484
150475;202202;5847;17040;4977;15726;667;1842;3537;11699;4204;13541
150480;202202;15081;44871;13530;42669;1851;4735;9974;33444;11825;38179
150490;202202;9238;30346;8401;29282;452;1512;7190;25513;7642;27025
150495;202202;5995;18604;5686;18204;133;563;5212;16657;5345;17220
150497;202202;3058;9212;2470;8194;437;1453;1430;5058;1867;6511
150500;202202;3596;8750;3195;8189;219;532;2527;6435;2746;6967
150503;202202;5492;13541;3873;11472;1180;3359;1552;5071;2732;8430
150506;202202;12455;34205;10488;31545;1641;4291;7321;23755;8962;28046
150510;202202;11543;37246;10074;34759;1051;3452;7413;26262;8464;29714
150520;202202;8432;29768;8096;29360;178;1042;7519;27108;7697;28150
150530;202202;13320;43236;11530;40723;983;2900;9013;33063;9996;35963
150540;202202;5626;14028;4849;12904;247;626;4117;10957;4364;11583
150543;202202;7652;19992;6326;18354;401;1147;5063;15283;5464;16430
150548;202202;11049;32989;9912;31418;259;984;8959;28389;9218;29373
150549;202202;2178;5951;1849;5496;61;200;1531;4574;1592;4774
150550;202202;22953;63897;19065;57798;4239;13025;8930;28489;13169;41514
150553;202202;39156;102814;30798;88832;6932;20248;14321;42466;21253;62714
150555;202202;2175;5463;1713;4754;155;325;1138;3372;1293;3697
150560;202202;2098;5828;1873;5419;221;612;1241;3678;1462;4290
150563;202202;2859;8113;2372;7284;413;1328;1391;4348;1804;5676
150565;202202;4847;14826;4325;14030;118;514;3652;11919;3770;12433
150570;202202;7200;20837;6709;20213;309;982;5899;17812;6208;18794
150580;202202;11721;42981;10020;41107;1054;3579;7988;34767;9042;38346
150590;202202;8774;28998;7498;27488;166;946;6904;25240;7070;26186
150600;202202;11020;33273;10219;32312;196;827;9521;30117;9717;30944
150610;202202;3306;8648;2956;8128;101;388;2549;6893;2650;7281
150611;202202;3602;9404;3210;8878;87;309;2870;7882;2957;8191
150613;202202;15594;40533;11982;34698;1940;6062;6657;19003;8597;25065
150616;202202;4095;10861;2998;9005;592;1857;1411;4257;2003;6114
150618;202202;7682;20931;6284;18818;720;2140;4058;12602;4778;14742
150619;202202;7455;19469;6153;17715;324;809;5157;15109;5481;15918
150620;202202;7303;23250;6347;21716;639;2037;4446;15713;5085;17750
150630;202202;7249;17968;6616;17224;167;509;5986;15515;6153;16024
150635;202202;5704;14677;4822;13298;550;1421;3284;9182;3834;10603
150640;202202;2368;6811;2161;6552;36;117;2019;6168;2055;6285
150650;202202;12794;33108;11157;30654;2677;6864;5710;16856;8387;23720
150655;202202;5974;16543;5413;15742;152;527;4784;13864;4936;14391
150658;202202;5004;13740;3783;11724;751;2416;1968;6378;2719;8794
150660;202202;6352;16987;5624;15983;661;1805;3923;11320;4584;13125
150670;202202;10254;21825;8165;19468;544;983;6867;17009;7411;17992
150680;202202;77879;214340;61524;189489;12769;38071;31352;106235;44121;144306
150690;202202;3021;7033;2603;6566;122;246;2277;5875;2399;6121
150700;202202;7092;19517;6356;18594;383;973;5241;15676;5624;16649
150710;202202;4069;12957;3688;12378;244;821;2898;9888;3142;10709
150715;202202;5734;14976;4730;13527;236;633;3935;11336;4171;11969
150720;202202;7966;24640;7389;23838;390;1383;6339;20613;6729;21996
150730;202202;14245;40421;12150;37385;1330;4195;9080;28672;10410;32867
150740;202202;4439;11640;3895;10823;317;720;3001;8582;3318;9302
150745;202202;5730;15333;4671;13840;528;1566;3484;10543;4012;12109
150746;202202;1905;5256;1719;4997;58;182;1463;4247;1521;4429
150747;202202;5554;15788;4938;14892;434;1167;3777;11706;4211;12873
150750;202202;4082;11936;3364;10859;236;820;2560;8550;2796;9370
150760;202202;12694;35588;11505;33991;1524;4039;8359;25593;9883;29632
150770;202202;7518;24389;6993;23812;228;548;6426;22529;6654;23077
150775;202202;1225;3082;956;2738;112;349;669;1923;781;2272
150780;202202;4809;14200;4277;13579;152;411;3888;12645;4040;13056
150790;202202;6646;17262;5676;16226;392;769;4070;13658;4462;14427
150795;202202;16156;46228;14016;43093;2499;7407;9074;28998;11573;36405
150796;202202;4237;9645;3680;9016;151;331;3218;7985;3369;8316
150797;202202;4582;13117;3948;12258;253;575;3275;10463;3528;11038
150800;202202;14418;43010;12915;41097;1176;3603;10225;33335;11401;36938
150803;202202;8430;23684;7814;22814;319;991;6940;20321;7259;21312
150805;202202;3846;11185;3271;10382;253;759;2552;8336;2805;9095
150808;202202;7065;19521;5277;16609;1822;6181;1095;3874;2917;10055
150810;202202;22998;56376;17420;49735;3360;9064;9501;30521;12861;39585
150812;202202;6371;16483;5645;15397;382;1192;4469;11928;4851;13120
150815;202202;10475;29086;8732;27044;696;2111;7222;22864;7918;24975
150820;202202;14477;34572;12511;32203;1541;2717;9532;26401;11073;29118
150830;202202;12972;43655;11981;42468;771;2125;10256;38048;11027;40173
150835;202202;3256;9395;2838;8786;323;1041;2037;6273;2360;7314
150840;202202;8798;23017;7130;20488;1023;3308;4386;12404;5409;15712
160005;202202;1315;3386;1159;3200;53;178;1017;2814;1070;2992
160010;202202;2494;6543;2316;6350;23;112;2244;6098;2267;6210
160015;202202;3690;9086;3324;8658;55;169;3140;8165;3195;8334
160020;202202;2433;7036;2122;6650;200;541;1679;5487;1879;6028
160021;202202;1376;4766;1261;4627;63;285;1006;3779;1069;4064
160023;202202;1452;4780;1300;4533;176;586;889;3272;1065;3858
160025;202202;1988;5729;1869;5598;26;60;1800;5425;1826;5485
160027;202202;10240;26039;9217;24770;528;1496;7897;21220;8425;22716
160030;202202;86396;227670;71322;208147;13161;35419;41991;132927;55152;168346
160040;202202;6356;20231;5782;19520;136;464;5397;18364;5533;18828
160050;202202;5698;15743;4549;14262;1353;3590;2272;8586;3625;12176
160053;202202;4469;12631;4005;12053;238;612;3306;10373;3544;10985
160055;202202;1148;2885;1113;2848;19;46;1056;2706;1075;2752
160060;202202;30004;71613;25091;66121;1657;3905;20408;55892;22065;59797
160070;202202;3146;10851;2775;10305;245;847;2188;8480;2433;9327
160080;202202;3757;10781;3310;10288;44;173;3131;9787;3175;9960
170025;202202;727;1803;517;1470;87;239;263;781;350;1020
170030;202202;1332;3844;1050;3381;188;592;485;1607;673;2199
170035;202202;1635;4049;1215;3402;83;254;793;2169;876;2423
170040;202202;2106;5482;1685;4906;161;479;1075;3233;1236;3712
170070;202202;2079;4623;1480;3883;75;195;909;2474;984;2669
170100;202202;2613;7136;2160;6401;157;486;1460;4358;1617;4844
170105;202202;762;2109;548;1685;132;407;191;563;323;970
170110;202202;1098;3079;857;2670;82;318;519;1540;601;1858
170130;202202;1506;4132;1144;3500;143;496;657;2012;800;2508
170190;202202;1712;4297;1318;3702;249;844;678;1813;927;2657
170200;202202;2293;5188;1535;3992;228;594;698;1813;926;2407
170210;202202;29316;75918;22510;64990;6567;20402;4768;14544;11335;34946
170215;202202;1444;3715;1165;3336;48;173;926;2642;974;2815
170220;202202;6443;18919;5379;17060;1454;4380;2151;7728;3605;12108
170230;202202;1356;3769;1021;3143;293;916;265;859;558;1775
170240;202202;2876;7527;2332;6688;133;482;1743;4869;1876;5351
170255;202202;4209;11616;3084;9702;544;1742;1486;4826;2030;6568
170270;202202;996;2344;687;1905;85;220;389;1073;474;1293
170290;202202;3227;8902;2815;8374;171;452;2265;6900;2436;7352
170300;202202;2303;5711;1887;5113;157;408;1400;3796;1557;4204
170305;202202;732;1926;620;1746;67;184;349;1003;416;1187
170307;202202;1112;3413;923;3071;100;358;582;1918;682;2276
170310;202202;1735;4153;1255;3422;160;481;668;1827;828;2308
170320;202202;1135;2861;861;2423;88;273;544;1554;632;1827
170330;202202;967;2834;874;2699;34;156;745;2239;779;2395
170360;202202;618;1539;450;1279;24;97;318;850;342;947
170370;202202;1428;3553;1041;2929;196;555;463;1288;659;1843
170380;202202;2016;5465;1556;4789;109;356;937;2997;1046;3353
170382;202202;589;1646;487;1479;29;117;369;1087;398;1204
170384;202202;1823;5972;1512;5414;311;1078;812;3007;1123;4085
170386;202202;1084;2841;697;2131;78;273;272;798;350;1071
170388;202202;796;2074;565;1688;72;230;265;771;337;1001
170389;202202;1062;3125;875;2817;67;248;606;1982;673;2230
170390;202202;1958;4189;1488;3638;33;89;1279;3165;1312;3254
170410;202202;669;1737;484;1435;34;124;331;938;365;1062
170460;202202;432;1116;358;1002;34;112;261;719;295;831
170510;202202;1001;2661;729;2207;40;177;474;1335;514;1512
170550;202202;7315;18593;5550;15877;1457;4481;1680;4909;3137;9390
170555;202202;1521;3893;1226;3459;116;268;609;1826;725;2094
170560;202202;1122;2988;865;2631;98;289;540;1723;638;2012
170600;202202;1454;3686;1158;3271;214;559;646;1920;860;2479
170610;202202;1782;4413;1349;3781;104;349;874;2393;978;2742
170625;202202;474;1198;328;931;33;84;140;369;173;453
170650;202202;1435;3953;1180;3562;130;428;759;2285;889;2713
170700;202202;3801;10702;2940;9105;573;1804;1343;4154;1916;5958
170710;202202;1670;4059;1313;3527;164;439;856;2324;1020;2763
170720;202202;1966;4645;1516;3947;196;547;962;2487;1158;3034
170730;202202;1187;3021;897;2576;95;245;544;1591;639;1836
170740;202202;2261;7083;1953;6547;159;641;1446;4794;1605;5435
170755;202202;956;2455;684;2015;120;381;289;827;409;1208
170765;202202;1263;3082;917;2568;180;488;456;1290;636;1778
170770;202202;2032;5482;1649;4912;137;466;1199;3530;1336;3996
170820;202202;4033;11220;3142;9706;581;1806;1559;4991;2140;6797
170825;202202;1113;2463;917;2213;75;176;712;1708;787;1884
170830;202202;1481;3741;1195;3310;235;676;664;1842;899;2518
170900;202202;2992;8885;2537;8242;173;607;2087;6841;2260;7448
170930;202202;4122;10830;3185;9151;717;2158;1087;3140;1804;5298
170950;202202;12391;33081;8862;26932;2504;8149;1316;4439;3820;12588
170980;202202;528;1319;402;1128;46;148;239;641;285;789
171050;202202;1795;5376;1572;5012;72;283;1299;4120;1371;4403
171070;202202;1459;3949;1248;3644;254;657;674;2283;928;2940
171090;202202;1138;2800;898;2455;118;329;528;1453;646;1782
171110;202202;620;1585;433;1266;78;231;198;537;276;768
171150;202202;1175;2764;744;2054;53;170;472;1281;525;1451
171180;202202;850;2205;576;1712;87;239;269;793;356;1032
171190;202202;2145;6610;1864;6138;284;970;1176;3985;1460;4955
171195;202202;885;2658;703;2326;81;333;449;1438;530;1771
171200;202202;667;1799;504;1531;105;365;202;595;307;960
171215;202202;434;1119;350;984;44;139;223;621;267;760
171240;202202;844;2628;670;2326;32;193;466;1561;498;1754
171245;202202;857;2308;670;1943;59;198;434;1200;493;1398
171250;202202;1075;2784;784;2338;131;422;397;1196;528;1618
171270;202202;522;1753;416;1527;82;313;195;754;277;1067
171280;202202;964;2730;781;2422;71;240;505;1597;576;1837
171320;202202;4377;11711;3460;10176;564;1629;1596;4838;2160;6467
171330;202202;3060;8070;2398;6937;514;1523;1144;3356;1658;4879
171360;202202;1608;4307;1279;3843;116;303;878;2835;994;3138
171370;202202;790;1864;615;1626;42;113;454;1208;496;1321
171380;202202;1622;4293;1372;3963;152;376;990;3027;1142;3403
171395;202202;1119;2800;779;2219;63;208;531;1455;594;1663
171420;202202;2175;5895;1646;4932;273;849;824;2441;1097;3290
171430;202202;1171;3248;987;2932;61;199;696;1986;757;2185
171488;202202;2668;7198;2146;6382;336;1011;1269;3827;1605;4838
171500;202202;1026;2505;767;2116;68;191;503;1369;571;1560
171510;202202;906;2746;789;2538;54;222;579;1836;633;2058
171515;202202;538;1294;409;1108;34;113;268;666;302;779
171525;202202;790;2082;592;1753;47;184;390;1104;437;1288
171550;202202;375;1037;294;911;40;157;172;499;212;656
171570;202202;1189;3376;1001;3050;115;363;623;1944;738;2307
171575;202202;1857;4823;1238;3771;126;381;587;1797;713;2178
171610;202202;6354;17056;4806;14512;1041;3415;1272;4225;2313;7640
171620;202202;2953;7663;2512;7050;121;416;2114;5896;2235;6312
171630;202202;1155;2811;899;2474;85;240;647;1829;732;2069
171650;202202;2377;6431;1869;5625;447;1428;615;2023;1062;3451
171660;202202;2545;6147;1804;4971;195;504;1128;3131;1323;3635
171665;202202;1344;3629;1074;3210;189;575;546;1688;735;2263
171670;202202;2079;5313;1569;4491;212;639;800;2291;1012;2930
171700;202202;1291;3467;953;2874;102;326;557;1672;659;1998
171720;202202;865;2114;681;1842;43;129;513;1376;556;1505
171750;202202;1415;3819;968;2988;244;762;169;616;413;1378
171780;202202;1383;3314;1037;2810;82;258;757;2023;839;2281
171790;202202;1532;4698;1247;4127;193;663;652;2170;845;2833
171800;202202;802;2035;619;1778;73;239;365;1017;438;1256
171820;202202;12663;34103;9553;28997;2296;7371;2744;8950;5040;16321
171830;202202;1693;5087;1446;4669;184;626;893;2949;1077;3575
171840;202202;803;2039;622;1769;31;115;391;1088;422;1203
171845;202202;717;1659;560;1435;45;148;394;972;439;1120
171850;202202;1018;3160;865;2835;76;320;622;1987;698;2307
171855;202202;1130;3269;967;2976;73;227;641;1933;714;2160
171865;202202;505;1398;436;1293;58;192;259;747;317;939
171870;202202;888;2323;626;1870;69;207;345;1034;414;1241
171875;202202;1453;3911;1185;3504;37;173;931;2727;968;2900
171880;202202;1418;3872;1233;3635;39;128;989;2955;1028;3083
171884;202202;1007;2767;761;2347;143;470;322;1026;465;1496
171886;202202;1614;4183;1182;3544;302;1005;313;990;615;1995
171888;202202;714;1924;503;1544;27;117;305;904;332;1021
171889;202202;436;1257;318;1049;68;230;119;380;187;610
171890;202202;1299;3567;957;3022;128;406;589;1843;717;2249
171900;202202;598;1937;471;1673;71;230;217;801;288;1031
172000;202202;627;1775;518;1602;71;222;280;852;351;1074
172010;202202;1202;3705;1042;3432;103;372;701;2299;804;2671
172015;202202;407;1323;314;1152;58;205;133;498;191;703
172020;202202;3047;8095;2666;7621;160;496;2029;6001;2189;6497
172025;202202;779;2061;574;1740;43;133;406;1235;449;1368
172030;202202;1370;3910;1122;3492;73;252;837;2596;910;2848
172049;202202;1405;3293;937;2654;134;365;498;1505;632;1870
172065;202202;1601;3831;1274;3416;122;238;981;2844;1103;3082
172080;202202;2559;7189;2094;6404;126;441;1431;4328;1557;4769
172085;202202;511;1331;337;984;59;179;131;349;190;528
172090;202202;4410;10337;3474;9122;134;351;2753;7295;2887;7646
172093;202202;490;1421;354;1191;24;111;213;688;237;799
172097;202202;774;1936;544;1554;80;248;233;653;313;901
172100;202202;54768;129938;40668;108697;6974;20091;17178;46444;24152;66535
172110;202202;1729;5939;1490;5586;100;438;1169;4456;1269;4894
172120;202202;5526;15471;4374;13647;502;1719;2634;8280;3136;9999
172125;202202;443;1142;337;985;30;102;201;553;231;655
172130;202202;680;1609;523;1355;20;84;366;877;386;961
172208;202202;2864;6570;2309;5875;165;370;1781;4579;1946;4949
172210;202202;2880;6941;2234;6143;256;701;1439;4166;1695;4867
210005;202202;20517;56026;15578;48151;3694;11885;7012;22603;10706;34488
210010;202202;2103;6065;1912;5842;53;237;1716;5221;1769;5458
210015;202202;3566;10179;3102;9575;167;541;2594;8056;2761;8597
210020;202202;7771;17795;6639;16485;98;307;6145;15268;6243;15575
210030;202202;4909;15589;4501;14976;464;1470;3576;12182;4040;13652
210040;202202;2241;4740;1971;4421;72;157;1703;3764;1775;3921
210043;202202;6367;17466;5387;16112;371;1162;4320;13081;4691;14243
210047;202202;7099;21005;5800;19315;185;845;5005;16716;5190;17561
210050;202202;2408;7552;1917;6686;184;759;1379;4781;1563;5540
210055;202202;2133;6291;1933;6013;51;186;1703;5341;1754;5527
210060;202202;7947;27851;7096;26372;664;2609;5050;19230;5714;21839
210070;202202;7584;20071;7059;19409;50;192;6676;18318;6726;18510
210080;202202;4643;14702;4392;14434;48;264;4077;13459;4125;13723
210083;202202;6114;16319;5101;15223;130;381;4759;14322;4889;14703
210087;202202;3101;8383;2640;7770;145;466;2143;6318;2288;6784
210090;202202;9693;28974;9049;27897;591;1556;7664;23901;8255;25457
210095;202202;6994;21760;6389;21000;394;1321;5314;18081;5708;19402
210100;202202;7147;21317;6272;19865;562;1826;4628;14805;5190;16631
210110;202202;3062;9276;2813;8973;69;334;2523;8026;2592;8360
210120;202202;26664;66774;22370;61406;1761;3806;16541;47476;18302;51282
210125;202202;4685;12211;4092;11539;531;1176;3130;9274;3661;10450
210130;202202;4541;11317;3734;10330;106;270;3254;9044;3360;9314
210135;202202;1765;4550;1466;4126;49;140;1263;3569;1312;3709
210140;202202;21579;54301;16815;48219;2790;7597;10333;30768;13123;38365
210150;202202;4965;11109;4403;10364;112;322;3871;8943;3983;9265
210160;202202;19430;51242;16523;47688;1422;3828;12467;37250;13889;41078
210170;202202;16739;48583;15536;47080;601;1908;13938;42286;14539;44194
210173;202202;2418;8954;2274;8720;109;581;1973;7525;2082;8106
210177;202202;3605;9608;3120;8993;361;876;2446;7334;2807;8210
210180;202202;1504;3887;1311;3660;22;69;1196;3337;1218;3406
210190;202202;5848;14673;4961;13509;96;368;4298;11593;4394;11961
210193;202202;1444;3973;1267;3701;49;164;960;2817;1009;2981
210197;202202;2218;6601;2032;6356;120;378;1720;5479;1840;5857
210200;202202;8314;25522;7358;24043;427;1665;5963;19425;6390;21090
210203;202202;7664;21567;6475;20014;380;1197;5261;16621;5641;17818
210207;202202;4174;9787;3263;8795;113;289;2749;7482;2862;7771
210210;202202;8192;25561;7443;24522;196;1018;6394;20961;6590;21979
210215;202202;2636;8061;2277;7538;182;850;1736;5670;1918;6520
210220;202202;6859;21941;6465;21376;157;1000;5818;18821;5975;19821
210230;202202;5713;16181;5184;15407;221;626;4600;13761;4821;14387
210232;202202;12422;36453;10201;33132;1539;4839;6731;23188;8270;28027
210235;202202;3565;10519;3152;9926;159;567;2665;8417;2824;8984
210237;202202;3749;10097;3144;9410;33;179;2964;8823;2997;9002
210240;202202;2767;8232;2542;7878;63;268;2097;6374;2160;6642
210250;202202;6206;17851;5621;17115;75;384;5140;15587;5215;15971
210255;202202;2812;8245;2422;7585;283;989;1628;5018;1911;6007
210260;202202;5746;16653;5052;15671;307;1073;4226;13142;4533;14215
210270;202202;5457;14100;4856;13348;82;393;4416;12008;4498;12401
210275;202202;3657;9018;3160;8422;151;415;2598;6951;2749;7366
210280;202202;6219;16486;5038;14761;216;908;3993;11454;4209;12362
210290;202202;8579;20510;7721;19466;151;393;7241;18291;7392;18684
210300;202202;34907;92193;28470;83037;4221;11694;17163;53950;21384;65644
210310;202202;3275;8013;2880;7469;63;180;2606;6744;2669;6924
210312;202202;3048;7070;2730;6731;14;70;2627;6447;2641;6517
210315;202202;3314;8660;2880;8179;100;257;2570;7456;2670;7713
210317;202202;4672;13791;4239;13287;92;454;3888;12112;3980;12566
210320;202202;24027;63493;22236;61211;342;1628;20515;55809;20857;57437
210325;202202;3831;10507;3257;9777;204;518;2746;8525;2950;9043
210330;202202;26765;69857;21589;63470;3608;8856;14037;45316;17645;54172
210340;202202;11510;30538;10309;28994;405;1342;8727;24573;9132;25915
210350;202202;9501;26315;8324;24885;145;535;7514;22486;7659;23021
210355;202202;4375;14153;3869;13364;131;578;3295;11429;3426;12007
210360;202202;14182;42716;12611;40314;628;2811;9630;30095;10258;32906
210370;202202;12260;25549;9444;22595;361;541;8555;21057;8916;21598
210375;202202;3514;9157;2652;7919;784;2426;927;3112;1711;5538
210380;202202;5778;14255;4973;13294;269;691;4226;11347;4495;12038
210390;202202;3091;9402;2866;9045;90;410;2544;7943;2634;8353
210400;202202;4825;13890;4261;13234;148;416;3828;12079;3976;12495
210405;202202;7709;19355;6311;17459;1116;2672;3770;11226;4886;13898
210407;202202;2209;6768;1865;6185;102;385;1469;4865;1571;5250
210408;202202;2844;9945;2641;9679;158;724;2139;7839;2297;8563
210409;202202;4108;13342;3735;12851;154;654;3127;10964;3281;11618
210410;202202;3790;10835;3198;9826;108;446;2602;7874;2710;8320
210420;202202;4085;12522;3644;11749;192;567;3073;10008;3265;10575
210430;202202;2373;6731;2094;6364;116;331;1764;5458;1880;5789
210440;202202;4619;11945;4007;11188;71;273;3681;10196;3752;10469
210450;202202;2450;6974;2106;6480;122;389;1733;5348;1855;5737
210455;202202;4895;12177;3764;10765;902;2561;1997;6000;2899;8561
210460;202202;3917;10916;3314;10134;73;316;2902;8844;2975;9160
210462;202202;1820;5207;1541;4779;58;173;1225;3838;1283;4011
210465;202202;2880;8032;2505;7517;122;514;2067;6066;2189;6580
210467;202202;6560;19204;5720;18137;286;1043;4862;15564;5148;16607
210470;202202;2061;5417;1546;4693;93;260;1203;3750;1296;4010
210480;202202;18100;50535;15082;46893;1590;3635;11141;37843;12731;41478
210490;202202;3746;9065;3003;8071;65;222;2584;6894;2649;7116
210500;202202;6747;24600;6225;23738;376;1790;5238;19847;5614;21637
210510;202202;6179;19586;5402;18764;119;533;4882;17186;5001;17719
210515;202202;4037;11297;3440;10586;187;634;2864;8975;3051;9609
210520;202202;2742;7660;2472;7306;92;333;2104;6177;2196;6510
210530;202202;56498;135606;44099;117787;7644;21887;16076;50532;23720;72419
210535;202202;3833;11541;3485;11045;123;474;3041;9657;3164;10131
210540;202202;16220;44511;13575;40801;1533;4225;9648;30354;11181;34579
210542;202202;7120;16032;5597;14325;494;1042;4462;11885;4956;12927
210545;202202;2412;7129;2243;6867;44;190;1987;6030;2031;6220
210547;202202;3909;13254;3460;12469;223;870;2730;9982;2953;10852
210550;202202;6256;18423;4869;16223;420;1559;3363;11538;3783;13097
210560;202202;4005;11637;3545;10918;102;386;3045;9274;3147;9660
210565;202202;1570;4753;1310;4386;75;344;1033;3456;1108;3800
210570;202202;11402;30001;10138;28464;322;903;9019;25607;9341;26510
210580;202202;3271;8216;2587;7377;177;466;1827;5513;2004;5979
210590;202202;4548;12918;3936;12160;80;402;3541;10889;3621;11291
210592;202202;2798;7897;2573;7549;25;134;2236;6482;2261;6616
210594;202202;2689;7043;2106;6160;121;331;1569;4753;1690;5084
210596;202202;3001;9782;2677;9211;256;910;2055;7236;2311;8146
210598;202202;1986;5422;1830;5202;82;237;1593;4547;1675;4784
210600;202202;3219;8446;2638;7639;233;616;1858;5444;2091;6060
210610;202202;3122;7956;2683;7434;62;270;2358;6494;2420;6764
210620;202202;3182;7557;2631;6892;119;257;2313;6097;2432;6354
210630;202202;3330;10424;2998;9865;134;581;2490;8100;2624;8681
210632;202202;5289;14845;4679;14026;203;854;3965;11699;4168;12553
210635;202202;1823;6235;1719;6048;125;416;1378;4961;1503;5377
210637;202202;2747;8611;2351;8055;182;718;1784;6217;1966;6935
210640;202202;4926;16546;4609;16175;62;320;4296;15115;4358;15435
210650;202202;7605;21075;6876;20157;123;439;6169;18141;6292;18580
210660;202202;8659;24223;7774;22842;257;1074;6650;19110;6907;20184
210663;202202;3124;7958;2844;7639;240;408;2273;6524;2513;6932
210667;202202;2138;6590;1921;6282;49;174;1673;5605;1722;5779
210670;202202;5358;16267;4836;15469;111;503;4312;13720;4423;14223
210675;202202;5571;14165;4797;13214;373;842;3879;11070;4252;11912
210680;202202;5117;11522;4329;10610;126;213;3944;9760;4070;9973
210690;202202;8096;23670;6712;22117;304;1088;5934;19738;6238;20826
210700;202202;2927;7904;2342;7074;169;494;1732;5399;1901;5893
210710;202202;5445;15840;4820;15003;112;527;4320;13324;4432;13851
210720;202202;3301;10072;2897;9586;85;440;2582;8471;2667;8911
210725;202202;1415;4407;1233;4134;58;216;868;3037;926;3253
210730;202202;1441;3304;1231;3023;49;119;1073;2619;1122;2738
210735;202202;5010;13831;4264;12897;203;544;3670;11403;3873;11947
210740;202202;5585;13915;4795;13015;114;337;4135;11208;4249;11545
210745;202202;4728;12323;4347;11852;65;253;3979;10762;4044;11015
210750;202202;25463;64205;22141;60040;2466;6069;15430;43932;17896;50001
210760;202202;6244;15530;5220;14454;92;194;4904;13773;4996;13967
210770;202202;6732;16204;5784;15130;68;264;5447;14169;5515;14433
210780;202202;7987;23868;6957;22184;472;1553;5545;17791;6017;19344
210790;202202;4762;13951;4255;13295;263;525;3530;11519;3793;12044
210800;202202;5106;13315;4368;12342;76;322;3919;10964;3995;11286
210805;202202;4302;14744;4072;14410;165;681;3558;12625;3723;13306
210810;202202;5179;14477;4723;13898;416;993;3815;11652;4231;12645
210820;202202;7545;20672;6304;18728;691;2050;4073;12409;4764;14459
210825;202202;7648;21931;6881;20941;373;1039;5906;18344;6279;19383
210830;202202;8623;22803;7794;21819;472;1084;6685;19215;7157;20299
210840;202202;3418;8623;3098;8216;39;170;2811;7349;2850;7519
210845;202202;6790;17679;5991;16803;46;162;5734;16155;5780;16317
210850;202202;6621;20435;5431;18680;307;1243;4334;15017;4641;16260
210860;202202;22677;54283;18833;49656;1079;2329;15302;42110;16381;44439
210870;202202;7890;19277;6305;17499;140;413;5700;15795;5840;16208
210880;202202;4427;13019;3967;12452;194;741;3188;9998;3382;10739
210890;202202;4402;11797;3997;11345;337;769;3270;9509;3607;10278
210900;202202;5145;14132;4041;12190;1540;4788;854;2989;2394;7777
210905;202202;2296;5644;1947;5210;54;94;1794;4890;1848;4984
210910;202202;7585;22352;6285;20314;684;2293;4337;14137;5021;16430
210920;202202;3365;10484;2931;9917;84;415;2628;8811;2712;9226
210923;202202;1741;4784;1480;4392;94;286;1139;3374;1233;3660
210927;202202;5219;16442;4555;15648;501;1646;3339;11989;3840;13635
210930;202202;2660;8444;2330;7833;119;485;1871;6202;1990;6687
210940;202202;4136;11394;3829;11038;90;432;3520;9966;3610;10398
210945;202202;7713;20329;6902;19385;305;784;5834;16824;6139;17608
210950;202202;5744;15040;4473;13323;516;1222;3183;10105;3699;11327
210955;202202;1654;4864;1417;4491;323;942;798;2691;1121;3633
210960;202202;10005;27967;8682;26023;1801;4971;5191;16691;6992;21662
210970;202202;1599;4361;1317;3897;87;296;1061;3062;1148;3358
210975;202202;1954;5595;1764;5308;158;469;1351;4105;1509;4574
210980;202202;10625;23594;9312;22238;107;245;8801;21087;8908;21332
210990;202202;18342;48258;14198;42987;1205;3191;10493;33286;11698;36477
211000;202202;15711;42955;13025;39658;1012;3047;10151;32041;11163;35088
211003;202202;6167;17133;5147;15923;145;527;4481;14157;4626;14684
211010;202202;6768;22670;6048;21779;107;484;5452;19916;5559;20400
211020;202202;8895;24266;7740;22974;225;815;6688;20419;6913;21234
211023;202202;2188;6733;2029;6528;91;336;1739;5565;1830;5901
211027;202202;3512;10082;3341;9824;180;540;2955;8696;3135;9236
211030;202202;4051;10857;3624;10325;298;725;2821;8297;3119;9022
211040;202202;4939;16816;4552;16167;123;649;4081;14434;4204;15083
211050;202202;9693;23888;8791;22750;146;488;7984;20627;8130;21115
211060;202202;7432;21372;6748;20458;167;706;6016;18130;6183;18836
211065;202202;2525;6395;2122;5899;98;260;1823;5125;1921;5385
211070;202202;8716;25380;7458;23555;351;1264;6284;19868;6635;21132
211080;202202;1394;3699;1126;3285;34;184;912;2536;946;2720
211085;202202;2320;6096;1954;5625;140;268;1623;4906;1763;5174
211090;202202;3356;8956;3028;8587;33;162;2814;7943;2847;8105
211100;202202;7071;17392;6548;16781;38;133;6140;15796;6178;15929
211102;202202;3499;10877;3182;10414;253;926;2598;8497;2851;9423
211105;202202;2522;7561;2115;6854;127;461;1598;5103;1725;5564
211107;202202;5142;15488;4392;14400;188;642;3473;11926;3661;12568
211110;202202;6594;16827;5233;14837;316;877;4074;11550;4390;12427
211120;202202;49105;115372;40578;105480;6390;14963;26272;72154;32662;87117
211125;202202;2151;6247;1815;5739;46;207;1546;4887;1592;5094
211130;202202;193869;446206;167221;412231;24687;53142;99004;262966;123691;316108
211140;202202;5251;14911;4591;14090;217;668;3883;12014;4100;12682
211150;202202;10131;25959;8528;23957;351;977;7223;20410;7574;21387
211153;202202;2670;7418;2140;6782;317;961;1405;4718;1722;5679
211157;202202;1296;3822;1101;3466;80;259;796;2509;876;2768
211160;202202;4959;12617;3965;11247;146;569;3174;8722;3320;9291
211163;202202;1653;5151;1502;4938;49;195;1331;4401;1380;4596
211167;202202;1764;5049;1643;4875;26;91;1532;4533;1558;4624
211170;202202;7133;16416;6622;15837;51;147;6319;15032;6370;15179
211172;202202;2783;7338;2415;6825;95;352;1969;5394;2064;5746
211174;202202;3005;8319;2719;7996;33;171;2572;7523;2605;7694
211176;202202;4548;12283;3573;10877;180;698;2929;8878;3109;9576
211178;202202;5547;11578;4781;10772;23;87;4636;10370;4659;10457
211180;202202;4467;13937;4109;13436;176;704;3456;11257;3632;11961
211190;202202;3388;9285;2878;8553;35;192;2612;7684;2647;7876
211195;202202;1575;4096;1352;3770;76;189;1147;3226;1223;3415
211200;202202;2339;6477;1876;5814;193;634;1339;4138;1532;4772
211210;202202;6447;19235;5791;18354;331;1267;4837;15256;5168;16523
211220;202202;41877;99913;34596;91140;2966;7396;26312;70632;29278;78028
211223;202202;5674;14419;4684;13125;456;1285;3337;9426;3793;10711
211227;202202;1841;5760;1624;5459;83;341;1288;4387;1371;4728
211230;202202;8780;23311;7494;21473;353;802;6280;18300;6633;19102
211240;202202;8199;25145;7698;24513;234;924;7015;22276;7249;23200
211245;202202;7739;19380;6786;18379;106;268;6431;17427;6537;17695
211250;202202;14974;43580;13554;41552;989;3268;10874;33345;11863;36613
211260;202202;8526;26335;7535;25069;202;908;6761;22600;6963;23508
211270;202202;10761;32819;9174;30740;401;1714;7506;25426;7907;27140
211280;202202;14773;36362;13345;34584;614;1416;11797;30910;12411;32326
211285;202202;2083;6290;1870;6015;137;479;1461;4768;1598;5247
211290;202202;7767;22568;7003;21561;278;980;5935;18296;6213;19276
211300;202202;8010;22575;7031;20998;406;1343;5557;16398;5963;17741
211400;202202;12644;33522;10355;30429;1232;3441;7010;21722;8242;25163
220005;202202;2044;4983;1858;4729;30;101;1582;3947;1612;4048
220010;202202;1562;4324;1275;3824;38;132;990;2937;1028;3069
220020;202202;4384;10775;3775;9958;113;378;3233;8403;3346;8781
220025;202202;2424;5201;2089;4719;38;84;1770;3887;1808;3971
220027;202202;1466;3387;1260;3114;28;92;1111;2695;1139;2787
220030;202202;3808;8973;3562;8662;111;292;3126;7519;3237;7811
220040;202202;7976;23061;6956;21187;1357;3803;3935;12522;5292;16325
220045;202202;1736;4741;1452;4296;27;145;1248;3593;1275;3738
220050;202202;5143;13080;4391;12140;63;285;4073;11136;4136;11421
220060;202202;2967;5497;2561;5037;20;50;2448;4769;2468;4819
220070;202202;2592;6295;2189;5732;72;159;1839;4787;1911;4946
220080;202202;812;2212;699;2056;21;84;603;1755;624;1839
220090;202202;1916;4385;1570;3881;93;132;1261;3250;1354;3382
220095;202202;895;1854;848;1807;39;55;761;1648;800;1703
220100;202202;1577;3993;1279;3550;30;116;1065;2850;1095;2966
220105;202202;2261;6509;1990;6042;124;412;1520;4578;1644;4990
220110;202202;3708;9820;3314;9172;38;190;2978;8133;3016;8323
220115;202202;2974;8152;2744;7861;77;228;2507;7173;2584;7401
220117;202202;1530;3471;1209;3039;7;28;1023;2510;1030;2538
220120;202202;14954;36336;13722;34850;73;322;12948;32703;13021;33025
220130;202202;1275;3145;1082;2888;11;53;983;2570;994;2623
220140;202202;2308;4592;1957;4191;58;145;1775;3756;1833;3901
220150;202202;7145;19478;6524;18444;157;597;5579;15474;5736;16071
220155;202202;1297;3517;1051;3079;26;91;763;2177;789;2268
220157;202202;1166;2643;982;2375;38;89;789;1869;827;1958
220160;202202;3071;8080;2633;7310;51;192;2132;5782;2183;5974
220170;202202;1706;4343;1447;3966;22;93;1276;3466;1298;3559
220173;202202;2357;6206;1893;5403;48;196;1500;4180;1548;4376
220177;202202;2285;5933;2178;5813;8;31;2156;5750;2164;5781
220180;202202;1234;2789;1020;2448;5;24;823;1853;828;1877
220190;202202;8217;18542;7042;17001;405;914;5662;13910;6067;14824
220191;202202;1737;4869;1578;4607;97;330;1160;3303;1257;3633
220192;202202;2234;5607;1648;4612;37;125;1328;3637;1365;3762
220194;202202;1917;5088;1694;4752;44;153;1435;3961;1479;4114
220196;202202;2261;5534;2054;5233;26;122;1824;4549;1850;4671
220198;202202;1421;3545;1214;3289;9;24;1122;3057;1131;3081
220200;202202;5512;15398;4818;14504;81;370;4179;12553;4260;12923
220202;202202;2329;6188;1995;5665;36;164;1712;4766;1748;4930
220205;202202;2685;7392;2391;6871;62;247;2032;5739;2094;5986
220207;202202;828;2395;697;2175;61;194;463;1461;524;1655
220208;202202;1891;5471;1569;4901;160;501;1008;3152;1168;3653
220209;202202;1716;4709;1484;4303;28;108;1238;3549;1266;3657
220210;202202;1999;4460;1754;4096;22;83;1550;3512;1572;3595
220211;202202;1915;4236;1761;4037;19;73;1561;3534;1580;3607
220213;202202;1999;4967;1715;4496;23;82;1416;3589;1439;3671
220217;202202;2493;6690;2335;6513;54;108;2166;6149;2220;6257
220220;202202;12279;29245;10420;26539;827;1713;7590;19944;8417;21657
220225;202202;1064;2685;864;2429;4;23;812;2265;816;2288
220230;202202;6233;14758;5356;13558;139;318;4700;11943;4839;12261
220240;202202;3403;9289;2943;8527;88;341;2454;7013;2542;7354
220245;202202;2013;4199;1519;3620;13;50;1391;3318;1404;3368
220250;202202;3288;8567;2890;8075;20;96;2716;7541;2736;7637
220253;202202;1806;4544;1540;4132;33;116;1327;3485;1360;3601
220255;202202;2185;4749;1896;4352;35;133;1668;3695;1703;3828
220260;202202;5199;14320;4512;13098;209;651;3601;10408;3810;11059
220265;202202;1543;4455;1404;4280;58;244;1191;3569;1249;3813
220270;202202;6305;19856;5947;19235;196;1040;5000;15674;5196;16714
220271;202202;1575;3912;1377;3638;22;92;1203;3144;1225;3236
220272;202202;1874;5205;1661;4813;55;196;1261;3515;1316;3711
220273;202202;1397;3732;1183;3356;54;188;904;2536;958;2724
220275;202202;2718;5701;2207;5021;35;64;2000;4514;2035;4578
220277;202202;2504;5732;2136;5233;52;129;1804;4340;1856;4469
220280;202202;1955;4083;1632;3683;28;61;1448;3206;1476;3267
220285;202202;1592;3720;1357;3443;10;42;1274;3201;1284;3243
220290;202202;7527;19604;6025;17557;449;1245;4422;13287;4871;14532
220300;202202;2185;5917;1738;5351;34;180;1450;4406;1484;4586
220310;202202;3365;8549;2654;7725;49;206;2289;6615;2338;6821
220320;202202;3355;9172;2615;7872;80;370;2071;6048;2151;6418
220323;202202;1805;4899;1411;4286;59;232;1174;3484;1233;3716
220325;202202;1339;3844;1139;3491;31;142;933;2806;964;2948
220327;202202;1734;4548;1525;4225;46;184;1268;3407;1314;3591
220330;202202;5315;11483;4575;10621;47;160;4227;9724;4274;9884
220335;202202;1898;5268;1724;5035;49;130;1543;4518;1592;4648
220340;202202;2021;5143;1551;4364;59;186;1038;2837;1097;3023
220342;202202;1270;3539;1145;3358;56;188;919;2667;975;2855
220345;202202;3322;7199;2530;6112;23;68;2268;5443;2291;5511
220350;202202;3654;8818;2937;7775;183;397;2101;5626;2284;6023
220360;202202;1365;3371;1084;2915;25;72;874;2313;899;2385
220370;202202;9384;25637;8551;24372;283;886;7313;20769;7596;21655
220375;202202;1773;4712;1563;4453;2;2;1500;4297;1502;4299
220380;202202;1674;3645;1394;3275;12;33;1247;2903;1259;2936
220385;202202;966;2137;796;1854;7;13;695;1597;702;1610
220390;202202;12036;28821;9518;25158;1918;4843;4465;12500;6383;17343
220400;202202;1658;3750;1279;3183;22;73;994;2373;1016;2446
220410;202202;1279;3375;1054;3004;34;105;876;2472;910;2577
220415;202202;900;2213;752;1968;17;39;610;1574;627;1613
220420;202202;2130;5759;1717;4977;63;219;1305;3707;1368;3926
220430;202202;3002;7054;2726;6681;52;144;2447;5910;2499;6054
220435;202202;2050;4853;1773;4441;33;111;1531;3745;1564;3856
220440;202202;3157;8239;2717;7610;66;318;2422;6527;2488;6845
220450;202202;2827;6900;2325;6283;46;179;2053;5514;2099;5693
220455;202202;1396;4116;1337;4039;13;70;1214;3669;1227;3739
220460;202202;1136;2601;1058;2504;28;72;927;2153;955;2225
220465;202202;2568;7482;2262;7023;149;463;1787;5632;1936;6095
220470;202202;4045;10379;3612;9684;159;381;2880;7642;3039;8023
220480;202202;3041;7422;2475;6548;220;448;1706;4536;1926;4984
220490;202202;2704;6378;2321;5910;29;134;2037;5093;2066;5227
220500;202202;3491;8038;2967;7262;120;237;2287;5536;2407;5773
220510;202202;2896;7457;2343;6501;108;260;1888;5273;1996;5533
220515;202202;1886;4220;1751;4037;43;69;1537;3511;1580;3580
220520;202202;5644;13587;5109;12852;109;293;4321;11028;4430;11321
220525;202202;1588;3642;1348;3351;10;37;1244;3080;1254;3117
220527;202202;1556;3826;1357;3549;29;69;1197;3151;1226;3220
220530;202202;1767;3882;1517;3570;89;172;1303;3154;1392;3326
220535;202202;910;2339;843;2240;40;119;675;1761;715;1880
220540;202202;3449;10480;3208;10022;168;548;2665;8318;2833;8866
220545;202202;1584;4438;1453;4241;54;219;1235;3561;1289;3780
220550;202202;9336;27734;8329;25946;427;1542;6415;19654;6842;21196
220551;202202;1576;4096;1413;3845;26;108;1173;3118;1199;3226
220552;202202;1809;4937;1462;4330;24;130;1191;3404;1215;3534
220553;202202;2141;4777;1812;4359;31;66;1614;3894;1645;3960
220554;202202;1023;2443;784;2076;52;125;566;1473;618;1598
220555;202202;3077;7416;2719;6976;38;142;2365;6117;2403;6259
220556;202202;1352;3677;1183;3370;39;170;909;2487;948;2657
220557;202202;1871;5355;1551;4682;105;364;1117;3275;1222;3639
220558;202202;1556;3840;1238;3400;19;82;1056;2852;1075;2934
220559;202202;1972;4589;1684;4154;48;76;1379;3417;1427;3493
220560;202202;1943;4099;1603;3689;34;73;1469;3376;1503;3449
220570;202202;8290;23019;7575;22033;396;1168;6256;18185;6652;19353
220580;202202;7402;19149;6712;18096;96;288;6056;16254;6152;16542
220585;202202;2244;6652;1856;5972;36;127;1554;5001;1590;5128
220590;202202;1555;3897;1274;3496;92;224;959;2659;1051;2883
220595;202202;2995;7444;2710;7081;33;103;2427;6297;2460;6400
220600;202202;1783;3441;1544;3167;29;52;1411;2872;1440;2924
220605;202202;1671;4701;1439;4297;27;137;1181;3416;1208;3553
220610;202202;2950;8195;2758;7919;21;112;2583;7378;2604;7490
220620;202202;8733;24914;7996;23928;138;706;7357;21774;7495;22480
220630;202202;398;1132;311;981;22;74;209;642;231;716
220635;202202;1983;5562;1770;5134;40;196;1440;4033;1480;4229
220640;202202;2565;6859;2199;6352;73;281;1810;5166;1883;5447
220650;202202;2461;6110;2134;5632;85;204;1690;4505;1775;4709
220660;202202;2772;8297;2347;7602;83;365;1949;6219;2032;6584
220665;202202;1359;3894;1156;3569;32;155;982;2959;1014;3114
220667;202202;1779;5133;1608;4834;65;245;1321;3915;1386;4160
220669;202202;1753;4968;1679;4858;44;177;1513;4293;1557;4470
220670;202202;2445;5851;1959;5181;28;109;1708;4489;1736;4598
220672;202202;3599;8333;2956;7566;78;281;2672;6732;2750;7013
220675;202202;1434;3713;1279;3444;41;94;1035;2795;1076;2889
220680;202202;3164;7650;3006;7452;145;256;2705;6847;2850;7103
220690;202202;1717;4288;1499;3961;92;254;1157;3046;1249;3300
220695;202202;1031;2658;958;2532;20;51;830;2174;850;2225
220700;202202;12213;26677;9987;23777;513;1106;7776;18270;8289;19376
220710;202202;979;2521;735;2095;24;77;560;1547;584;1624
220720;202202;2427;5276;2185;4964;22;71;1953;4352;1975;4423
220730;202202;1404;3748;1205;3440;19;89;1027;2870;1046;2959
220735;202202;1110;2392;864;2029;27;67;709;1626;736;1693
220740;202202;1494;3651;1198;3261;40;106;999;2764;1039;2870
220750;202202;4525;10289;4009;9588;170;368;3604;8608;3774;8976
220755;202202;1608;3542;1355;3179;22;69;1140;2606;1162;2675
220760;202202;3688;8837;3252;8268;59;189;3055;7744;3114;7933
220770;202202;27081;75178;23246;68933;6070;18201;9849;30748;15919;48949
220775;202202;1372;3170;1229;2994;8;31;1190;2871;1198;2902
220777;202202;1732;4195;1350;3616;66;134;1001;2761;1067;2895
220779;202202;1358;3396;1180;3134;26;94;1020;2663;1046;2757
220780;202202;6523;15129;5641;13854;228;658;4610;11100;4838;11758
220785;202202;1645;3408;1457;3175;7;23;1398;3018;1405;3041
220790;202202;11199;29667;10075;28105;217;950;8618;23731;8835;24681
220793;202202;1053;2536;848;2195;12;24;714;1851;726;1875
220795;202202;1513;3687;1342;3465;21;81;1187;3041;1208;3122
220800;202202;22259;44863;19233;40970;1053;1948;15300;32224;16353;34172
220810;202202;3276;8680;2771;7834;56;163;2311;6472;2367;6635
220820;202202;5876;13868;5164;12857;324;634;4138;10362;4462;10996
220830;202202;7918;19687;7059;18492;288;840;5826;15049;6114;15889
220840;202202;13630;38315;11490;34311;2248;6146;6246;19144;8494;25290
220850;202202;3380;9861;3028;9432;67;303;2722;8494;2789;8797
220855;202202;856;1873;755;1747;18;59;685;1561;703;1620
220860;202202;1147;2657;1006;2449;19;71;932;2236;951;2307
220865;202202;2551;6524;1976;5530;58;245;1501;4059;1559;4304
220870;202202;3507;8666;2929;7931;31;136;2706;7286;2737;7422
220880;202202;6214;13327;5414;12345;58;226;5076;11417;5134;11643
220885;202202;1547;4259;1281;3847;70;215;997;3026;1067;3241
220887;202202;1728;3507;1447;3147;24;39;1339;2908;1363;2947
220890;202202;1510;4342;1320;4080;57;187;1092;3399;1149;3586
220900;202202;2298;4978;1943;4526;37;88;1728;3979;1765;4067
220910;202202;1845;4445;1589;4075;148;255;1241;3332;1389;3587
220915;202202;1040;2656;844;2319;14;55;628;1649;642;1704
220920;202202;1617;4683;1400;4406;73;276;1173;3705;1246;3981
220930;202202;2054;4974;1731;4542;15;60;1627;4235;1642;4295
220935;202202;1181;3266;964;2810;20;84;634;1750;654;1834
220937;202202;1647;4082;1408;3703;39;123;1129;2925;1168;3048
220940;202202;1851;4553;1516;3993;29;128;1238;3150;1267;3278
220945;202202;545;1708;434;1512;21;118;306;1038;327;1156
220950;202202;1529;3376;1032;2639;21;59;822;2013;843;2072
220955;202202;1742;4225;1454;3742;20;70;1258;3197;1278;3267
220960;202202;839;2074;623;1713;40;120;422;1103;462;1223
220965;202202;1963;4988;1716;4640;28;132;1482;3928;1510;4060
220970;202202;2284;4920;1717;4105;21;56;1499;3508;1520;3564
220975;202202;786;1993;675;1862;14;76;601;1605;615;1681
220980;202202;1298;3391;1157;3206;27;95;991;2716;1018;2811
220985;202202;1510;3520;1317;3235;63;148;1076;2604;1139;2752
220987;202202;1619;4488;1432;4170;58;216;1183;3393;1241;3609
220990;202202;1813;4819;1587;4485;21;113;1346;3744;1367;3857
220995;202202;1363;3575;1128;3164;24;81;899;2482;923;2563
220997;202202;2562;7354;2355;7029;58;227;2096;6180;2154;6407
221000;202202;4928;12644;4320;11792;109;428;3723;10048;3832;10476
221005;202202;1619;3994;1463;3732;21;100;1258;3109;1279;3209
221010;202202;1409;2896;1109;2527;26;47;969;2179;995;2226
221020;202202;1697;4906;1536;4633;25;101;1213;3631;1238;3732
221030;202202;1781;4087;1525;3780;28;84;1332;3353;1360;3437
221035;202202;1725;4116;1493;3798;22;26;1341;3462;1363;3488
221037;202202;790;1999;666;1792;12;44;499;1269;511;1313
221038;202202;561;1497;431;1275;22;70;299;877;321;947
221039;202202;931;2447;776;2191;29;129;623;1705;652;1834
221040;202202;4745;12944;4140;11925;192;566;3374;9702;3566;10268
221050;202202;4425;10537;3939;9929;75;241;3588;9013;3663;9254
221060;202202;9845;25958;8163;23228;398;984;6489;18628;6887;19612
221062;202202;1241;3751;1069;3484;41;186;866;2770;907;2956
221063;202202;1240;3162;1076;2933;57;190;872;2316;929;2506
221065;202202;2918;7032;2553;6435;19;63;2260;5618;2279;5681
221070;202202;3669;10737;2987;9344;367;1082;1856;5933;2223;7015
221080;202202;3844;8918;3177;7936;58;203;2664;6505;2722;6708
221090;202202;1551;3674;1284;3271;15;55;1108;2763;1123;2818
221093;202202;1688;4246;1556;4008;159;335;1109;2856;1268;3191
221095;202202;969;2403;822;2190;18;61;690;1805;708;1866
221097;202202;913;2248;696;1883;19;61;525;1348;544;1409
221100;202202;134395;336779;113243;302914;8840;26905;79529;205122;88369;232027
221110;202202;10649;30023;9754;28869;147;725;8868;26016;9015;26741
221120;202202;5192;13991;4633;13159;129;416;4079;11586;4208;12002
221130;202202;6243;14782;4865;12318;699;1710;2947;7259;3646;8969
221135;202202;2147;4840;1908;4544;57;117;1650;4021;1707;4138
221140;202202;1534;3292;1297;3001;18;57;1184;2684;1202;2741
221150;202202;1200;2847;949;2424;27;129;744;1778;771;1907
221160;202202;801;1900;710;1788;41;62;557;1431;598;1493
221170;202202;1101;2931;1012;2777;8;33;897;2406;905;2439
230010;202202;3330;8267;2756;7306;39;140;2289;5896;2328;6036
230015;202202;3497;10503;3098;9718;173;624;2212;6911;2385;7535
230020;202202;14410;42800;13524;41516;458;1820;11764;35858;12222;37678
230030;202202;13764;32962;11571;30138;278;794;10007;26020;10285;26814
230040;202202;4881;11885;4058;10575;56;242;3452;8839;3508;9081
230050;202202;2863;8566;2223;7152;283;930;1080;3305;1363;4235
230060;202202;2649;6810;2114;5888;38;157;1696;4602;1734;4759
230070;202202;4754;11417;3819;9799;394;919;2559;6611;2953;7530
230075;202202;9964;29803;9099;28349;529;1965;7282;22394;7811;24359
230080;202202;3390;6703;2606;5761;7;18;2417;5334;2424;5352
230090;202202;4898;11281;4141;10119;169;441;3424;8240;3593;8681
230100;202202;21537;50902;18882;47495;1355;3495;14041;35168;15396;38663
230110;202202;13787;39126;11586;34963;1623;5021;6499;19532;8122;24553
230120;202202;8701;21684;7619;20027;429;1162;5922;15433;6351;16595
230125;202202;3470;8669;2821;7683;90;326;2241;5928;2331;6254
230130;202202;6294;18073;5160;15711;418;1251;3492;10540;3910;11791
230140;202202;3756;10694;3194;9591;98;454;2489;7224;2587;7678
230150;202202;1779;5007;1486;4409;175;490;930;2776;1105;3266
230160;202202;7335;17239;6342;15807;128;415;5489;13398;5617;13813
230170;202202;6980;18789;5722;16310;420;1142;4035;11365;4455;12507
230180;202202;1809;4720;1529;4203;19;84;1254;3323;1273;3407
230185;202202;4873;12921;4146;11745;302;911;3094;8814;3396;9725
230190;202202;15500;43323;13055;38899;1288;4086;8165;23926;9453;28012
230195;202202;6037;16561;5500;15635;350;992;4256;12049;4606;13041
230200;202202;5267;14026;4419;12506;183;589;3403;9432;3586;10021
230205;202202;4791;12691;4197;11863;225;731;3345;9268;3570;9999
230210;202202;11781;25755;10027;23490;446;1125;8088;18527;8534;19652
230220;202202;16017;37642;14110;34994;709;1805;11692;28637;12401;30442
230230;202202;7811;21179;7030;19684;449;1232;5423;15033;5872;16265
230240;202202;14351;36031;12348;32697;305;1272;10231;26279;10536;27551
230250;202202;9651;25538;8938;24479;239;832;7322;19442;7561;20274
230260;202202;16456;45022;14275;41364;2209;6174;8285;24450;10494;30624
230270;202202;8342;20969;6462;17622;714;1749;4026;11318;4740;13067
230280;202202;21605;54834;17831;48737;445;1918;14250;37325;14695;39243
230290;202202;5370;14026;4466;12393;187;535;3531;9639;3718;10174
230300;202202;5299;13318;4796;12644;95;283;4264;11210;4359;11493
230310;202202;5125;13928;4335;12544;173;614;3122;8835;3295;9449
230320;202202;8499;23423;7117;21003;249;1035;5548;15967;5797;17002
230330;202202;5224;13430;4134;11423;137;492;3165;8481;3302;8973
230340;202202;4149;12177;3583;11073;201;723;2617;7883;2818;8606
230350;202202;20079;51181;17601;47706;856;2791;12747;34114;13603;36905
230360;202202;3259;8131;2582;6990;140;399;1870;4978;2010;5377
230365;202202;3384;7793;2793;6949;70;263;2404;5899;2474;6162
230370;202202;69577;176492;60030;163182;5345;15781;42731;114152;48076;129933
230380;202202;6891;18099;5494;15602;139;555;4129;11345;4268;11900
230390;202202;3690;10245;3178;9441;95;403;2504;7310;2599;7713
230393;202202;3714;10149;2954;8655;97;517;2320;6486;2417;7003
230395;202202;6174;16266;5338;14896;441;1215;3693;10319;4134;11534
230400;202202;6071;15593;5332;14448;96;475;4310;11243;4406;11718
230410;202202;14299;40875;11822;36498;889;3013;8254;25520;9143;28533
230420;202202;32246;83466;26652;74277;2709;7930;16376;44797;19085;52727
230423;202202;5130;14463;4500;13278;278;894;3368;9788;3646;10682
230425;202202;6314;18301;5813;17348;505;1554;4206;12459;4711;14013
230426;202202;3031;7547;2233;6077;44;172;1698;4497;1742;4669
230427;202202;2029;5407;1495;4360;117;377;896;2468;1013;2845
230428;202202;10867;27574;9377;25451;1405;3759;5568;14950;6973;18709
230430;202202;5339;14293;4246;12429;157;588;3217;9199;3374;9787
230435;202202;6919;16625;5776;14700;711;1685;3586;9149;4297;10834
230440;202202;484394;1116425;410910;1014150;28781;78768;296353;712293;325134;791061
230445;202202;4543;11721;3701;10298;210;601;2540;6876;2750;7477
230450;202202;3979;10739;3483;10044;206;830;2635;7337;2841;8167
230460;202202;2282;6032;1978;5559;58;234;1670;4618;1728;4852
230465;202202;4608;12079;3898;10752;137;484;2994;7930;3131;8414
230470;202202;12135;37986;10937;35874;810;3256;7933;25486;8743;28742
230480;202202;1631;4431;1367;3967;73;304;1034;2853;1107;3157
230490;202202;2981;7799;2535;6986;196;626;1690;4358;1886;4984
230495;202202;6438;17470;5672;16176;688;1939;3558;10233;4246;12172
230500;202202;9906;30402;8757;28359;316;1307;7112;22980;7428;24287
230510;202202;1855;4968;1487;4241;157;468;880;2425;1037;2893
230520;202202;5195;13440;4499;12287;415;985;3185;8700;3600;9685
230523;202202;17041;48102;13744;41464;3002;8919;4125;12867;7127;21786
230526;202202;4219;11039;3601;10045;230;616;2638;7474;2868;8090
230530;202202;6040;17969;5100;16236;752;2391;3289;10532;4041;12923
230533;202202;5184;11078;4224;9654;71;195;3639;8108;3710;8303
230535;202202;5576;15033;4724;13632;347;1098;3186;9197;3533;10295
230540;202202;16842;44398;14439;40872;337;1226;11954;33563;12291;34789
230550;202202;23860;58808;19422;51645;1418;4003;13457;34916;14875;38919
230560;202202;8515;19946;6921;17526;105;313;5938;14977;6043;15290
230565;202202;3327;8791;2780;7807;114;422;2179;5992;2293;6414
230570;202202;3649;8979;3104;8237;86;273;2564;6743;2650;7016
230580;202202;12682;30173;10933;27747;520;1135;8988;22898;9508;24033
230590;202202;10078;27053;8398;24131;518;1625;6234;17510;6752;19135
230600;202202;4148;9877;3271;8404;144;337;2238;5804;2382;6141
230610;202202;7388;19065;6571;17722;411;1158;5303;14204;5714;15362
230620;202202;2277;5845;1802;4975;102;328;1165;3080;1267;3408
230625;202202;9686;25212;8301;22824;1925;5414;3594;9838;5519;15252
230630;202202;12700;33703;11186;30977;1154;2959;7620;21222;8774;24181
230640;202202;29763;85767;26949;81334;1165;4782;22046;65183;23211;69965
230650;202202;5783;14686;4899;13226;118;518;4073;10620;4191;11138
230655;202202;10057;32017;9458;31049;592;2115;7856;25817;8448;27932
230660;202202;6430;18419;5215;16299;180;900;4208;12879;4388;13779
230670;202202;6727;15104;4921;12333;158;434;3915;9550;4073;9984
230680;202202;3017;7697;2537;6884;153;349;1828;4981;1981;5330
230690;202202;7674;21646;6575;19595;404;1396;4351;12724;4755;14120
230700;202202;11458;27296;9259;23405;470;1181;6962;17216;7432;18397
230710;202202;7395;22321;6499;20491;571;1821;4527;14168;5098;15989
230720;202202;2094;5869;1733;5214;106;337;1226;3619;1332;3956
230725;202202;4820;13195;4345;12412;378;1210;2947;8223;3325;9433
230730;202202;64660;162853;51285;143588;11417;31830;19218;57672;30635;89502
230740;202202;6628;17622;5602;16005;175;572;4503;12828;4678;13400
230750;202202;9151;23300;7606;20799;172;649;6127;16284;6299;16933
230760;202202;12481;30874;10869;28508;445;1487;8378;21309;8823;22796
230763;202202;5401;13870;4482;12308;114;518;3641;9654;3755;10172
230765;202202;45110;115686;37888;104658;4565;13477;22438;60392;27003;73869
230770;202202;30248;66542;25711;60811;1929;4605;19312;45016;21241;49621
230780;202202;7037;23325;6400;21872;803;2744;3927;13680;4730;16424
230790;202202;3312;8933;2979;8427;111;468;2335;6347;2446;6815
230800;202202;9288;27362;8174;25229;1036;3269;4921;14948;5957;18217
230810;202202;11816;34227;10594;32309;449;1681;8397;25166;8846;26847
230820;202202;3879;11801;3235;10481;267;1072;2091;6428;2358;7500
230830;202202;8307;21380;7078;19422;140;572;5905;15722;6045;16294
230835;202202;4536;10323;3549;8841;117;317;2862;7016;2979;7333
230837;202202;3607;9879;3232;9266;106;402;2672;7481;2778;7883
230840;202202;10471;28729;9053;26371;749;2161;6758;19580;7507;21741
230850;202202;10836;29014;9145;25908;425;1370;6911;19191;7336;20561
230860;202202;6335;14260;5302;12832;73;202;4715;11253;4788;11455
230870;202202;18333;41497;15842;37513;584;1432;13004;30261;13588;31693
230880;202202;2253;6485;2066;6195;56;268;1650;4814;1706;5082
230890;202202;4837;14677;4409;13906;282;987;3324;10329;3606;11316
230900;202202;3450;9266;2987;8431;156;549;2147;5810;2303;6359
230910;202202;3552;8860;2834;7792;70;272;2298;6298;2368;6570
230920;202202;5323;13844;4430;12455;114;446;3506;9601;3620;10047
230930;202202;7529;19813;6239;17584;301;878;4386;12182;4687;13060
230940;202202;9022;21348;7873;19671;163;420;6771;16762;6934;17182
230945;202202;7078;19240;6056;17411;294;1023;4402;12299;4696;13322
230950;202202;6785;16131;6011;15104;134;335;5202;13091;5336;13426
230960;202202;14723;39951;12944;36792;1992;5701;6870;19265;8862;24966
230970;202202;16353;40554;13977;37041;1278;3543;9485;24643;10763;28186
230980;202202;3273;8360;2878;7710;318;763;1984;5474;2302;6237
230990;202202;1797;4827;1485;4229;74;282;1070;2909;1144;3191
231000;202202;2782;7105;2241;6083;70;223;1691;4414;1761;4637
231010;202202;4229;8828;3378;7476;20;101;3033;6498;3053;6599
231020;202202;9277;26356;8279;24571;1074;2968;5383;16293;6457;19261
231025;202202;8542;21485;7506;19859;556;1411;5774;15213;6330;16624
231030;202202;8013;22673;6332;19307;843;2528;3606;10952;4449;13480
231040;202202;3284;8625;2847;7864;84;294;2331;6235;2415;6529
231050;202202;13136;31239;10868;27454;479;1312;8482;20774;8961;22086
231060;202202;3192;8417;2838;7876;77;280;2325;6443;2402;6723
231070;202202;8813;23986;7615;21945;591;1876;5345;15125;5936;17001
231080;202202;4253;11452;3588;10389;168;670;2718;7719;2886;8389
231085;202202;7544;17210;6045;15491;223;550;4881;12519;5104;13069
231090;202202;4863;12127;3641;9852;129;492;2541;6589;2670;7081
231095;202202;2419;6896;1935;5912;184;562;1300;3960;1484;4522
231100;202202;3393;9392;2801;8316;115;442;2129;6221;2244;6663
231110;202202;4078;11250;3761;10691;199;615;2838;7913;3037;8528
231120;202202;2598;7052;2181;6355;105;337;1619;4673;1724;5010
231123;202202;2073;5170;1718;4574;95;263;1231;3237;1326;3500
231126;202202;6044;15691;4990;13765;286;735;3640;9959;3926;10694
231130;202202;24608;57558;20533;52571;1152;3603;15898;39742;17050;43345
231135;202202;4517;12135;3748;10703;189;623;2681;7556;2870;8179
231140;202202;18149;48674;14767;43114;699;2731;10864;30793;11563;33524
231150;202202;6552;16837;4813;13549;691;1988;2098;6008;2789;7996
231160;202202;7123;20457;6363;19086;721;1966;3945;12119;4666;14085
231170;202202;5058;13621;4230;12114;253;818;3045;8386;3298;9204
231180;202202;16284;43404;13375;37672;2364;6676;6578;18329;8942;25005
231190;202202;4397;11692;3565;10237;98;377;2746;7723;2844;8100
231195;202202;5543;15637;4607;13803;294;985;3400;10073;3694;11058
231200;202202;8729;24637;7633;22576;194;951;6244;17794;6438;18745
231210;202202;5352;14675;4553;13362;165;660;3580;10217;3745;10877
231220;202202;14296;33698;11373;28527;474;1269;8603;20743;9077;22012
231230;202202;10014;30481;8859;28411;666;2357;6572;21027;7238;23384
231240;202202;12896;35670;11441;33091;1498;4305;7386;21328;8884;25633
231250;202202;2281;5513;1535;3964;95;237;945;2364;1040;2601
231260;202202;3536;9304;3086;8614;291;718;2176;6203;2467;6921
231270;202202;6977;17269;5680;15192;164;616;4346;11243;4510;11859
231280;202202;1902;5572;1712;5244;117;319;1261;3874;1378;4193
231290;202202;40821;115939;34451;104059;4769;14816;18269;53903;23038;68719
231300;202202;4519;11812;3564;9978;122;415;2508;6784;2630;7199
231310;202202;8367;20163;6743;17295;505;1347;4781;11936;5286;13283
231320;202202;8015;21364;6286;18357;116;474;4960;14357;5076;14831
231325;202202;2750;6663;2279;5991;175;373;1660;4411;1835;4784
231330;202202;11046;30496;9326;27271;1475;3889;5583;16845;7058;20734
231335;202202;5982;15294;5053;13849;86;380;4417;11973;4503;12353
231340;202202;20336;58227;18382;54949;1229;3788;14130;42480;15359;46268
231350;202202;17267;44826;15806;42764;280;1054;14333;38396;14613;39450
231355;202202;4873;13468;4397;12616;202;680;3551;9996;3753;10676
231360;202202;8695;24444;7569;22587;334;1119;6059;17869;6393;18988
231370;202202;2333;6171;1882;5383;47;152;1444;4094;1491;4246
231375;202202;4484;13413;4106;12810;107;476;3499;10801;3606;11277
231380;202202;6400;16533;5758;15668;177;526;4806;13116;4983;13642
231390;202202;3742;10263;3348;9613;122;510;2550;7074;2672;7584
231395;202202;4582;12530;3849;11412;285;861;2663;7796;2948;8657
231400;202202;10523;28945;8822;25872;321;1359;6776;19347;7097;20706
231410;202202;16409;47182;14997;44991;731;2365;12245;36689;12976;39054
240010;202202;2839;7043;2244;6019;297;768;1216;3237;1513;4005
240020;202202;14355;37354;12057;33408;774;2464;8226;22292;9000;24756
240030;202202;3715;7846;3353;7328;110;292;2987;6389;3097;6681
240040;202202;889;2452;751;2203;25;104;513;1431;538;1535
240050;202202;3679;9416;2942;8107;59;199;2268;6101;2327;6300
240060;202202;1562;3928;1273;3408;26;101;1031;2683;1057;2784
240070;202202;2713;7177;2415;6576;174;505;1775;4667;1949;5172
240080;202202;3185;8181;2543;7074;90;321;1892;5179;1982;5500
240090;202202;2426;5735;1985;5015;21;57;1680;4163;1701;4220
240100;202202;11872;26796;9599;22983;210;691;7790;17856;8000;18547
240110;202202;4979;13442;4195;12043;171;652;3153;8782;3324;9434
240120;202202;3752;9939;3136;9175;220;697;2312;6760;2532;7457
240130;202202;4267;8106;3497;7128;35;85;3172;6379;3207;6464
240140;202202;1964;5672;1679;5158;187;646;1110;3352;1297;3998
240145;202202;7374;19435;6047;17235;757;2264;3820;10793;4577;13057
240150;202202;1102;2942;964;2673;54;182;756;2034;810;2216
240160;202202;1595;4502;1334;4027;34;143;1024;3071;1058;3214
240165;202202;1061;2737;893;2429;26;102;748;1979;774;2081
240170;202202;3018;7489;2553;6702;288;748;1682;4381;1970;5129
240180;202202;3324;9403;2702;8180;603;1758;1239;3922;1842;5680
240185;202202;1407;4116;1296;3934;51;202;1065;3153;1116;3355
240190;202202;1203;3198;1024;2925;19;84;856;2445;875;2529
240200;202202;12823;30132;10414;26194;1126;2866;6300;15442;7426;18308
240210;202202;3668;8372;3003;7327;41;185;2587;6070;2628;6255
240220;202202;7959;23047;7151;21808;427;1637;5691;17187;6118;18824
240230;202202;6361;15317;5076;13241;222;570;3952;10351;4174;10921
240240;202202;1931;5350;1307;3984;141;456;465;1278;606;1734
240250;202202;3340;8138;2902;7525;56;203;2543;6482;2599;6685
240260;202202;14985;42458;12979;39198;3302;9448;6600;21322;9902;30770
240270;202202;2587;7239;2243;6672;113;362;1681;5085;1794;5447
240280;202202;1851;4490;1541;3991;68;186;1224;3129;1292;3315
240290;202202;1277;3559;1050;3099;35;156;759;2112;794;2268
240300;202202;2504;6114;1838;4940;106;295;1145;3012;1251;3307
240310;202202;9144;23376;7284;20152;890;2493;3909;10676;4799;13169
240320;202202;2176;5689;1597;4592;77;269;1138;3134;1215;3403
240325;202202;36240;90870;29599;79986;4092;11842;16128;42374;20220;54216
240330;202202;1960;5077;1516;4270;59;209;1071;2896;1130;3105
240340;202202;2267;4745;1848;4144;37;95;1569;3405;1606;3500
240350;202202;2636;6004;2357;5691;33;118;2198;5264;2231;5382
240360;202202;11543;29544;10318;27717;1354;3325;6916;18953;8270;22278
240370;202202;2345;5478;1817;4518;97;255;1312;3113;1409;3368
240375;202202;1015;2440;846;2158;29;101;679;1663;708;1764
240380;202202;2478;6586;1916;5414;185;494;1084;3022;1269;3516
240390;202202;1116;2580;812;2031;31;73;529;1225;560;1298
240400;202202;1638;3791;1254;3159;42;144;896;2112;938;2256
240410;202202;627;1772;515;1561;43;151;330;961;373;1112
240420;202202;5156;16674;4591;15565;428;1818;3028;9916;3456;11734
240430;202202;3871;9310;3226;8228;124;438;2535;6209;2659;6647
240440;202202;2929;6190;2526;5636;162;324;2030;4520;2192;4844
240450;202202;4850;12660;3861;10898;347;1121;2334;6298;2681;7419
240460;202202;3631;9141;3259;8563;237;630;2678;7045;2915;7675
240470;202202;3825;11147;2916;9284;499;1508;1493;4932;1992;6440
240480;202202;636;1646;425;1198;24;69;216;574;240;643
240485;202202;2397;6345;1933;5537;139;406;1319;3786;1458;4192
240490;202202;1767;4237;1386;3575;83;187;1004;2598;1087;2785
240500;202202;2260;5959;1956;5447;103;290;1562;4344;1665;4634
240510;202202;1806;4654;1554;4275;74;240;1253;3397;1327;3637
240520;202202;1744;3818;1333;3274;88;183;1017;2552;1105;2735
240530;202202;2610;6565;2347;6154;77;228;2005;5140;2082;5368
240540;202202;2553;5943;2266;5516;52;146;2006;4853;2058;4999
240550;202202;843;2111;753;1952;15;60;659;1669;674;1729
240560;202202;3677;8705;3140;8009;188;466;2499;6366;2687;6832
240570;202202;3000;7587;2057;5610;303;822;759;1962;1062;2784
240580;202202;9075;25047;8027;23217;581;1696;6453;18696;7034;20392
240590;202202;905;2037;789;1860;8;22;647;1487;655;1509
240600;202202;1980;5072;1479;4094;55;171;1015;2678;1070;2849
240610;202202;4871;12010;4199;10858;174;506;3254;8173;3428;8679
240615;202202;1379;3390;1112;2947;100;258;802;2068;902;2326
240620;202202;1992;5286;1712;4823;82;272;1404;3928;1486;4200
240630;202202;2362;5984;2122;5602;259;472;1487;4148;1746;4620
240640;202202;1025;2593;811;2243;25;94;609;1636;634;1730
240650;202202;4476;12062;3807;10750;267;756;2759;7728;3026;8484
240660;202202;3551;8216;3188;7753;52;163;2956;7120;3008;7283
240670;202202;2760;7173;2213;6119;152;475;1513;4039;1665;4514
240680;202202;1738;4306;1406;3752;50;164;1093;2805;1143;2969
240690;202202;1238;2827;973;2391;26;101;797;1863;823;1964
240700;202202;2657;7374;2159;6484;99;335;1634;4861;1733;5196
240710;202202;18833;44913;16072;40476;1484;3810;11347;27977;12831;31787
240720;202202;5725;13517;4925;12405;506;1241;3486;8796;3992;10037
240725;202202;1239;3356;951;2826;44;138;648;1863;692;2001
240730;202202;2505;6540;2008;5618;66;213;1541;4236;1607;4449
240740;202202;2069;5366;1668;4574;65;228;1188;3076;1253;3304
240750;202202;2445;7577;2076;6795;257;919;1209;3972;1466;4891
240760;202202;1857;3967;1352;3227;89;130;1061;2572;1150;2702
240770;202202;3554;9267;2986;8486;122;438;2482;6958;2604;7396
240780;202202;5338;14083;4471;12683;598;1661;2885;8276;3483;9937
240790;202202;980;2592;805;2293;22;96;621;1700;643;1796
240800;202202;57391;128133;45759;111261;5186;12685;27610;65251;32796;77936
240810;202202;103187;249990;88860;227722;7868;21677;62923;157191;70791;178868
240820;202202;6484;18281;5666;16851;678;2048;3684;11071;4362;13119
240830;202202;9445;25795;8327;24135;337;1249;6788;19460;7125;20709
240840;202202;1181;2818;959;2485;35;92;682;1713;717;1805
240850;202202;1568;4054;1117;3132;96;276;637;1703;733;1979
240860;202202;1515;3755;1150;3133;30;106;896;2354;926;2460
240870;202202;1175;2831;893;2368;128;331;510;1382;638;1713
240880;202202;1394;4229;1216;3886;99;395;903;2828;1002;3223
240890;202202;5114;13049;4015;11073;446;1360;2315;6020;2761;7380
240895;202202;3143;9086;2870;8653;257;729;2256;6976;2513;7705
240910;202202;3840;9773;3258;8779;65;236;2677;7025;2742;7261
240920;202202;1104;2655;892;2339;78;155;568;1523;646;1678
240930;202202;3981;8604;3289;7755;224;354;2401;6047;2625;6401
240933;202202;1772;4185;1494;3797;41;164;1308;3249;1349;3413
240940;202202;7227;16504;5739;14094;672;1597;3553;8442;4225;10039
240950;202202;1199;3370;1043;3086;44;180;847;2421;891;2601
240960;202202;728;2118;655;1976;15;57;525;1542;540;1599
240970;202202;2081;5026;1684;4385;64;237;1393;3514;1457;3751
240980;202202;3841;10304;3441;9640;83;364;2919;7965;3002;8329
240990;202202;2939;7576;2605;6981;208;658;1954;5012;2162;5670
241000;202202;1047;2569;815;2162;15;49;624;1584;639;1633
241010;202202;3178;9359;2878;8759;159;592;2236;6658;2395;7250
241020;202202;2339;5904;1792;4861;89;281;1276;3298;1365;3579
241025;202202;1890;5179;1533;4569;51;214;1129;3278;1180;3492
241030;202202;2653;8048;2152;7027;225;692;1400;4596;1625;5288
241040;202202;2350;7100;2058;6606;78;372;1588;5083;1666;5455
241050;202202;1520;4053;1225;3525;36;124;895;2511;931;2635
241060;202202;877;2296;763;2069;37;106;536;1408;573;1514
241070;202202;765;1931;635;1726;15;44;499;1316;514;1360
241080;202202;1232;3349;956;2790;31;103;676;1954;707;2057
241090;202202;2238;6052;1807;5315;81;347;1381;3944;1462;4291
241100;202202;1314;3432;1000;2817;43;114;682;1862;725;1976
241105;202202;1048;3023;853;2672;190;654;374;1167;564;1821
241110;202202;1058;2818;795;2269;55;160;510;1387;565;1547
241120;202202;8106;22106;6836;19966;833;2383;4278;12816;5111;15199
241140;202202;3657;9253;2832;7647;124;385;2097;5490;2221;5875
241142;202202;850;2208;639;1833;28;90;398;1088;426;1178
241150;202202;6426;15737;5681;14602;212;529;4553;11613;4765;12142
241160;202202;1347;3487;1054;2968;164;506;607;1625;771;2131
241170;202202;1477;3609;1245;3216;35;112;1025;2548;1060;2660
241180;202202;1150;2785;852;2245;86;233;444;1116;530;1349
241190;202202;1286;3154;1081;2771;17;61;791;1944;808;2005
241200;202202;23743;56990;20902;52571;2346;6156;13995;34257;16341;40413
241210;202202;1640;4107;1204;3299;106;320;713;1910;819;2230
241220;202202;10177;27620;8983;25703;1694;4849;4780;13977;6474;18826
241230;202202;3147;7936;2790;7397;114;325;2316;6086;2430;6411
241240;202202;1352;3618;875;2618;97;303;312;909;409;1212
241250;202202;6254;16637;5038;14495;193;856;3852;10622;4045;11478
241255;202202;2716;7662;2395;7047;123;467;1840;5258;1963;5725
241260;202202;5395;13308;4333;11611;131;445;3497;9161;3628;9606
241270;202202;1781;4968;1488;4422;128;384;1040;3089;1168;3473
241280;202202;2600;5819;2254;5227;68;174;1930;4395;1998;4569
241290;202202;3592;8371;2649;6894;73;229;2086;5286;2159;5515
241300;202202;1643;4193;1336;3674;36;129;907;2400;943;2529
241310;202202;2443;5552;2113;5095;68;124;1848;4488;1916;4612
241320;202202;1060;3242;914;2970;102;359;585;1894;687;2253
241330;202202;1946;4686;1537;4153;17;72;1353;3631;1370;3703
241335;202202;3859;10069;3392;9260;119;378;2813;7558;2932;7936
241340;202202;1743;4595;1398;3937;194;623;729;1936;923;2559
241350;202202;2383;6134;2074;5598;120;337;1615;4289;1735;4626
241355;202202;1492;3800;1214;3282;32;78;915;2440;947;2518
241360;202202;2243;5513;1677;4420;57;156;1246;3176;1303;3332
241370;202202;1518;3869;1201;3243;79;243;847;2177;926;2420
241380;202202;779;1952;616;1673;67;172;338;899;405;1071
241390;202202;2925;8126;2600;7647;168;505;2035;6015;2203;6520
241400;202202;4012;10505;3549;9835;193;614;2808;7700;3001;8314
241410;202202;2697;7584;2200;6602;239;743;1360;4057;1599;4800
241415;202202;1983;5166;1677;4597;51;195;1330;3515;1381;3710
241420;202202;2923;8217;2605;7690;397;1325;1692;4926;2089;6251
241430;202202;674;1696;484;1318;14;37;324;834;338;871
241440;202202;8798;25338;7909;23822;332;1137;6372;19045;6704;20182
241445;202202;1497;3284;1313;3045;48;78;1167;2749;1215;2827
241450;202202;3143;7135;2639;6353;267;566;1960;4741;2227;5307
241460;202202;4290;10975;3471;9342;217;601;2432;6322;2649;6923
241470;202202;1523;3878;1254;3471;32;111;1051;2895;1083;3006
241475;202202;1353;3515;1068;3004;25;108;809;2158;834;2266
241480;202202;3273;9646;2706;8469;739;2268;1021;3496;1760;5764
241490;202202;802;1740;610;1478;13;35;466;1100;479;1135
241500;202202;825;2227;749;2139;3;10;708;2039;711;2049
250010;202202;2838;8091;2365;7129;66;259;1751;5141;1817;5400
250020;202202;1792;4482;1331;3643;74;144;970;2650;1044;2794
250030;202202;7413;19604;6521;18267;598;1790;4894;13520;5492;15310
250040;202202;4919;13412;4318;12382;441;1314;3109;8751;3550;10065
250050;202202;4000;10060;3612;9570;148;427;3093;8187;3241;8614
250053;202202;1410;3687;1285;3505;101;263;950;2567;1051;2830
250057;202202;768;2415;703;2320;9;47;649;2157;658;2204
250060;202202;6198;15122;5580;14355;305;790;4697;12067;5002;12857
250070;202202;4360;11560;3652;10385;52;221;2968;8226;3020;8447
250073;202202;866;2169;708;1920;12;35;573;1521;585;1556
250077;202202;2749;6456;2140;5518;41;150;1762;4423;1803;4573
250080;202202;5827;13172;4924;12054;56;232;4443;10707;4499;10939
250090;202202;3829;8555;3349;7940;70;200;2939;6835;3009;7035
250100;202202;3814;11059;3438;10414;132;537;2750;8108;2882;8645
250110;202202;5275;14045;4780;13372;284;966;3734;10327;4018;11293
250115;202202;821;1889;620;1588;15;57;490;1222;505;1279
250120;202202;2064;5693;1735;5161;33;162;1402;4113;1435;4275
250130;202202;6272;15519;5319;14221;72;354;4622;12122;4694;12476
250135;202202;1442;3613;1263;3317;25;73;1102;2870;1127;2943
250140;202202;2437;6771;2260;6555;94;349;1973;5711;2067;6060
250150;202202;5141;15171;4630;14350;170;696;3774;11450;3944;12146
250153;202202;1513;3811;1262;3448;44;118;1005;2729;1049;2847
250157;202202;2179;5716;1934;5318;61;226;1582;4253;1643;4479
250160;202202;4259;10008;3416;8881;87;225;2946;7658;3033;7883
250170;202202;2084;5091;1883;4818;30;105;1648;4143;1678;4248
250180;202202;23329;52380;20062;48315;691;2204;16475;38445;17166;40649
250190;202202;4653;11516;3949;10526;318;840;2908;7652;3226;8492
250200;202202;2674;5719;2314;5263;60;153;2056;4587;2116;4740
250205;202202;940;2797;800;2573;15;63;639;2049;654;2112
250210;202202;1623;4705;1456;4453;47;233;1180;3529;1227;3762
250215;202202;1773;4588;1498;4212;101;316;881;2503;982;2819
250220;202202;704;1899;557;1670;31;118;379;1117;410;1235
250230;202202;1821;3947;1291;3189;22;75;1036;2502;1058;2577
250240;202202;2845;7577;2518;7022;39;158;2207;6068;2246;6226
250250;202202;5004;13108;4391;12263;153;433;3679;10437;3832;10870
250260;202202;1779;4825;1499;4334;55;153;1172;3399;1227;3552
250270;202202;1313;3781;1203;3645;65;230;922;2866;987;3096
250280;202202;4084;9894;3668;9338;177;379;2909;7478;3086;7857
250290;202202;1793;4400;1536;4016;20;66;1250;3194;1270;3260
250300;202202;6159;15109;5566;14411;145;637;4831;12112;4976;12749
250310;202202;1293;3445;1077;3099;45;140;805;2303;850;2443
250320;202202;14070;29369;12263;27347;186;533;11281;24793;11467;25326
250330;202202;2793;7020;2362;6440;100;309;2010;5390;2110;5699
250340;202202;1348;3097;1191;2894;11;39;1092;2629;1103;2668
250350;202202;4370;11761;3835;10856;271;625;3041;8817;3312;9442
250355;202202;2317;6266;2073;5958;25;119;1902;5461;1927;5580
250360;202202;2002;5092;1792;4818;36;144;1542;4071;1578;4215
250370;202202;15499;36860;12982;33165;252;853;11191;28019;11443;28872
250375;202202;1416;3257;1164;2962;6;21;1096;2800;1102;2821
250380;202202;1867;4332;1718;4153;28;107;1559;3659;1587;3766
250390;202202;2029;4930;1709;4439;75;183;1393;3603;1468;3786
250400;202202;77162;183200;58634;155374;16332;44073;18606;53175;34938;97248
250403;202202;2177;5340;1947;5083;51;281;1617;4021;1668;4302
250407;202202;1522;3397;1174;2877;127;243;761;2007;888;2250
250410;202202;778;1929;672;1753;9;32;560;1409;569;1441
250415;202202;2049;5391;1793;5008;39;149;1544;4276;1583;4425
250420;202202;1302;3408;1165;3226;19;56;1068;2955;1087;3011
250430;202202;7304;16635;6255;15264;229;563;5173;12357;5402;12920
250435;202202;1745;4683;1398;4110;18;86;1060;3050;1078;3136
250440;202202;4991;12717;4330;11885;80;224;3841;10490;3921;10714
250450;202202;1976;4921;1629;4452;56;149;1318;3657;1374;3806
250460;202202;8013;20588;7097;19325;428;1219;5672;15417;6100;16636
250470;202202;1769;4293;1451;3805;43;126;1161;2955;1204;3081
250480;202202;4243;11185;3586;10391;40;141;3193;9322;3233;9463
250485;202202;778;1683;591;1428;57;103;408;971;465;1074
250490;202202;5536;12521;4924;11834;105;364;4469;10538;4574;10902
250500;202202;2190;5777;1950;5372;54;176;1616;4397;1670;4573
250510;202202;6025;14125;5181;12996;92;204;4517;11396;4609;11600
250520;202202;2091;5275;1794;4883;89;286;1398;3727;1487;4013
250523;202202;2430;5617;2157;5268;133;382;1788;4266;1921;4648
250527;202202;1918;4481;1738;4282;16;52;1581;3870;1597;3922
250530;202202;713;1748;613;1607;22;44;526;1373;548;1417
250535;202202;1480;4096;1329;3835;30;138;1069;2985;1099;3123
250540;202202;3559;7290;3001;6680;193;256;2584;5946;2777;6202
250550;202202;838;2581;746;2409;31;125;537;1708;568;1833
250560;202202;1921;5052;1682;4713;39;149;1420;3886;1459;4035
250570;202202;2984;8304;2575;7584;113;375;2015;5871;2128;6246
250580;202202;1121;2836;989;2654;45;194;844;2187;889;2381
250590;202202;1049;2470;941;2316;32;81;824;1989;856;2070
250600;202202;8605;22013;7163;20072;249;825;5701;15803;5950;16628
250610;202202;3211;8674;2884;8202;103;384;2419;6836;2522;7220
250620;202202;966;2295;828;2070;34;98;621;1514;655;1612
250625;202202;2585;7141;2319;6729;46;220;1999;5674;2045;5894
250630;202202;11845;30208;9879;26997;888;2655;6823;18072;7711;20727
250640;202202;3980;10015;3567;9486;77;346;3180;8314;3257;8660
250650;202202;1162;2562;964;2305;14;55;853;1991;867;2046
250660;202202;1748;4122;1400;3654;30;106;1158;2919;1188;3025
250670;202202;2561;7545;2333;7158;55;229;2047;6168;2102;6397
250680;202202;6469;14298;5823;13572;49;190;5481;12590;5530;12780
250690;202202;7860;16510;6704;15123;90;231;6015;13387;6105;13618
250700;202202;4961;13272;4344;12353;676;1839;2766;8039;3442;9878
250710;202202;4695;13063;4112;12248;277;892;3102;9228;3379;10120
250720;202202;3057;7811;2732;7369;39;180;2475;6611;2514;6791
250730;202202;4817;11757;4250;11005;155;538;3604;9073;3759;9611
250740;202202;2212;5176;1834;4688;105;259;1434;3684;1539;3943
250750;202202;122482;285239;105273;261700;7435;20270;79156;192660;86591;212930
250760;202202;2950;6456;2622;5953;44;155;2339;5150;2383;5305
250770;202202;4296;12382;3837;11777;342;1097;2886;8952;3228;10049
250780;202202;1995;4983;1685;4444;54;172;1375;3542;1429;3714
250790;202202;2785;7710;2426;7200;92;378;1887;5459;1979;5837
250800;202202;2690;6726;2355;6195;100;211;1934;5102;2034;5313
250810;202202;1507;3611;1268;3287;65;122;1046;2769;1111;2891
250820;202202;2110;5665;1942;5480;39;162;1768;4940;1807;5102
250830;202202;6676;18818;5514;16528;232;871;3855;11065;4087;11936
250840;202202;822;2506;715;2302;32;117;539;1754;571;1871
250850;202202;1932;5411;1726;5059;36;177;1440;4120;1476;4297
250855;202202;1159;3057;1016;2845;45;144;819;2263;864;2407
250860;202202;3766;10350;3152;9356;457;1359;1820;5417;2277;6776
250870;202202;1138;2954;968;2687;29;106;786;2147;815;2253
250880;202202;1809;4371;1511;3942;110;280;1144;2976;1254;3256
250890;202202;11714;27380;10366;25670;330;1333;8798;20735;9128;22068
250900;202202;3264;8259;2853;7575;69;229;2463;6403;2532;6632
250905;202202;2696;7152;2490;6877;42;154;2271;6258;2313;6412
250910;202202;7194;16152;6040;14871;86;293;5411;13265;5497;13558
250915;202202;2357;5185;1688;4472;24;56;1499;4024;1523;4080
250920;202202;3968;9438;3529;8806;195;448;2908;7153;3103;7601
250930;202202;2558;6503;2306;6186;43;195;2030;5325;2073;5520
250933;202202;1370;3728;1198;3424;39;162;960;2667;999;2829
250937;202202;806;2083;673;1873;25;80;541;1516;566;1596
250939;202202;2173;5162;1916;4849;61;155;1569;3930;1630;4085
250940;202202;4360;10993;3841;10330;24;74;3485;9370;3509;9444
250950;202202;1890;4678;1525;4201;38;142;1234;3340;1272;3482
250960;202202;1216;3424;1056;3144;32;153;868;2510;900;2663
250970;202202;9052;22430;7962;20699;197;641;6641;16834;6838;17475
250980;202202;2662;6594;2422;6258;23;112;2144;5392;2167;5504
250990;202202;2282;6536;1930;5948;75;326;1476;4448;1551;4774
251000;202202;2207;5943;1792;5241;51;208;1454;4224;1505;4432
251010;202202;2841;7548;2572;7136;31;121;2296;6378;2327;6499
251020;202202;1732;4592;1556;4325;30;129;1357;3701;1387;3830
251030;202202;1130;2862;929;2509;54;137;630;1684;684;1821
251040;202202;2050;5311;1746;4821;35;152;1479;4017;1514;4169
251050;202202;1113;2980;933;2645;51;184;685;1859;736;2043
251060;202202;1191;2429;907;2077;20;52;691;1570;711;1622
251065;202202;528;1385;398;1146;11;44;285;776;296;820
251070;202202;825;2002;693;1821;17;62;589;1508;606;1570
251080;202202;21995;51825;18063;46108;2793;6914;10793;28190;13586;35104
251090;202202;3142;8538;2685;7767;73;230;2153;6172;2226;6402
251100;202202;877;2680;772;2482;28;128;608;1870;636;1998
251110;202202;1967;4934;1661;4396;89;207;1242;3255;1331;3462
251120;202202;8452;21870;7135;20282;363;1206;5587;15851;5950;17057
251130;202202;4740;9318;4188;8708;47;124;3886;7967;3933;8091
251140;202202;4574;12287;4058;11569;69;269;3353;9470;3422;9739
251150;202202;2962;8136;2717;7744;67;322;2357;6558;2424;6880
251160;202202;2425;6633;2097;6155;33;175;1833;5273;1866;5448
251170;202202;1873;4599;1649;4322;23;91;1507;3895;1530;3986
251180;202202;2889;7276;2385;6582;148;395;1754;4832;1902;5227
251190;202202;4854;12021;4387;11504;49;251;3997;10278;4046;10529
251200;202202;4790;13149;4217;12430;80;309;3706;10944;3786;11253
251203;202202;1071;3271;976;3052;37;145;728;2222;765;2367
251207;202202;1241;3181;932;2675;22;88;648;1816;670;1904
251210;202202;8779;20694;7190;18553;404;888;5366;14183;5770;15071
251220;202202;1405;3155;1068;2720;79;162;798;2101;877;2263
251230;202202;5141;13701;4439;12474;127;446;3559;9713;3686;10159
251240;202202;4000;10676;3383;9634;197;526;2475;6979;2672;7505
251250;202202;12438;30847;10968;28396;566;1596;8548;21419;9114;23015
251260;202202;575;1433;518;1350;17;79;418;1040;435;1119
251270;202202;4673;13852;4179;13171;187;619;3348;10831;3535;11450
251272;202202;1396;3679;1283;3534;58;223;1087;2915;1145;3138
251274;202202;985;2627;806;2319;52;181;543;1493;595;1674
251275;202202;1505;3719;1267;3335;53;175;1007;2562;1060;2737
251276;202202;1462;3796;1273;3542;35;163;1032;2775;1067;2938
251278;202202;677;1714;608;1609;35;101;486;1281;521;1382
251280;202202;2801;6578;2564;6252;60;188;2252;5344;2312;5532
251290;202202;7367;15299;6777;14618;198;532;6115;12905;6313;13437
251300;202202;960;2673;864;2530;19;78;735;2139;754;2217
251310;202202;3111;8218;2721;7641;63;303;2271;6213;2334;6516
251315;202202;2003;5813;1808;5449;120;370;1409;4225;1529;4595
251320;202202;1790;4508;1335;3728;38;135;1020;2782;1058;2917
251330;202202;2355;5143;1929;4642;34;95;1700;4097;1734;4192
251335;202202;1217;3208;1092;3024;25;111;980;2658;1005;2769
251340;202202;4199;9342;3357;8265;133;348;2666;6521;2799;6869
251350;202202;1164;3179;1067;3028;30;104;889;2485;919;2589
251360;202202;2058;5327;1671;4784;33;120;1369;3871;1402;3991
251365;202202;845;2135;668;1812;9;32;538;1431;547;1463
251370;202202;26895;68114;23105;62869;3190;8233;14407;40118;17597;48351
251380;202202;1494;3749;1284;3419;20;96;1118;2889;1138;2985
251385;202202;841;2079;658;1755;21;56;473;1220;494;1276
251390;202202;6953;19300;6151;18077;524;1629;4286;12605;4810;14234
251392;202202;1120;2894;947;2621;39;116;747;2057;786;2173
251394;202202;732;1966;588;1717;54;160;399;1146;453;1306
251396;202202;726;1895;615;1709;26;75;418;1131;444;1206
251398;202202;1117;2733;798;2188;21;74;592;1572;613;1646
251400;202202;1504;3264;1204;2869;26;101;997;2275;1023;2376
251410;202202;1729;3772;1397;3311;15;59;1198;2731;1213;2790
251420;202202;2248;5422;1858;4973;37;140;1503;3924;1540;4064
251430;202202;1687;4832;1526;4561;44;183;1324;3921;1368;4104
251440;202202;1178;3138;957;2736;52;125;725;2120;777;2245
251445;202202;1743;4565;1608;4382;30;121;1404;3746;1434;3867
251450;202202;4831;13454;4325;12678;85;384;3649;10647;3734;11031
251455;202202;952;2738;874;2596;21;92;720;2090;741;2182
251460;202202;1050;2771;886;2522;52;170;683;1919;735;2089
251465;202202;508;1395;432;1254;12;51;332;926;344;977
251470;202202;1308;3454;984;2810;121;361;522;1419;643;1780
251480;202202;1129;2794;900;2409;24;97;701;1792;725;1889
251490;202202;2159;5337;1747;4788;74;214;1335;3659;1409;3873
251500;202202;2186;5778;2010;5560;36;137;1811;4978;1847;5115
251510;202202;2908;8237;2423;7302;102;391;1709;4969;1811;5360
251520;202202;1169;2849;896;2378;78;180;590;1529;668;1709
251530;202202;15866;36112;12853;32410;139;698;11458;28346;11597;29044
251540;202202;3378;8999;3028;8400;66;237;2599;7079;2665;7316
251550;202202;4531;9579;3675;8557;140;246;3023;7141;3163;7387
251560;202202;606;1785;546;1699;41;167;402;1191;443;1358
251570;202202;1045;2803;866;2453;22;113;704;1926;726;2039
251580;202202;2230;5038;1994;4703;33;127;1730;3923;1763;4050
251590;202202;1817;4129;1545;3810;57;144;1329;3218;1386;3362
251593;202202;1024;2893;917;2708;82;268;620;1790;702;2058
251597;202202;2281;6024;2046;5712;16;80;1860;5134;1876;5214
251600;202202;6837;17749;5974;16450;246;750;4931;13400;5177;14150
251610;202202;3446;9308;3013;8550;226;634;2176;6181;2402;6815
251615;202202;1439;3370;1150;2944;20;63;947;2349;967;2412
251620;202202;21663;45870;16847;40060;160;438;14839;35284;14999;35722
251630;202202;5553;12070;4482;10600;241;504;3448;7988;3689;8492
251640;202202;2452;6230;2192;5835;25;119;1984;5189;2009;5308
251650;202202;4763;11325;4152;10563;122;369;3649;9182;3771;9551
251660;202202;3903;11034;3451;10270;70;325;2896;8477;2966;8802
251670;202202;4625;12057;4109;11363;61;248;3714;10181;3775;10429
251675;202202;914;2102;831;2003;69;154;662;1601;731;1755
251680;202202;2919;7048;2467;6471;59;157;2077;5447;2136;5604
251690;202202;3560;9380;3057;8539;110;320;2343;6503;2453;6823
251700;202202;2396;6377;1980;5825;45;190;1673;4809;1718;4999
251710;202202;873;2148;631;1687;48;152;374;921;422;1073
251720;202202;1434;3885;1145;3397;23;100;892;2566;915;2666
251740;202202;659;1776;531;1548;39;129;378;1062;417;1191
260005;202202;33031;66966;27617;60208;1682;3709;21808;46408;23490;50117
260010;202202;11251;28161;9299;25062;633;1742;5651;15213;6284;16955
260020;202202;7615;16541;6345;14760;88;378;5493;12507;5581;12885
260030;202202;7603;18204;6415;16523;119;451;5360;13524;5479;13975
260040;202202;8350;19976;7104;18297;511;1200;5258;13841;5769;15041
260050;202202;15017;37116;12517;34368;218;743;11607;31883;11825;32626
260060;202202;4697;10660;4069;9704;345;656;3072;7532;3417;8188
260070;202202;12083;28079;10470;25819;292;1054;8728;20853;9020;21907
260080;202202;7073;15408;6141;14215;115;350;5238;11896;5353;12246
260090;202202;5459;13018;4831;12190;275;723;3871;9768;4146;10491
260100;202202;3255;8316;2748;7591;51;245;2345;6377;2396;6622
260105;202202;5432;14190;4893;13483;127;511;4238;11460;4365;11971
260110;202202;24440;64385;21828;60672;879;2983;18351;50148;19230;53131
260120;202202;16379;40330;13944;36905;1408;3566;9682;25759;11090;29325
260130;202202;3625;8318;3198;7724;127;318;2599;6116;2726;6434
260140;202202;14153;29886;12286;27718;406;1082;10740;23812;11146;24894
260150;202202;4032;8654;3534;8052;92;220;3171;7190;3263;7410
260160;202202;7298;17457;6236;16186;91;309;5739;14919;5830;15228
260170;202202;23454;51451;20190;47164;924;2222;16564;38115;17488;40337
260180;202202;3858;9627;3335;8927;79;281;2903;7658;2982;7939
260190;202202;21378;39523;18235;35903;193;533;16543;31867;16736;32400
260200;202202;12247;27626;10606;25549;485;1058;9176;22240;9661;23298
260210;202202;12520;33376;10603;30335;375;1273;8570;24372;8945;25645
260220;202202;13014;27113;12094;25996;347;681;10801;23052;11148;23733
260230;202202;12717;27945;11100;25879;264;692;9483;21828;9747;22520
260240;202202;3031;8576;2634;7827;85;345;2070;6054;2155;6399
260250;202202;2574;6107;2240;5617;99;240;1846;4572;1945;4812
260260;202202;14541;34790;12961;32493;589;1597;10463;25926;11052;27523
260270;202202;5231;11172;4642;10504;90;339;4113;9077;4203;9416
260280;202202;13449;38532;12144;36705;374;1725;10560;31290;10934;33015
260290;202202;45282;108491;39221;100163;3605;9314;28068;71247;31673;80561
260300;202202;10836;27139;9401;25186;237;869;8073;21466;8310;22335
260310;202202;6546;14786;5840;13930;419;733;4584;11268;5003;12001
260320;202202;8405;23078;7165;21044;191;692;5976;17429;6167;18121
260330;202202;2775;8025;2429;7341;66;256;1961;5763;2027;6019
260340;202202;2344;5813;2042;5382;35;148;1819;4670;1854;4818
260345;202202;29347;70810;24843;64584;3014;8290;15102;38128;18116;46418
260350;202202;6457;13729;5607;12782;41;134;5148;11612;5189;11746
260360;202202;2772;6794;2493;6305;62;198;1838;4558;1900;4756
260370;202202;6045;16341;5212;14965;199;685;4122;11619;4321;12304
260380;202202;5492;15169;4701;13903;178;622;3666;10691;3844;11313
260390;202202;5116;14553;4229;12825;211;680;2878;8529;3089;9209
260392;202202;3941;11366;3583;10927;92;529;3067;9281;3159;9810
260400;202202;21939;46527;19080;42832;430;1245;15795;33845;16225;35090
260410;202202;84535;193751;67687;170989;12307;31670;32890;85341;45197;117011
260415;202202;4870;12035;4198;11008;61;243;3577;9179;3638;9422
260420;202202;13909;27176;11903;24987;75;263;11232;23323;11307;23586
260430;202202;3041;8981;2591;8119;159;554;1784;5532;1943;6086
260440;202202;4427;10165;3939;9507;47;173;3513;8322;3560;8495
260450;202202;6158;14734;5518;13911;260;544;4716;11999;4976;12543
260460;202202;5855;16119;4997;14675;435;1454;3266;9367;3701;10821
260470;202202;5289;13086;4496;12187;72;213;4149;11319;4221;11532
260480;202202;4396;10840;3725;9922;302;835;2668;7166;2970;8001
260490;202202;6003;12799;5303;11835;36;141;4877;10699;4913;10840
260500;202202;6631;15612;5704;14323;430;989;4152;10485;4582;11474
260510;202202;11257;25668;9515;23264;108;418;8540;20547;8648;20965
260515;202202;4900;12253;3875;10432;153;488;2800;7155;2953;7643
260520;202202;17780;39634;15513;36827;556;1490;13186;30797;13742;32287
260530;202202;10642;28911;9052;26526;134;646;7921;22877;8055;23523
260540;202202;8087;16382;7191;15278;88;251;6647;13937;6735;14188
260545;202202;95;273;64;201;7;27;24;69;31;96
260550;202202;3510;8997;2855;7928;157;512;2026;5452;2183;5964
260560;202202;6255;15552;5268;14119;127;473;4472;11796;4599;12269
260570;202202;8920;21777;7909;20452;271;822;6743;17200;7014;18022
260580;202202;5081;11205;4589;10568;30;110;4257;9723;4287;9833
260590;202202;7967;16262;6811;15001;142;355;6109;13376;6251;13731
260600;202202;35518;85927;29352;76900;1067;3331;23077;58829;24144;62160
260610;202202;8206;20200;7299;19029;402;1105;5591;14495;5993;15600
260620;202202;20032;47177;17800;44154;1195;3393;13907;33554;15102;36947
260630;202202;2605;6688;2130;5964;51;176;1762;4835;1813;5011
260640;202202;25423;52873;21595;48549;629;1525;18485;40939;19114;42464
260650;202202;6766;16517;5450;14928;513;911;4410;12531;4923;13442
260660;202202;7810;18903;6814;17652;269;835;5957;15197;6226;16032
260670;202202;2482;6203;2025;5499;63;169;1491;3929;1554;4098
260680;202202;32402;73199;27552;66612;1906;4809;20081;47478;21987;52287
260690;202202;3777;9433;3145;8464;72;253;2501;6671;2573;6924
260700;202202;7581;18229;7048;17641;20;82;6851;17167;6871;17249
260710;202202;1521;3716;1298;3395;56;190;1037;2672;1093;2862
260720;202202;29483;66107;25345;61056;1932;4603;19371;46957;21303;51560
260730;202202;8681;23406;7574;21907;202;791;6541;18625;6743;19416
260740;202202;1451;3930;1208;3551;23;84;963;2870;986;2954
260750;202202;8388;20348;6742;18317;149;379;5968;16540;6117;16919
260760;202202;6953;14695;6079;13690;114;328;5402;12054;5516;12382
260765;202202;9293;24679;8148;23154;448;1680;6033;16695;6481;18375
260770;202202;4290;10274;3557;9106;105;337;2875;7207;2980;7544
260775;202202;6027;14871;5314;13857;168;595;4347;10916;4515;11511
260780;202202;4056;11353;3635;10700;337;1239;2435;6904;2772;8143
260790;202202;139768;296253;117544;268632;14461;32178;80625;182619;95086;214797
260795;202202;3406;7969;2947;7392;91;271;2461;6134;2552;6405
260800;202202;6574;13381;6003;12635;222;461;5269;10862;5491;11323
260805;202202;4041;10631;3446;9650;178;585;2626;7194;2804;7779
260810;202202;7240;18261;6360;16689;351;925;4984;12746;5335;13671
260820;202202;4920;10771;4372;10155;76;264;3744;8553;3820;8817
260825;202202;3296;9140;2909;8486;120;393;2261;6509;2381;6902
260830;202202;4808;12943;4041;11636;439;1111;2731;8047;3170;9158
260840;202202;5010;11472;4529;10844;202;478;3952;9371;4154;9849
260845;202202;4984;12336;4430;11440;223;625;3422;8619;3645;9244
260850;202202;5600;14325;4708;12707;349;1042;3173;8195;3522;9237
260860;202202;3756;10095;3241;9233;82;321;2660;7360;2742;7681
260870;202202;4994;11025;4290;10174;89;280;3869;9063;3958;9343
260875;202202;8765;19309;7226;17107;573;1268;5225;12498;5798;13766
260880;202202;10767;28376;9446;26227;309;976;7815;21419;8124;22395
260890;202202;14678;34864;12725;32032;803;2130;9280;22870;10083;25000
260900;202202;6101;16017;5076;14594;327;1059;3564;10120;3891;11179
260910;202202;3614;9169;3169;8530;112;354;2539;6756;2651;7110
260915;202202;5424;14988;4781;14263;55;265;4417;13176;4472;13441
260920;202202;3860;8474;3322;7905;71;167;2973;7059;3044;7226
260930;202202;4481;12487;3865;11443;168;676;3063;8763;3231;9439
260940;202202;16536;36906;14429;34054;1001;2414;11167;25862;12168;28276
260950;202202;7945;19925;6470;17526;316;1144;4449;11357;4765;12501
260960;202202;84343;174178;69728;156242;6352;14212;49355;108173;55707;122385
260970;202202;6310;15414;5602;14458;418;804;4219;11175;4637;11979
260980;202202;5054;13818;4435;13057;55;182;4085;12105;4140;12287
260990;202202;19835;50566;16828;46533;718;2295;13514;36808;14232;39103
261000;202202;18630;40407;15797;36916;464;1312;13108;29899;13572;31211
261010;202202;2498;6202;2170;5780;86;230;1870;4991;1956;5221
261020;202202;7314;17870;6417;16446;299;843;5309;13265;5608;14108
261030;202202;4526;12307;4006;11431;132;498;3228;8927;3360;9425
261040;202202;6024;16124;4953;14205;190;651;3866;10784;4056;11435
261050;202202;8895;20963;8080;19806;227;522;6806;16491;7033;17013
261060;202202;15927;37337;13882;34944;286;921;11842;29380;12128;30301
261070;202202;74375;154986;62331;139627;3999;8787;47379;104163;51378;112950
261080;202202;7438;16688;6745;15858;109;233;6314;14798;6423;15031
261090;202202;21639;48135;19296;45116;381;1234;17106;39220;17487;40454
261100;202202;9503;24146;8322;22453;580;1536;6355;17108;6935;18644
261110;202202;76761;202225;65026;181654;7832;23458;41114;112861;48946;136319
261120;202202;3997;9460;3479;8756;81;207;3021;7554;3102;7761
261130;202202;7994;18408;7041;17173;111;361;6251;15062;6362;15423
261140;202202;4057;8916;3631;8351;208;501;2898;6569;3106;7070
261150;202202;5991;14539;5312;13573;144;377;4589;11638;4733;12015
261153;202202;2121;6034;1768;5374;76;248;1224;3715;1300;3963
261160;202202;247359;539931;205134;484440;45096;104513;101851;244758;146947;349271
261170;202202;7986;17034;7049;15848;228;474;6106;13494;6334;13968
261180;202202;10277;24366;9008;22758;477;1073;6821;17390;7298;18463
261190;202202;5095;13804;4599;13036;168;750;3791;10415;3959;11165
261200;202202;3788;8119;3345;7543;133;335;2855;6311;2988;6646
261210;202202;2080;4838;1784;4425;54;152;1515;3681;1569;3833
261220;202202;15918;40882;13592;36926;1390;3946;8963;23777;10353;27723
261230;202202;4344;11740;3612;10792;50;191;3056;9198;3106;9389
261240;202202;6413;14309;5682;13242;273;653;4772;10946;5045;11599
261245;202202;4167;10885;3454;9660;78;362;2807;7555;2885;7917
261247;202202;3425;9427;2845;8418;232;628;1967;5882;2199;6510
261250;202202;28492;59179;25132;55334;3828;7410;17435;40240;21263;47650
261255;202202;4488;12416;3679;10892;157;605;2854;8227;3011;8832
261260;202202;16448;36736;14601;34419;264;994;13361;30793;13625;31787
261270;202202;5436;11586;4817;10857;155;370;4209;9326;4364;9696
261280;202202;2736;7268;2399;6728;78;280;1926;5272;2004;5552
261290;202202;3188;7799;2667;7217;86;286;2202;5975;2288;6261
261300;202202;14367;36591;12357;33416;426;1637;9816;25637;10242;27274
261310;202202;10666;24622;9245;22761;632;1667;7094;17105;7726;18772
261320;202202;6704;17662;5805;16242;74;347;4983;13719;5057;14066
261330;202202;6584;14609;5968;13843;99;370;5348;12074;5447;12444
261340;202202;4946;12469;4344;11720;103;424;3819;10126;3922;10550
261350;202202;9425;26531;8288;24637;180;686;6745;19874;6925;20560
261360;202202;9315;20591;7900;18619;271;729;6477;14805;6748;15534
261370;202202;26702;63128;22655;57822;2162;5400;15536;39676;17698;45076
261380;202202;4617;12625;4089;11759;423;1291;2877;8214;3300;9505
261390;202202;18520;49895;15669;45505;1119;3713;10895;31114;12014;34827
261400;202202;5296;15137;4656;13878;257;875;3565;10346;3822;11221
261410;202202;10766;25045;8908;22311;298;973;7417;18001;7715;18974
261420;202202;8098;22697;7329;21792;562;2049;5692;16780;6254;18829
261430;202202;4131;10300;3554;9443;65;302;3090;7961;3155;8263
261440;202202;1569;4483;1310;3998;58;260;954;2782;1012;3042
261450;202202;15882;40759;14038;38034;339;1058;11500;31223;11839;32281
261460;202202;8792;21955;7664;20251;239;745;6400;16666;6639;17411
261470;202202;4391;10501;3789;9677;40;173;3260;8257;3300;8430
261480;202202;5916;16607;5092;15265;247;910;4033;11812;4280;12722
261485;202202;5681;14994;5000;14001;359;1166;3803;10488;4162;11654
261500;202202;7021;16516;6143;15342;526;1062;4316;11288;4842;12350
261510;202202;2013;5684;1748;5255;80;287;1352;4067;1432;4354
261520;202202;2554;7374;2300;6884;88;308;1755;5184;1843;5492
261530;202202;13512;36656;11118;32595;878;3194;6517;17933;7395;21127
261540;202202;10176;26348;9295;25137;2015;4865;5004;14814;7019;19679
261550;202202;4052;10202;3539;9428;221;688;2661;6900;2882;7588
261560;202202;9407;24630;8226;22938;363;1163;6678;18478;7041;19641
261570;202202;3835;9874;3048;8584;200;629;2107;5823;2307;6452
261580;202202;7499;18593;6497;17241;92;437;5926;15520;6018;15957
261590;202202;3013;7185;2457;6400;97;307;1903;4867;2000;5174
261600;202202;6149;13821;5258;12577;233;532;4140;9732;4373;10264
261610;202202;2295;6446;1848;5641;149;484;1224;3719;1373;4203
261618;202202;2880;6499;2535;6022;124;334;2109;4862;2233;5196
261620;202202;4772;12621;4373;12043;616;1525;3146;8933;3762;10458
261630;202202;6564;17870;5594;16070;433;1419;3710;10250;4143;11669
261640;202202;42338;88067;36366;80926;2009;3597;28882;65269;30891;68866
261650;202202;4781;10679;4087;9824;278;565;3144;7600;3422;8165
270010;202202;4734;15106;4081;14014;165;852;3318;11118;3483;11970
270020;202202;4473;10175;3942;9528;112;430;3477;8110;3589;8540
270030;202202;36632;96187;30850;87185;2466;7297;22751;63675;25217;70972
270040;202202;11825;29399;10208;27504;396;1254;8702;23348;9098;24602
270050;202202;5910;13172;5037;12201;243;491;4456;10883;4699;11374
270060;202202;2413;5951;2042;5511;124;328;1640;4435;1764;4763
270070;202202;5254;13612;4590;12708;104;475;3981;10715;4085;11190
270080;202202;1615;4140;1373;3757;54;155;1082;2869;1136;3024
270090;202202;1906;5551;1733;5227;49;210;1470;4340;1519;4550
270100;202202;6736;15197;5889;14035;174;499;5144;11998;5318;12497
270110;202202;3583;7865;2930;7117;186;320;2360;6017;2546;6337
270120;202202;2757;7319;2398;6843;75;301;2016;5631;2091;5932
270130;202202;5488;13610;4764;12749;171;512;4092;10933;4263;11445
270135;202202;2171;5010;1845;4651;27;116;1712;4280;1739;4396
270140;202202;10173;23200;8215;20560;346;1114;6495;15513;6841;16627
270150;202202;3016;8334;2761;7986;16;84;2627;7547;2643;7631
270160;202202;6190;16449;5301;15406;171;542;4799;13964;4970;14506
270170;202202;3564;10021;3013;9269;192;888;2290;6747;2482;7635
270180;202202;2476;7281;2276;7028;40;212;2082;6366;2122;6578
270190;202202;2205;5420;1994;5173;22;109;1859;4768;1881;4877
270200;202202;2799;7929;2435;7417;196;562;1747;5448;1943;6010
270210;202202;6261;13934;5342;12894;55;226;4983;11866;5038;12092
270220;202202;1816;4461;1470;3970;139;426;1033;2691;1172;3117
270230;202202;10617;27323;8950;24869;778;2190;6634;18334;7412;20524
270235;202202;6431;18928;5607;17650;179;687;4730;14760;4909;15447
270240;202202;12928;32467;10832;29687;932;2604;8169;22483;9101;25087
270250;202202;3153;7300;2801;6809;167;395;2371;5732;2538;6127
270255;202202;4922;13281;3911;11539;120;474;3068;8836;3188;9310
270260;202202;5744;16693;5213;15821;95;509;4579;13635;4674;14144
270270;202202;1145;2831;957;2605;99;245;727;1988;826;2233
270280;202202;4259;9682;3423;8663;222;522;2692;6885;2914;7407
270290;202202;8585;25456;7763;24192;146;721;6968;21449;7114;22170
270300;202202;4610;11432;3607;10342;169;455;2889;8442;3058;8897
270310;202202;7630;20247;6569;18674;116;543;5764;16040;5880;16583
270320;202202;5918;16824;5140;15388;280;985;3874;11214;4154;12199
270330;202202;4499;13570;3986;12816;223;962;3256;10361;3479;11323
270340;202202;1793;4457;1521;4096;76;153;1294;3493;1370;3646
270350;202202;2048;4511;1660;4064;110;284;1269;3091;1379;3375
270360;202202;3146;7102;2837;6759;46;139;2711;6421;2757;6560
270370;202202;1520;4417;1395;4198;36;176;1204;3569;1240;3745
270375;202202;3567;7755;3043;7189;18;61;2894;6826;2912;6887
270380;202202;6089;15699;5188;14596;521;1349;3874;11178;4395;12527
270390;202202;1328;3179;1065;2873;15;71;915;2475;930;2546
270400;202202;7289;17621;6162;16015;189;527;5127;13137;5316;13664
270410;202202;5128;14007;4461;13026;120;454;3823;11087;3943;11541
270420;202202;6510;17768;5889;16882;129;615;5233;14665;5362;15280
270430;202202;156129;350715;123377;309608;19747;50706;67963;172370;87710;223076
270440;202202;5121;13152;4467;12352;107;410;3983;10917;4090;11327
270450;202202;8070;20195;7132;19069;305;810;6079;16455;6384;17265
270460;202202;4117;8697;3521;7986;115;254;3232;7301;3347;7555
270470;202202;12542;32533;10975;30388;548;1714;8901;24525;9449;26239
270480;202202;3261;8139;2768;7469;136;454;2289;6057;2425;6511
270490;202202;1008;2629;877;2470;39;139;729;2017;768;2156
270500;202202;5372;15291;4798;14346;209;794;3976;11662;4185;12456
270510;202202;6468;15731;5445;14464;326;1082;4323;11102;4649;12184
270520;202202;4512;12030;3628;10623;725;2220;1680;5053;2405;7273
270530;202202;1433;3964;1227;3643;69;176;876;2645;945;2821
270540;202202;2497;6513;2120;6025;60;233;1844;5191;1904;5424
270550;202202;7370;17953;5879;16319;493;1326;4546;12837;5039;14163
270560;202202;3241;7962;2737;7287;129;419;2246;5878;2375;6297
270570;202202;5225;12803;4545;11836;290;709;3740;9688;4030;10397
270580;202202;2541;6704;2296;6368;119;339;1992;5508;2111;5847
270590;202202;1670;4896;1539;4715;15;85;1463;4460;1478;4545
270600;202202;3059;8856;2778;8438;63;289;2494;7470;2557;7759
270610;202202;4009;9980;3505;9326;78;230;3146;8286;3224;8516
270620;202202;1368;3887;1262;3696;30;131;1099;3120;1129;3251
270630;202202;19298;44644;16705;41162;690;2053;14245;34401;14935;36454
270640;202202;5950;16018;5218;14893;184;710;4404;12314;4588;13024
270642;202202;2702;8362;2382;7880;154;678;1864;6036;2018;6714
270644;202202;4163;9719;3479;8847;273;623;2753;7051;3026;7674
270650;202202;3632;9819;3189;9237;213;750;2619;7512;2832;8262
270660;202202;2142;5240;1849;4847;88;297;1455;3717;1543;4014
270670;202202;19516;41232;16525;37641;405;1159;14540;32238;14945;33397
270680;202202;6460;13803;5820;13114;228;303;5361;12337;5589;12640
270690;202202;10593;24725;8900;22585;314;920;7386;18491;7700;19411
270700;202202;583;1692;514;1589;47;164;377;1138;424;1302
270710;202202;6227;17409;5507;16327;330;1095;4430;13031;4760;14126
270720;202202;4120;10953;3681;10246;78;335;3305;9027;3383;9362
270730;202202;8899;18577;7797;17420;907;1082;6248;15370;7155;16452
270740;202202;2523;6423;2226;6079;94;300;1881;5090;1975;5390
270750;202202;6199;15370;5436;14426;110;416;4874;12824;4984;13240
270760;202202;3626;9610;3060;8845;64;289;2588;7393;2652;7682
270770;202202;23805;56400;19454;50977;2949;7082;12343;33587;15292;40669
270780;202202;2074;5144;1927;4953;50;170;1755;4451;1805;4621
270790;202202;1897;4754;1610;4370;113;316;1256;3394;1369;3710
270800;202202;12328;31157;11163;29532;456;1417;9588;25172;10044;26589
270810;202202;3693;9706;2960;8584;183;640;2165;6130;2348;6770
270820;202202;1745;4962;1487;4555;53;250;1211;3641;1264;3891
270830;202202;5740;12965;4684;11697;120;495;3986;9662;4106;10157
270840;202202;9103;25956;8040;24424;226;1052;7017;20906;7243;21958
270850;202202;9613;21556;8506;20270;487;1373;7350;17258;7837;18631
270860;202202;16009;33729;12861;30216;587;1339;10624;24816;11211;26155
270870;202202;2491;6660;2047;5942;216;572;1421;4250;1637;4822
270880;202202;8501;24470;7623;23178;219;949;6433;19213;6652;20162
270890;202202;3503;9066;2985;8342;260;744;2036;5681;2296;6425
270895;202202;3795;10235;3446;9797;62;330;3136;8725;3198;9055
270900;202202;1852;4618;1423;3946;30;108;1133;3097;1163;3205
270910;202202;4452;12143;3854;11250;118;398;3258;9389;3376;9787
270915;202202;10555;28319;8620;25288;706;2454;6093;17368;6799;19822
270920;202202;6714;17739;6065;16783;88;461;5389;14477;5477;14938
270930;202202;19263;42126;15094;37340;1723;3465;10873;28311;12596;31776
270940;202202;6952;17512;5871;16247;193;876;4783;12789;4976;13665
280010;202202;700;1921;564;1647;23;102;404;1092;427;1194
280020;202202;5452;13045;4624;11808;347;873;3436;8662;3783;9535
280030;202202;91831;201027;75323;178476;12972;30108;41730;100098;54702;130206
280040;202202;3330;8439;2926;7862;249;725;2146;5675;2395;6400
280050;202202;4552;12289;3880;11247;704;2043;2140;6212;2844;8255
280060;202202;7447;17712;6027;15666;962;2584;3355;8884;4317;11468
280067;202202;7915;17957;6785;16249;385;807;5093;12055;5478;12862
280070;202202;1946;5670;1807;5456;119;374;1514;4537;1633;4911
280100;202202;4538;11142;3838;10081;412;1017;2627;6994;3039;8011
280110;202202;1679;3972;1463;3666;18;77;1338;3278;1356;3355
280120;202202;8487;22459;7538;20977;854;2150;5514;15629;6368;17779
280130;202202;9848;21887;8661;20299;437;1104;7099;16537;7536;17641
280140;202202;6408;13909;5685;12932;447;893;4521;10445;4968;11338
280150;202202;4526;10874;3957;10104;411;952;3013;7769;3424;8721
280160;202202;1357;3638;1156;3318;116;396;805;2211;921;2607
280170;202202;5887;14100;5291;13362;233;616;4437;11134;4670;11750
280190;202202;1557;3072;1396;2867;40;107;1243;2492;1283;2599
280200;202202;1401;3522;1168;3201;73;219;888;2376;961;2595
280210;202202;19239;44018;16784;40615;1734;4112;11448;27516;13182;31628
280220;202202;1794;4590;1513;4228;50;176;1263;3489;1313;3665
280230;202202;4716;11271;3913;10080;285;629;2797;7225;3082;7854
280240;202202;3599;9093;3199;8502;47;239;2800;7259;2847;7498
280250;202202;1006;2265;847;2039;53;151;646;1501;699;1652
280260;202202;2547;5635;2243;5261;45;113;2063;4838;2108;4951
280270;202202;2641;6817;2337;6375;142;432;1940;5256;2082;5688
280280;202202;4308;12331;3839;11652;462;1204;2780;8750;3242;9954
280290;202202;21536;51807;18662;47856;1611;4247;12824;32933;14435;37180
280300;202202;13888;30059;12196;28243;1556;2083;8877;22859;10433;24942
280310;202202;1514;3744;1268;3351;40;122;980;2525;1020;2647
280320;202202;9456;24119;8208;22292;835;2331;5835;15602;6670;17933
280330;202202;5133;12071;4324;10948;298;740;3285;8243;3583;8983
280340;202202;5897;11889;4929;10823;211;358;4359;9668;4570;10026
280350;202202;30103;65034;26610;60501;1054;2692;21956;48778;23010;51470
280360;202202;6036;16128;5324;15011;600;1856;3491;9824;4091;11680
280370;202202;2552;5617;2095;4875;94;170;1657;3796;1751;3966
280380;202202;1140;2820;961;2590;78;182;687;1877;765;2059
280390;202202;4314;9538;3673;8581;208;432;2993;6924;3201;7356
280400;202202;4378;10108;3831;9400;470;979;2716;6856;3186;7835
280410;202202;2906;7309;2445;6621;220;605;1568;4128;1788;4733
280420;202202;4780;11832;4375;11343;73;260;4049;10421;4122;10681
280430;202202;2373;5352;2092;4989;73;225;1763;4087;1836;4312
280440;202202;4680;11672;4145;10882;129;487;3570;9113;3699;9600
280445;202202;2511;6188;2254;5766;56;179;1780;4387;1836;4566
280450;202202;10920;25101;9508;23223;2311;5458;4495;11656;6806;17114
280460;202202;7777;17061;7063;16107;378;820;6092;13746;6470;14566
280470;202202;1840;4938;1561;4422;110;314;1138;3183;1248;3497
280480;202202;51156;114847;44653;106006;3986;9750;32364;75169;36350;84919
280490;202202;4000;11019;3379;9954;144;572;2571;7301;2715;7873
280500;202202;1162;2531;1003;2328;24;71;842;1941;866;2012
280510;202202;3147;6896;2736;6357;83;252;2285;5106;2368;5358
280520;202202;1939;4450;1695;4113;103;223;1367;3292;1470;3515
280530;202202;2570;6210;2255;5782;136;348;1779;4537;1915;4885
280540;202202;9319;24038;8440;22811;288;926;7399;19798;7687;20724
280550;202202;7362;16039;6172;14400;126;466;5283;11874;5409;12340
280560;202202;8265;20962;7765;20246;138;518;7006;17947;7144;18465
280570;202202;6997;16154;5689;14571;330;855;4260;10961;4590;11816
280580;202202;6249;15333;5482;14253;442;1049;4250;11089;4692;12138
280590;202202;3069;6829;2633;6315;139;438;2090;4785;2229;5223
280600;202202;4316;10383;3840;9713;186;490;2974;7404;3160;7894
280610;202202;2990;6600;2672;6200;117;286;2279;5168;2396;5454
280620;202202;6101;13914;5259;12829;365;777;4034;9994;4399;10771
280630;202202;4359;11105;4014;10652;215;587;3335;8850;3550;9437
280640;202202;2611;6513;2283;6150;41;137;2090;5631;2131;5768
280650;202202;1325;3342;1098;3010;98;283;785;2077;883;2360
280660;202202;4106;8440;3561;7819;154;269;3096;6843;3250;7112
280670;202202;21673;47642;18803;43968;1461;3465;14401;33416;15862;36881
280680;202202;3163;7036;2732;6426;258;471;1928;4680;2186;5151
280690;202202;1077;2453;914;2250;35;111;767;1820;802;1931
280700;202202;1299;3010;1119;2758;39;109;905;2187;944;2296
280710;202202;17079;35832;14565;33003;1036;1606;12289;28608;13325;30214
280720;202202;2879;6275;2391;5707;81;207;1864;4554;1945;4761
280730;202202;1146;2843;997;2620;76;232;742;1872;818;2104
280740;202202;17526;37126;15236;33804;958;2181;11849;25497;12807;27678
280750;202202;3862;10261;3351;9400;214;614;2449;6772;2663;7386
280760;202202;7443;18020;6463;16637;716;1575;4350;11582;5066;13157
290010;202202;3439;6867;2283;5135;12;36;1918;4131;1930;4167
290020;202202;6329;14797;5815;14175;395;724;4983;12448;5378;13172
290030;202202;5162;10936;4207;9909;191;392;3587;8565;3778;8957
290035;202202;5738;11667;4707;10356;289;518;3732;8316;4021;8834
290040;202202;5121;11036;4373;10153;493;711;3337;8340;3830;9051
290050;202202;2238;6864;1906;6199;114;435;1353;4291;1467;4726
290060;202202;1546;3367;1161;2815;148;341;764;1833;912;2174
290070;202202;44167;89381;38485;82464;2171;4606;30867;65000;33038;69606
290080;202202;6128;16563;5355;15449;472;1435;3937;11385;4409;12820
290090;202202;2366;4311;1687;3585;21;57;1545;3254;1566;3311
290100;202202;11170;26849;9124;23961;1460;3496;5119;14110;6579;17606
290110;202202;6059;14714;5352;13646;624;1478;3570;9176;4194;10654
290115;202202;4433;12363;3800;11283;274;834;2987;8856;3261;9690
290120;202202;7167;16776;6008;15187;189;599;5107;12708;5296;13307
290130;202202;5108;11773;3992;10322;206;524;3036;7936;3242;8460
290135;202202;4864;10745;3994;9360;153;387;3230;7305;3383;7692
290140;202202;4911;12138;3842;10766;147;476;3253;9140;3400;9616
290150;202202;2927;6799;2515;6325;130;314;2026;5098;2156;5412
290160;202202;3931;8182;3503;7608;180;359;2960;6364;3140;6723
290170;202202;3772;8807;3356;8366;92;228;3067;7679;3159;7907
290180;202202;3306;8474;2757;7611;75;288;2328;6332;2403;6620
290190;202202;5133;12392;4576;11664;148;453;3814;9698;3962;10151
290195;202202;2667;6137;2147;5473;53;208;1863;4690;1916;4898
290200;202202;4550;11991;3628;10432;144;481;2770;7847;2914;8328
290205;202202;3905;9380;3487;8784;186;551;2817;6934;3003;7485
290210;202202;14482;36776;12866;34357;885;2214;10333;27661;11218;29875
290220;202202;3351;7357;2961;6875;103;275;2538;5826;2641;6101
290225;202202;3563;7036;2746;6190;73;155;2474;5548;2547;5703
290230;202202;3098;7057;2850;6766;71;143;2541;6071;2612;6214
290240;202202;4314;9795;3476;8794;71;262;3034;7581;3105;7843
290250;202202;4292;11794;3567;10741;115;360;2987;9131;3102;9491
290260;202202;5957;13753;5055;12477;247;683;4267;10307;4514;10990
290265;202202;3814;10582;3110;9303;206;657;2207;6530;2413;7187
290270;202202;11557;37838;10687;36389;623;2600;8609;29168;9232;31768
290280;202202;6692;19164;5799;17419;352;1212;4225;12474;4577;13686
290290;202202;10732;29986;8806;26566;776;2613;6015;17868;6791;20481
290300;202202;4664;11900;3440;9657;223;656;2449;6782;2672;7438
290310;202202;2131;4348;1737;3896;30;113;1566;3421;1596;3534
290320;202202;29117;70902;23685;63028;4354;10906;13227;36543;17581;47449
290323;202202;4231;10721;3632;9799;121;328;2828;7656;2949;7984
290327;202202;4698;12577;4037;11386;352;887;2866;8078;3218;8965
290330;202202;2691;5036;2151;4462;29;46;1970;4121;1999;4167
290340;202202;6671;15224;5150;13421;497;1142;3871;10322;4368;11464
290350;202202;5211;13890;4343;12431;277;793;3104;8877;3381;9670
290360;202202;5671;13464;5010;12623;107;302;4431;11125;4538;11427
290370;202202;5578;12928;4121;11016;154;443;3020;8065;3174;8508
290380;202202;6332;15489;5274;14073;150;363;4574;12290;4724;12653
290390;202202;16374;43937;13586;39543;1366;3987;9256;27174;10622;31161
290395;202202;3294;8730;2633;7629;74;340;2051;5813;2125;6153
290400;202202;4233;10711;3427;9433;157;492;2640;7112;2797;7604
290405;202202;5053;13864;4307;12606;340;1015;3027;8947;3367;9962
290410;202202;6145;15808;4718;13603;161;607;3627;10252;3788;10859
290420;202202;3501;8873;2893;7942;94;289;2351;6374;2445;6663
290430;202202;3851;9244;3206;8286;177;553;2454;6082;2631;6635
290440;202202;3104;7301;2260;6010;154;355;1606;4374;1760;4729
290450;202202;4065;9242;3239;8060;147;384;2657;6467;2804;6851
290460;202202;13642;36506;11479;32607;2297;6526;5055;14462;7352;20988
290470;202202;5245;11641;3922;9850;460;1144;2416;6131;2876;7275
290475;202202;7235;19799;6086;17867;97;493;5140;14831;5237;15324
290480;202202;2025;4763;1666;4258;67;231;1243;3013;1310;3244
290485;202202;5035;13814;4421;12966;128;579;3774;10911;3902;11490
290490;202202;10226;22371;9276;21115;334;869;7781;17588;8115;18457
290500;202202;4589;12978;3667;11136;578;1808;1633;4879;2211;6687
290510;202202;3935;9051;3312;8263;66;222;2975;7331;3041;7553
290515;202202;3878;10419;3375;9724;40;127;3069;8957;3109;9084
290520;202202;13259;35348;10425;30058;682;2102;6620;18504;7302;20606
290530;202202;5309;14630;4486;13327;111;476;3804;11190;3915;11666
290540;202202;3916;9489;3552;9096;41;141;3342;8527;3383;8668
290550;202202;4556;11483;3978;10808;33;111;3664;10064;3697;10175
290560;202202;6841;16916;5245;14648;381;1318;3611;9741;3992;11059
290570;202202;48204;114298;42827;107684;1917;5199;35646;88623;37563;93822
290580;202202;9106;24157;7878;22435;796;1991;5755;17074;6551;19065
290590;202202;7471;22240;6308;20202;199;777;5136;16552;5335;17329
290600;202202;20760;55134;18015;50794;912;2540;14448;40778;15360;43318
290610;202202;2748;8178;2178;7049;102;375;1537;4939;1639;5314
290620;202202;6563;18028;5697;16636;285;796;4732;13869;5017;14665
290630;202202;10458;23299;8438;20755;709;1626;6516;16227;7225;17853
290640;202202;3025;7227;2335;6270;201;402;1633;4627;1834;5029
290650;202202;14990;34911;13419;33167;1559;3543;10511;26485;12070;30028
290660;202202;4098;10042;3334;8861;108;317;2515;6721;2623;7038
290670;202202;8385;19819;7259;18145;304;830;6049;15007;6353;15837
290680;202202;12153;31497;10190;28670;272;1178;8561;23616;8833;24794
290682;202202;5547;12972;4853;12070;272;489;3912;10134;4184;10623
290685;202202;3872;8287;2849;6857;417;807;1598;4188;2015;4995
290687;202202;7409;18538;6102;16468;721;1795;4111;11261;4832;13056
290689;202202;3094;8150;2379;6898;243;772;1582;4601;1825;5373
290690;202202;5977;14784;4882;13292;247;818;3719;9912;3966;10730
290700;202202;3258;7507;2921;7096;44;176;2671;6400;2715;6576
290710;202202;9397;24305;8047;22473;243;772;6901;19243;7144;20015
290720;202202;20822;53156;18928;50316;987;2948;15584;40757;16571;43705
290730;202202;7519;17231;6454;15999;297;616;5179;12894;5476;13510
290740;202202;1174;2922;942;2573;21;76;827;2222;848;2298
290750;202202;13635;30699;11904;28049;541;1414;9540;21597;10081;23011
290755;202202;2213;5971;1778;5216;128;347;1225;3630;1353;3977
290760;202202;4064;11333;3349;10044;236;627;2315;7084;2551;7711
290770;202202;2905;8475;2659;8182;76;230;2268;7110;2344;7340
290780;202202;8546;20562;7371;19035;330;715;5777;15209;6107;15924
290790;202202;5538;13964;4822;12938;224;573;4016;10849;4240;11422
290800;202202;7754;14827;5530;12288;274;513;4303;9599;4577;10112
290810;202202;5876;14207;4767;12634;171;410;3654;9894;3825;10304
290820;202202;5673;14009;5128;13253;348;795;3789;9887;4137;10682
290830;202202;4811;10915;4254;10137;66;238;3605;8243;3671;8481
290840;202202;19260;48147;16473;43961;1788;4029;11501;31833;13289;35862
290850;202202;8431;17959;7467;16938;328;582;6473;14834;6801;15416
290860;202202;6692;17801;5818;16803;312;825;4889;14439;5201;15264
290870;202202;5261;13670;4020;11373;292;805;2714;7651;3006;8456
290880;202202;1566;3622;1267;3243;166;369;764;2120;930;2489
290890;202202;9970;19472;8928;18332;136;332;8378;17076;8514;17408
290900;202202;2633;6611;2049;5614;137;384;1299;3495;1436;3879
290910;202202;5644;12690;4312;10727;48;145;3720;9150;3768;9295
290920;202202;5868;13574;5200;12787;136;189;4772;12053;4908;12242
290930;202202;8072;21638;6529;18991;244;942;5069;14371;5313;15313
290940;202202;3830;10395;3235;9534;164;582;2623;7683;2787;8265
290950;202202;1562;3774;1272;3345;98;263;890;2341;988;2604
290960;202202;6441;15258;5764;14445;254;565;4877;12219;5131;12784
290970;202202;3387;9800;2786;8711;115;449;2179;6787;2294;7236
290980;202202;14501;32418;12366;29336;875;2044;8386;19256;9261;21300
290990;202202;10274;26444;9151;24705;298;1189;7763;20289;8061;21478
291000;202202;3661;8947;2814;7887;117;357;2320;6555;2437;6912
291005;202202;17453;40784;15532;38393;979;2387;12892;31630;13871;34017
291010;202202;3297;9663;2661;8310;159;550;1733;5265;1892;5815
291020;202202;1399;3263;1129;2808;33;106;833;1936;866;2042
291030;202202;2743;6304;1976;5058;131;311;1290;3197;1421;3508
291040;202202;5870;15224;4827;13759;204;680;3823;10883;4027;11563
291050;202202;10164;23191;8899;21514;946;2187;6662;15961;7608;18148
291060;202202;8166;20807;7105;19425;434;1393;5638;15230;6072;16623
291070;202202;18261;45344;15367;40850;418;1460;12858;33597;13276;35057
291072;202202;29759;69388;22448;57727;3229;8657;12235;30632;15464;39289
291075;202202;6046;14029;5475;13174;100;275;4674;10940;4774;11215
291077;202202;1820;4611;1418;3913;67;134;1001;2768;1068;2902
291080;202202;133629;306397;107910;271996;25064;59455;45526;121257;70590;180712
291085;202202;6071;14650;4960;12987;172;505;4183;10839;4355;11344
291090;202202;2349;4166;1771;3525;33;68;1547;3032;1580;3100
291100;202202;3609;7335;2532;6081;99;262;2002;4742;2101;5004
291110;202202;6503;18510;5507;16854;257;1074;4383;12974;4640;14048
291120;202202;8745;19690;7461;18100;314;848;6001;14375;6315;15223
291125;202202;2522;4194;1932;3538;67;109;1659;3023;1726;3132
291130;202202;3522;9576;2644;7923;77;358;2016;5807;2093;6165
291140;202202;5257;13361;3860;10948;482;1211;2400;6793;2882;8004
291150;202202;2882;5757;2253;5064;7;19;2156;4831;2163;4850
291160;202202;5453;14345;4569;13112;402;1248;3130;8914;3532;10162
291165;202202;2310;6127;1709;4957;39;167;1227;3425;1266;3592
291170;202202;23526;56672;19705;50377;1174;3170;13425;33327;14599;36497
291180;202202;7561;15641;5737;13272;184;495;4870;11075;5054;11570
291185;202202;3480;8512;3089;7931;158;406;2460;6305;2618;6711
291190;202202;8465;19566;7057;17816;218;637;5814;14683;6032;15320
291200;202202;3018;7925;2242;6464;81;287;1491;4107;1572;4394
291210;202202;8130;16125;6061;13791;330;689;4601;10478;4931;11167
291220;202202;5031;12770;4557;12101;359;942;3475;9239;3834;10181
291230;202202;5104;10067;3939;8800;54;99;3617;8109;3671;8208
291240;202202;4521;11107;3826;9970;71;223;3287;8450;3358;8673
291250;202202;3613;10170;2823;8759;195;607;1804;5626;1999;6233
291260;202202;1601;3547;1323;3196;27;74;1111;2681;1138;2755
291270;202202;6118;14568;4831;12785;369;889;3675;9854;4044;10743
291280;202202;3054;6959;2303;5917;191;447;1542;3874;1733;4321
291290;202202;6115;15496;4700;13357;395;1221;3193;8940;3588;10161
291300;202202;4211;10731;3352;9355;115;405;2619;7096;2734;7501
291310;202202;5593;14164;4810;12810;150;435;4101;10805;4251;11240
291320;202202;7133;18162;5627;15590;1083;2766;3073;8828;4156;11594
291330;202202;2072;4960;1726;4403;58;173;1354;3354;1412;3527
291340;202202;4675;11427;3761;9916;157;393;2725;7171;2882;7564
291345;202202;3121;8733;2811;8277;108;376;2363;6934;2471;7310
291350;202202;7747;17623;6056;15606;104;269;5314;13774;5418;14043
291360;202202;43551;91822;34980;81839;3645;7916;23967;57540;27612;65456
291370;202202;8873;23001;7866;21482;565;1689;5991;15985;6556;17674
291380;202202;4367;10206;3893;9579;118;384;3407;8255;3525;8639
291390;202202;14090;28803;10829;25246;386;909;9161;21254;9547;22163
291400;202202;16962;38178;14256;34302;1448;3158;9951;24455;11399;27613
291410;202202;3265;8220;2561;7036;58;201;1921;5170;1979;5371
291420;202202;2093;4859;1631;4293;26;105;1456;3812;1482;3917
291430;202202;2918;7792;2514;7125;102;399;1990;5480;2092;5879
291440;202202;7009;18988;6066;17505;360;1067;4698;13676;5058;14743
291450;202202;11487;24332;9553;22152;196;282;8575;20233;8771;20515
291460;202202;17914;43976;15748;40875;731;2190;12337;31385;13068;33575
291465;202202;9686;22853;7608;20487;173;704;6593;17595;6766;18299
291470;202202;20674;42259;17510;38662;1014;2053;13534;30244;14548;32297
291480;202202;50449;103827;38696;88509;3566;8188;24411;54249;27977;62437
291490;202202;6384;14873;5581;13981;118;379;5118;12733;5236;13112
291500;202202;5694;12712;4781;11535;80;229;4448;10729;4528;10958
291510;202202;4841;11076;3608;9525;53;264;3104;8074;3157;8338
291520;202202;4966;10674;3810;9199;273;634;2962;7140;3235;7774
291530;202202;2603;5558;1907;4686;184;406;1335;3388;1519;3794
291535;202202;3830;10545;3275;9566;201;515;2554;7633;2755;8148
291540;202202;2407;5076;1693;4241;65;169;1431;3564;1496;3733
291550;202202;6944;14225;5393;12324;492;981;3831;8827;4323;9808
291560;202202;19728;45046;14572;38376;1933;4597;8638;23660;10571;28257
291570;202202;2554;5668;1959;4987;81;173;1647;4296;1728;4469
291580;202202;7115;17113;5623;15164;318;948;4249;11279;4567;12227
291590;202202;2512;5595;2219;5266;62;214;2016;4699;2078;4913
291600;202202;6059;13169;4716;11190;398;997;3295;7573;3693;8570
291610;202202;6441;15424;5793;14717;68;246;5338;13490;5406;13736
291620;202202;3375;7191;2561;6309;161;363;1990;5011;2151;5374
291630;202202;3875;7753;2954;6618;167;369;2421;5365;2588;5734
291640;202202;18747;42350;14449;36369;1473;3784;8333;20511;9806;24295
291650;202202;10075;23223;8916;21868;537;999;7623;19013;8160;20012
291660;202202;2188;5144;1610;4286;108;397;1101;2741;1209;3138
291670;202202;2183;5532;1831;5024;145;367;1337;3729;1482;4096
291680;202202;4548;10335;3712;9171;402;960;2490;6262;2892;7222
291685;202202;5209;12088;4182;10695;206;435;3269;8492;3475;8927
291690;202202;4393;9202;3112;7396;290;547;2370;5692;2660;6239
291700;202202;9675;25999;8566;24154;295;1111;7216;19858;7511;20969
291710;202202;5926;12996;4513;11087;321;801;3346;8076;3667;8877
291720;202202;4749;13608;3958;12101;756;2291;2197;6767;2953;9058
291730;202202;7285;16577;6316;15328;338;816;5312;12866;5650;13682
291733;202202;3168;7618;2686;6985;133;286;2022;5488;2155;5774
291735;202202;3080;7962;2440;6862;78;196;1858;5225;1936;5421
291740;202202;4304;10651;3146;8525;120;263;2205;5933;2325;6196
291750;202202;23040;51087;19053;45312;2304;4790;12612;30794;14916;35584
291760;202202;12017;31973;9532;28188;2838;9390;2961;8654;5799;18044
291770;202202;8107;20494;6795;18272;305;1005;5273;13648;5578;14653
291780;202202;5571;14101;5021;13365;110;372;4386;11525;4496;11897
291790;202202;3167;7873;2896;7540;240;541;2294;6078;2534;6619
291800;202202;35826;82770;27926;71727;4227;10270;15568;40201;19795;50471
291810;202202;11502;25767;9764;23690;508;1030;8077;19956;8585;20986
291820;202202;4184;10455;3646;9762;115;341;2959;7912;3074;8253
291830;202202;5008;10895;4094;9681;183;356;3325;7874;3508;8230
291835;202202;7089;20203;5690;17662;490;1549;3924;12349;4414;13898
291840;202202;51679;135379;45246;125709;3853;11628;33648;92774;37501;104402
291845;202202;3161;7213;2577;6516;92;231;2223;5671;2315;5902
291850;202202;4699;12150;3946;10962;132;339;3286;9168;3418;9507
291855;202202;2462;4474;1947;3909;28;59;1805;3611;1833;3670
291860;202202;2418;6128;1691;4770;40;119;1113;3045;1153;3164
291870;202202;1398;3361;959;2603;34;112;680;1797;714;1909
291875;202202;3204;9252;2755;8341;79;343;2064;6034;2143;6377
291880;202202;5997;16060;5161;14735;255;673;3909;11289;4164;11962
291890;202202;1829;3546;1213;2832;176;382;750;1758;926;2140
291900;202202;1462;3283;1119;2782;32;103;886;2141;918;2244
291905;202202;2609;6397;2169;5745;95;311;1688;4319;1783;4630
291910;202202;3856;8149;3338;7538;73;165;2998;6824;3071;6989
291915;202202;7932;21372;6480;18968;245;749;4877;14485;5122;15234
291920;202202;32354;77346;27991;71650;1804;5524;21575;53681;23379;59205
291930;202202;2757;6768;2380;6250;209;534;1769;4701;1978;5235
291940;202202;4248;10215;2905;8035;264;675;1762;4852;2026;5527
291950;202202;9869;28879;8303;26011;372;1377;5797;17993;6169;19370
291955;202202;18216;43000;16345;40641;1112;2914;13414;33221;14526;36135
291960;202202;3987;8819;3368;8033;223;403;2691;6591;2914;6994
291970;202202;5145;11957;4337;10973;164;502;3388;8494;3552;8996
291980;202202;11110;29349;9004;25891;900;2286;6150;18080;7050;20366
291990;202202;2568;6183;2119;5645;28;110;1969;5225;1997;5335
291992;202202;4529;10162;3788;9243;242;497;3089;7668;3331;8165
291995;202202;2428;6079;1998;5418;80;284;1595;4197;1675;4481
292000;202202;2903;6446;2378;5823;74;232;1966;4784;2040;5016
292010;202202;6310;13903;5151;12256;99;361;4416;10217;4515;10578
292020;202202;5250;13758;4447;12437;170;630;3581;9661;3751;10291
292030;202202;2192;6130;1951;5705;143;437;1279;3662;1422;4099
292040;202202;5037;11753;3977;10234;191;465;3181;8222;3372;8687
292045;202202;4639;10856;3549;9295;30;98;3237;8541;3267;8639
292050;202202;7181;18793;5860;16597;303;1023;3928;10929;4231;11952
292060;202202;12992;27656;12077;26533;325;747;10902;23567;11227;24314
292070;202202;6302;15296;5504;14356;314;808;4759;12385;5073;13193
292080;202202;3903;8381;3252;7564;48;151;3006;6926;3054;7077
292090;202202;4946;10211;3544;8519;171;467;2833;6721;3004;7188
292100;202202;14030;31405;12052;28996;1937;4303;7270;18326;9207;22629
292105;202202;3875;9181;3378;8523;50;191;2882;7211;2932;7402
292110;202202;6885;15264;4970;12478;762;1920;3004;7453;3766;9373
292120;202202;7891;18883;6529;16631;482;1112;4806;12147;5288;13259
292130;202202;3768;8536;3131;7767;185;503;2420;5949;2605;6452
292140;202202;6185;12945;5288;11719;172;365;4665;10235;4837;10600
292145;202202;2867;7318;2409;6569;117;264;1906;5247;2023;5511
292150;202202;16579;41032;14381;37604;356;1322;12127;30983;12483;32305
292160;202202;3290;7491;2512;6507;42;119;2012;5527;2054;5646
292170;202202;9714;24032;8195;21660;393;1281;6424;16504;6817;17785
292180;202202;3199;8264;2390;6809;138;413;1541;4289;1679;4702
292190;202202;3220;7989;2749;7313;226;579;2009;5460;2235;6039
292200;202202;10047;23148;7621;19809;1423;3606;3897;10576;5320;14182
292205;202202;4174;10870;3641;10098;95;329;3133;8704;3228;9033
292210;202202;7186;15474;5857;13833;81;299;5368;12548;5449;12847
292220;202202;2432;5325;2112;4862;77;183;1663;3694;1740;3877
292225;202202;3539;9694;3118;9080;66;305;2753;7871;2819;8176
292230;202202;9629;21571;8632;20337;188;582;7562;17507;7750;18089
292240;202202;5231;14355;4584;13225;282;795;3310;9517;3592;10312
292250;202202;6556;15745;5899;14819;255;719;4782;11798;5037;12517
292260;202202;3531;8957;3137;8456;63;200;2766;7436;2829;7636
292265;202202;3932;9844;3255;8813;66;293;2705;7110;2771;7403
292270;202202;4795;10175;3837;9047;146;310;3186;7527;3332;7837
292273;202202;3136;6296;2518;5558;145;220;1814;4275;1959;4495
292275;202202;1870;4553;1508;4078;57;174;1191;3219;1248;3393
292280;202202;2930;6461;2379;5828;109;191;2018;5081;2127;5272
292285;202202;2856;6414;2280;5654;75;168;1903;4738;1978;4906
292290;202202;8304;20174;6568;17780;185;532;5481;14795;5666;15327
292300;202202;11499;27124;9167;24086;941;2554;6349;16796;7290;19350
292303;202202;3314;8707;2875;8037;123;276;2424;6872;2547;7148
292305;202202;2456;6336;2243;6050;53;203;2015;5360;2068;5563
292310;202202;7638;17652;6639;16448;95;358;5957;14507;6052;14865
292320;202202;6542;16844;5227;14545;191;674;4018;10877;4209;11551
292330;202202;3150;6250;2596;5643;170;280;2052;4646;2222;4926
292335;202202;5350;13150;4739;12266;214;473;4026;10541;4240;11014
292340;202202;5834;15862;4829;13976;258;748;3551;10189;3809;10937
292350;202202;2857;7194;2410;6608;127;363;1975;5408;2102;5771
292360;202202;5449;13775;4562;12322;216;615;3355;8934;3571;9549
292370;202202;11301;25339;9725;23303;113;414;9109;21543;9222;21957
292380;202202;7432;19824;6648;18470;396;1169;5161;14173;5557;15342
292390;202202;5475;9410;4177;7940;77;148;3830;7201;3907;7349
292400;202202;24602;66002;21293;60977;1884;5519;15138;43527;17022;49046
292405;202202;5019;11421;4229;10231;120;312;3545;8458;3665;8770
292410;202202;2484;5442;2109;4971;53;141;1912;4485;1965;4626
292420;202202;4669;11209;4204;10560;80;335;3784;9256;3864;9591
292430;202202;5392;15228;4140;12982;320;1139;2803;8705;3123;9844
292440;202202;9412;28025;8662;26940;139;706;7808;24137;7947;24843
292450;202202;4496;11991;3505;10149;109;368;2745;7875;2854;8243
292460;202202;6304;14810;5298;13260;206;523;4394;10808;4600;11331
292465;202202;2914;7001;2480;6462;174;317;1670;4759;1844;5076
292467;202202;2211;5675;1960;5349;277;618;1382;3998;1659;4616
292470;202202;3202;7824;2456;6679;90;203;1853;5076;1943;5279
292480;202202;7001;15281;5740;13776;75;252;5282;12519;5357;12771
292490;202202;2878;6179;2442;5592;89;176;2052;4637;2141;4813
292500;202202;7723;19060;6203;16591;338;987;4467;11757;4805;12744
292510;202202;15101;37289;11827;32318;690;2081;8574;23253;9264;25334
292520;202202;8009;18910;7094;17581;324;933;5822;14154;6146;15087
292525;202202;7053;15289;5806;13887;99;240;5241;12602;5340;12842
292530;202202;34429;85324;27552;74482;5031;14053;14615;39243;19646;53296
292540;202202;5003;8569;4011;7520;101;174;3694;6921;3795;7095
292550;202202;8707;21761;6680;19373;491;1332;4852;14914;5343;16246
292560;202202;4842;11641;4088;10613;171;510;3097;7918;3268;8428
292570;202202;4073;10068;3400;8908;64;249;2888;7335;2952;7584
292575;202202;7386;20183;6780;19402;605;1607;5262;15289;5867;16896
292580;202202;8134;19522;6713;17479;119;401;5790;14851;5909;15252
292590;202202;7905;20275;6630;18053;323;1029;5361;14300;5684;15329
292593;202202;3063;7396;2547;6536;73;207;2144;5437;2217;5644
292595;202202;5964;14949;5136;13936;161;538;4437;11949;4598;12487
292600;202202;12300;30981;10677;28628;515;1307;8625;23159;9140;24466
292610;202202;4941;11610;4233;10466;144;330;3410;8381;3554;8711
292620;202202;7240;18220;5970;16702;146;358;5454;15478;5600;15836
292630;202202;9871;22503;7992;19613;899;2009;5182;12856;6081;14865
292640;202202;8880;24442;7659;22503;328;1086;5564;16410;5892;17496
292650;202202;4694;11289;4178;10622;68;262;3848;9635;3916;9897
292660;202202;12149;31540;10330;28901;669;1793;7755;21925;8424;23718
292665;202202;2285;6463;1956;6035;66;209;1618;5082;1684;5291
292670;202202;3835;10065;2994;8531;168;525;2049;5707;2217;6232
292680;202202;4402;10870;3500;9346;133;368;2706;7007;2839;7375
292690;202202;2847;7057;1971;5653;209;526;1245;3692;1454;4218
292700;202202;11180;28372;9758;26224;733;1690;7104;19435;7837;21125
292710;202202;3114;8304;2904;8040;47;151;2708;7495;2755;7646
292720;202202;9946;22037;8428;20299;418;874;6740;16640;7158;17514
292730;202202;5637;12023;5136;11295;331;527;4248;9572;4579;10099
292740;202202;374127;843502;328385;781598;37694;89871;226602;533454;264296;623325
292750;202202;7173;17212;6332;16068;222;582;5306;13508;5528;14090
292760;202202;4347;11560;3800;10642;191;611;2924;8031;3115;8642
292770;202202;7495;17945;6140;16142;765;1957;4319;11562;5084;13519
292780;202202;2361;4353;1782;3677;54;131;1484;2912;1538;3043
292790;202202;4281;8608;3253;7501;166;371;2726;6300;2892;6671
292800;202202;12275;29473;10516;26851;450;1205;8723;22062;9173;23267
292805;202202;4096;9103;3249;8049;119;309;2651;6504;2770;6813
292810;202202;13064;29796;10606;26096;643;1562;8297;19872;8940;21434
292820;202202;7768;20684;5709;17239;371;1354;4089;12102;4460;13456
292830;202202;3153;7104;2688;6554;101;234;2299;5675;2400;5909
292840;202202;9774;23949;8292;22005;152;570;7403;19350;7555;19920
292850;202202;2897;7005;2465;6401;239;561;1718;4483;1957;5044
292860;202202;19035;38847;17256;36808;624;1272;15051;31876;15675;33148
292870;202202;22269;50300;19458;46510;1211;2810;14226;33299;15437;36109
292880;202202;12568;32448;10787;29803;394;1408;8515;22747;8909;24155
292890;202202;8314;20934;7369;19618;154;566;6605;17414;6759;17980
292895;202202;3687;7096;2825;5852;166;286;2253;4677;2419;4963
292900;202202;2955;7440;2691;7068;53;225;2279;5819;2332;6044
292905;202202;4905;11669;3933;10238;108;339;3123;7954;3231;8293
292910;202202;5204;13451;4759;12844;163;469;3832;10183;3995;10652
292920;202202;10688;27926;9948;26959;258;971;8782;23457;9040;24428
292925;202202;5711;15614;4775;13921;306;901;3445;10008;3751;10909
292930;202202;7132;19635;6233;18063;604;1929;4028;11459;4632;13388
292935;202202;2860;6302;2287;5671;23;93;2078;5153;2101;5246
292937;202202;3028;7332;2603;6794;152;378;1956;5194;2108;5572
292940;202202;3309;7792;2658;6835;291;633;1790;4785;2081;5418
292950;202202;10306;25170;9032;23386;460;1140;7010;17938;7470;19078
292960;202202;5837;13332;4898;12031;161;344;3947;9641;4108;9985
292970;202202;4189;11215;3716;10548;94;348;3139;8957;3233;9305
292975;202202;4838;9898;4322;9330;114;227;3962;8567;4076;8794
292980;202202;4085;8677;3374;7679;71;220;2950;6566;3021;6786
292990;202202;12644;32912;10616;29506;448;1425;8239;22284;8687;23709
293000;202202;2997;6777;2589;6167;78;235;2090;4922;2168;5157
293010;202202;20432;48989;16612;43317;1808;4792;11088;28747;12896;33539
293015;202202;9586;27387;7633;23730;590;1850;5291;16704;5881;18554
293020;202202;10690;29352;9650;27894;160;625;8736;25258;8896;25883
293030;202202;5661;14218;4371;12254;223;547;3020;8729;3243;9276
293040;202202;4850;11758;4038;10643;82;281;3564;9324;3646;9605
293050;202202;26003;58008;22954;53628;1380;3074;17692;40848;19072;43922
293060;202202;4107;10253;3317;8805;206;593;2426;6215;2632;6808
293070;202202;29460;65899;26285;62021;1902;4621;20731;48448;22633;53069
293075;202202;4066;11685;3538;10835;92;450;3029;9209;3121;9659
293076;202202;3856;8863;3509;8464;84;168;3134;7649;3218;7817
293077;202202;7095;18465;5750;16410;620;1741;3620;10882;4240;12623
293080;202202;5148;14332;4372;12994;105;492;3603;10487;3708;10979
293090;202202;3451;9700;2681;8405;212;650;1863;5864;2075;6514
293100;202202;6374;15951;5288;14086;248;611;4210;11192;4458;11803
293105;202202;4192;12529;3637;11431;230;740;2581;8085;2811;8825
293110;202202;2688;6175;2255;5580;70;212;1883;4544;1953;4756
293120;202202;5346;12796;4863;12093;307;516;4051;10321;4358;10837
293130;202202;3991;10489;3450;9811;83;343;3046;8572;3129;8915
293135;202202;34310;76708;25608;65322;4336;11450;11786;30559;16122;42009
293140;202202;2922;5670;2580;5267;77;121;2288;4623;2365;4744
293150;202202;5637;16261;4665;14503;338;1160;3278;10120;3616;11280
293160;202202;4449;9877;3876;9249;354;533;3168;8076;3522;8609
293170;202202;5791;10776;5095;9954;75;183;4639;8958;4714;9141
293180;202202;4896;12910;4082;11467;89;372;3328;9102;3417;9474
293190;202202;16619;40326;14599;37538;138;602;13219;33539;13357;34141
293200;202202;9774;22147;7988;19406;213;627;6733;16077;6946;16704
293210;202202;5754;14121;4878;12840;375;916;3721;9858;4096;10774
293220;202202;6064;14094;4558;11691;704;1738;2660;6812;3364;8550
293230;202202;4602;10550;3444;9032;265;637;2517;6710;2782;7347
293240;202202;5061;12233;4104;10742;183;308;3070;8458;3253;8766
293245;202202;4302;10895;3910;10337;136;415;3376;8782;3512;9197
293250;202202;6474;14485;5275;12926;253;661;4259;10328;4512;10989
293260;202202;5271;12881;4347;11475;188;394;3130;8360;3318;8754
293270;202202;8180;16729;6525;14968;579;738;5199;12805;5778;13543
293280;202202;4962;12186;4343;11324;270;619;3395;8971;3665;9590
293290;202202;18084;46870;16148;43976;1552;4284;11700;31802;13252;36086
293300;202202;6823;15144;5951;13907;404;909;4550;10504;4954;11413
293305;202202;4705;10563;4048;9738;47;123;3710;8911;3757;9034
293310;202202;2406;5749;2043;5197;37;126;1685;4190;1722;4316
293315;202202;4821;10339;4016;9191;268;447;3315;7652;3583;8099
293317;202202;3156;6716;2810;6238;239;399;2158;4823;2397;5222
293320;202202;13786;30747;12318;29147;156;516;11361;26597;11517;27113
293325;202202;1958;4610;1562;4111;190;494;1052;2778;1242;3272
293330;202202;75591;192117;62913;171314;8569;25028;35967;94483;44536;119511
293340;202202;2374;6354;1943;5606;149;461;1317;3768;1466;4229
293345;202202;4080;10219;3272;9013;336;667;2220;6620;2556;7287
293350;202202;6741;18376;5776;17214;88;329;5218;15726;5306;16055
293360;202202;17100;39711;14774;36669;222;983;13420;32616;13642;33599
310010;202202;1072;2317;721;1856;73;198;298;725;371;923
310020;202202;3179;8063;2449;6829;453;1311;909;2409;1362;3720
310030;202202;2088;5618;1621;4818;210;680;1085;3150;1295;3830
310040;202202;926;2307;734;1989;70;238;408;977;478;1215
310050;202202;1665;4640;1424;4271;97;385;1006;2923;1103;3308
310060;202202;3531;9267;3042;8629;133;436;2475;7024;2608;7460
310070;202202;355;800;260;667;9;23;196;499;205;522
310080;202202;784;2038;576;1672;72;231;303;842;375;1073
310090;202202;5406;12947;4492;11520;196;615;3591;8970;3787;9585
310100;202202;4029;10047;3420;9106;102;398;2920;7547;3022;7945
310110;202202;5200;12912;4058;11028;600;1859;2328;6028;2928;7887
310120;202202;704;1616;465;1251;58;186;265;640;323;826
310130;202202;404;1002;347;918;17;61;281;723;298;784
310140;202202;333;882;250;767;49;175;121;337;170;512
310150;202202;6627;16035;5064;13341;476;1509;2796;6846;3272;8355
310160;202202;10271;24133;7851;20380;1131;3193;3704;9340;4835;12533
310163;202202;1247;3525;994;3034;198;667;337;931;535;1598
310170;202202;10588;24993;8610;22063;747;1885;6172;15797;6919;17682
310180;202202;2170;4951;1591;4057;141;446;1060;2581;1201;3027
310190;202202;3012;8258;2495;7375;606;1948;569;1610;1175;3558
310200;202202;2292;6221;1743;5258;216;750;929;2693;1145;3443
310205;202202;1235;3214;999;2851;127;379;623;1800;750;2179
310210;202202;2702;7000;2215;6141;117;366;1586;4243;1703;4609
310220;202202;1336;3471;1030;2890;79;242;688;1847;767;2089
310230;202202;2443;6398;1991;5585;221;712;1289;3399;1510;4111
310240;202202;1111;3102;956;2853;64;234;667;1917;731;2151
310250;202202;1206;2945;994;2623;41;120;771;1975;812;2095
310260;202202;3705;9147;2545;7118;644;2114;950;2211;1594;4325
310270;202202;3085;6909;2499;6146;87;249;2126;5202;2213;5451
310280;202202;2825;6160;2290;5434;149;435;1629;3658;1778;4093
310285;202202;2019;6080;1697;5506;155;581;1097;3506;1252;4087
310290;202202;1521;3795;1300;3431;153;491;832;2004;985;2495
310300;202202;1794;4814;1506;4341;158;553;903;2433;1061;2986
310310;202202;362;828;248;641;37;105;138;335;175;440
310320;202202;562;1351;400;1100;17;67;246;644;263;711
310330;202202;545;1247;335;884;47;135;143;338;190;473
310340;202202;9075;22314;7275;19293;879;2289;4066;10754;4945;13043
310350;202202;14566;33939;10436;27485;1570;4497;5455;13733;7025;18230
310360;202202;637;1365;517;1218;21;59;352;802;373;861
310370;202202;1349;4020;1171;3712;202;706;391;1334;593;2040
310375;202202;941;2239;691;1877;115;317;380;1042;495;1359
310380;202202;421;942;240;668;25;71;127;333;152;404
310390;202202;562;1589;453;1388;72;253;189;519;261;772
310400;202202;12869;30215;9702;25528;652;2107;6510;16403;7162;18510
310410;202202;1163;3264;667;2198;75;273;258;774;333;1047
310420;202202;5151;12819;3848;10544;488;1496;1940;4898;2428;6394
310430;202202;1868;4823;1303;3830;202;619;570;1484;772;2103
310440;202202;730;1830;517;1456;50;178;276;721;326;899
310445;202202;1499;4036;1124;3332;85;247;785;2272;870;2519
310450;202202;4912;11778;3790;10047;149;538;2991;7706;3140;8244
310460;202202;1946;4979;1518;4228;202;640;650;1652;852;2292
310470;202202;3971;8519;3099;7389;319;656;2147;5287;2466;5943
310480;202202;1105;2720;853;2316;94;295;521;1338;615;1633
310490;202202;3166;8196;2527;7188;289;989;1482;3931;1771;4920
310500;202202;1557;4003;1199;3436;179;584;697;1917;876;2501
310510;202202;2438;6114;1743;4869;257;774;822;2229;1079;3003
310520;202202;1268;3142;941;2558;144;391;495;1355;639;1746
310530;202202;845;2072;600;1666;97;317;229;527;326;844
310540;202202;3344;9088;2772;8064;439;1458;1449;3881;1888;5339
310550;202202;1400;3321;1020;2703;68;241;638;1556;706;1797
310560;202202;17795;44450;12961;35916;1557;4823;6258;15632;7815;20455
310570;202202;1152;2880;922;2561;48;177;732;1988;780;2165
310590;202202;4754;11814;3821;10132;219;714;2409;5962;2628;6676
310600;202202;1507;4192;1248;3668;158;523;685;1887;843;2410
310610;202202;527;1397;352;1117;114;385;81;246;195;631
310620;202202;221375;534414;168877;442938;18280;57149;96093;229253;114373;286402
310630;202202;5136;13408;4026;11283;432;1284;2473;6731;2905;8015
310640;202202;1451;3826;1195;3360;149;504;699;1812;848;2316
310650;202202;2699;7021;2017;5777;145;512;1314;3566;1459;4078
310660;202202;1540;3867;1281;3514;33;98;1115;3033;1148;3131
310665;202202;1559;3700;1289;3344;23;70;1058;2774;1081;2844
310670;202202;67994;164994;57858;148613;4456;13433;41547;101346;46003;114779
310680;202202;867;1915;720;1717;23;90;610;1391;633;1481
310690;202202;2430;5742;1805;4784;128;422;1205;2987;1333;3409
310700;202202;537;1117;418;974;8;24;325;729;333;753
310710;202202;6765;18035;4967;15337;1019;3761;1047;2950;2066;6711
310720;202202;1197;2628;947;2323;30;109;732;1716;762;1825
310730;202202;11359;28069;9759;25653;360;1246;7537;19209;7897;20455
310740;202202;7287;19011;5458;15487;690;2274;2492;6394;3182;8668
310750;202202;1442;3251;1123;2807;78;244;710;1628;788;1872
310760;202202;766;1846;552;1521;42;121;340;923;382;1044
310770;202202;1158;3017;819;2512;80;308;440;1239;520;1547
310780;202202;4702;10508;3899;9456;162;423;3063;7407;3225;7830
310790;202202;1978;6016;1714;5457;387;1386;351;942;738;2328
310800;202202;2591;7394;1918;6083;485;1749;147;416;632;2165
310810;202202;1475;3430;1232;3047;46;135;930;2193;976;2328
310820;202202;1298;3184;816;2400;165;494;226;675;391;1169
310825;202202;2897;7932;2337;7049;65;342;1937;5650;2002;5992
310830;202202;2201;5821;1688;4896;310;1044;769;2074;1079;3118
310840;202202;2408;6243;1832;5291;380;1294;591;1485;971;2779
310850;202202;1497;3995;1248;3630;46;221;976;2731;1022;2952
310855;202202;3434;8583;2683;7404;165;505;1975;5330;2140;5835
310860;202202;7481;20494;6140;18062;621;1775;3898;11555;4519;13330
310870;202202;1029;2368;824;2087;57;161;609;1506;666;1667
310880;202202;1042;3005;841;2613;102;326;494;1517;596;1843
310890;202202;2459;6786;1638;5159;324;1105;282;783;606;1888
310900;202202;4370;11731;3193;9318;492;1607;1469;3910;1961;5517
310910;202202;2421;5644;1721;4569;241;698;444;1086;685;1784
310920;202202;2077;5144;1597;4449;141;437;1061;2876;1202;3313
310925;202202;1139;2791;926;2475;44;155;715;1819;759;1974
310930;202202;6196;15289;4471;12604;819;2299;2195;6460;3014;8759
310940;202202;7643;16635;6259;14688;210;604;5083;11582;5293;12186
310945;202202;1457;3558;1154;3070;146;444;691;1747;837;2191
310950;202202;2067;5907;1401;4455;238;849;437;1190;675;2039
310960;202202;788;2021;470;1383;80;267;121;333;201;600
310970;202202;1282;3671;944;2994;230;754;200;617;430;1371
310980;202202;373;838;204;553;18;50;103;269;121;319
310990;202202;1488;3834;1196;3354;132;420;723;1933;855;2353
311000;202202;4318;11393;3250;9715;602;1984;1660;4736;2262;6720
311010;202202;1080;2779;890;2459;194;564;468;1284;662;1848
311020;202202;1261;3102;840;2376;44;142;470;1274;514;1416
311030;202202;2004;4764;1476;3918;302;930;680;1677;982;2607
311040;202202;326;971;273;863;78;268;82;247;160;515
311050;202202;3348;8030;2563;6892;361;1093;1379;3581;1740;4674
311060;202202;3680;9030;2802;7503;380;1144;1250;3092;1630;4236
311070;202202;2679;6258;1995;5231;173;605;1245;3045;1418;3650
311080;202202;1257;2734;1017;2372;46;159;809;1778;855;1937
311090;202202;2565;7583;2108;6765;421;1482;779;2457;1200;3939
311100;202202;2665;7224;1687;5328;340;1196;420;1169;760;2365
311110;202202;4104;8206;2368;5782;486;1192;762;1905;1248;3097
311115;202202;1533;3194;1288;2877;46;103;1082;2374;1128;2477
311120;202202;7712;19372;6008;16441;856;2661;2472;5983;3328;8644
311130;202202;2061;5210;1573;4558;116;411;959;2708;1075;3119
311140;202202;1663;3947;1314;3474;96;288;944;2445;1040;2733
311150;202202;1596;4855;1271;4249;163;617;691;2238;854;2855
311160;202202;4408;12004;3244;9928;617;2159;1325;3817;1942;5976
311170;202202;1003;2473;824;2243;39;117;529;1531;568;1648
311180;202202;1541;3304;1022;2565;173;436;535;1321;708;1757
311190;202202;936;2533;709;2097;109;364;296;755;405;1119
311200;202202;2433;6246;1795;5044;290;903;748;1887;1038;2790
311205;202202;996;2722;835;2436;38;150;575;1571;613;1721
311210;202202;1149;3158;1016;2979;112;292;745;2265;857;2557
311220;202202;895;2263;766;2037;26;99;569;1405;595;1504
311230;202202;8821;24930;6798;20998;1096;3507;2827;8810;3923;12317
311240;202202;1178;2901;923;2550;152;454;477;1290;629;1744
311250;202202;1371;3686;1087;3180;186;599;477;1297;663;1896
311260;202202;3019;7061;1980;5315;263;815;963;2282;1226;3097
311265;202202;1442;3491;1077;2911;50;180;782;2051;832;2231
311270;202202;3253;9225;2839;8573;156;698;2096;6061;2252;6759
311280;202202;1221;3128;676;2066;128;442;150;405;278;847
311290;202202;2051;5883;1863;5522;110;377;1306;3825;1416;4202
311300;202202;5163;13369;4288;11945;211;744;3478;9476;3689;10220
311310;202202;627;1656;533;1493;31;93;364;985;395;1078
311320;202202;3569;10332;3116;9378;279;1062;1730;4739;2009;5801
311330;202202;6576;15444;5279;13476;484;1346;3194;8065;3678;9411
311340;202202;11860;31267;9528;27315;2056;6477;3437;9279;5493;15756
311350;202202;2655;6155;1970;4990;171;488;1141;2617;1312;3105
311360;202202;1207;2833;833;2315;222;661;326;930;548;1591
311370;202202;5258;12143;3936;10122;292;940;2510;6051;2802;6991
311380;202202;413;1215;304;996;58;193;150;496;208;689
311390;202202;1893;5530;1516;5032;628;2350;456;1367;1084;3717
311400;202202;1779;4631;1319;3789;235;695;403;1004;638;1699
311410;202202;2058;5756;1656;5125;220;809;978;2903;1198;3712
311420;202202;1727;4843;1298;4038;272;982;422;1097;694;2079
311430;202202;4855;12239;3330;9350;474;1403;1416;3763;1890;5166
311440;202202;3347;8812;2587;7582;659;2214;670;1888;1329;4102
311450;202202;2152;6132;1580;5077;402;1486;402;1080;804;2566
311455;202202;1144;2484;807;2006;108;260;453;1118;561;1378
311460;202202;608;1764;416;1368;80;299;95;258;175;557
311470;202202;569;1661;398;1293;103;370;63;211;166;581
311480;202202;1221;2852;1007;2536;71;175;784;1961;855;2136
311490;202202;278;794;218;695;35;139;96;273;131;412
311500;202202;528;1250;415;1083;27;83;276;696;303;779
311510;202202;3665;8938;2621;7227;286;923;1265;3216;1551;4139
311520;202202;702;1850;617;1694;54;180;383;1039;437;1219
311530;202202;9682;21702;6568;16931;1276;3750;2396;5871;3672;9621
311535;202202;923;2398;659;1868;100;302;278;735;378;1037
311540;202202;538;1592;478;1483;55;204;359;1086;414;1290
311545;202202;2155;5900;1866;5466;99;357;1468;4241;1567;4598
311547;202202;1748;3964;1537;3662;52;108;1237;2891;1289;2999
311550;202202;3263;8444;2664;7426;373;1142;1248;3272;1621;4414
311560;202202;342;703;214;504;39;98;75;148;114;246
311570;202202;1678;3763;1185;3086;41;115;910;2408;951;2523
311580;202202;2420;4463;1681;3583;138;266;1189;2501;1327;2767
311590;202202;597;1515;491;1364;66;197;302;823;368;1020
311600;202202;1752;3974;1461;3590;123;351;1136;2721;1259;3072
311610;202202;2520;7367;2108;6600;138;529;1393;4205;1531;4734
311615;202202;3694;9617;2996;8510;120;440;2440;6786;2560;7226
311620;202202;563;1402;450;1250;67;210;294;788;361;998
311630;202202;1454;3814;1216;3356;133;377;767;2087;900;2464
311640;202202;813;2101;653;1853;69;242;359;950;428;1192
311650;202202;2130;5070;1730;4476;187;514;1080;2718;1267;3232
311660;202202;3284;9004;2489;7519;384;1312;715;1747;1099;3059
311670;202202;1772;4302;1325;3522;148;448;673;1746;821;2194
311680;202202;2468;6466;1903;5502;126;370;1377;3990;1503;4360
311690;202202;667;1364;516;1176;29;62;394;918;423;980
311700;202202;2320;5323;1812;4607;25;118;1528;3775;1553;3893
311710;202202;1720;4707;1272;3947;286;925;487;1524;773;2449
311720;202202;462;1300;379;1158;43;151;208;635;251;786
311730;202202;4393;10728;3036;8155;723;2037;1181;3006;1904;5043
311740;202202;1060;2612;888;2379;70;162;739;2033;809;2195
311750;202202;4407;12242;3606;10894;334;1215;2417;6943;2751;8158
311760;202202;732;1968;599;1751;89;318;255;625;344;943
311770;202202;2440;6606;1930;5724;317;1021;888;2502;1205;3523
311780;202202;1537;4203;1165;3528;203;680;433;1162;636;1842
311783;202202;2524;6355;2068;5625;61;254;1697;4448;1758;4702
311787;202202;914;2517;728;2119;93;302;340;862;433;1164
311790;202202;1663;4396;1134;3436;223;755;380;1064;603;1819
311800;202202;5677;16242;4616;14054;962;3023;861;2150;1823;5173
311810;202202;1032;2896;824;2539;55;187;555;1688;610;1875
311820;202202;913;2107;712;1817;46;160;484;1157;530;1317
311830;202202;9342;25438;6828;20255;1956;5997;1299;3774;3255;9771
311840;202202;4178;9870;3385;8771;220;582;2594;6702;2814;7284
311850;202202;394;984;322;861;15;54;221;554;236;608
311860;202202;73841;176151;58555;150890;6321;18414;37046;90087;43367;108501
311870;202202;2059;5269;1480;4292;263;921;656;1744;919;2665
311880;202202;7077;17201;5942;15642;355;879;4483;11988;4838;12867
311890;202202;1927;4334;1516;3788;60;205;1152;2708;1212;2913
311900;202202;815;1974;620;1715;85;234;371;1052;456;1286
311910;202202;4587;11071;3531;9700;609;1738;1871;5218;2480;6956
311920;202202;2341;5774;1898;5153;121;306;1287;3524;1408;3830
311930;202202;4699;10308;3488;8695;743;2029;1625;3788;2368;5817
311940;202202;17576;43591;13116;35574;1702;5093;6267;15797;7969;20890
311950;202202;2596;6467;1993;5452;167;493;1284;3483;1451;3976
311960;202202;536;1279;428;1120;48;151;233;543;281;694
311970;202202;471;1448;353;1165;73;281;98;281;171;562
311980;202202;510;1317;278;873;29;98;110;326;139;424
311990;202202;578;1335;380;1040;59;198;167;407;226;605
311995;202202;1046;2835;561;1729;33;125;78;147;111;272
312000;202202;878;2001;662;1687;41;117;478;1210;519;1327
312010;202202;1158;2917;928;2565;38;151;677;1779;715;1930
312015;202202;1512;4100;1344;3837;58;243;1092;3027;1150;3270
312020;202202;1935;5680;1403;4505;257;884;334;962;591;1846
312030;202202;2298;5161;1996;4828;14;62;1893;4559;1907;4621
312040;202202;915;2597;666;2111;95;312;307;936;402;1248
312050;202202;1332;3886;1099;3470;236;930;430;1213;666;2143
312060;202202;1046;2452;697;1988;144;419;349;979;493;1398
312070;202202;995;2687;727;2173;39;146;445;1234;484;1380
312080;202202;3061;7212;2372;6215;127;390;1662;4126;1789;4516
312083;202202;1030;2487;801;2146;50;177;610;1573;660;1750
312087;202202;2810;6738;2293;5957;69;187;1888;4907;1957;5094
312090;202202;12084;30068;9654;26294;1073;3413;5631;14480;6704;17893
312100;202202;1779;4743;1412;4116;87;362;946;2591;1033;2953
312110;202202;1096;3249;915;2892;171;646;397;1145;568;1791
312120;202202;1113;2938;803;2418;187;664;266;682;453;1346
312125;202202;2047;4897;1758;4513;89;272;1421;3544;1510;3816
312130;202202;1232;2845;922;2336;85;248;460;1046;545;1294
312140;202202;771;2171;647;1927;97;313;327;919;424;1232
312150;202202;525;1371;450;1237;27;84;304;779;331;863
312160;202202;10202;26057;8050;22406;888;2875;4262;11227;5150;14102
312170;202202;983;2453;757;2047;43;141;508;1325;551;1466
312180;202202;1525;3864;1249;3384;132;392;732;1910;864;2302
312190;202202;806;2094;617;1768;68;231;322;871;390;1102
312200;202202;5126;13094;4083;11455;603;1680;2309;6376;2912;8056
312210;202202;1507;3200;1137;2700;48;165;892;2053;940;2218
312220;202202;1769;5128;1535;4715;105;379;1045;3187;1150;3566
312230;202202;18160;44450;13156;35834;2669;8252;4261;10006;6930;18258
312235;202202;2262;5310;1812;4692;141;383;1310;3309;1451;3692
312240;202202;846;2582;666;2218;143;493;226;745;369;1238
312245;202202;3107;7119;2608;6401;45;131;2291;5536;2336;5667
312247;202202;1156;2527;857;2113;78;203;585;1404;663;1607
312250;202202;1014;2609;652;1923;96;300;238;681;334;981
312260;202202;1075;2679;867;2370;45;170;692;1809;737;1979
312270;202202;778;2090;605;1759;34;136;341;904;375;1040
312280;202202;458;1287;362;1117;82;276;98;276;180;552
312290;202202;955;2622;796;2360;149;498;299;819;448;1317
312300;202202;1167;3394;832;2607;186;650;190;486;376;1136
312310;202202;1051;2987;854;2608;114;413;460;1338;574;1751
312320;202202;2286;5554;1692;4576;343;946;456;1210;799;2156
312330;202202;1002;2687;838;2373;88;277;526;1422;614;1699
312340;202202;276;681;200;563;28;107;115;285;143;392
312350;202202;291;579;212;492;15;45;148;315;163;360
312352;202202;1651;4814;1461;4463;186;562;800;2656;986;3218
312360;202202;3499;9572;2674;8097;452;1566;1138;3173;1590;4739
312370;202202;2129;5225;1791;4699;169;535;1182;2933;1351;3468
312380;202202;2410;5172;2008;4670;6;20;1796;4101;1802;4121
312385;202202;1384;3536;1085;3012;307;884;323;942;630;1826
312390;202202;2134;5771;1594;4783;244;831;486;1287;730;2118
312400;202202;3297;8888;2814;8120;773;2399;1027;3001;1800;5400
312410;202202;14383;36829;11933;32972;1488;4523;7635;20382;9123;24905
312420;202202;4404;11030;3643;9838;674;1975;1971;5149;2645;7124
312430;202202;9139;22421;7520;19679;287;942;5683;14378;5970;15320
312440;202202;1079;3297;906;2947;409;1392;193;622;602;2014
312450;202202;1426;3945;1101;3380;237;766;486;1501;723;2267
312460;202202;513;1233;376;1031;38;119;234;632;272;751
312470;202202;515;1235;329;905;45;137;107;248;152;385
312480;202202;1129;2727;814;2267;70;245;471;1238;541;1483
312490;202202;2608;5703;2118;5041;164;429;1362;3146;1526;3575
312500;202202;1162;2655;974;2408;34;122;756;1844;790;1966
312510;202202;4652;11985;3485;9861;796;2213;1114;3024;1910;5237
312520;202202;339;823;270;721;43;143;157;401;200;544
312530;202202;753;1673;638;1540;30;72;498;1237;528;1309
312540;202202;1744;4538;1221;3575;133;398;702;1990;835;2388
312550;202202;889;2241;690;1870;49;166;462;1152;511;1318
312560;202202;2033;5161;1631;4541;103;304;1167;3241;1270;3545
312570;202202;2813;6241;2142;5422;415;960;1153;3017;1568;3977
312580;202202;662;1731;471;1353;56;195;218;570;274;765
312590;202202;1708;4654;1333;3924;121;427;803;2159;924;2586
312595;202202;2252;6144;1870;5549;242;628;1187;3727;1429;4355
312600;202202;1332;3105;871;2200;123;373;218;600;341;973
312610;202202;7916;19301;5465;14913;743;2301;2140;5205;2883;7506
312620;202202;2723;6655;2060;5733;64;253;1653;4632;1717;4885
312630;202202;351;937;257;768;40;146;109;309;149;455
312640;202202;577;1528;431;1294;39;149;232;664;271;813
312650;202202;2304;5435;1651;4270;62;196;1209;2932;1271;3128
312660;202202;1451;3314;1123;2786;100;247;777;1845;877;2092
312670;202202;5949;14134;4994;12683;150;629;3958;9487;4108;10116
312675;202202;1374;3351;1128;3004;43;139;936;2445;979;2584
312680;202202;1663;4165;1473;3890;49;193;1277;3264;1326;3457
312690;202202;3171;6510;2426;5614;92;177;1990;4615;2082;4792
312695;202202;1122;2760;955;2498;41;87;774;2006;815;2093
312700;202202;2264;5776;1699;4797;157;511;996;2677;1153;3188
312705;202202;1666;3587;1458;3298;12;46;1364;3056;1376;3102
312707;202202;1559;4217;1170;3553;71;300;779;2240;850;2540
312710;202202;7536;16714;4827;12650;1112;2858;1693;4610;2805;7468
312720;202202;1198;2982;907;2532;95;308;601;1591;696;1899
312730;202202;1741;3961;1243;3290;103;312;783;2015;886;2327
312733;202202;1468;3725;1117;3082;46;158;771;2001;817;2159
312735;202202;840;2093;675;1789;60;163;429;1063;489;1226
312737;202202;880;1869;642;1540;55;153;462;1071;517;1224
312738;202202;828;1978;601;1601;52;159;380;944;432;1103
312740;202202;472;1169;293;874;58;195;88;197;146;392
312750;202202;1659;4533;1242;3777;165;568;606;1727;771;2295
312760;202202;1984;5562;1462;4520;230;739;591;1763;821;2502
312770;202202;49373;114425;32341;85936;5439;15707;12925;32855;18364;48562
312780;202202;2754;7567;2342;6891;238;745;1568;4543;1806;5288
312790;202202;264;606;142;413;5;21;37;73;42;94
312800;202202;5809;15243;4562;12981;618;2018;2428;6520;3046;8538
312810;202202;1713;4427;1164;3528;265;869;449;1272;714;2141
312820;202202;1917;4860;1562;4262;86;249;1144;3072;1230;3321
312825;202202;1588;3380;1373;3115;23;65;1202;2665;1225;2730
312830;202202;3042;8204;1973;6119;411;1395;569;1679;980;3074
312840;202202;1602;3986;1266;3448;90;316;771;1983;861;2299
312850;202202;1123;2493;812;2052;25;100;548;1274;573;1374
312860;202202;1196;2972;837;2431;191;599;265;696;456;1295
312870;202202;6655;17130;4336;12871;699;2205;1284;3483;1983;5688
312880;202202;1602;3856;1262;3311;72;192;761;1989;833;2181
312890;202202;2489;5861;1870;4880;124;284;1075;2763;1199;3047
312900;202202;1439;3488;1188;3160;111;342;728;1969;839;2311
312910;202202;1639;2950;943;2062;149;305;463;970;612;1275
312920;202202;1051;2723;748;2247;119;430;300;800;419;1230
312930;202202;2645;6139;2027;5230;361;963;1042;2737;1403;3700
312940;202202;1122;2883;907;2592;71;271;544;1466;615;1737
312950;202202;3428;8018;2370;6380;387;1177;1149;2948;1536;4125
312960;202202;2002;4978;1692;4520;101;244;1267;3488;1368;3732
312965;202202;1773;4557;1474;4103;118;356;1014;2797;1132;3153
312970;202202;1665;4439;1353;3957;148;528;874;2423;1022;2951
312980;202202;27831;72785;22835;64104;3873;11907;11655;30805;15528;42712
312990;202202;592;1383;415;1091;60;188;226;538;286;726
313000;202202;513;1401;390;1191;24;107;249;714;273;821
313005;202202;2751;7529;2334;6853;124;388;1733;4956;1857;5344
313010;202202;6015;15507;4861;13683;666;2110;3064;8393;3730;10503
313020;202202;1212;3535;910;2891;151;545;223;626;374;1171
313030;202202;1244;2696;865;2176;52;174;613;1472;665;1646
313040;202202;919;2717;768;2426;36;163;492;1491;528;1654
313050;202202;1995;5232;1421;4373;233;862;448;1256;681;2118
313055;202202;2121;5330;1873;4974;309;812;1348;3569;1657;4381
313060;202202;1097;2591;819;2121;176;542;209;494;385;1036
313065;202202;1794;5015;1584;4674;53;233;1279;3655;1332;3888
313070;202202;1016;2579;801;2237;74;216;482;1324;556;1540
313080;202202;421;1146;319;960;58;196;122;315;180;511
313090;202202;5864;14411;4991;13073;319;893;3502;9114;3821;10007
313100;202202;1451;3607;1147;3171;41;150;861;2320;902;2470
313110;202202;1628;4095;1212;3395;101;343;675;1723;776;2066
313115;202202;3128;8388;2542;7328;264;941;1468;3886;1732;4827
313120;202202;4159;9509;3079;8102;209;560;2112;5618;2321;6178
313130;202202;35651;87215;27468;72900;2572;7985;16276;40440;18848;48425
313140;202202;771;1598;514;1252;27;72;399;959;426;1031
313150;202202;1517;4123;1150;3482;368;1246;243;660;611;1906
313160;202202;1407;3355;1105;2915;25;89;854;2181;879;2270
313170;202202;12604;33945;9536;28336;1574;5188;3782;10166;5356;15354
313180;202202;2610;6564;1934;5199;224;579;1207;3169;1431;3748
313190;202202;4846;13333;3642;11009;627;2066;1384;3839;2011;5905
313200;202202;1248;3196;1075;2897;16;70;925;2427;941;2497
313210;202202;4342;11496;3614;10305;393;1268;2315;6371;2708;7639
313220;202202;1970;4962;1354;3789;163;508;639;1594;802;2102
313230;202202;3094;8309;2527;7602;71;235;2064;6366;2135;6601
313240;202202;11668;27452;8113;22008;949;3049;4360;11058;5309;14107
313250;202202;6857;19210;5313;15961;913;2779;2556;7372;3469;10151
313260;202202;826;2016;605;1659;84;308;324;777;408;1085
313270;202202;6675;15250;5500;13683;463;1056;4209;10645;4672;11701
313280;202202;512;1354;348;1034;45;157;153;431;198;588
313290;202202;1116;3343;861;2885;188;713;351;1158;539;1871
313300;202202;1939;5009;1499;4274;328;1015;530;1364;858;2379
313310;202202;1457;4149;1180;3592;194;711;417;1067;611;1778
313320;202202;2231;5674;1619;4711;312;960;643;1935;955;2895
313330;202202;4552;11300;3499;9761;220;685;2360;6512;2580;7197
313340;202202;1645;3554;1232;2990;78;223;922;2191;1000;2414
313350;202202;3306;8774;2283;6580;228;786;1001;2514;1229;3300
313360;202202;1716;4042;1205;3251;178;602;663;1650;841;2252
313370;202202;1742;4578;1413;3958;256;773;590;1506;846;2279
313375;202202;2052;5171;1368;3953;237;786;390;1003;627;1789
313380;202202;7250;17387;5451;14232;763;2343;2922;6785;3685;9128
313390;202202;867;2634;755;2438;56;249;526;1626;582;1875
313400;202202;4124;9569;3206;8275;151;445;2463;6225;2614;6670
313410;202202;1533;3749;1149;3100;153;449;703;1816;856;2265
313420;202202;17317;37451;9773;25244;2400;6681;1677;4290;4077;10971
313430;202202;1175;3044;961;2648;91;351;610;1491;701;1842
313440;202202;7081;14539;5017;11940;216;576;3744;8734;3960;9310
313450;202202;819;2081;597;1682;103;318;226;542;329;860
313460;202202;2423;6533;1946;5792;352;1171;990;2854;1342;4025
313470;202202;3088;7538;2464;6629;149;474;1870;4957;2019;5431
313480;202202;1162;3187;730;2269;75;258;268;757;343;1015
313490;202202;3368;8112;1888;5483;331;1065;590;1604;921;2669
313500;202202;635;1634;471;1308;37;109;212;540;249;649
313505;202202;11039;27743;9416;25538;334;1091;7662;20750;7996;21841
313507;202202;1547;3807;1243;3349;42;163;1000;2624;1042;2787
313510;202202;16130;42073;12707;35485;1306;3918;6839;18137;8145;22055
313520;202202;16680;42856;13470;37575;663;2249;10408;28255;11071;30504
313530;202202;632;1794;478;1471;59;218;194;510;253;728
313535;202202;2563;6834;2110;5985;215;585;1346;3794;1561;4379
313540;202202;919;2555;750;2169;111;342;365;967;476;1309
313545;202202;1242;3894;1061;3558;113;464;614;1956;727;2420
313550;202202;2209;6115;1856;5308;200;647;1229;3405;1429;4052
313560;202202;3075;5595;2320;4695;40;77;2040;4097;2080;4174
313570;202202;1093;2991;912;2680;168;506;455;1316;623;1822
313580;202202;6572;15493;5201;13296;414;1150;3483;8689;3897;9839
313590;202202;1247;3181;1020;2862;193;543;561;1660;754;2203
313600;202202;4668;11245;3922;10130;82;311;3457;8740;3539;9051
313610;202202;1147;2725;938;2375;68;199;642;1547;710;1746
313620;202202;6040;15241;4904;13250;448;1445;3146;8181;3594;9626
313630;202202;9778;22652;7056;18633;649;2051;4456;11354;5105;13405
313640;202202;1383;2816;900;2205;88;241;601;1442;689;1683
313650;202202;1801;5194;1426;4577;110;418;920;2993;1030;3411
313652;202202;927;2562;836;2407;60;217;637;1748;697;1965
313655;202202;1268;2977;990;2633;75;201;711;1898;786;2099
313657;202202;1269;3182;1004;2772;35;126;764;1990;799;2116
313660;202202;1169;3022;976;2696;64;246;707;1847;771;2093
313665;202202;5937;14763;4794;12837;362;1130;3274;8283;3636;9413
313670;202202;58073;136901;39663;106761;4927;14910;19981;50648;24908;65558
313680;202202;1179;2919;983;2605;48;142;696;1782;744;1924
313690;202202;1024;2929;747;2390;148;527;238;699;386;1226
313695;202202;2009;5049;1517;4243;114;312;1018;2918;1132;3230
313700;202202;3086;9216;2679;8690;224;794;2136;6956;2360;7750
313710;202202;1619;3502;1177;2932;88;228;817;2038;905;2266
313720;202202;6733;17607;4934;14008;666;2062;2195;5658;2861;7720
313730;202202;1571;3219;1179;2722;86;172;791;1817;877;1989
313740;202202;1814;6258;1540;5585;346;1449;382;1231;728;2680
313750;202202;2367;5894;1896;5118;288;886;1079;2689;1367;3575
313753;202202;2386;5609;1610;4368;168;513;854;2240;1022;2753
313760;202202;6344;16744;5046;14350;813;2571;2577;6773;3390;9344
313770;202202;4473;11903;3560;10497;202;567;2705;8107;2907;8674
313780;202202;4484;11214;3369;9469;446;1186;1175;3433;1621;4619
313790;202202;617;1710;543;1574;66;213;345;964;411;1177
313800;202202;1523;3247;1122;2705;97;270;665;1511;762;1781
313810;202202;1860;4378;1509;3893;52;196;1233;3088;1285;3284
313820;202202;19490;48137;12989;34684;2090;5780;3861;9739;5951;15519
313830;202202;449;1250;332;1002;60;197;137;385;197;582
313835;202202;971;2694;806;2412;75;289;467;1306;542;1595
313840;202202;8646;21616;6859;18779;1431;4150;2053;5668;3484;9818
313850;202202;1082;2524;863;2228;126;379;468;1118;594;1497
313860;202202;3000;7501;2316;6308;299;981;1193;2946;1492;3927
313862;202202;1343;2783;691;1857;39;120;338;923;377;1043
313865;202202;2859;7094;2366;6325;78;251;1825;4720;1903;4971
313867;202202;1553;4492;1291;4020;224;708;697;2259;921;2967
313868;202202;1880;5350;1540;4730;52;226;1205;3557;1257;3783
313870;202202;1128;2779;766;2142;87;249;344;881;431;1130
313880;202202;2152;5365;1627;4494;168;546;928;2361;1096;2907
313890;202202;2431;4776;1835;4023;40;108;1447;3073;1487;3181
313900;202202;5521;14890;3998;11776;856;2799;1231;3209;2087;6008
313910;202202;798;2247;611;1876;116;378;155;462;271;840
313920;202202;3168;9012;2670;8043;426;1366;1477;4415;1903;5781
313925;202202;1793;4252;1465;3708;125;321;1020;2554;1145;2875
313930;202202;5393;14634;4396;12943;263;960;3108;8906;3371;9866
313940;202202;10382;28540;8030;24671;1278;4220;2248;7569;3526;11789
313950;202202;6083;12591;4740;10964;263;694;3418;7868;3681;8562
313960;202202;6368;14612;4299;11209;749;2216;1541;3607;2290;5823
313970;202202;1709;4320;1461;3920;56;160;988;2578;1044;2738
313980;202202;1452;3663;1007;2994;176;590;452;1277;628;1867
313990;202202;2142;6402;1642;5348;284;1102;797;2344;1081;3446
314000;202202;11322;27066;9369;23886;639;2034;6340;15874;6979;17908
314010;202202;1544;3534;1224;3104;40;143;946;2305;986;2448
314015;202202;2316;6031;1848;5245;182;612;1115;3010;1297;3622
314020;202202;576;1489;393;1181;101;358;72;231;173;589
314030;202202;891;2415;702;2071;99;299;348;1012;447;1311
314040;202202;663;1747;557;1559;71;241;317;847;388;1088
314050;202202;2106;5301;1578;4358;120;415;958;2452;1078;2867
314053;202202;2226;6151;1792;5307;269;759;1081;3292;1350;4051
314055;202202;2461;6017;2087;5471;54;189;1758;4573;1812;4762
314060;202202;1443;3641;1100;3104;33;114;787;2183;820;2297
314070;202202;5383;13786;4350;12037;659;1902;2333;6294;2992;8196
314080;202202;2296;5739;1667;4729;155;513;805;2098;960;2611
314085;202202;2552;6594;2084;5924;191;573;1341;3801;1532;4374
314090;202202;5577;13678;4844;12643;378;984;3335;8998;3713;9982
314100;202202;3260;7614;2539;6627;48;155;1890;4972;1938;5127
314110;202202;5546;14763;4580;13030;463;1504;2657;6953;3120;8457
314120;202202;763;1713;354;990;68;219;115;289;183;508
314130;202202;727;1847;490;1413;27;97;306;854;333;951
314140;202202;5024;13090;4043;11350;409;1274;2366;6407;2775;7681
314150;202202;1612;3883;1187;3171;73;218;816;2126;889;2344
314160;202202;2564;6240;1916;5130;205;590;952;2491;1157;3081
314170;202202;1016;2704;828;2344;41;171;562;1467;603;1638
314180;202202;6095;15783;4927;13975;421;1250;3019;8577;3440;9827
314190;202202;689;1652;518;1412;60;194;313;797;373;991
314200;202202;3258;8700;2711;7813;185;574;1890;5344;2075;5918
314210;202202;2286;5650;1841;4895;284;784;800;2050;1084;2834
314220;202202;1718;4473;1358;3895;208;705;655;1738;863;2443
314225;202202;1185;3263;982;2906;93;259;678;1970;771;2229
314230;202202;940;2341;771;2117;78;226;521;1434;599;1660
314240;202202;1200;3097;939;2715;191;592;428;1216;619;1808
314250;202202;503;1403;335;1050;38;130;137;383;175;513
314260;202202;1223;3008;972;2675;184;518;510;1364;694;1882
314270;202202;3662;9718;3041;8765;107;399;2286;6514;2393;6913
314280;202202;3927;8742;2781;7052;265;761;1719;4082;1984;4843
314290;202202;4951;12105;4166;10777;272;745;2984;7533;3256;8278
314300;202202;2231;6062;1467;4471;269;892;524;1440;793;2332
314310;202202;4231;10781;2941;8653;859;2835;476;1248;1335;4083
314315;202202;1054;3165;896;2847;55;231;647;2005;702;2236
314320;202202;3542;9121;2420;7078;385;1273;1024;2793;1409;4066
314330;202202;57565;154628;44826;132907;10447;32165;12960;38864;23407;71029
314340;202202;2812;6793;1870;5174;357;1133;611;1465;968;2598
314345;202202;1610;4404;1324;3911;102;319;942;2704;1044;3023
314350;202202;905;2392;611;1873;142;479;156;385;298;864
314360;202202;597;1665;406;1273;59;205;129;363;188;568
314370;202202;822;2069;671;1847;49;166;461;1212;510;1378
314380;202202;1250;3271;863;2627;203;696;247;726;450;1422
314390;202202;16200;38911;11462;30865;1587;4830;4774;11394;6361;16224
314400;202202;4350;12513;3392;10665;828;2701;1399;4582;2227;7283
314410;202202;3222;8715;2285;6929;371;1283;630;1911;1001;3194
314420;202202;891;2107;664;1757;33;118;456;1148;489;1266
314430;202202;8886;20196;6412;16313;867;2358;3306;8003;4173;10361
314435;202202;2056;5294;1608;4591;213;645;966;2702;1179;3347
314437;202202;975;2377;703;1942;61;177;411;1129;472;1306
314440;202202;670;1856;486;1503;143;486;117;314;260;800
314450;202202;1618;4047;1345;3613;153;457;779;1994;932;2451
314460;202202;3607;10395;2767;8761;665;2257;918;2720;1583;4977
314465;202202;2488;6695;2115;6032;54;219;1660;4564;1714;4783
314467;202202;1045;2604;885;2341;41;114;676;1732;717;1846
314470;202202;2493;6796;2078;6007;287;918;1083;2945;1370;3863
314480;202202;8596;22770;6695;18980;981;3107;2970;7540;3951;10647
314490;202202;1178;2922;872;2340;63;203;589;1513;652;1716
314500;202202;1904;4384;1391;3729;309;802;588;1613;897;2415
314505;202202;2352;5289;1928;4712;95;257;1500;3541;1595;3798
314510;202202;2215;5566;1611;4674;331;1044;730;2086;1061;3130
314520;202202;6077;17587;4823;15201;1083;3791;1063;3039;2146;6830
314530;202202;5923;17605;5322;16541;294;1205;4074;12284;4368;13489
314535;202202;2906;6959;2351;6171;106;333;1846;4835;1952;5168
314537;202202;1304;3474;1011;3010;60;183;741;2171;801;2354
314540;202202;470;1117;344;919;12;37;213;536;225;573
314545;202202;2145;4784;1934;4544;35;83;1702;4076;1737;4159
314550;202202;823;1899;577;1519;40;139;350;838;390;977
314560;202202;5192;14542;3953;11986;517;1903;1689;4486;2206;6389
314570;202202;339;921;243;745;21;76;130;404;151;480
314580;202202;505;1463;407;1276;95;297;161;488;256;785
314585;202202;726;2106;572;1785;51;193;282;834;333;1027
314587;202202;2468;6236;1927;5392;344;847;1152;3294;1496;4141
314590;202202;4691;12022;3630;10161;405;1315;1840;4765;2245;6080
314600;202202;2016;5309;1295;3987;325;1035;180;518;505;1553
314610;202202;10225;24466;7911;21012;967;3110;3983;10944;4950;14054
314620;202202;2604;5656;2119;5056;87;216;1788;4255;1875;4471
314625;202202;1684;4314;1449;3988;29;156;1257;3392;1286;3548
314630;202202;5833;13878;4752;12414;163;513;3944;10228;4107;10741
314640;202202;825;1803;626;1496;50;151;430;949;480;1100
314650;202202;907;2035;597;1558;60;192;358;841;418;1033
314655;202202;1682;4437;1225;3657;165;486;633;1906;798;2392
314660;202202;370;804;268;633;13;32;188;423;201;455
314670;202202;1803;3888;1265;3151;29;91;882;2126;911;2217
314675;202202;1869;4565;1591;4122;85;232;1248;3176;1333;3408
314690;202202;2220;5832;1684;5043;403;1237;708;2118;1111;3355
314700;202202;12498;32742;8717;25885;1424;4639;3817;10821;5241;15460
314710;202202;9120;24444;6858;19816;960;3126;2844;7253;3804;10379
314720;202202;2486;7096;1795;5718;347;1206;427;1224;774;2430
314730;202202;2689;6718;1951;5431;323;985;779;1987;1102;2972
314740;202202;3441;9178;2753;7995;395;1210;1484;4175;1879;5385
314750;202202;314;810;245;669;26;90;151;367;177;457
314760;202202;2098;5943;1413;4472;230;850;404;1030;634;1880
314770;202202;1156;3233;706;2191;87;270;223;643;310;913
314780;202202;399;963;290;796;28;97;166;414;194;511
314790;202202;13192;33606;9682;27370;1397;4589;4479;11961;5876;16550
314795;202202;1668;4155;1425;3764;34;150;1154;2916;1188;3066
314800;202202;12243;30134;8187;22984;1380;4263;2669;6693;4049;10956
314810;202202;10554;26653;7976;22391;1905;5691;3088;8404;4993;14095
314820;202202;1446;3295;1144;2854;75;243;745;1766;820;2009
314830;202202;1871;5113;1570;4601;166;537;928;2623;1094;3160
314840;202202;941;2804;743;2452;47;226;540;1695;587;1921
314850;202202;2559;5230;2084;4650;44;130;1858;4110;1902;4240
314860;202202;3599;9812;3028;8820;153;614;2229;6261;2382;6875
314870;202202;7286;16136;5621;14094;258;650;4336;11014;4594;11664
314875;202202;2069;5807;1847;5528;152;409;1476;4504;1628;4913
314880;202202;896;2103;698;1800;39;118;451;1132;490;1250
314890;202202;503;1419;391;1209;53;183;192;543;245;726
314900;202202;928;2274;717;1920;90;266;361;945;451;1211
314910;202202;1863;5024;1401;4286;200;734;741;2129;941;2863
314915;202202;2308;6476;1926;5806;131;480;1309;3854;1440;4334
314920;202202;556;1390;387;1149;18;58;268;806;286;864
314930;202202;6459;17356;5066;14824;784;2630;2303;6173;3087;8803
314940;202202;448;1029;373;910;27;65;265;613;292;678
314950;202202;634;1521;451;1249;40;146;255;642;295;788
314960;202202;984;2182;774;1852;44;119;576;1315;620;1434
314970;202202;1183;3370;921;2863;141;484;431;1239;572;1723
314980;202202;1850;4529;1435;3925;190;608;869;2303;1059;2911
314990;202202;2937;8135;2176;6508;361;1149;602;1626;963;2775
314995;202202;1839;4851;1483;4232;43;178;1011;2715;1054;2893
315000;202202;1225;2999;902;2499;79;255;595;1607;674;1862
315010;202202;431;1124;342;983;39;145;200;539;239;684
315015;202202;2613;6865;2287;6344;209;692;1592;4298;1801;4990
315020;202202;845;2376;626;1934;67;266;309;877;376;1143
315030;202202;696;1756;490;1395;140;390;125;316;265;706
315040;202202;1049;2643;883;2387;128;361;571;1466;699;1827
315050;202202;1318;3217;995;2737;72;233;551;1462;623;1695
315053;202202;1303;3199;991;2686;69;236;606;1546;675;1782
315057;202202;1953;5418;1577;4807;157;417;1047;3359;1204;3776
315060;202202;716;2044;539;1694;112;370;147;431;259;801
315070;202202;713;1686;544;1412;104;297;257;584;361;881
315080;202202;3515;9080;2744;7745;138;473;1979;5318;2117;5791
315090;202202;884;2548;684;2203;93;326;306;928;399;1254
315100;202202;1513;4254;1044;3223;134;505;503;1356;637;1861
315110;202202;2326;5265;1720;4384;146;362;989;2509;1135;2871
315120;202202;14044;31132;10560;26055;1118;2608;6498;16221;7616;18829
315130;202202;1852;4849;1582;4402;162;537;745;1916;907;2453
315140;202202;3316;8786;2654;7663;504;1619;1408;3820;1912;5439
315150;202202;4837;11478;3509;9409;470;1440;1758;4637;2228;6077
315160;202202;2061;4818;1426;3838;236;678;735;1939;971;2617
315170;202202;1495;4564;1094;3639;222;793;328;1049;550;1842
315180;202202;19375;45723;11750;32279;1560;4849;4374;10634;5934;15483
315190;202202;2379;5054;1874;4404;164;386;1421;3356;1585;3742
315200;202202;4681;12454;3566;10594;937;2970;1191;3405;2128;6375
315210;202202;9856;24359;7084;18915;652;1972;3713;8879;4365;10851
315213;202202;1176;3011;1024;2800;22;89;850;2272;872;2361
315217;202202;3033;8277;2313;7078;113;486;1606;4714;1719;5200
315220;202202;9380;24375;7483;21215;677;1817;4354;12413;5031;14230
315230;202202;3201;7071;2642;6331;183;372;1837;4646;2020;5018
315240;202202;2677;7368;2246;6643;442;1366;1155;3422;1597;4788
315250;202202;15709;40563;11814;33517;1698;5320;5470;14560;7168;19880
315260;202202;996;2603;589;1792;133;400;61;167;194;567
315270;202202;1001;2766;758;2305;122;417;298;806;420;1223
315280;202202;3238;7840;2140;5957;555;1610;491;1366;1046;2976
315290;202202;1302;3077;805;2306;186;581;298;828;484;1409
315300;202202;734;1740;539;1449;32;99;369;982;401;1081
315310;202202;1351;3489;1046;2956;80;274;658;1714;738;1988
315320;202202;694;1977;495;1592;66;256;208;620;274;876
315330;202202;843;2614;507;1789;62;249;200;625;262;874
315340;202202;3263;7663;2277;6187;379;1076;1083;2891;1462;3967
315350;202202;1934;4799;1615;4318;123;388;1161;3007;1284;3395
315360;202202;1914;5340;1521;4594;206;645;705;2002;911;2647
315370;202202;607;1611;498;1416;69;202;261;713;330;915
315380;202202;279;757;199;597;38;114;26;60;64;174
315390;202202;1330;3591;1094;3187;106;393;631;1691;737;2084
315400;202202;4539;11565;3642;10033;378;1199;2302;5986;2680;7185
315410;202202;2685;5843;1998;4857;372;985;504;1269;876;2254
315415;202202;1594;4142;1303;3690;266;884;473;1300;739;2184
315420;202202;1648;4406;1180;3569;228;730;315;868;543;1598
315430;202202;3988;9363;2832;7658;430;1315;1417;3698;1847;5013
315440;202202;1136;2879;905;2516;73;247;541;1401;614;1648
315445;202202;2203;4878;1639;4090;75;251;1321;3213;1396;3464
315450;202202;2512;6507;2067;5798;207;565;1378;3825;1585;4390
315460;202202;46236;119601;38988;107391;4157;13753;24814;63884;28971;77637
315470;202202;746;1999;540;1515;42;129;292;769;334;898
315480;202202;1335;3643;972;2906;150;478;405;1157;555;1635
315490;202202;3199;7704;2263;6216;275;841;996;2543;1271;3384
315500;202202;577;1479;372;1066;28;103;212;533;240;636
315510;202202;1448;3482;1229;3185;11;56;1090;2754;1101;2810
315520;202202;1162;2893;974;2607;44;143;796;2069;840;2212
315530;202202;742;1867;609;1641;70;220;423;1071;493;1291
315540;202202;1811;4607;1253;3578;106;369;567;1523;673;1892
315550;202202;2020;5233;1412;4126;256;871;443;1299;699;2170
315560;202202;7096;19928;6115;18228;377;1134;4395;13088;4772;14222
315570;202202;2656;6540;1976;5395;247;819;1042;2603;1289;3422
315580;202202;3484;7770;2748;6642;409;1057;1158;2638;1567;3695
315590;202202;1107;2542;897;2239;40;155;654;1510;694;1665
315600;202202;2762;8018;1975;6526;363;1095;972;3436;1335;4531
315610;202202;1078;2594;817;2151;111;380;414;942;525;1322
315620;202202;572;1469;443;1275;52;161;239;693;291;854
315630;202202;1163;2980;891;2496;122;408;452;1136;574;1544
315640;202202;395;941;298;823;31;110;189;495;220;605
315645;202202;1089;2688;770;2194;146;458;233;639;379;1097
315650;202202;1897;4212;1544;3725;61;153;1238;2937;1299;3090
315660;202202;2424;5936;1875;4982;118;339;1303;3370;1421;3709
315670;202202;16478;42287;12979;36168;2041;6179;6658;17474;8699;23653
315680;202202;3463;9379;2630;7887;304;1029;1454;4188;1758;5217
315690;202202;4100;9671;2560;7118;485;1319;802;2356;1287;3675
315700;202202;9429;24326;7267;20238;781;2450;3890;10117;4671;12567
315710;202202;2042;4763;1482;3948;70;231;1034;2672;1104;2903
315720;202202;4795;12665;3984;11269;195;797;2872;7761;3067;8558
315725;202202;2485;6063;1954;5234;189;493;1287;3561;1476;4054
315727;202202;638;1565;488;1321;66;208;242;617;308;825
315730;202202;667;1917;583;1761;133;441;224;603;357;1044
315733;202202;1513;3652;1173;3123;164;488;521;1266;685;1754
315737;202202;1299;3409;984;2815;33;131;706;1929;739;2060
315740;202202;889;2409;722;2079;59;226;503;1359;562;1585
315750;202202;1387;3421;1113;3005;83;235;759;2053;842;2288
315760;202202;1275;2863;1104;2640;37;121;936;2166;973;2287
315765;202202;2132;5208;1754;4725;29;120;1573;4224;1602;4344
315770;202202;1156;3061;918;2745;341;1099;256;732;597;1831
315780;202202;34156;88603;28867;79487;1723;5960;20030;52280;21753;58240
315790;202202;3895;11377;3335;10345;306;958;2092;6721;2398;7679
315800;202202;1437;4572;1112;3832;145;606;444;1334;589;1940
315810;202202;1471;3434;1235;3051;57;176;988;2361;1045;2537
315820;202202;3074;7389;2477;6602;230;624;1789;4778;2019;5402
315830;202202;1342;3829;935;2944;100;354;299;786;399;1140
315840;202202;973;2249;699;1787;54;176;384;887;438;1063
315850;202202;1309;3576;1050;3158;148;468;585;1687;733;2155
315860;202202;554;1493;401;1232;81;287;147;387;228;674
315870;202202;509;1334;403;1162;24;82;293;807;317;889
315880;202202;1236;2974;889;2382;119;351;347;837;466;1188
315890;202202;1954;5197;1613;4746;378;1153;833;2521;1211;3674
315895;202202;7060;18253;5396;15151;538;1764;2855;7415;3393;9179
315900;202202;843;2134;720;1962;56;189;540;1408;596;1597
315910;202202;593;1531;505;1404;57;169;371;1021;428;1190
315920;202202;1559;3839;925;2670;144;487;340;885;484;1372
315930;202202;1253;2664;869;2133;97;236;461;1090;558;1326
315935;202202;1083;3083;881;2701;174;534;372;1137;546;1671
315940;202202;682;1734;547;1547;77;227;300;815;377;1042
315950;202202;1283;3362;1074;3037;99;305;828;2308;927;2613
315960;202202;6218;16693;4435;13235;1037;3456;1092;2580;2129;6036
315970;202202;621;1604;501;1445;56;174;342;1008;398;1182
315980;202202;4691;9749;2732;6682;484;1255;1242;2754;1726;4009
315990;202202;3836;9520;3042;8195;305;887;1768;4575;2073;5462
316000;202202;777;1748;612;1519;52;159;385;906;437;1065
316010;202202;830;2247;620;1870;68;229;298;782;366;1011
316020;202202;1021;2851;821;2468;106;369;487;1377;593;1746
316030;202202;3012;7948;2333;6749;258;745;1544;4536;1802;5281
316040;202202;2927;8047;2176;6652;372;1326;650;1717;1022;3043
316045;202202;2392;5567;2210;5346;65;127;1996;4862;2061;4989
316050;202202;420;1127;329;984;37;120;187;511;224;631
316060;202202;772;1789;574;1531;27;98;424;1091;451;1189
316070;202202;6060;15917;5008;14007;730;2117;2630;7090;3360;9207
316080;202202;841;2524;668;2178;185;643;129;375;314;1018
316090;202202;493;1296;404;1135;46;167;239;585;285;752
316095;202202;1436;4225;1126;3478;261;882;475;1368;736;2250
316100;202202;2685;7415;2021;6082;319;1115;849;2299;1168;3414
316105;202202;895;2205;728;1950;47;126;472;1318;519;1444
316110;202202;15235;40670;12778;36682;871;2959;9233;25927;10104;28886
316120;202202;1360;3579;910;2625;152;470;330;757;482;1227
316130;202202;1387;3023;933;2295;74;223;589;1374;663;1597
316140;202202;1319;3375;850;2493;109;346;360;1051;469;1397
316150;202202;2378;5162;1898;4468;150;437;1033;2301;1183;2738
316160;202202;1094;2792;882;2416;41;147;643;1715;684;1862
316165;202202;989;2250;797;1969;84;231;527;1246;611;1477
316170;202202;1397;3202;1085;2760;52;189;792;1893;844;2082
316180;202202;1642;4431;1179;3557;209;702;331;901;540;1603
316190;202202;2928;7992;1792;5367;246;783;758;2015;1004;2798
316200;202202;3789;10273;2982;8919;506;1741;1274;3624;1780;5365
316210;202202;5559;15759;4000;12171;1389;4649;374;977;1763;5626
316220;202202;739;2166;524;1734;105;361;83;300;188;661
316225;202202;1733;3773;1323;3164;48;173;1017;2233;1065;2406
316230;202202;513;1324;406;1148;73;230;206;562;279;792
316240;202202;6104;16792;5342;15461;390;1274;4044;11490;4434;12764
316245;202202;3489;10418;3171;9904;149;752;2549;7606;2698;8358
316250;202202;12076;27790;9245;23294;1650;4459;3830;9634;5480;14093
316255;202202;3303;8667;2881;8011;155;382;2136;6080;2291;6462
316257;202202;1566;3531;1160;2876;66;183;813;1914;879;2097
316260;202202;2564;5853;2034;5029;207;488;1222;3030;1429;3518
316265;202202;1226;3180;971;2751;20;82;731;1992;751;2074
316270;202202;4067;11836;3509;10691;394;1310;2012;5821;2406;7131
316280;202202;3302;8665;2803;7774;340;1059;1638;4373;1978;5432
316290;202202;4044;10648;3280;9217;418;1314;1339;3582;1757;4896
316292;202202;6216;15498;5035;13660;546;1615;3374;8858;3920;10473
316294;202202;960;2736;739;2370;113;445;225;655;338;1100
316295;202202;3715;9991;3087;8948;184;696;2167;5987;2351;6683
316300;202202;1110;2998;886;2652;43;150;627;1849;670;1999
316310;202202;874;2266;603;1793;145;497;170;459;315;956
316320;202202;737;1965;580;1718;121;411;168;459;289;870
316330;202202;1184;2945;907;2483;50;147;684;1841;734;1988
316340;202202;1074;2803;815;2350;74;289;493;1335;567;1624
316350;202202;1470;3879;1232;3478;152;438;822;2280;974;2718
316360;202202;708;1770;601;1604;43;115;479;1287;522;1402
316370;202202;6303;15273;4926;12982;558;1752;2683;6327;3241;8079
316380;202202;1897;4311;1510;3774;93;199;1068;2662;1161;2861
316390;202202;826;2161;608;1794;244;811;113;297;357;1108
316400;202202;1313;3566;885;2746;98;328;336;939;434;1267
316410;202202;1249;3216;1049;2919;31;111;897;2424;928;2535
316420;202202;2141;5547;1855;5174;38;169;1556;4226;1594;4395
316430;202202;962;2407;672;1943;99;338;307;810;406;1148
316440;202202;929;2741;757;2438;135;513;221;640;356;1153
316443;202202;601;1602;444;1312;100;342;121;340;221;682
316447;202202;2306;5683;1999;5230;36;101;1757;4533;1793;4634
316450;202202;2326;6575;1809;5544;201;705;1142;3354;1343;4059
316460;202202;1389;3458;1140;3069;104;307;782;2004;886;2311
316470;202202;7992;21815;6040;17950;838;2874;2755;7395;3593;10269
316480;202202;225;573;198;541;37;109;119;306;156;415
316490;202202;355;938;262;772;45;151;92;232;137;383
316500;202202;1399;4104;983;3153;207;737;252;729;459;1466
316510;202202;878;2730;713;2413;112;395;381;1286;493;1681
316520;202202;1505;3509;1186;2978;164;487;591;1340;755;1827
316530;202202;1233;3114;916;2562;104;386;481;1217;585;1603
316540;202202;1088;2650;897;2380;106;339;501;1214;607;1553
316550;202202;1515;4126;1286;3718;53;187;1031;2953;1084;3140
316553;202202;5045;14062;3801;11261;465;1571;1745;4532;2210;6103
316555;202202;2908;8237;2610;7843;82;317;2249;6693;2331;7010
316556;202202;567;1330;441;1114;33;101;274;608;307;709
316557;202202;1240;3569;1072;3315;322;1095;447;1334;769;2429
316560;202202;375;1010;277;864;42;152;131;383;173;535
316570;202202;1546;4147;1310;3748;301;806;481;1484;782;2290
316580;202202;424;870;279;643;36;92;148;321;184;413
316590;202202;1455;3542;1019;2731;137;343;582;1497;719;1840
316600;202202;1051;2987;913;2731;140;421;532;1575;672;1996
316610;202202;684;1966;560;1777;49;204;348;1060;397;1264
316620;202202;2419;5848;2137;5454;109;288;1747;4428;1856;4716
316630;202202;1717;4861;1445;4365;357;1021;593;2056;950;3077
316640;202202;174;458;145;417;31;105;56;130;87;235
316650;202202;1190;3370;962;3023;71;260;668;2042;739;2302
316660;202202;210;485;99;260;15;43;30;59;45;102
316670;202202;1881;4561;1436;3871;347;961;523;1370;870;2331
316680;202202;2525;6253;1912;5126;144;439;1377;3571;1521;4010
316690;202202;1536;4150;1167;3495;195;645;503;1449;698;2094
316695;202202;1092;3055;916;2746;26;104;633;1855;659;1959
316700;202202;475;972;399;891;9;27;344;741;353;768
316710;202202;3663;11040;2930;9603;451;1671;1550;4882;2001;6553
316720;202202;23010;60130;17765;50587;2639;8167;8634;23221;11273;31388
316730;202202;571;1376;466;1204;58;158;251;605;309;763
316740;202202;885;2392;773;2218;100;323;529;1501;629;1824
316750;202202;436;1203;336;1033;60;199;159;469;219;668
316760;202202;4054;11994;3502;10988;1155;3949;1359;4224;2514;8173
316770;202202;1765;3750;1353;3213;36;88;1095;2657;1131;2745
316780;202202;616;1728;499;1528;159;536;147;418;306;954
316790;202202;803;2084;601;1695;80;245;195;521;275;766
316800;202202;7174;19136;5780;16695;681;2154;2984;8334;3665;10488
316805;202202;1214;2445;988;2193;43;109;830;1824;873;1933
316810;202202;718;1890;536;1557;67;221;344;965;411;1186
316820;202202;366;833;216;584;18;61;114;292;132;353
316830;202202;921;2283;727;1978;78;221;463;1248;541;1469
316840;202202;3123;7547;2526;6618;144;480;1924;4829;2068;5309
316850;202202;2323;5561;1766;4640;169;535;1070;2581;1239;3116
316860;202202;23177;55985;17525;47632;2239;7111;9160;23912;11399;31023
316870;202202;9245;23620;7160;19835;850;2723;3758;9601;4608;12324
316880;202202;1112;2832;940;2595;116;367;570;1487;686;1854
316890;202202;1261;2748;787;2134;81;287;522;1336;603;1623
316900;202202;2655;6765;2142;5836;386;1079;864;2227;1250;3306
316905;202202;538;1541;441;1358;101;318;200;642;301;960
316910;202202;1068;2639;717;2046;207;647;157;408;364;1055
316920;202202;2027;4616;1489;3844;190;568;930;2250;1120;2818
316930;202202;9520;25625;7469;22130;1506;4881;2924;7955;4430;12836
316935;202202;4722;12081;3574;10040;573;1799;1646;4260;2219;6059
316940;202202;7017;19726;5595;16989;707;2486;2705;7596;3412;10082
316950;202202;2126;4683;1659;4061;39;112;1421;3439;1460;3551
316960;202202;5677;12162;4159;10173;290;790;3030;7241;3320;8031
316970;202202;4376;11462;3764;10413;470;1387;1852;4808;2322;6195
316980;202202;783;2257;613;1940;211;743;144;447;355;1190
316990;202202;13986;35935;10690;29564;2381;7030;2239;5710;4620;12740
317000;202202;2778;7629;2458;7185;210;537;1881;5557;2091;6094
317005;202202;2859;7561;2267;6399;309;945;1319;3594;1628;4539
317010;202202;27950;63919;18748;50079;3120;9028;8742;23279;11862;32307
317020;202202;73259;169972;46387;124475;7903;23225;17286;42826;25189;66051
317030;202202;755;1902;601;1692;13;49;468;1295;481;1344
317040;202202;12384;29995;8859;24144;1871;5365;3326;9424;5197;14789
317043;202202;999;2114;736;1763;43;110;562;1309;605;1419
317047;202202;1270;2923;894;2327;53;171;628;1571;681;1742
317050;202202;1340;3982;980;3182;130;494;404;1119;534;1613
317052;202202;2695;6911;2177;6107;189;575;1531;4246;1720;4821
317057;202202;2228;4778;1678;3974;39;103;1263;2883;1302;2986
317060;202202;566;1465;356;1038;50;155;150;392;200;547
317065;202202;1212;3445;1000;3048;63;239;651;1856;714;2095
317070;202202;8265;22299;6312;18634;978;3271;2600;7151;3578;10422
317075;202202;1084;2679;829;2256;94;299;474;1210;568;1509
317080;202202;7067;15787;5375;13167;1090;2835;2463;5869;3553;8704
317090;202202;5300;14330;4703;13399;263;766;3626;10283;3889;11049
317100;202202;2856;6594;1918;5094;371;1007;830;2158;1201;3165
317103;202202;2488;6019;2129;5527;63;282;1748;4374;1811;4656
317107;202202;1641;4065;1254;3370;65;239;822;1971;887;2210
317110;202202;716;1658;401;1160;77;257;151;437;228;694
317115;202202;1202;3291;1012;2947;99;317;655;1888;754;2205
317120;202202;19327;48921;16092;43868;1066;3656;10933;28179;11999;31835
317130;202202;12752;28658;8881;22396;1225;3344;3504;8816;4729;12160
317140;202202;1053;2398;823;2043;57;142;583;1466;640;1608
317150;202202;1046;2418;820;2131;35;116;669;1702;704;1818
317160;202202;3898;8973;2621;6980;232;576;1460;4025;1692;4601
317170;202202;2094;5052;1601;4192;110;362;997;2372;1107;2734
317180;202202;2147;6377;1610;5126;320;1088;484;1409;804;2497
317190;202202;1264;3315;945;2796;134;419;527;1531;661;1950
317200;202202;6972;17717;5249;14352;965;2838;1652;4076;2617;6914
317210;202202;1318;3053;1026;2662;38;133;751;1969;789;2102
317220;202202;319;907;278;837;49;151;149;439;198;590
320010;202202;5142;14428;4050;12252;401;1381;2496;7305;2897;8686
320013;202202;2328;6022;1681;4803;250;718;807;2403;1057;3121
320016;202202;3185;7855;2529;6870;194;526;1791;4871;1985;5397
320020;202202;4742;11790;3635;9898;572;1742;1699;4633;2271;6375
320030;202202;1931;5170;1299;3949;212;705;486;1407;698;2112
320035;202202;2143;5500;1775;4905;335;1020;988;2645;1323;3665
320040;202202;4853;13189;4101;11895;508;1604;2393;6642;2901;8246
320050;202202;2004;4394;1748;4031;205;557;1106;2416;1311;2973
320060;202202;15594;40751;11876;33542;1725;5300;5689;14826;7414;20126
320070;202202;1955;5070;1456;4135;227;748;673;1695;900;2443
320080;202202;6257;15518;4519;12171;789;2243;1923;4878;2712;7121
320090;202202;9500;24347;6489;18383;1341;4045;2594;6851;3935;10896
320100;202202;3587;9174;2953;8098;405;1189;1713;4649;2118;5838
320110;202202;2449;5439;1783;4417;180;552;1082;2475;1262;3027
320115;202202;2400;7102;2085;6607;660;2153;908;2999;1568;5152
320120;202202;28186;68844;20607;55826;2604;7781;10557;26800;13161;34581
320130;202202;58772;152540;49068;135764;5366;16555;30634;81400;36000;97955
320140;202202;4255;11208;3010;8806;383;1325;1416;3934;1799;5259
320150;202202;16007;39794;11790;32176;2772;8400;2179;5374;4951;13774
320160;202202;7071;18755;5349;15608;669;2221;2633;7435;3302;9656
320170;202202;1987;5469;1444;4410;355;1073;581;1870;936;2943
320180;202202;814;2433;664;2149;224;781;189;578;413;1359
320190;202202;3301;10072;2620;8620;672;2453;671;2027;1343;4480
320200;202202;1473;3878;1044;3123;227;726;341;1031;568;1757
320210;202202;5000;12233;3904;10407;583;1700;2166;5444;2749;7144
320220;202202;3762;9294;2949;8004;459;1330;1556;4012;2015;5342
320225;202202;1621;4780;1150;3725;351;1248;303;965;654;2213
320230;202202;5975;15552;4593;13283;970;2989;1726;4992;2696;7981
320240;202202;19234;46679;14586;39483;3523;10158;4786;12852;8309;23010
320245;202202;3570;10075;2734;8351;875;2832;532;1577;1407;4409
320250;202202;3094;7924;2137;5854;369;1178;943;2239;1312;3417
320255;202202;2264;6548;1978;6047;386;1239;1127;3494;1513;4733
320260;202202;1620;4394;1051;3203;212;711;284;724;496;1435
320265;202202;2633;7829;2117;6813;885;3047;371;1159;1256;4206
320270;202202;2498;6862;1959;5803;453;1488;745;2194;1198;3682
320280;202202;8757;21895;7212;19372;1100;3333;4322;11085;5422;14418
320290;202202;1513;4322;1000;3135;240;821;264;790;504;1611
320300;202202;4648;13045;3793;11405;967;3221;1387;3959;2354;7180
320305;202202;5867;15717;4574;13297;827;2592;2243;6315;3070;8907
320310;202202;2503;6532;1793;5115;312;972;819;2186;1131;3158
320313;202202;2790;6616;1939;5106;365;1070;652;1517;1017;2587
320316;202202;1811;4845;1397;4164;212;633;768;2295;980;2928
320320;202202;25307;63479;18533;52202;3973;11664;7322;20583;11295;32247
320330;202202;3212;8319;2521;7115;382;1120;1435;4070;1817;5190
320332;202202;9406;24051;7557;20742;1449;4301;3671;9792;5120;14093
320334;202202;2071;5611;1462;4378;289;1046;383;877;672;1923
320335;202202;1765;4981;1257;3826;237;836;402;1127;639;1963
320340;202202;5890;13590;4937;12250;457;1248;3215;7921;3672;9169
320350;202202;6064;14190;4366;11266;416;1244;2536;6103;2952;7347
320360;202202;1579;3882;1189;3180;142;387;588;1511;730;1898
320370;202202;3054;8818;2332;7306;638;2176;820;2456;1458;4632
320380;202202;3136;7769;2608;6929;257;786;1700;4336;1957;5122
320390;202202;8672;22021;6491;17832;1263;3721;2778;7193;4041;10914
320400;202202;3693;9992;2795;8120;716;2232;1043;2888;1759;5120
320405;202202;5978;14800;4596;12479;571;1696;2545;6642;3116;8338
320410;202202;5468;13454;4221;11500;705;1939;2172;6037;2877;7976
320420;202202;4160;10030;3267;8634;699;1987;1221;3068;1920;5055
320425;202202;2425;5593;1884;4711;166;437;1195;2884;1361;3321
320430;202202;3610;8777;2896;7575;369;1018;1801;4554;2170;5572
320435;202202;2542;7554;2004;6446;546;1891;798;2595;1344;4486
320440;202202;1719;4586;1308;3827;207;680;606;1659;813;2339
320450;202202;2136;5734;1700;4952;299;1036;877;2336;1176;3372
320455;202202;5028;14663;3501;11178;818;2905;957;2750;1775;5655
320460;202202;2347;6655;1734;5417;429;1498;527;1537;956;3035
320465;202202;1637;4367;1210;3558;227;697;598;1768;825;2465
320470;202202;4393;11359;3346;9279;658;2040;1168;2921;1826;4961
320480;202202;2411;5780;1985;5084;230;598;1346;3366;1576;3964
320490;202202;27276;66043;20926;55425;3267;9014;10003;26158;13270;35172
320495;202202;1566;4108;1165;3338;272;900;314;804;586;1704
320500;202202;65203;164585;53275;144929;6060;18642;33240;86011;39300;104653
320501;202202;5419;15024;4134;12705;1102;3755;1336;4077;2438;7832
320503;202202;2657;7353;1791;5612;491;1656;505;1526;996;3182
320506;202202;3022;8769;2298;7234;685;2330;286;899;971;3229
320510;202202;12632;32279;10416;28647;851;2779;6846;17983;7697;20762
320515;202202;2014;5362;1587;4511;388;1210;585;1601;973;2811
320517;202202;2465;6996;1997;6037;559;1795;740;2197;1299;3992
320520;202202;44489;110143;34308;93485;5135;15594;16387;42649;21522;58243
320530;202202;39016;97343;31411;84528;2454;8053;20427;51573;22881;59626
330010;202202;28267;68886;23927;62170;2045;6105;17604;44127;19649;50232
330015;202202;1629;3765;1316;3327;176;515;839;2021;1015;2536
330020;202202;22392;53478;19025;48759;2122;5880;13894;35117;16016;40997
330022;202202;2200;5651;1753;4943;268;754;929;2645;1197;3399
330023;202202;7060;15904;5490;13601;713;1952;3568;8546;4281;10498
330025;202202;7957;17582;5192;13171;1026;2917;1777;4208;2803;7125
330030;202202;11964;29931;9435;26067;678;2428;6500;16951;7178;19379
330040;202202;18146;44607;14989;39582;841;2793;11041;27739;11882;30532
330045;202202;104400;227399;88139;207485;4254;10909;74638;173009;78892;183918
330050;202202;3249;8068;2548;6968;404;1258;1443;3696;1847;4954
330060;202202;6405;15531;5104;13341;873;2650;2412;5757;3285;8407
330070;202202;29278;68409;24371;61672;2830;7828;16428;40866;19258;48694
330080;202202;10965;25239;9421;23127;1006;2637;6648;16210;7654;18847
330090;202202;3808;7599;2772;6207;165;365;2040;4568;2205;4933
330093;202202;3140;7114;2393;6126;115;322;1883;4745;1998;5067
330095;202202;1656;4285;1308;3674;129;406;778;2059;907;2465
330100;202202;83235;204795;72399;189594;2994;9998;58386;149821;61380;159819
330110;202202;2463;6402;1991;5682;234;746;1287;3524;1521;4270
330115;202202;3128;7049;2267;5740;352;966;1278;3068;1630;4034
330120;202202;4122;8421;3196;7287;167;459;2521;5506;2688;5965
330130;202202;5018;12763;4178;11573;445;1322;2862;7785;3307;9107
330140;202202;4499;10557;3698;9498;272;885;2815;6955;3087;7840
330150;202202;2847;6974;2294;6122;350;989;1358;3456;1708;4445
330160;202202;1629;4170;1250;3533;238;712;689;1844;927;2556
330170;202202;143959;325705;120062;294510;13015;31362;88907;217748;101922;249110
330180;202202;2291;5138;1815;4504;96;300;1353;3237;1449;3537
330185;202202;12254;27970;10398;25479;411;1302;8818;21028;9229;22330
330187;202202;5775;13371;4670;11643;566;1482;3041;7349;3607;8831
330190;202202;46798;101598;40608;93387;1854;4976;34050;76503;35904;81479
330200;202202;19419;45816;16120;41833;2221;5551;11582;30293;13803;35844
330205;202202;2562;6002;1978;5083;140;408;1357;3318;1497;3726
330210;202202;3810;8887;2876;7358;330;868;1623;3942;1953;4810
330220;202202;15135;35198;11332;29068;1853;5292;5205;12386;7058;17678
330225;202202;4551;10810;3558;9365;191;634;2651;6775;2842;7409
330227;202202;20273;45793;17219;42186;531;1524;15128;36520;15659;38044
330230;202202;2327;4969;1559;3990;146;411;820;2100;966;2511
330240;202202;28131;68267;23887;62061;1707;5166;18026;45503;19733;50669
330245;202202;1980;4676;1273;3487;250;684;523;1370;773;2054
330250;202202;47561;111924;40056;101243;4726;12836;27956;69473;32682;82309
330260;202202;5665;12797;4378;11094;274;853;3408;8367;3682;9220
330270;202202;37381;82738;24036;61246;3329;9204;11010;26551;14339;35755
330280;202202;2881;6880;2272;5905;179;591;1540;3743;1719;4334
330285;202202;31210;68585;25436;60560;1289;3705;20355;46830;21644;50535
330290;202202;4958;10947;4079;9831;276;860;3203;7364;3479;8224
330300;202202;6659;14633;5029;12394;346;952;3691;8794;4037;9746
330310;202202;3138;7133;2355;5910;139;379;1706;4135;1845;4514
330320;202202;20225;44413;15980;39206;1623;3483;12090;29846;13713;33329
330330;202202;51633;106651;41279;93080;2827;7061;31368;68726;34195;75787
330340;202202;20971;47338;15593;39304;2012;5891;8736;20538;10748;26429
330350;202202;175431;376745;147604;343673;6056;15334;127948;294110;134004;309444
330360;202202;8466;19320;7291;17904;261;654;6272;15296;6533;15950
330370;202202;5907;15707;4703;13755;878;2747;2386;6898;3264;9645
330380;202202;6918;16979;5433;14420;632;2040;3477;8693;4109;10733
330385;202202;4724;12431;3915;11302;651;2110;2270;6319;2921;8429
330390;202202;33424;82926;26544;71901;2792;9035;17373;44285;20165;53320
330395;202202;3801;8707;3128;7873;132;426;2456;6016;2588;6442
330400;202202;4022;9904;3472;9075;162;585;2717;6680;2879;7265
330410;202202;3937;9554;2915;7893;439;1371;1638;4141;2077;5512
330411;202202;3259;8422;2591;7265;163;584;1836;4896;1999;5480
330412;202202;1901;4993;1583;4477;122;423;1096;2928;1218;3351
330414;202202;27137;64623;22447;58392;1225;3737;17845;45496;19070;49233
330415;202202;5539;13962;4161;11629;392;1235;2477;6654;2869;7889
330420;202202;14643;34652;10924;28830;1068;3352;6440;15802;7508;19154
330430;202202;12291;26026;10598;23833;234;788;9149;19891;9383;20679
330440;202202;3315;8091;2586;6919;252;832;1758;4436;2010;5268
330450;202202;1681;4404;1371;3898;129;405;859;2338;988;2743
330452;202202;21572;51315;17643;45507;1735;5202;12307;30545;14042;35747
330455;202202;700023;1539287;568072;1358243;56666;145933;410912;958331;467578;1104264
330460;202202;1357;3469;1055;3048;166;525;610;1732;776;2257
330470;202202;6393;14733;4732;12267;1087;2975;1862;4758;2949;7733
330475;202202;11146;26615;9117;24071;1034;3234;6388;16345;7422;19579
330480;202202;6760;16427;5753;15004;438;1257;4138;10448;4576;11705
330490;202202;129044;282112;106235;252231;9279;23276;79899;186769;89178;210045
330500;202202;9224;21000;7802;19156;500;1402;6009;14461;6509;15863
330510;202202;48745;113160;37476;97848;4256;12048;25873;66252;30129;78300
330513;202202;1507;3612;1237;3260;164;472;784;2054;948;2526
330515;202202;2907;7374;2392;6670;328;1039;1501;4012;1829;5051
330520;202202;14287;34855;12016;31527;1012;3113;8547;21638;9559;24751
330530;202202;1930;4423;1444;3726;248;691;753;1924;1001;2615
330540;202202;3331;8267;2612;7087;599;1732;1134;3025;1733;4757
330550;202202;12637;28587;10051;25306;1895;5080;5802;14403;7697;19483
330555;202202;22650;44039;19183;40071;633;1445;16581;34819;17214;36264
330560;202202;4641;11442;3793;10120;502;1395;2488;6434;2990;7829
330570;202202;3260;8197;2849;7622;384;1094;2019;5339;2403;6433
330575;202202;6762;16099;5898;14717;284;822;4880;11760;5164;12582
330580;202202;23000;56741;18850;49630;2391;7093;11179;27627;13570;34720
330590;202202;1681;4227;1417;3897;192;504;959;2711;1151;3215
330600;202202;14658;35961;12104;32010;778;2546;8452;21438;9230;23984
330610;202202;11322;27881;9328;24858;833;2459;6446;16675;7279;19134
330615;202202;2490;6247;2026;5628;321;833;1376;3911;1697;4744
330620;202202;4784;12727;3854;11193;757;2423;1803;5021;2560;7444
330630;202202;31301;73400;25111;64015;1215;4016;18729;45605;19944;49621
350010;202202;2433;6225;1488;4292;302;934;393;890;695;1824
350020;202202;801;1987;499;1433;63;184;178;493;241;677
350030;202202;3969;10539;3100;9095;617;2085;1629;4446;2246;6531
350040;202202;858;2353;527;1670;72;292;178;437;250;729
350050;202202;1618;3829;1121;3018;200;631;452;1021;652;1652
350055;202202;1027;2570;833;2283;109;302;499;1310;608;1612
350060;202202;273;666;157;427;25;82;63;161;88;243
350070;202202;3643;9309;2487;7284;445;1491;989;2599;1434;4090
350075;202202;679;1876;524;1586;191;603;103;318;294;921
350080;202202;742;1870;520;1502;52;179;240;624;292;803
350090;202202;664;1503;422;1109;72;212;212;517;284;729
350100;202202;2757;6947;1974;5647;119;451;1285;3431;1404;3882
350110;202202;549;1315;402;1067;16;54;265;680;281;734
350115;202202;1357;3789;1122;3337;170;580;598;1612;768;2192
350120;202202;725;1664;441;1176;41;140;245;599;286;739
350130;202202;3619;9271;2885;7960;440;1281;1533;3908;1973;5189
350140;202202;835;2205;604;1792;44;159;339;918;383;1077
350150;202202;569;1651;474;1483;101;341;159;446;260;787
350160;202202;13094;32498;9215;25375;1112;3518;5584;14482;6696;18000
350170;202202;2785;7496;2359;6619;319;1021;1337;3419;1656;4440
350180;202202;1137;2657;675;1845;108;318;295;737;403;1055
350190;202202;3392;9384;2406;7229;356;1263;1133;2938;1489;4201
350200;202202;497;1348;387;1142;18;72;264;730;282;802
350210;202202;6730;15138;4748;12119;408;1230;3140;7591;3548;8821
350220;202202;3312;8785;2356;6979;433;1361;946;2551;1379;3912
350230;202202;1158;2817;955;2541;160;462;583;1489;743;1951
350240;202202;689;1920;471;1431;91;286;135;365;226;651
350250;202202;3695;9759;2811;8338;658;2083;1018;2930;1676;5013
350260;202202;962;2142;634;1616;63;172;397;956;460;1128
350270;202202;5117;12958;4132;11212;515;1584;2412;6071;2927;7655
350275;202202;2880;7376;2335;6580;229;783;1621;4337;1850;5120
350280;202202;20799;46291;13569;34852;2093;5644;6294;15315;8387;20959
350290;202202;3594;9605;2568;7573;455;1454;1145;3141;1600;4595
350300;202202;762;1922;592;1620;67;203;361;925;428;1128
350310;202202;1062;2873;823;2428;104;353;393;1070;497;1423
350315;202202;676;1610;477;1303;30;110;277;662;307;772
350320;202202;17904;44393;13635;37084;2335;7074;6406;16153;8741;23227
350330;202202;15544;36895;11497;29582;1013;2981;7691;18628;8704;21609
350335;202202;421;1150;332;986;42;135;156;443;198;578
350340;202202;1391;3468;882;2542;114;395;415;1076;529;1471
350350;202202;825;1992;643;1794;73;227;412;1134;485;1361
350360;202202;1172;3355;932;2896;174;569;404;1242;578;1811
350370;202202;758;1822;555;1460;164;398;212;534;376;932
350380;202202;5122;13595;3800;10898;920;2714;1361;3765;2281;6479
350390;202202;12411;30957;9961;27049;1446;4192;5812;15004;7258;19196
350395;202202;491;1217;263;785;35;108;90;250;125;358
350400;202202;9436;22411;6781;18202;1642;4629;2178;5792;3820;10421
350410;202202;11781;31574;8993;26461;1630;5297;4011;10998;5641;16295
350420;202202;1084;2742;775;2136;136;365;239;569;375;934
350430;202202;768;1950;608;1712;73;240;361;941;434;1181
350440;202202;2364;5582;1939;4966;111;344;1338;3274;1449;3618
350450;202202;7396;19736;5830;17099;1167;3833;2677;7358;3844;11191
350460;202202;2230;5605;1367;3933;196;602;558;1453;754;2055
350470;202202;282;685;228;603;11;37;167;422;178;459
350480;202202;1115;2654;769;2098;167;516;218;514;385;1030
350490;202202;2182;5449;1597;4534;285;911;633;1600;918;2511
350500;202202;720;1875;544;1581;59;195;240;659;299;854
350510;202202;1352;3298;1043;2772;94;282;669;1686;763;1968
350520;202202;2581;7357;2065;6417;322;1159;960;2680;1282;3839
350530;202202;3362;8220;2586;6785;242;748;1579;3830;1821;4578
350535;202202;1684;4356;1436;4004;175;551;946;2544;1121;3095
350540;202202;2234;4913;1717;4193;140;364;1237;2872;1377;3236
350550;202202;9290;22286;6597;17918;621;2109;3996;9976;4617;12085
350560;202202;4306;11402;3519;10133;254;880;2451;6777;2705;7657
350570;202202;30643;81214;25502;72008;3831;12004;14413;38878;18244;50882
350580;202202;2355;6038;1540;4463;382;1240;469;1132;851;2372
350590;202202;5502;14379;4138;11467;467;1486;2548;6518;3015;8004
350600;202202;38175;86516;24861;64228;3333;9834;12432;29561;15765;39395
350610;202202;7993;20864;5865;16851;774;2588;3173;8484;3947;11072
350620;202202;478;1194;301;911;33;111;166;473;199;584
350630;202202;1769;4183;1336;3471;83;274;909;2174;992;2448
350635;202202;11179;26030;8533;21995;934;2688;5615;13878;6549;16566
350640;202202;1026;2676;588;1747;107;325;178;447;285;772
350650;202202;9758;25030;6980;19829;1150;3595;3075;8085;4225;11680
350660;202202;5193;12856;4106;11145;515;1428;2510;6691;3025;8119
350670;202202;1905;4992;1563;4500;199;609;1019;2936;1218;3545
350680;202202;1250;3268;876;2595;141;428;391;1107;532;1535
350690;202202;1492;3709;1085;3028;149;456;602;1631;751;2087
350700;202202;5525;13362;4262;11483;731;2189;2306;5900;3037;8089
350710;202202;3284;8497;2802;7687;491;1519;1571;4009;2062;5528
350715;202202;849;2331;725;2133;125;445;390;1027;515;1472
350720;202202;181;451;133;380;23;70;50;123;73;193
350730;202202;677;1835;574;1655;38;130;399;1090;437;1220
350740;202202;1925;4855;1383;3839;228;698;547;1369;775;2067
350745;202202;675;1656;405;1166;29;117;196;504;225;621
350750;202202;11614;29424;9320;25583;1512;4934;4864;12144;6376;17078
350760;202202;17678;41906;13311;34676;2179;6549;6989;16375;9168;22924
350770;202202;1187;2816;739;2057;60;186;446;1198;506;1384
350775;202202;789;1756;560;1429;71;171;308;785;379;956
350780;202202;2662;6216;1964;5259;545;1339;716;2243;1261;3582
350790;202202;2352;6113;1559;4657;293;922;483;1236;776;2158
350800;202202;3990;10871;3441;9968;242;838;2468;6920;2710;7758
350810;202202;3276;7566;2524;6489;440;1103;1294;3289;1734;4392
350820;202202;1040;2374;633;1663;65;198;333;810;398;1008
350830;202202;945;2524;573;1746;98;325;178;448;276;773
350840;202202;3814;10804;2977;9326;530;1882;1463;4230;1993;6112
350850;202202;9081;23899;7318;20835;1131;3530;4136;11097;5267;14627
350860;202202;4042;10252;3502;9539;135;494;2774;7460;2909;7954
350870;202202;3001;7950;2287;6829;231;780;1424;4146;1655;4926
350880;202202;1558;4204;1266;3656;360;1064;357;984;717;2048
350890;202202;560;1434;374;1057;50;157;139;340;189;497
350900;202202;9698;24802;6884;19188;1147;3489;3336;8498;4483;11987
350910;202202;1040;2395;890;2180;87;228;688;1638;775;1866
350920;202202;13585;32336;11634;29351;384;1296;9713;23625;10097;24921
350925;202202;4558;11891;3341;9823;521;1745;1752;4752;2273;6497
350930;202202;1622;4135;1161;3257;83;268;707;1924;790;2192
350940;202202;2642;6597;2100;5744;202;663;1407;3622;1609;4285
350945;202202;997;2690;779;2284;116;364;416;1139;532;1503
350950;202202;103774;256084;81781;216360;8978;26325;53055;133780;62033;160105
350960;202202;7153;18694;5638;15945;694;2241;3395;9122;4089;11363
350970;202202;3899;10480;2866;8623;814;2696;859;2216;1673;4912
350980;202202;765;1982;635;1756;137;393;323;866;460;1259
350990;202202;2134;5567;1644;4798;352;1162;686;1911;1038;3073
350995;202202;912;2697;834;2551;66;252;592;1735;658;1987
351000;202202;3256;8375;2266;6523;496;1469;804;2231;1300;3700
351010;202202;417;1002;271;754;37;110;127;345;164;455
351015;202202;1037;2962;869;2643;135;437;427;1184;562;1621
351020;202202;9552;24977;7355;21331;1442;4381;3692;10335;5134;14716
351030;202202;3246;9217;2634;8025;344;1195;1515;4446;1859;5641
351040;202202;5734;13577;4851;12295;175;568;4078;10034;4253;10602
351050;202202;19226;45112;14581;38293;2289;6350;7878;20191;10167;26541
351060;202202;55726;134457;43543;114290;3582;10662;30630;77459;34212;88121
351070;202202;1505;3618;890;2610;255;763;168;474;423;1237
351080;202202;3085;7163;2279;6222;232;733;1574;4101;1806;4834
351090;202202;354;973;275;837;52;164;98;297;150;461
351100;202202;3054;7918;2079;6039;432;1367;690;1969;1122;3336
351110;202202;6987;17335;4897;13657;710;2241;2420;6332;3130;8573
351120;202202;820;2088;587;1691;98;279;231;632;329;911
351130;202202;1257;3243;610;1820;104;333;170;439;274;772
351140;202202;2517;6720;1928;5664;388;1286;924;2418;1312;3704
351150;202202;3192;8801;2265;6894;318;1117;887;2413;1205;3530
351160;202202;1229;3661;919;2973;190;663;238;643;428;1306
351170;202202;1584;4152;1379;3804;118;371;975;2561;1093;2932
351190;202202;1121;3020;801;2402;165;482;294;842;459;1324
351200;202202;1790;4133;1363;3543;87;263;988;2434;1075;2697
351210;202202;1709;4057;1133;3041;81;293;678;1654;759;1947
351220;202202;3887;10154;3376;9365;264;818;2453;6617;2717;7435
351230;202202;2210;5601;1720;4792;282;865;907;2323;1189;3188
351240;202202;2689;6671;1728;4773;400;1125;612;1525;1012;2650
351250;202202;1205;3130;742;2199;75;245;284;837;359;1082
351260;202202;1004;2421;740;1957;138;389;302;751;440;1140
351270;202202;575;1500;410;1186;42;147;205;502;247;649
351280;202202;4335;11003;3408;9368;649;1883;1577;4130;2226;6013
351290;202202;1439;3430;1047;2770;113;340;692;1748;805;2088
351300;202202;22087;57158;16102;46244;2652;8367;7952;21630;10604;29997
351310;202202;3915;9232;3031;7885;136;494;2313;5719;2449;6213
351320;202202;995;2798;731;2280;130;440;248;682;378;1122
351330;202202;542;1308;429;1085;27;98;297;669;324;767
351340;202202;7532;19710;6267;17590;1226;3653;3402;9223;4628;12876
351350;202202;13682;32835;11439;29329;761;2195;8895;21990;9656;24185
351360;202202;4274;10860;3543;9808;696;2165;1787;4551;2483;6716
351370;202202;2292;6158;1578;4744;358;1194;502;1320;860;2514
351380;202202;51863;121076;37695;97507;3971;11344;23455;57789;27426;69133
351385;202202;437;1092;190;569;28;83;67;183;95;266
351390;202202;1476;3487;951;2732;111;359;606;1671;717;2030
351400;202202;1115;2955;930;2609;87;260;633;1700;720;1960
351410;202202;2929;7810;2182;6419;372;1100;940;2676;1312;3776
351420;202202;549;1294;333;928;34;107;200;499;234;606
351430;202202;1065;2719;882;2443;56;163;646;1736;702;1899
351440;202202;3872;9850;2679;7524;505;1501;842;2044;1347;3545
351450;202202;1903;4883;1324;3873;258;864;320;726;578;1590
351460;202202;1024;2542;827;2245;116;348;527;1386;643;1734
351470;202202;1359;3285;1090;2865;69;230;764;1888;833;2118
351480;202202;2687;7545;2137;6672;352;1296;1040;2977;1392;4273
351490;202202;2272;6137;1981;5636;71;303;1646;4537;1717;4840
351492;202202;381;992;329;885;5;18;255;670;260;688
351495;202202;230;577;183;494;16;36;114;302;130;338
351500;202202;45280;105702;35467;90234;4198;11280;23279;56780;27477;68060
351510;202202;14398;33788;10788;27901;1094;3253;7221;17819;8315;21072
351512;202202;541;1389;402;1097;78;218;159;406;237;624
351515;202202;3647;8058;2387;6066;469;1263;684;1838;1153;3101
351518;202202;2774;6770;1897;5272;241;778;1015;2517;1256;3295
351519;202202;689;1828;438;1360;77;248;89;244;166;492
351520;202202;1397;3401;674;1979;68;235;321;842;389;1077
351530;202202;385;982;237;684;35;109;113;274;148;383
351535;202202;1964;4706;1450;3846;217;630;748;1899;965;2529
351540;202202;2987;7128;2061;5537;216;704;1029;2434;1245;3138
351550;202202;8169;19680;5779;15519;545;1686;3361;8351;3906;10037
351560;202202;541;1476;437;1280;112;363;138;376;250;739
351565;202202;284;767;229;669;50;172;69;170;119;342
351570;202202;24648;62494;19418;52669;1712;5205;12873;33362;14585;38567
351580;202202;250;620;146;443;10;30;71;212;81;242
351590;202202;536;1199;278;747;23;76;162;396;185;472
351600;202202;1469;3850;1152;3267;156;488;650;1716;806;2204
351610;202202;808;1865;527;1384;37;111;308;763;345;874
351620;202202;26340;67365;19766;56683;2903;9697;9760;25636;12663;35333
351630;202202;31971;79531;26134;70123;2473;7673;18260;46780;20733;54453
351640;202202;20276;50175;16241;43370;1181;3910;11632;29423;12813;33333
351650;202202;405;1066;213;658;25;90;61;168;86;258
351660;202202;774;2080;525;1584;85;260;124;325;209;585
351670;202202;6849;17793;4627;13125;903;2530;2020;5350;2923;7880
351680;202202;478;1281;334;981;60;189;88;203;148;392
351685;202202;484;1322;394;1179;93;280;158;430;251;710
351690;202202;1293;3196;765;2196;93;320;361;947;454;1267
351700;202202;1476;3539;1097;2919;196;569;580;1432;776;2001
351710;202202;862;2196;656;1833;56;191;390;990;446;1181
351720;202202;1662;4123;1166;3291;178;547;546;1433;724;1980
351730;202202;1070;2647;890;2373;72;236;568;1412;640;1648
351740;202202;3777;9157;3089;7920;453;1286;1739;4085;2192;5371
351750;202202;1785;4428;1083;3203;163;510;503;1426;666;1936
351760;202202;3677;9806;2808;8187;530;1732;1316;3503;1846;5235
351770;202202;2104;5780;1743;5137;242;814;1091;3065;1333;3879
351780;202202;1322;3228;812;2321;104;351;340;897;444;1248
351790;202202;1562;3609;1250;3190;150;392;840;2103;990;2495
351800;202202;561;1268;315;830;32;100;132;299;164;399
351810;202202;1203;3082;1005;2792;87;233;668;1773;755;2006
351820;202202;3084;8185;2271;6681;527;1726;710;1876;1237;3602
351830;202202;5047;12858;3906;10955;332;1102;2531;6703;2863;7805
351840;202202;10034;26221;7775;22262;869;2871;4638;12327;5507;15198
351850;202202;1666;4455;1134;3441;191;656;409;1028;600;1684
351860;202202;2929;8082;2279;6938;266;901;1379;4177;1645;5078
351870;202202;27547;67283;21159;57066;4527;12492;9877;26637;14404;39129
351880;202202;162633;395109;126766;336295;19996;59691;74506;186741;94502;246432
351885;202202;1043;2646;837;2326;50;191;591;1578;641;1769
351890;202202;955;2420;632;1893;124;424;151;387;275;811
351900;202202;1336;3389;1028;2939;103;283;662;1867;765;2150
351905;202202;519;1395;380;1138;41;142;192;507;233;649
351907;202202;24130;61010;19207;52649;1854;5889;12966;33889;14820;39778
351910;202202;1856;4611;1360;3620;104;319;805;1917;909;2236
351920;202202;986;2571;770;2163;117;363;341;872;458;1235
351925;202202;1027;2643;816;2278;110;367;481;1248;591;1615
351930;202202;3689;9825;3339;9206;298;919;2620;7063;2918;7982
351940;202202;1167;2928;862;2400;130;422;446;1221;576;1643
351950;202202;1884;4044;1461;3453;66;189;1077;2438;1143;2627
351960;202202;5702;13902;4307;11546;915;2638;2030;5148;2945;7786
351970;202202;9100;24785;7395;22009;1073;3702;4474;12692;5547;16394
351980;202202;1166;2686;786;2078;86;288;477;1154;563;1442
351990;202202;1646;3755;1211;3129;63;227;641;1458;704;1685
352000;202202;2950;8017;2584;7303;230;783;1789;4751;2019;5534
352010;202202;2580;6537;2120;5816;597;1704;582;1637;1179;3341
352020;202202;1627;4264;1283;3696;208;667;653;1766;861;2433
352030;202202;6591;16516;5299;14473;736;2294;3198;8316;3934;10610
352040;202202;4664;11289;3382;8947;546;1582;1288;3048;1834;4630
352042;202202;3648;8461;2548;6767;334;1032;1457;3741;1791;4773
352044;202202;2378;6133;1493;4489;257;857;358;947;615;1804
352050;202202;14747;37913;10173;29171;2536;7874;2588;6416;5124;14290
352060;202202;840;2183;649;1842;110;351;291;748;401;1099
352070;202202;1029;2031;695;1595;44;124;426;904;470;1028
352080;202202;512;1286;325;933;41;111;108;289;149;400
352090;202202;1720;4860;1459;4383;168;590;741;2023;909;2613
352100;202202;3996;10718;3226;9315;553;1780;1594;4373;2147;6153
352110;202202;741;2064;561;1726;117;368;240;699;357;1067
352115;202202;613;1601;507;1441;87;262;297;823;384;1085
352120;202202;966;2692;788;2357;82;262;481;1335;563;1597
352130;202202;2257;6097;1515;4330;217;630;666;1794;883;2424
352140;202202;1294;3442;947;2768;157;479;454;1308;611;1787
352150;202202;1027;2576;785;2178;79;246;545;1463;624;1709
352160;202202;1087;2606;805;2155;77;254;441;1116;518;1370
352170;202202;3324;8532;2691;7364;288;917;1709;4377;1997;5294
352180;202202;2745;7103;2131;6047;458;1408;861;2253;1319;3661
352190;202202;1505;3867;1215;3431;159;483;743;2062;902;2545
352200;202202;351;1048;259;875;38;123;98;328;136;451
352210;202202;23094;51560;18370;45337;862;2598;14789;35565;15651;38163
352215;202202;736;1837;610;1646;95;271;338;891;433;1162
352220;202202;27183;63181;20279;51789;2832;8133;11865;27907;14697;36040
352230;202202;17231;46838;13690;40538;3105;10077;5570;15252;8675;25329
352240;202202;11505;28455;8998;24452;1701;4995;4490;11436;6191;16431
352250;202202;25489;68531;21139;61349;2324;7444;14480;41047;16804;48491
352260;202202;5582;13488;3903;10339;493;1519;2354;5607;2847;7126
352265;202202;1022;2770;912;2617;125;399;595;1651;720;2050
352270;202202;1828;5197;1420;4349;277;961;566;1581;843;2542
352280;202202;2579;6241;1974;5398;204;668;1197;3040;1401;3708
352290;202202;1537;4151;1250;3626;151;485;693;1821;844;2306
352300;202202;1010;2588;702;1979;79;261;388;1023;467;1284
352310;202202;45127;115990;34586;98597;6139;18331;18764;52863;24903;71194
352320;202202;7432;18342;5887;15606;753;2259;3492;8375;4245;10634
352330;202202;2663;6540;2084;5745;258;891;1367;3522;1625;4413
352340;202202;7439;19042;5723;15960;850;2664;3073;7848;3923;10512
352350;202202;2576;6920;2043;5799;146;513;1366;3664;1512;4177
352360;202202;1481;3792;1209;3318;83;275;910;2399;993;2674
352370;202202;1168;3168;1016;2929;28;115;828;2346;856;2461
352380;202202;969;2505;741;2120;154;448;309;848;463;1296
352390;202202;16565;39693;11601;31119;1665;5011;6658;16767;8323;21778
352400;202202;3962;10766;3270;9500;823;2618;1582;4383;2405;7001
352410;202202;3825;9451;2988;8110;226;720;1915;4971;2141;5691
352420;202202;931;2278;646;1832;142;419;214;602;356;1021
352430;202202;9406;22176;7079;18303;1012;2971;3982;9714;4994;12685
352440;202202;21065;55474;16286;46584;3545;10718;6684;18350;10229;29068
352450;202202;866;2066;478;1425;74;229;186;516;260;745
352460;202202;3419;8892;2478;7284;437;1350;1154;3201;1591;4551
352470;202202;3663;9145;2856;7859;252;822;1863;4825;2115;5647
352480;202202;4770;10980;3288;8427;420;1273;1691;3880;2111;5153
352490;202202;903;2485;729;2186;118;401;354;1002;472;1403
352500;202202;11943;29782;8385;23381;3254;10430;1683;3026;4937;13456
352510;202202;4466;11802;3466;10058;539;1721;1950;5408;2489;7129
352520;202202;3253;8154;2549;7013;353;1123;1575;3967;1928;5090
352530;202202;12741;31411;9108;24863;1632;5003;3638;8605;5270;13608
352540;202202;625;1778;480;1487;74;230;190;545;264;775
352550;202202;1085;2878;769;2323;128;442;296;802;424;1244
352560;202202;681;1779;553;1557;62;227;356;909;418;1136
352570;202202;2611;7158;1765;5456;427;1445;264;609;691;2054
352580;202202;722;1816;618;1630;68;195;390;995;458;1190
352585;202202;385;1028;286;856;27;101;177;494;204;595
352590;202202;14764;37632;10794;30433;2089;6519;5777;15129;7866;21648
352600;202202;2156;5598;1730;4873;135;441;1148;3028;1283;3469
352610;202202;3026;8023;2308;6838;382;1351;1129;3125;1511;4476
352620;202202;6314;15209;4868;13186;1112;3026;2399;6462;3511;9488
352630;202202;956;2286;726;1969;94;288;394;1026;488;1314
352640;202202;3374;8318;2515;6830;239;712;1505;3891;1744;4603
352650;202202;653;1781;465;1402;64;214;190;541;254;755
352660;202202;1193;3356;1011;3011;105;384;658;1840;763;2224
352670;202202;11295;28948;8119;22974;1587;5051;3583;9175;5170;14226
352680;202202;3589;10097;2605;7950;394;1388;1275;3443;1669;4831
352690;202202;29973;72961;23944;63296;1148;3805;17686;44875;18834;48680
352700;202202;778;1900;583;1614;120;339;260;720;380;1059
352710;202202;6031;14979;4442;12200;967;2899;2008;5158;2975;8057
352720;202202;9771;24868;7908;21608;1589;4653;3812;9837;5401;14490
352725;202202;609;1407;355;964;24;73;198;495;222;568
352730;202202;5814;16702;5281;15540;656;2157;2583;6585;3239;8742
352740;202202;2617;6090;2011;5208;175;537;1250;3044;1425;3581
352750;202202;485;1186;315;890;41;139;149;365;190;504
352760;202202;1889;5025;1512;4333;154;412;859;2431;1013;2843
352770;202202;1021;2618;742;2107;103;305;370;982;473;1287
352780;202202;728;1991;531;1585;103;285;165;497;268;782
352790;202202;478;1207;370;1010;40;106;170;413;210;519
352800;202202;1528;4395;1098;3463;294;954;236;595;530;1549
352810;202202;1339;3052;886;2279;117;294;544;1341;661;1635
352820;202202;510;1397;379;1166;79;253;101;283;180;536
352830;202202;635;1558;327;949;31;98;107;263;138;361
352840;202202;4420;11979;3648;10637;926;2938;1650;4644;2576;7582
352850;202202;12493;29305;9010;23904;1940;5689;4026;9751;5966;15440
352860;202202;1193;3199;935;2750;152;488;383;1061;535;1549
352870;202202;957;2345;679;1803;56;171;438;1112;494;1283
352880;202202;1872;4374;1336;3453;209;588;614;1499;823;2087
352885;202202;361;934;283;807;29;89;178;493;207;582
352890;202202;773;1794;540;1332;34;106;340;731;374;837
352900;202202;20709;52100;14219;39673;2140;6365;6404;16695;8544;23060
352910;202202;433;1111;264;777;18;58;104;255;122;313
352920;202202;3039;7467;2321;6298;113;368;1676;4351;1789;4719
352930;202202;6590;17086;5105;14287;834;2651;2609;6806;3443;9457
352940;202202;26426;67853;20365;55910;3161;9570;11330;29247;14491;38817
352950;202202;636;1645;420;1259;92;296;123;321;215;617
352960;202202;824;2100;505;1455;76;244;170;388;246;632
352965;202202;275;751;189;589;42;138;54;155;96;293
352970;202202;3280;7566;2574;6441;161;436;1909;4645;2070;5081
352980;202202;1513;3740;1205;3304;246;711;689;1858;935;2569
352990;202202;4857;12570;3706;10707;618;1955;2046;5734;2664;7689
353000;202202;530;1414;325;957;54;182;94;223;148;405
353010;202202;2961;7110;2045;5471;344;1087;980;2377;1324;3464
353020;202202;3810;9622;2375;6773;352;1083;930;2500;1282;3583
353030;202202;5196;12692;3662;10107;816;2435;1180;3089;1996;5524
353040;202202;734;1630;526;1326;90;223;286;709;376;932
353050;202202;5821;15883;4260;12790;687;2249;2148;6134;2835;8383
353060;202202;54111;132932;45211;119245;2790;8926;34860;88736;37650;97662
353070;202202;11470;31246;8605;25252;1321;4364;4121;11069;5442;15433
353080;202202;5123;13316;3530;10349;639;2130;1494;3819;2133;5949
353090;202202;680;1928;571;1722;37;138;379;1098;416;1236
353100;202202;328;844;165;498;32;103;49;116;81;219
353110;202202;8440;21044;6840;18868;1523;4101;3570;10298;5093;14399
353120;202202;462;1136;356;963;44;155;183;424;227;579
353130;202202;2977;6806;1971;5107;457;1274;806;1853;1263;3127
353140;202202;3148;7401;2398;6219;119;386;1756;4341;1875;4727
353150;202202;1735;4184;1270;3443;241;704;590;1510;831;2214
353160;202202;727;1843;531;1524;78;251;251;655;329;906
353170;202202;592;1528;453;1338;77;235;225;678;302;913
353180;202202;11442;27066;9122;23446;1655;4431;5421;13525;7076;17956
353190;202202;3759;9758;2994;8269;367;1135;1810;4684;2177;5819
353200;202202;1973;5127;1228;3692;174;617;442;1191;616;1808
353205;202202;482;1400;412;1248;49;162;229;665;278;827
353210;202202;1008;2189;675;1666;25;73;496;1177;521;1250
353215;202202;432;1112;346;966;47;165;172;430;219;595
353220;202202;820;2154;575;1678;123;353;138;369;261;722
353230;202202;872;2320;695;2049;162;560;277;736;439;1296
353240;202202;2590;6752;2191;6142;267;863;1399;3773;1666;4636
353250;202202;1316;2919;853;2190;97;273;483;1196;580;1469
353260;202202;1276;2878;744;2021;111;331;358;902;469;1233
353270;202202;811;1990;680;1770;59;184;479;1168;538;1352
353280;202202;778;2007;568;1661;133;383;184;537;317;920
353282;202202;2005;5439;1694;4908;154;539;1105;3017;1259;3556
353284;202202;402;897;235;613;21;73;119;267;140;340
353286;202202;196;472;123;355;25;67;32;74;57;141
353290;202202;1607;4107;1014;2959;157;479;358;928;515;1407
353300;202202;2394;6144;1789;5009;294;938;863;2137;1157;3075
353310;202202;442;1039;337;865;18;62;227;542;245;604
353320;202202;770;1878;661;1728;15;52;529;1348;544;1400
353325;202202;773;2157;570;1729;100;303;236;681;336;984
353330;202202;689;1685;471;1300;69;214;246;623;315;837
353340;202202;3490;9157;2720;7701;455;1471;1466;3812;1921;5283
353350;202202;4215;10247;3143;8291;684;1830;1163;2780;1847;4610
353360;202202;729;1972;585;1708;56;200;360;997;416;1197
353370;202202;639;1751;533;1586;45;163;379;1086;424;1249
353380;202202;337;953;277;845;35;123;137;380;172;503
353390;202202;7089;17007;5400;14314;415;1286;3508;8823;3923;10109
353400;202202;566;1457;437;1226;75;240;195;454;270;694
353410;202202;572;1476;436;1235;57;162;263;732;320;894
353420;202202;507;1281;340;950;71;188;61;148;132;336
353430;202202;2570;6762;2058;5857;365;1110;1089;2954;1454;4064
353440;202202;76507;197201;58230;162847;7864;24501;34587;91245;42451;115746
353450;202202;421;1041;295;831;41;143;154;393;195;536
353460;202202;3712;9650;2805;8029;481;1462;878;2361;1359;3823
353470;202202;9683;24616;7197;20096;1128;3573;3499;9003;4627;12576
353475;202202;1842;4461;1278;3419;144;440;699;1694;843;2134
353480;202202;1766;4501;1457;4008;65;237;1077;2851;1142;3088
353490;202202;1203;3051;875;2462;114;332;410;1086;524;1418
353500;202202;1193;2758;872;2272;158;423;529;1338;687;1761
353510;202202;986;2750;736;2207;182;609;253;654;435;1263
353520;202202;1136;2846;754;2200;73;238;380;993;453;1231
353530;202202;2741;6910;2220;6004;242;786;1297;3262;1539;4048
353540;202202;2328;6037;1915;5405;256;786;1186;3236;1442;4022
353550;202202;6671;16320;5472;14454;669;1908;3478;8779;4147;10687
353560;202202;2542;6506;1977;5687;482;1519;770;2013;1252;3532
353570;202202;729;1856;506;1458;85;288;233;610;318;898
353580;202202;2480;6287;1932;5255;348;948;996;2608;1344;3556
353590;202202;788;1940;566;1569;60;173;334;904;394;1077
353600;202202;1826;4441;1408;3739;154;454;817;2092;971;2546
353610;202202;787;2208;583;1801;108;384;240;680;348;1064
353620;202202;3181;7978;2325;6583;440;1337;912;2362;1352;3699
353625;202202;633;1532;399;1124;39;132;222;598;261;730
353630;202202;1613;4635;1396;4221;234;779;716;1999;950;2778
353640;202202;1421;3591;1148;3178;159;454;696;1893;855;2347
353650;202202;8453;21936;6650;18734;728;2297;3946;10450;4674;12747
353657;202202;412;1057;314;910;26;94;151;401;177;495
353660;202202;1460;2989;1039;2436;183;432;607;1395;790;1827
353670;202202;4615;12269;3643;10480;626;2056;1853;4881;2479;6937
353680;202202;784;1967;587;1690;71;238;367;986;438;1224
353690;202202;491;1267;244;726;32;97;64;174;96;271
353700;202202;2297;5721;1913;5125;127;430;1411;3620;1538;4050
353710;202202;5819;12968;3571;9020;342;905;1909;4256;2251;5161
353715;202202;482;1249;299;889;14;58;122;334;136;392
353720;202202;2223;5611;1741;4903;268;811;976;2676;1244;3487
353730;202202;4847;12323;3809;10564;466;1535;2267;5793;2733;7328
353740;202202;2243;5708;1629;4662;336;1103;652;1688;988;2791
353750;202202;1026;2961;776;2506;184;621;238;737;422;1358
353760;202202;15030;32756;11771;28551;2142;5343;6901;16465;9043;21808
353770;202202;678;1917;438;1408;83;300;73;203;156;503
353780;202202;6749;17159;5573;15131;874;2716;3346;8482;4220;11198
353790;202202;3143;9067;2376;7499;558;1943;588;1635;1146;3578
353800;202202;20848;52431;16806;46198;2395;6559;9854;26710;12249;33269
353810;202202;1376;3596;952;2735;147;466;438;1197;585;1663
353820;202202;1946;5059;1355;3944;291;957;427;1131;718;2088
353830;202202;701;1697;528;1430;77;236;260;668;337;904
353850;202202;1751;4635;1379;3967;256;758;607;1667;863;2425
353860;202202;2982;7752;2316;6694;482;1596;1155;3022;1637;4618
353870;202202;33658;85089;25070;69334;3064;9504;13616;34589;16680;44093
353880;202202;3416;9077;2758;7891;200;693;1779;4834;1979;5527
353890;202202;3340;6869;2464;5644;140;386;1786;3752;1926;4138
353900;202202;815;2189;621;1832;87;287;269;728;356;1015
353910;202202;2952;7748;2519;7094;200;649;1848;5102;2048;5751
353920;202202;2213;5812;1632;4770;404;1299;428;1058;832;2357
353930;202202;5169;13229;3670;10454;629;2095;1693;4235;2322;6330
353940;202202;1339;3739;973;3037;145;495;365;1014;510;1509
353950;202202;3678;9525;2878;8098;607;1838;1408;3718;2015;5556
353960;202202;898;2248;650;1806;146;395;232;611;378;1006
353970;202202;707;1624;541;1384;46;140;388;963;434;1103
353980;202202;17941;43662;14247;37601;747;2420;10636;26802;11383;29222
353990;202202;1028;2428;655;1781;108;322;326;839;434;1161
354000;202202;2852;6663;1687;4506;389;1059;395;952;784;2011
354010;202202;360;913;261;760;44;138;145;412;189;550
354020;202202;4091;10655;3322;9168;589;1767;1704;4361;2293;6128
354025;202202;797;2116;550;1655;78;267;175;493;253;760
354030;202202;545;1146;310;783;61;152;152;363;213;515
354040;202202;882;1981;585;1530;31;95;440;1102;471;1197
354050;202202;1055;2900;758;2376;153;542;309;927;462;1469
354060;202202;3927;10697;2878;8543;510;1692;1316;3506;1826;5198
354070;202202;4382;10952;3067;8457;487;1544;1495;3645;1982;5189
354075;202202;3142;8485;2548;7468;280;904;1639;4619;1919;5523
354080;202202;1588;4220;1114;3319;198;615;405;1075;603;1690
354085;202202;482;949;388;833;0;0;310;619;310;619
354090;202202;1803;4884;1559;4400;89;271;1208;3310;1297;3581
354100;202202;22521;58143;16239;47727;3377;10407;7326;21094;10703;31501
354105;202202;1540;3764;1133;3066;142;460;562;1406;704;1866
354110;202202;474;1306;356;1089;63;220;135;387;198;607
354120;202202;1509;3925;1081;3054;215;671;388;956;603;1627
354130;202202;6191;15816;4244;12113;1201;3594;511;1138;1712;4732
354140;202202;21938;52750;15735;41737;2277;6728;7734;18736;10011;25464
354150;202202;3150;7280;2486;6281;542;1379;1056;2654;1598;4033
354160;202202;3146;8748;2467;7451;612;2029;931;2602;1543;4631
354165;202202;752;2146;595;1844;87;329;326;945;413;1274
354170;202202;2102;5604;1741;4958;127;414;1053;2845;1180;3259
354180;202202;441;1199;343;1008;40;119;188;516;228;635
354190;202202;1743;4751;1268;3786;82;290;678;1910;760;2200
354200;202202;989;2306;762;1964;57;177;525;1263;582;1440
354210;202202;1055;2678;878;2410;49;167;639;1640;688;1807
354220;202202;3447;8931;2668;7488;384;1187;1475;3910;1859;5097
354230;202202;881;2103;726;1924;27;104;563;1438;590;1542
354240;202202;1945;5229;1345;4038;242;799;471;1267;713;2066
354250;202202;678;1614;442;1221;93;253;148;382;241;635
354260;202202;9011;22537;7032;19237;1067;3248;3822;9892;4889;13140
354270;202202;1121;3202;942;2881;170;556;432;1220;602;1776
354280;202202;921;2159;799;1988;56;166;583;1352;639;1518
354290;202202;1022;3122;874;2831;150;518;468;1526;618;2044
354300;202202;3856;10866;3283;9839;758;2334;1561;4603;2319;6937
354310;202202;788;2273;665;2053;148;483;289;839;437;1322
354320;202202;1074;2519;716;1942;98;297;334;805;432;1102
354323;202202;531;1232;337;883;43;102;153;374;196;476
354325;202202;1625;4698;1149;3639;209;690;319;960;528;1650
354330;202202;10641;25821;7587;19945;740;2223;4875;11922;5615;14145
354340;202202;38598;93603;27695;75328;3324;10332;16686;43241;20010;53573
354350;202202;1323;3261;1068;2864;134;400;653;1658;787;2058
354360;202202;680;1670;431;1273;101;310;133;375;234;685
354370;202202;1099;3019;898;2703;124;415;577;1676;701;2091
354380;202202;717;1846;536;1562;102;382;179;425;281;807
354390;202202;15904;37194;11012;28937;1590;4604;5871;14403;7461;19007
354400;202202;1751;5392;1411;4627;271;942;532;1713;803;2655
354410;202202;7196;18104;5630;15267;827;2507;3179;8013;4006;10520
354420;202202;1666;4165;1249;3431;149;470;778;1985;927;2455
354425;202202;3062;7239;2253;5883;430;1180;1045;2690;1475;3870
354430;202202;1686;4311;1349;3823;104;333;873;2360;977;2693
354440;202202;676;1683;460;1278;59;182;236;598;295;780
354450;202202;513;1333;318;976;44;143;107;273;151;416
354460;202202;922;2286;640;1809;104;321;313;843;417;1164
354470;202202;497;1225;350;960;17;56;175;415;192;471
354480;202202;1453;3192;963;2434;78;219;626;1479;704;1698
354490;202202;889;2513;667;2042;117;380;321;902;438;1282
354500;202202;2401;6449;1951;5758;564;1721;587;1741;1151;3462
354510;202202;803;2160;663;1905;44;151;410;1074;454;1225
354515;202202;412;1135;298;906;42;142;122;353;164;495
354520;202202;7744;20484;5661;16242;654;2221;3322;8812;3976;11033
354530;202202;5159;13876;4127;11959;909;2631;1693;4988;2602;7619
354540;202202;1496;3758;1114;3098;213;603;478;1290;691;1893
354550;202202;657;1703;534;1489;69;218;303;786;372;1004
354560;202202;2487;5866;1407;3853;166;469;757;1888;923;2357
354570;202202;1335;3270;574;1588;127;360;81;209;208;569
354580;202202;9357;24078;6406;18544;942;3030;3373;9272;4315;12302
354600;202202;2251;5651;1805;4894;239;689;1154;2980;1393;3669
354610;202202;507;1279;295;846;32;96;138;367;170;463
354620;202202;529;1414;333;1044;39;155;148;419;187;574
354625;202202;337;895;207;651;35;128;56;140;91;268
354630;202202;2492;7010;2059;6202;609;1892;569;1647;1178;3539
354640;202202;3911;10655;3031;8993;403;1398;1433;3882;1836;5280
354650;202202;966;2487;781;2189;104;287;447;1229;551;1516
354660;202202;3918;8975;2226;6265;218;757;1025;2602;1243;3359
354670;202202;1196;3227;863;2574;168;552;359;989;527;1541
354680;202202;6033;15055;4657;12889;843;2474;2637;7312;3480;9786
354690;202202;567;1697;419;1387;86;293;145;454;231;747
354700;202202;1018;2639;738;2110;80;269;406;1064;486;1333
354710;202202;552;1442;390;1130;44;132;179;458;223;590
354720;202202;334;774;160;449;64;162;35;109;99;271
354730;202202;11291;30834;8876;26386;1075;3593;5395;15330;6470;18923
354740;202202;342;915;157;498;25;91;30;83;55;174
354750;202202;3106;7724;2071;5818;288;898;921;2282;1209;3180
354760;202202;2385;6163;1758;5055;352;1122;685;1786;1037;2908
354765;202202;394;1039;181;557;17;68;60;164;77;232
354770;202202;2780;6660;2085;5461;351;942;982;2442;1333;3384
354780;202202;64953;157103;50996;130752;3801;11653;35582;85188;39383;96841
354790;202202;1121;2969;883;2589;71;256;574;1612;645;1868
354800;202202;2903;7283;2259;6271;440;1308;1118;2892;1558;4200
354805;202202;1518;3375;1103;2788;106;267;717;1688;823;1955
354810;202202;696;1994;436;1453;73;280;139;429;212;709
354820;202202;1073;2938;778;2405;140;492;248;623;388;1115
354830;202202;551;1314;346;945;79;229;117;287;196;516
354840;202202;999;2456;643;1737;60;176;365;908;425;1084
354850;202202;23469;58245;17046;47386;1671;5379;10968;28846;12639;34225
354860;202202;1892;5024;1243;3722;202;671;468;1295;670;1966
354870;202202;68760;167717;54398;142100;4567;13813;36911;90743;41478;104556
354880;202202;6545;15730;3450;9423;393;1272;1459;3273;1852;4545
354890;202202;18041;43941;14313;37789;1883;5643;8389;21458;10272;27101
354900;202202;438;1061;293;819;61;195;112;248;173;443
354910;202202;6592;16922;4258;12800;933;3005;1106;3043;2039;6048
354920;202202;565;1463;296;936;40;139;74;193;114;332
354925;202202;319;875;196;618;24;82;52;150;76;232
354930;202202;415;994;291;781;36;99;144;364;180;463
354940;202202;2659;7575;2009;6237;640;2088;606;1694;1246;3782
354950;202202;1716;4153;1386;3734;65;224;1055;2713;1120;2937
354960;202202;978;2518;738;2159;73;259;401;1108;474;1367
354970;202202;4650;12432;3703;10879;349;1252;2505;7109;2854;8361
354980;202202;37707;87210;26506;68466;2482;7694;17027;41037;19509;48731
354990;202202;80986;194759;60678;159206;4149;13205;41745;102532;45894;115737
354995;202202;3338;7050;2594;6109;129;387;2058;4668;2187;5055
355000;202202;1738;4141;1327;3554;187;599;708;1741;895;2340
355010;202202;4515;11753;2999;8618;950;2675;667;1880;1617;4555
355020;202202;3977;10614;2998;8955;562;1906;1370;3819;1932;5725
355030;202202;1534633;3671112;1156916;2968607;149922;427761;647508;1538345;797430;1966106
355040;202202;3407;7974;2665;7036;191;558;2066;5416;2257;5974
355050;202202;1185;2546;904;2173;211;549;441;969;652;1518
355060;202202;7027;18128;5278;15004;818;2688;2884;7507;3702;10195
355070;202202;11030;26970;9131;24039;980;3029;6095;15116;7075;18145
355080;202202;1055;2925;687;2267;155;553;119;332;274;885
355090;202202;1378;3699;1114;3278;193;634;579;1579;772;2213
355100;202202;24697;62166;19554;54740;2550;7677;12710;34945;15260;42622
355110;202202;991;2642;749;2293;214;741;109;305;323;1046
355120;202202;815;2070;590;1745;68;220;268;768;336;988
355130;202202;906;1985;498;1262;27;82;323;752;350;834
355140;202202;2290;4796;1948;4335;86;235;1668;3611;1754;3846
355150;202202;4903;12364;3981;10814;445;1324;2600;6777;3045;8101
355160;202202;2502;6596;1836;5450;374;1192;556;1536;930;2728
355170;202202;12600;30518;10078;26477;1565;4434;5755;14676;7320;19110
355180;202202;3146;7974;2303;6643;409;1346;1114;2948;1523;4294
355190;202202;2064;5296;1648;4635;413;1120;831;2525;1244;3645
355200;202202;874;2609;748;2418;181;640;359;1119;540;1759
355210;202202;3359;8829;2621;7317;457;1407;1334;3512;1791;4919
355220;202202;54158;137226;44196;118800;7235;21262;23328;58216;30563;79478
355230;202202;1308;3225;740;2137;124;365;276;733;400;1098
355240;202202;27781;71369;20269;57052;2090;6648;11997;31646;14087;38294
355250;202202;42484;109083;32566;90698;6979;20197;14973;39814;21952;60011
355255;202202;707;1717;392;1151;46;135;150;435;196;570
355260;202202;1742;3993;1281;3280;104;343;848;2015;952;2358
355270;202202;1265;3588;1002;3075;206;675;461;1313;667;1988
355280;202202;35007;85623;25986;69592;2979;8945;14868;37348;17847;46293
355290;202202;1033;2664;808;2301;135;387;382;1030;517;1417
355300;202202;1502;4238;1250;3786;238;759;530;1489;768;2248
355310;202202;1013;2717;765;2306;93;311;460;1370;553;1681
355320;202202;592;1526;458;1286;96;317;197;456;293;773
355330;202202;3280;8051;2583;6870;106;369;1991;5055;2097;5424
355340;202202;4515;9836;3473;8479;485;1182;2166;5376;2651;6558
355350;202202;1507;4126;1163;3470;208;686;517;1453;725;2139
355360;202202;1312;3193;1024;2763;96;282;662;1731;758;2013
355365;202202;393;984;214;680;51;155;41;135;92;290
355370;202202;5812;14517;4569;12573;960;2445;2205;6511;3165;8956
355380;202202;3164;8155;2449;6886;435;1372;995;2469;1430;3841
355385;202202;1601;4002;1335;3640;107;388;891;2220;998;2608
355390;202202;900;2407;661;1912;113;360;297;781;410;1141
355395;202202;2150;5751;1592;4681;253;823;644;1664;897;2487
355400;202202;10318;28372;8361;24658;1769;5938;3611;9678;5380;15616
355410;202202;26108;69612;17113;51418;3355;10999;5662;16413;9017;27412
355420;202202;688;2093;581;1901;151;551;197;613;348;1164
355430;202202;4076;9983;3155;8372;556;1549;1605;4152;2161;5701
355440;202202;840;2207;550;1617;102;303;142;379;244;682
355450;202202;3724;9327;2591;7191;374;1151;1227;3075;1601;4226
355460;202202;563;1343;356;1001;35;126;172;440;207;566
355465;202202;500;1237;406;1091;55;154;252;661;307;815
355470;202202;1245;3086;745;2113;171;557;254;649;425;1206
355475;202202;388;875;326;798;10;26;258;616;268;642
355480;202202;4454;11847;3624;10617;426;1447;2464;7091;2890;8538
355490;202202;1021;2662;596;1821;55;198;288;810;343;1008
355495;202202;931;2502;700;2131;98;360;283;775;381;1135
355500;202202;7643;18984;4957;13959;706;2173;2030;5218;2736;7391
355510;202202;1547;3668;1027;2817;170;508;439;1094;609;1602
355520;202202;408;932;213;614;44;111;62;183;106;294
355530;202202;366;840;150;429;7;20;72;192;79;212
355535;202202;587;1553;465;1364;103;322;223;634;326;956
355540;202202;12359;29485;10358;26760;1033;3080;7548;18833;8581;21913
355550;202202;668;1918;567;1737;58;217;315;881;373;1098
355560;202202;1273;3192;757;2220;186;609;45;143;231;752
355570;202202;322;850;182;555;30;96;48;130;78;226
355580;202202;1343;3113;856;2320;144;451;327;799;471;1250
355590;202202;181;461;142;401;11;33;87;235;98;268
355600;202202;1712;4113;1148;3166;185;552;392;1067;577;1619
355610;202202;2061;4917;1414;3828;143;413;788;1982;931;2395
355620;202202;5642;14476;4307;11943;468;1586;2478;6272;2946;7858
355630;202202;2814;7287;2071;5980;279;853;1204;3313;1483;4166
355635;202202;1007;2838;754;2352;124;413;263;771;387;1184
355640;202202;3780;9998;2673;7902;596;1746;810;2392;1406;4138
355645;202202;4506;12161;3360;10199;479;1606;1887;5512;2366;7118
355650;202202;7180;18850;5677;16176;1311;3843;2368;6344;3679;10187
355660;202202;1573;3933;1096;3112;198;517;343;925;541;1442
355670;202202;4315;11240;3083;8577;385;1303;1623;3940;2008;5243
355680;202202;3187;8505;1610;4903;403;1351;133;400;536;1751
355690;202202;863;2443;594;1951;170;603;18;51;188;654
355695;202202;282;768;172;527;17;61;34;77;51;138
355700;202202;8404;23068;7065;20265;919;2944;4261;11546;5180;14490
355710;202202;10455;24078;7219;18324;958;2851;3873;8649;4831;11500
355715;202202;524;1395;296;887;69;212;57;157;126;369
355720;202202;1597;4314;1292;3805;169;553;752;2064;921;2617
355730;202202;1036;2748;859;2444;114;372;486;1298;600;1670
410010;202202;1338;3627;1046;3039;211;667;284;782;495;1449
410020;202202;1159;3304;898;2754;238;699;270;786;508;1485
410030;202202;1706;4503;1473;4154;193;588;871;2488;1064;3076
410040;202202;14529;38749;10918;32211;2231;7180;3931;10754;6162;17934
410045;202202;870;2289;641;1846;106;337;256;666;362;1003
410050;202202;2479;6048;1751;4833;262;804;725;1875;987;2679
410060;202202;2283;6192;1825;5356;409;1279;584;1629;993;2908
410070;202202;2151;5286;1631;4407;276;836;642;1561;918;2397
410080;202202;1441;3750;1054;3093;245;760;233;651;478;1411
410090;202202;1226;2942;1043;2685;92;234;608;1636;700;1870
410100;202202;2201;6096;1544;4607;277;903;166;468;443;1371
410105;202202;525;1302;316;910;30;90;123;331;153;421
410110;202202;3597;8714;2609;6969;322;940;1296;3236;1618;4176
410115;202202;610;1539;450;1262;60;190;189;471;249;661
410120;202202;3095;8022;2692;7434;394;1129;1730;4692;2124;5821
410130;202202;1423;3646;1246;3323;165;491;731;1873;896;2364
410140;202202;18551;43974;12709;33903;2235;6485;3935;9670;6170;16155
410150;202202;18077;41703;9860;26232;1703;4860;2757;6580;4460;11440
410160;202202;3300;8874;2694;7853;587;1849;1045;2973;1632;4822
410165;202202;710;1862;568;1570;68;222;320;824;388;1046
410170;202202;3194;8000;2120;5803;444;1316;245;633;689;1949
410180;202202;17377;46880;13679;39754;2019;6396;7088;19029;9107;25425
410185;202202;500;1396;379;1102;49;167;141;356;190;523
410190;202202;2431;5887;1793;4788;378;1053;531;1298;909;2351
410200;202202;6442;14204;3669;9594;690;1887;573;1444;1263;3331
410210;202202;3520;8570;2286;6431;354;1152;802;1948;1156;3100
410220;202202;586;1479;400;1150;65;201;122;317;187;518
410230;202202;1989;5223;1528;4332;230;748;682;1731;912;2479
410240;202202;5715;14578;4037;11406;841;2658;685;1767;1526;4425
410250;202202;2650;6263;1978;5205;152;497;1001;2553;1153;3050
410260;202202;2043;4980;1297;3607;171;515;659;1765;830;2280
410270;202202;532;1384;395;1140;54;186;159;421;213;607
410275;202202;662;1804;475;1412;73;262;211;561;284;823
410280;202202;2580;6610;1778;5105;226;753;775;2018;1001;2771
410290;202202;3632;9891;2565;7738;651;1942;773;2312;1424;4254
410300;202202;772;1845;610;1599;63;199;306;712;369;911
410302;202202;375;942;229;675;24;84;116;329;140;413
410304;202202;1456;3521;1250;3154;121;326;859;2058;980;2384
410305;202202;1844;4292;1315;3553;96;304;879;2295;975;2599
410310;202202;3008;7925;2489;7010;261;894;1519;4101;1780;4995
410315;202202;722;1629;467;1230;150;408;142;382;292;790
410320;202202;1103;3012;765;2373;105;345;129;367;234;712
410322;202202;700;1810;372;1071;46;141;161;402;207;543
410330;202202;1666;3966;1171;3077;188;505;393;1006;581;1511
410335;202202;912;2383;697;1991;101;323;311;817;412;1140
410337;202202;895;2161;640;1680;97;263;231;547;328;810
410340;202202;540;1500;374;1113;30;105;158;375;188;480
410345;202202;2778;7123;1643;4758;314;983;532;1363;846;2346
410347;202202;832;2104;614;1728;68;204;204;581;272;785
410350;202202;1787;4271;1321;3538;144;449;671;1649;815;2098
410360;202202;4488;10992;3445;9209;587;1674;1416;3654;2003;5328
410370;202202;15396;40162;10278;28590;1189;3658;4401;10636;5590;14294
410380;202202;1877;4513;1394;3706;233;700;483;1120;716;1820
410390;202202;3016;7267;2088;5705;422;1325;828;1995;1250;3320
410395;202202;1013;2792;818;2412;138;412;357;1065;495;1477
410400;202202;7852;19548;6024;16210;734;2221;3400;8553;4134;10774
410405;202202;943;2129;667;1722;79;232;354;848;433;1080
410410;202202;1506;3837;1412;3710;150;453;991;2661;1141;3114
410420;202202;12614;32985;9722;27477;1392;4393;4472;11390;5864;15783
410425;202202;3808;10229;2716;8056;465;1483;1062;2848;1527;4331
410430;202202;14375;35088;10416;28166;1540;4633;4107;10282;5647;14915
410440;202202;2541;7206;2180;6553;325;1078;1190;3508;1515;4586
410442;202202;2692;7677;2193;6649;559;1788;662;1905;1221;3693
410445;202202;2454;6779;1799;5541;409;1397;302;1002;711;2399
410450;202202;1638;3915;1257;3346;229;638;536;1333;765;1971
410460;202202;2495;5994;1851;4924;247;708;905;2249;1152;2957
410465;202202;3134;8709;2487;7547;445;1407;905;2557;1350;3964
410470;202202;2463;6518;1761;5298;445;1477;279;929;724;2406
410480;202202;42693;100180;24851;69746;3786;11854;6845;16612;10631;28466
410490;202202;12752;33866;9402;27261;1485;4660;4156;11131;5641;15791
410500;202202;2060;5197;1396;3973;267;828;365;878;632;1706
410510;202202;1983;4800;1389;3775;279;718;461;1249;740;1967
410520;202202;3289;9903;2915;9203;857;2844;1064;3406;1921;6250
410530;202202;1758;4170;867;2399;108;322;233;518;341;840
410540;202202;3060;8006;2145;6204;335;1061;948;2606;1283;3667
410550;202202;8446;21846;5834;16478;1016;3162;1745;4213;2761;7375
410560;202202;1705;4292;1268;3445;251;734;458;1062;709;1796
410570;202202;2891;7517;2144;6276;656;2230;266;810;922;3040
410580;202202;30509;76144;23030;63052;3470;10693;11551;29411;15021;40104
410590;202202;1761;4805;1276;3734;185;578;407;1012;592;1590
410600;202202;1962;5002;1553;4226;317;860;551;1524;868;2384
410610;202202;783;1956;598;1634;69;216;287;727;356;943
410620;202202;2851;7689;2027;5888;474;1435;415;1146;889;2581
410630;202202;2814;7058;1896;5311;343;1153;488;1140;831;2293
410640;202202;5284;12096;3748;9470;834;2360;615;1573;1449;3933
410645;202202;1230;3289;1019;3030;200;634;630;1866;830;2500
410650;202202;2690;7086;1891;5513;322;1001;781;2092;1103;3093
410655;202202;966;2263;695;1813;41;104;358;882;399;986
410657;202202;668;1788;412;1242;65;208;126;318;191;526
410660;202202;3925;9573;2449;6510;408;1156;876;2080;1284;3236
410670;202202;1114;2712;706;1973;128;342;244;635;372;977
410680;202202;2677;7802;1876;5865;526;1696;385;1194;911;2890
410685;202202;573;1430;436;1201;87;261;185;487;272;748
410690;202202;151579;357088;106379;277151;15962;46741;46743;108673;62705;155414
410700;202202;2681;6619;2242;5975;413;1149;1080;2756;1493;3905
410710;202202;986;2426;642;1792;108;331;293;743;401;1074
410712;202202;710;1906;590;1694;99;313;317;878;416;1191
410715;202202;940;2626;599;1877;66;226;257;751;323;977
410720;202202;3811;9404;3144;8271;499;1564;1062;2706;1561;4270
410725;202202;1247;2965;766;2105;181;533;143;339;324;872
410730;202202;818;2092;642;1789;134;415;160;450;294;865
410740;202202;937;2547;704;2113;71;255;319;944;390;1199
410750;202202;2032;4841;1654;4187;277;733;853;2048;1130;2781
410752;202202;413;977;227;630;34;97;114;287;148;384
410753;202202;381;1092;274;857;39;139;68;196;107;335
410754;202202;1184;2951;989;2668;68;177;692;1939;760;2116
410755;202202;619;1553;458;1264;49;134;219;556;268;690
410760;202202;4019;10155;2949;8248;678;2192;851;2243;1529;4435
410765;202202;17224;45873;13792;39460;2794;8839;4067;10154;6861;18993
410770;202202;1151;2664;816;2110;87;199;423;1112;510;1311
410773;202202;1402;3576;1227;3316;111;342;839;2217;950;2559
410775;202202;1709;4003;1490;3688;52;137;1063;2538;1115;2675
410780;202202;697;1680;479;1283;83;237;155;390;238;627
410785;202202;783;1974;603;1685;94;317;219;593;313;910
410790;202202;1056;2922;880;2594;205;631;128;298;333;929
410800;202202;3738;8101;3010;7089;85;260;1988;4524;2073;4784
410810;202202;491;1261;381;1057;40;134;163;394;203;528
410820;202202;1071;2952;585;1721;114;360;114;278;228;638
410830;202202;46115;107132;33231;86195;6024;17346;14357;35078;20381;52424
410832;202202;1149;2919;934;2560;90;303;592;1503;682;1806
410840;202202;9765;23802;5966;16836;1195;3573;1756;4491;2951;8064
410845;202202;1251;3013;976;2603;146;423;469;1190;615;1613
410850;202202;2377;6512;2089;6020;327;1037;1034;2897;1361;3934
410855;202202;836;2035;545;1482;64;174;260;636;324;810
410860;202202;4970;11686;3956;10100;216;707;2647;6404;2863;7111
410865;202202;1575;4376;1352;3974;137;458;813;2440;950;2898
410870;202202;1340;3488;1096;3075;98;304;717;1978;815;2282
410880;202202;5156;13259;3681;10660;713;2196;736;2122;1449;4318
410890;202202;1148;3079;908;2639;161;518;354;965;515;1483
410895;202202;1099;3352;936;3024;294;1034;266;820;560;1854
410900;202202;930;2416;662;1927;108;351;174;423;282;774
410910;202202;465;1053;295;742;11;40;159;359;170;399
410920;202202;964;2272;721;1903;94;269;369;956;463;1225
410930;202202;1897;4667;1333;3725;342;1056;261;712;603;1768
410940;202202;26020;68052;19344;56485;3588;11462;7279;20550;10867;32012
410950;202202;2124;5917;1921;5605;93;315;1560;4502;1653;4817
410960;202202;8742;20699;6236;16685;1376;4016;2744;7236;4120;11252
410965;202202;1296;3132;905;2448;71;209;590;1540;661;1749
410970;202202;4550;11890;3260;9434;792;2632;537;1320;1329;3952
410975;202202;1548;3618;1190;3081;168;502;601;1500;769;2002
410980;202202;8420;20381;5648;15629;628;1960;2663;6684;3291;8644
410990;202202;1563;3609;1079;2873;182;547;484;1265;666;1812
411000;202202;757;1972;556;1617;99;315;175;447;274;762
411005;202202;502;1219;307;821;46;136;109;254;155;390
411007;202202;2737;7157;2072;5971;389;1270;831;2263;1220;3533
411010;202202;4669;13499;3749;11756;971;3285;477;1394;1448;4679
411020;202202;2582;6999;2144;6264;537;1657;725;2044;1262;3701
411030;202202;825;1989;585;1516;51;156;302;687;353;843
411040;202202;1100;2709;597;1675;95;262;172;419;267;681
411050;202202;2187;6565;1820;5811;425;1496;357;987;782;2483
411060;202202;2344;6045;1584;4532;314;973;424;1137;738;2110
411065;202202;457;1139;291;812;27;85;122;325;149;410
411070;202202;8349;20348;6706;17750;761;2295;3727;9434;4488;11729
411080;202202;2055;5314;1706;4731;393;1257;491;1334;884;2591
411090;202202;889;2306;595;1737;86;262;156;405;242;667
411095;202202;2883;6605;1665;4481;259;716;380;914;639;1630
411100;202202;1338;3373;958;2711;114;358;357;969;471;1327
411110;202202;712;1802;356;1053;45;130;27;56;72;186
411120;202202;1507;3905;1263;3507;327;1046;427;1050;754;2096
411125;202202;5836;16380;5228;15303;1032;3057;2709;8116;3741;11173
411130;202202;782;2013;563;1620;123;304;199;648;322;952
411140;202202;2468;7222;2066;6419;536;1750;688;2149;1224;3899
411150;202202;4424;10839;3066;8230;651;1865;333;729;984;2594
411155;202202;1114;2777;732;2082;103;320;349;908;452;1228
411160;202202;407;917;281;729;40;114;80;200;120;314
411170;202202;858;2387;679;2015;138;453;287;807;425;1260
411180;202202;6362;16153;5060;14028;707;2202;2646;6832;3353;9034
411190;202202;2101;5256;1601;4381;208;642;692;1671;900;2313
411200;202202;5356;13974;4018;11610;893;2931;1218;3092;2111;6023
411210;202202;3706;8138;2642;6457;399;1119;1142;2627;1541;3746
411220;202202;985;2431;701;1917;154;440;227;591;381;1031
411230;202202;944;2432;701;1984;149;480;244;633;393;1113
411240;202202;1775;4081;1240;3186;141;412;611;1464;752;1876
411250;202202;2477;6322;1828;5188;367;1185;601;1612;968;2797
411260;202202;356;886;237;659;25;83;100;241;125;324
411270;202202;2173;5628;1643;4594;246;726;807;2085;1053;2811
411275;202202;1657;3678;1173;2920;137;415;644;1488;781;1903
411280;202202;1477;3875;1049;3089;267;841;216;583;483;1424
411290;202202;905;2301;586;1688;66;209;312;861;378;1070
411295;202202;1362;3334;996;2674;127;364;471;1179;598;1543
411300;202202;1118;2747;748;2055;77;235;333;792;410;1027
411310;202202;986;2191;773;1907;119;301;358;845;477;1146
411320;202202;5987;14900;4475;12340;641;1891;2085;5191;2726;7082
411325;202202;1575;4261;1312;3782;244;708;682;2024;926;2732
411330;202202;3583;9341;2665;7728;552;1748;885;2577;1437;4325
411340;202202;914;2451;559;1685;87;281;175;481;262;762
411342;202202;1166;2753;651;1735;108;309;230;559;338;868
411345;202202;1249;3060;962;2611;59;194;703;1899;762;2093
411350;202202;3213;8322;2164;6316;564;1740;444;1169;1008;2909
411360;202202;832;1926;626;1615;66;202;332;769;398;971
411370;202202;66171;159136;49170;131120;3731;11905;29491;72876;33222;84781
411373;202202;1567;3825;1271;3394;133;388;684;1843;817;2231
411375;202202;1244;3020;892;2374;123;333;377;967;500;1300
411380;202202;1251;2838;879;2166;48;130;565;1282;613;1412
411390;202202;1667;4428;1335;3750;191;591;542;1330;733;1921
411400;202202;2593;6184;1988;5117;160;497;1134;2748;1294;3245
411410;202202;3008;8149;2290;6710;491;1541;580;1574;1071;3115
411420;202202;4763;11294;2694;7530;411;1256;567;1231;978;2487
411430;202202;4139;10678;3191;8969;663;2068;1142;2909;1805;4977
411435;202202;472;1258;304;928;58;187;97;260;155;447
411440;202202;2780;7459;2252;6500;456;1473;773;2094;1229;3567
411450;202202;2702;6942;2076;5940;233;717;1235;3523;1468;4240
411460;202202;4841;12177;3143;9006;513;1637;709;1757;1222;3394
411470;202202;902;2211;676;1825;122;345;277;666;399;1011
411480;202202;5875;14945;4295;12078;683;2273;1660;4253;2343;6526
411490;202202;1799;4461;1376;3803;163;533;628;1551;791;2084
411500;202202;1449;3752;1018;2885;181;572;232;539;413;1111
411510;202202;2537;6120;2049;5350;325;972;689;1848;1014;2820
411520;202202;38019;90892;23452;63113;2793;8690;9739;23297;12532;31987
411530;202202;1040;2615;645;1893;109;338;119;317;228;655
411535;202202;540;1529;367;1140;46;165;114;315;160;480
411540;202202;2890;6890;2026;5380;97;319;1194;3091;1291;3410
411545;202202;971;2733;822;2479;62;217;548;1642;610;1859
411550;202202;782;1899;592;1566;85;232;180;444;265;676
411560;202202;2175;5829;1261;3900;199;669;103;263;302;932
411570;202202;7850;17763;5528;14366;1272;3561;1395;3551;2667;7112
411573;202202;838;2199;692;1945;128;394;315;832;443;1226
411575;202202;2165;5695;1644;4705;297;914;505;1370;802;2284
411580;202202;5332;12149;3360;9168;549;1685;685;1695;1234;3380
411585;202202;655;1893;332;1053;61;193;66;187;127;380
411590;202202;468;1238;358;1032;37;125;191;508;228;633
411600;202202;369;891;235;680;40;126;89;238;129;364
411605;202202;1706;3868;1113;2955;172;489;565;1516;737;2005
411610;202202;2972;6636;2158;5248;61;218;1566;3529;1627;3747
411620;202202;3121;7935;2645;7229;384;1094;1493;4101;1877;5195
411630;202202;904;2236;583;1669;68;239;222;561;290;800
411640;202202;520;1303;370;997;49;131;134;312;183;443
411650;202202;218;615;142;452;28;94;32;78;60;172
411660;202202;1010;2504;729;1981;75;224;292;722;367;946
411670;202202;1595;3693;1107;2818;107;300;609;1417;716;1717
411680;202202;1554;4045;1188;3355;240;746;461;1252;701;1998
411690;202202;4328;10639;3270;8839;647;1716;1043;2981;1690;4697
411695;202202;694;2006;494;1502;52;179;208;588;260;767
411700;202202;1851;4624;1258;3531;275;818;252;668;527;1486
411705;202202;2512;7084;2149;6469;348;991;1319;4211;1667;5202
411710;202202;2214;5484;1543;4253;345;974;438;1131;783;2105
411720;202202;1184;2729;852;2170;136;354;355;871;491;1225
411721;202202;1117;2686;846;2206;134;357;315;783;449;1140
411722;202202;1029;2753;581;1735;92;311;189;443;281;754
411725;202202;1348;3667;915;2827;194;656;232;683;426;1339
411727;202202;1616;4346;1081;3226;253;776;146;397;399;1173
411729;202202;693;1656;391;1072;47;166;137;305;184;471
411730;202202;5882;14927;4646;12634;672;1989;2474;6516;3146;8505
411740;202202;559;1429;310;906;78;213;64;154;142;367
411745;202202;885;2469;639;1945;71;270;176;410;247;680
411750;202202;6398;16280;4788;13262;595;1813;2390;6197;2985;8010
411760;202202;7746;19784;6076;17090;1848;5269;1522;4681;3370;9950
411770;202202;3492;9709;2607;7854;572;1855;587;1602;1159;3457
411780;202202;2897;7915;2534;7280;628;1900;1033;3005;1661;4905
411790;202202;3216;7523;1968;5378;365;1138;581;1364;946;2502
411800;202202;1244;3479;904;2659;185;587;207;522;392;1109
411810;202202;1736;4362;1326;3583;225;629;561;1412;786;2041
411820;202202;14048;37758;11720;33882;2479;7683;5958;16710;8437;24393
411830;202202;577;1389;439;1157;127;306;73;209;200;515
411840;202202;13748;35399;9754;27444;1581;4860;3133;7895;4714;12755
411845;202202;684;1892;422;1301;75;263;106;276;181;539
411850;202202;8474;20802;5969;16555;1377;4088;1393;3574;2770;7662
411860;202202;768;2070;577;1694;88;275;140;368;228;643
411870;202202;642;1807;461;1418;119;387;111;313;230;700
411880;202202;2546;6029;1842;4933;239;739;794;1976;1033;2715
411885;202202;1215;3082;890;2508;117;386;273;666;390;1052
411890;202202;1571;4073;1163;3366;225;714;155;418;380;1132
411900;202202;916;2405;590;1738;113;340;149;431;262;771
411910;202202;1203;3387;904;2801;167;613;342;964;509;1577
411915;202202;17047;40974;12147;32333;1666;4977;5417;13101;7083;18078
411920;202202;1309;3609;1091;3208;208;697;444;1231;652;1928
411925;202202;531;1358;387;1107;67;203;179;476;246;679
411930;202202;5461;15712;4624;14240;1915;6254;607;2163;2522;8417
411940;202202;3642;10140;2900;8656;659;2078;1109;2983;1768;5061
411950;202202;16254;42336;13615;38137;1493;4840;8603;23048;10096;27888
411960;202202;6631;16939;5317;14471;886;2500;2339;6073;3225;8573
411965;202202;542;1441;400;1161;53;177;197;531;250;708
411970;202202;1275;2794;997;2428;186;405;470;1316;656;1721
411980;202202;1653;3831;1212;3156;237;633;558;1381;795;2014
411990;202202;42384;107261;28446;82967;4794;15395;11445;31682;16239;47077
411995;202202;4660;11020;3655;9492;999;2888;1168;2886;2167;5774
412000;202202;2013;4538;1426;3579;41;135;1012;2366;1053;2501
412010;202202;676;2007;515;1665;78;282;138;383;216;665
412015;202202;579;1588;470;1389;61;166;275;826;336;992
412020;202202;483;1317;317;980;53;195;137;396;190;591
412030;202202;662;1844;503;1556;71;247;209;618;280;865
412033;202202;1020;2621;739;2086;76;224;274;668;350;892
412035;202202;775;2049;505;1558;62;205;271;798;333;1003
412040;202202;767;2003;452;1369;61;176;70;191;131;367
412050;202202;1711;4159;1176;3202;254;757;298;809;552;1566
412060;202202;8066;22347;6691;19685;1679;5533;2076;5912;3755;11445
412065;202202;687;1853;515;1511;100;338;155;428;255;766
412070;202202;1379;3460;1083;2910;122;382;465;1120;587;1502
412080;202202;2600;6783;1880;5435;261;844;747;1863;1008;2707
412085;202202;357;847;133;397;14;52;36;89;50;141
412090;202202;6919;17131;5161;14004;980;2797;2258;6153;3238;8950
412100;202202;1952;4976;1464;4127;435;1341;406;1191;841;2532
412110;202202;1012;2597;680;1944;84;265;244;646;328;911
412120;202202;2422;6531;1887;5583;427;1400;560;1449;987;2849
412125;202202;722;1982;491;1498;94;295;119;341;213;636
412130;202202;886;2137;618;1658;129;349;168;438;297;787
412135;202202;658;1712;328;972;50;164;109;284;159;448
412140;202202;1981;4673;1433;3736;227;672;362;914;589;1586
412150;202202;3061;7629;2562;6747;474;1364;1289;3151;1763;4515
412160;202202;991;2980;585;1902;70;266;56;128;126;394
412170;202202;4859;12791;4118;11645;690;2177;1992;5244;2682;7421
412175;202202;1434;3930;1209;3558;261;781;538;1584;799;2365
412180;202202;1849;4949;1388;4130;175;607;628;1728;803;2335
412190;202202;3693;8976;2714;7262;326;968;1164;3023;1490;3991
412200;202202;2095;5803;1420;4331;353;1158;279;794;632;1952
412210;202202;727;1679;462;1252;63;195;194;476;257;671
412215;202202;3529;9235;2653;7536;625;1774;1139;3347;1764;5121
412217;202202;1086;2728;912;2437;32;97;671;1697;703;1794
412220;202202;6388;17550;5280;15610;1282;3774;1838;5500;3120;9274
412230;202202;2953;8330;2352;7257;436;1483;599;1630;1035;3113
412240;202202;8446;21330;5606;15915;932;2875;1784;4533;2716;7408
412250;202202;2192;5471;1625;4434;362;1048;392;980;754;2028
412260;202202;1432;3649;1104;3023;179;537;393;992;572;1529
412265;202202;1048;2682;844;2344;140;423;449;1164;589;1587
412270;202202;1095;2935;732;2191;90;304;292;804;382;1108
412280;202202;434;1143;343;990;68;201;102;277;170;478
412290;202202;1133;2791;812;2238;141;436;313;801;454;1237
412300;202202;1843;4675;1342;3841;245;731;370;1040;615;1771
412310;202202;781;2181;596;1816;101;366;194;542;295;908
412320;202202;838;2089;537;1495;50;163;157;421;207;584
412330;202202;1730;4437;1211;3509;219;671;453;1328;672;1999
412340;202202;1345;3566;939;2734;144;475;133;360;277;835
412350;202202;3347;8566;2236;6430;435;1328;527;1379;962;2707
412360;202202;296;779;225;636;5;21;150;400;155;421
412370;202202;927;2551;660;2013;134;421;125;379;259;800
412380;202202;1676;4471;1207;3563;354;1121;141;445;495;1566
412382;202202;534;1272;355;976;42;148;180;406;222;554
412385;202202;2459;6412;2016;5597;540;1471;838;2408;1378;3879
412390;202202;2733;6350;2214;5571;369;1009;857;2129;1226;3138
412395;202202;789;2133;580;1677;78;209;279;781;357;990
412400;202202;990;2519;726;2042;137;401;237;634;374;1035
412402;202202;2566;6131;1812;4929;425;1129;422;1178;847;2307
412405;202202;3398;8728;2291;6768;640;1945;267;758;907;2703
412410;202202;6876;17404;5148;14659;816;2730;1771;4769;2587;7499
412420;202202;605;1471;413;1100;33;104;209;484;242;588
412430;202202;619;1533;342;968;37;108;144;379;181;487
412440;202202;3138;7994;2196;6336;509;1494;646;1839;1155;3333
412450;202202;539;1518;376;1118;71;208;38;79;109;287
412460;202202;1219;3026;959;2600;146;446;472;1224;618;1670
412470;202202;1695;5102;1412;4498;353;1232;364;1110;717;2342
412480;202202;1237;3098;857;2356;137;406;352;852;489;1258
412490;202202;1455;3439;1141;2909;113;310;646;1534;759;1844
412500;202202;2221;5396;1698;4481;293;846;598;1408;891;2254
412510;202202;2137;6258;1545;4846;404;1345;262;720;666;2065
412520;202202;1446;3562;864;2403;191;531;163;420;354;951
412530;202202;738;1912;539;1530;80;245;123;334;203;579
412535;202202;863;2224;601;1732;124;398;110;252;234;650
412540;202202;1243;3071;915;2516;119;399;289;826;408;1225
412545;202202;747;1879;535;1476;88;258;180;468;268;726
412550;202202;38725;99390;28590;80084;4192;12919;12904;32805;17096;45724
412555;202202;320;816;226;624;25;83;76;170;101;253
412560;202202;5567;15273;4287;12511;807;2587;1327;3766;2134;6353
412570;202202;4873;11916;2978;8419;586;1860;491;1331;1077;3191
412575;202202;1166;2822;955;2485;142;378;526;1297;668;1675
412580;202202;1642;4097;1191;3289;93;288;671;1742;764;2030
412590;202202;441;1134;258;775;47;163;34;88;81;251
412600;202202;1801;4594;1398;3853;144;461;761;1925;905;2386
412610;202202;929;2415;677;1902;97;293;315;778;412;1071
412620;202202;1402;3518;1096;3069;224;696;416;1083;640;1779
412625;202202;9578;24692;6243;18310;1151;3611;534;1469;1685;5080
412627;202202;1191;3278;814;2529;141;490;260;797;401;1287
412630;202202;3047;8651;2236;6959;423;1405;664;1874;1087;3279
412635;202202;470;1234;320;942;44;134;105;253;149;387
412640;202202;1114;2853;683;1994;93;271;182;457;275;728
412650;202202;1855;4882;1481;4146;238;762;603;1498;841;2260
412660;202202;2841;7076;2126;5787;257;776;829;2025;1086;2801
412665;202202;434;1048;336;882;59;181;156;381;215;562
412667;202202;1950;4966;1448;3992;209;623;652;1728;861;2351
412670;202202;933;2139;634;1667;123;333;187;459;310;792
412680;202202;2298;5894;1619;4661;200;690;594;1483;794;2173
412690;202202;1271;3240;907;2545;176;524;313;809;489;1333
412700;202202;2104;5348;1782;4855;211;649;1025;2725;1236;3374
412710;202202;6353;17826;4827;14724;924;3130;1392;3687;2316;6817
412720;202202;1313;3661;1055;3133;158;533;312;752;470;1285
412730;202202;2832;7170;2047;5706;329;1031;838;2158;1167;3189
412740;202202;2097;5683;1498;4531;294;976;220;644;514;1620
412750;202202;4359;11015;3595;9939;296;985;2343;6175;2639;7160
412760;202202;3187;8373;2681;7558;460;1466;1540;4107;2000;5573
412770;202202;12008;30408;6903;20653;906;2931;1521;3828;2427;6759
412780;202202;1296;3334;1001;2813;227;707;388;1005;615;1712
412785;202202;2367;5395;1683;4281;177;471;1136;2838;1313;3309
412788;202202;1551;4237;1274;3757;302;894;544;1551;846;2445
412790;202202;1490;3827;919;2713;151;492;308;777;459;1269
412795;202202;1341;3388;755;2230;125;392;145;407;270;799
412796;202202;2520;6902;2123;6221;445;1412;742;2006;1187;3418
412800;202202;4123;9662;2968;7593;337;1030;1479;3345;1816;4375
412810;202202;13607;34004;9270;25537;1088;3529;3937;9675;5025;13204
412820;202202;6807;18094;4910;14400;1046;3276;1678;4849;2724;8125
412830;202202;364;1008;279;839;33;99;74;208;107;307
412840;202202;2054;4894;1501;3894;152;444;798;1885;950;2329
412850;202202;2996;7597;2253;6395;273;863;1095;2918;1368;3781
412853;202202;1688;4119;1434;3709;187;560;785;1774;972;2334
412855;202202;1486;3745;865;2482;115;388;221;527;336;915
412860;202202;804;1963;555;1562;77;238;286;743;363;981
412862;202202;724;1752;494;1383;91;254;200;549;291;803
412863;202202;1381;3959;1229;3690;308;991;483;1382;791;2373
412865;202202;750;1983;555;1602;134;409;171;493;305;902
412870;202202;942;2377;693;1986;169;529;221;682;390;1211
412880;202202;965;2541;684;2011;135;430;197;523;332;953
420005;202202;452;1287;276;884;22;63;137;441;159;504
420010;202202;3611;8565;2426;6585;163;479;1823;4966;1986;5445
420020;202202;487;1454;332;1075;59;229;91;235;150;464
420030;202202;115;405;77;305;25;100;21;89;46;189
420040;202202;598;1753;369;1253;91;354;36;109;127;463
420050;202202;781;1743;532;1315;113;298;303;682;416;980
420055;202202;173;520;97;331;20;83;32;100;52;183
420060;202202;126;351;84;252;13;39;20;52;33;91
420070;202202;825;2384;620;1965;127;423;273;846;400;1269
420075;202202;86;222;49;150;8;29;12;20;20;49
420080;202202;435;1177;344;974;66;224;153;403;219;627
420090;202202;457;1379;296;1014;69;256;71;208;140;464
420100;202202;1441;3490;1208;3160;54;162;986;2536;1040;2698
420110;202202;295;911;258;831;40;152;145;453;185;605
420120;202202;650;1719;461;1325;52;174;255;659;307;833
420125;202202;393;1151;275;893;63;235;102;308;165;543
420127;202202;335;864;145;438;21;75;59;171;80;246
420130;202202;4318;11558;3352;10002;564;1965;1530;4195;2094;6160
420140;202202;4275;11083;3267;9439;903;2862;826;2333;1729;5195
420150;202202;720;1771;518;1446;45;161;317;847;362;1008
420160;202202;200;472;80;242;12;43;25;70;37;113
420165;202202;174;489;113;358;21;65;44;121;65;186
420170;202202;291;889;204;679;36;126;66;194;102;320
420180;202202;181;573;116;409;18;83;29;93;47;176
420190;202202;227;661;137;443;34;114;56;170;90;284
420195;202202;1797;4478;1393;3871;379;1245;499;1242;878;2487
420200;202202;6084;14409;4016;10710;516;1631;1905;4425;2421;6056
420205;202202;2166;5606;1506;4296;237;735;814;2279;1051;3014
420207;202202;2197;5477;1424;4058;225;730;613;1608;838;2338
420208;202202;356;983;213;703;65;225;64;192;129;417
420209;202202;176;540;119;372;15;56;59;162;74;218
420210;202202;3847;9582;2774;7850;389;1333;1541;4129;1930;5462
420213;202202;873;2532;738;2270;134;458;323;955;457;1413
420215;202202;233;689;166;533;37;135;50;160;87;295
420220;202202;335;975;222;741;32;128;96;290;128;418
420230;202202;5913;15353;4650;13091;546;1768;2684;7135;3230;8903
420240;202202;16042;43482;10712;31445;1256;4364;5286;13554;6542;17918
420243;202202;432;1137;364;1015;43;143;248;667;291;810
420245;202202;1722;4292;1312;3590;108;348;851;2191;959;2539
420250;202202;510;1356;443;1251;42;144;310;835;352;979
420253;202202;495;1171;363;991;30;91;218;593;248;684
420257;202202;166;417;107;315;17;50;61;182;78;232
420260;202202;1244;3095;944;2701;88;300;711;2003;799;2303
420270;202202;600;1545;326;942;44;135;134;359;178;494
420280;202202;1465;4164;1197;3636;186;657;560;1607;746;2264
420285;202202;141;325;79;230;13;52;26;46;39;98
420287;202202;493;1103;358;923;73;195;167;435;240;630
420290;202202;5474;15124;4327;12649;545;1849;2612;7108;3157;8957
420300;202202;8163;22452;5024;15178;890;2986;1770;4759;2660;7745
420310;202202;907;2012;507;1323;49;148;310;743;359;891
420315;202202;854;2293;603;1881;82;287;318;963;400;1250
420320;202202;6041;15610;4466;13127;1256;4065;1441;4028;2697;8093
420325;202202;371;1023;269;829;39;126;116;342;155;468
420330;202202;1050;2980;696;2262;125;472;230;677;355;1149
420340;202202;1086;2877;832;2429;187;580;258;665;445;1245
420350;202202;1300;3231;985;2693;89;297;690;1850;779;2147
420360;202202;3205;8497;1818;5585;378;1253;181;555;559;1808
420370;202202;1408;3551;1152;3128;81;284;859;2209;940;2493
420380;202202;4847;12289;3375;9697;617;1971;1488;4000;2105;5971
420390;202202;1124;2691;800;2071;143;436;335;636;478;1072
420395;202202;1305;3607;941;2893;175;612;183;411;358;1023
420400;202202;1139;3047;813;2414;104;355;406;1153;510;1508
420410;202202;623;1589;490;1326;29;87;363;965;392;1052
420415;202202;334;931;253;762;59;201;107;336;166;537
420417;202202;650;1851;519;1596;115;359;258;809;373;1168
420419;202202;150;525;117;447;53;216;12;48;65;264
420420;202202;13531;34478;9411;27021;2341;7559;3354;8931;5695;16490
420425;202202;677;1793;479;1386;41;135;251;697;292;832
420430;202202;3374;8802;2101;6106;400;1341;836;2186;1236;3527
420435;202202;298;752;160;497;28;96;79;234;107;330
420440;202202;755;1957;491;1418;106;320;195;537;301;857
420445;202202;283;672;189;507;26;80;80;180;106;260
420450;202202;824;2367;610;1899;97;375;234;625;331;1000
420455;202202;2232;5166;1679;4372;301;824;857;2192;1158;3016
420460;202202;10227;26423;7928;22329;1032;3326;4365;11696;5397;15022
420470;202202;672;1714;366;1076;74;248;99;246;173;494
420475;202202;75;199;36;112;7;29;6;13;13;42
420480;202202;5694;13660;3704;10478;602;1888;1589;4430;2191;6318
420490;202202;415;1131;295;879;48;154;137;393;185;547
420500;202202;1426;3763;951;2925;142;506;473;1413;615;1919
420510;202202;168;467;91;301;22;80;23;65;45;145
420515;202202;90;247;59;181;10;37;19;60;29;97
420517;202202;792;2120;674;1907;76;227;427;1204;503;1431
420519;202202;334;815;247;684;23;69;144;400;167;469
420520;202202;293;768;158;509;26;86;13;38;39;124
420530;202202;859;2442;608;1930;94;352;242;658;336;1010
420535;202202;238;682;109;352;14;48;40;115;54;163
420540;202202;43069;101365;30145;80175;4051;12319;12061;28242;16112;40561
420543;202202;236;683;189;584;23;77;88;251;111;328
420545;202202;1394;4071;1069;3379;216;744;394;1147;610;1891
420550;202202;3996;10223;2702;8098;399;1367;1308;3999;1707;5366
420555;202202;331;921;240;736;25;91;140;402;165;493
420560;202202;415;1008;285;818;44;121;183;535;227;656
420570;202202;2864;7285;2225;6149;364;1113;1144;3028;1508;4141
420580;202202;1906;4905;1362;4048;271;839;469;1350;740;2189
420590;202202;2969;7848;1895;5562;327;1101;559;1319;886;2420
420600;202202;1176;3249;942;2832;94;369;586;1674;680;2043
420610;202202;450;1273;312;988;66;220;134;422;200;642
420620;202202;861;2063;613;1674;132;382;260;691;392;1073
420630;202202;1018;3013;764;2409;91;313;453;1349;544;1662
420640;202202;537;1431;288;931;93;310;65;194;158;504
420650;202202;3959;10174;2633;7515;387;1228;1152;2885;1539;4113
420660;202202;459;1164;300;833;71;220;77;191;148;411
420665;202202;747;1905;504;1505;76;249;237;643;313;892
420670;202202;1360;3692;885;2715;139;503;308;822;447;1325
420675;202202;193;501;117;360;15;59;67;194;82;253
420680;202202;318;707;171;505;25;92;91;249;116;341
420690;202202;923;2636;611;1935;86;326;179;469;265;795
420700;202202;3013;7692;2359;6630;187;598;1596;4355;1783;4953
420710;202202;1183;3255;955;2783;113;439;581;1491;694;1930
420720;202202;1363;3646;1015;3045;153;509;595;1676;748;2185
420730;202202;3513;8898;2683;7574;410;1315;1523;4091;1933;5406
420740;202202;527;1539;304;1053;75;276;24;87;99;363
420750;202202;2173;6127;1477;4566;243;896;600;1674;843;2570
420757;202202;92;222;42;129;6;21;19;56;25;77
420760;202202;347;983;206;620;34;108;66;173;100;281
420765;202202;521;1440;273;848;30;99;154;461;184;560
420768;202202;1450;3909;1270;3621;110;330;1006;2850;1116;3180
420770;202202;433;1187;203;716;22;95;56;178;78;273
420775;202202;301;849;212;657;39;140;87;231;126;371
420780;202202;1035;2885;633;1969;115;370;100;286;215;656
420785;202202;219;564;163;452;18;67;81;180;99;247
420790;202202;1139;3262;869;2721;144;535;525;1557;669;2092
420800;202202;743;1788;435;1213;75;246;229;610;304;856
420810;202202;1573;4661;1319;4192;304;1149;634;1772;938;2921
420820;202202;14230;34830;10570;29070;1671;5142;5390;13824;7061;18966
420830;202202;5093;12958;3878;10867;603;1886;1799;4792;2402;6678
420840;202202;521;1555;271;988;75;260;37;131;112;391
420845;202202;2879;7193;1925;5527;354;1225;848;2315;1202;3540
420850;202202;1197;3674;789;2643;155;572;200;609;355;1181
420860;202202;402;1035;237;737;45;159;69;189;114;348
420870;202202;855;2349;636;1917;141;461;234;662;375;1123
420880;202202;1182;3458;938;2967;198;706;399;1182;597;1888
420890;202202;8717;23272;5694;17145;800;2668;2115;5704;2915;8372
420895;202202;186;530;125;378;23;72;50;147;73;219
420900;202202;1655;4004;1040;2961;153;542;500;1233;653;1775
420910;202202;35659;92134;23984;70540;3427;11684;10533;27526;13960;39210
420915;202202;541;1881;414;1534;51;216;235;866;286;1082
420917;202202;486;1209;232;624;33;84;123;330;156;414
420920;202202;93;241;46;143;5;17;13;42;18;59
420930;202202;18201;45752;13400;37623;2074;6534;6685;17782;8759;24316
420940;202202;3522;8412;2223;6270;494;1572;558;1313;1052;2885
420945;202202;158;450;118;358;22;86;50;139;72;225
420950;202202;383;1072;244;755;40;134;69;194;109;328
420960;202202;1175;2835;859;2326;121;369;430;1073;551;1442
420970;202202;2598;6841;1798;5405;410;1285;636;1921;1046;3206
420980;202202;288;964;250;882;97;351;82;296;179;647
420985;202202;363;1017;210;707;49;188;61;187;110;375
420990;202202;359;1080;215;734;36;132;54;168;90;300
421000;202202;594;1726;453;1440;110;378;116;312;226;690
421003;202202;479;1121;182;516;14;36;19;45;33;81
421005;202202;88;250;63;205;19;64;23;77;42;141
421010;202202;3742;9788;2753;8050;518;1682;948;2441;1466;4123
421020;202202;412;1251;330;1100;46;182;174;553;220;735
421030;202202;951;2649;753;2279;169;570;330;946;499;1516
421040;202202;705;1658;444;1266;38;112;278;780;316;892
421050;202202;1156;3041;807;2311;131;404;343;880;474;1284
421055;202202;179;480;106;317;17;59;61;166;78;225
421060;202202;738;2095;538;1678;80;292;277;795;357;1087
421070;202202;724;2109;453;1432;62;218;194;561;256;779
421080;202202;559;1577;459;1393;70;254;240;698;310;952
421085;202202;395;1097;181;600;20;65;31;77;51;142
421090;202202;286;730;167;467;18;62;58;139;76;201
421100;202202;884;1950;413;1194;95;307;130;321;225;628
421105;202202;1730;4515;1242;3625;170;554;638;1770;808;2324
421110;202202;1290;3288;1063;2957;86;300;688;1952;774;2252
421120;202202;1145;3349;819;2648;132;459;239;683;371;1142
421125;202202;317;794;230;642;72;218;99;254;171;472
421130;202202;5679;15976;4713;14088;819;2688;2652;7580;3471;10268
421140;202202;375;982;255;741;35;111;112;289;147;400
421145;202202;461;1223;308;913;71;230;97;251;168;481
421150;202202;758;2054;526;1594;105;364;227;611;332;975
421160;202202;567;1538;437;1297;58;229;277;760;335;989
421165;202202;240;683;152;474;25;80;68;201;93;281
421170;202202;1179;3136;1001;2857;96;281;701;2012;797;2293
421175;202202;1007;2437;614;1840;97;366;303;852;400;1218
421180;202202;424;1096;245;747;37;139;117;318;154;457
421185;202202;335;836;238;652;22;74;135;347;157;421
421187;202202;283;859;183;607;35;110;64;211;99;321
421189;202202;419;1169;332;998;50;169;140;389;190;558
421190;202202;13262;34696;9571;27896;1648;5411;4024;10703;5672;16114
421200;202202;769;2082;631;1854;89;327;376;1048;465;1375
421205;202202;214;555;158;466;28;92;77;218;105;310
421210;202202;1176;2871;690;2060;129;391;267;790;396;1181
421220;202202;1494;4271;1195;3683;291;1008;440;1239;731;2247
421223;202202;359;929;233;710;44;152;142;419;186;571
421225;202202;933;2625;805;2421;104;367;525;1567;629;1934
421227;202202;771;2117;514;1586;79;254;253;803;332;1057
421230;202202;621;1581;409;1193;78;254;167;473;245;727
421240;202202;311;885;159;542;23;96;32;93;55;189
421250;202202;2295;5646;1668;4666;204;620;1026;2775;1230;3395
421260;202202;230;716;59;208;13;57;7;22;20;79
421265;202202;818;2006;713;1869;32;93;618;1598;650;1691
421270;202202;384;1014;189;618;47;152;71;218;118;370
421280;202202;2271;5821;1724;4935;226;783;1022;2769;1248;3552
421290;202202;1091;2960;579;1743;99;307;145;394;244;701
421300;202202;303;780;154;493;21;85;25;77;46;162
421310;202202;224;634;158;505;33;102;85;271;118;373
421315;202202;267;668;184;503;42;100;68;196;110;296
421320;202202;659;2042;378;1254;47;155;43;74;90;229
421330;202202;666;1907;489;1552;102;356;143;408;245;764
421335;202202;382;1140;311;1020;48;181;155;500;203;681
421340;202202;1515;4054;1101;3327;157;556;584;1674;741;2230
421350;202202;1708;4252;1140;3314;192;643;480;1328;672;1971
421360;202202;2434;6290;1495;4463;294;968;584;1544;878;2512
421370;202202;813;2517;540;1821;96;366;180;495;276;861
421380;202202;919;2300;796;2116;86;280;513;1302;599;1582
421390;202202;173;450;72;231;19;59;25;68;44;127
421400;202202;503;1352;330;1011;50;179;180;504;230;683
421410;202202;195;504;96;319;21;67;31;105;52;172
421415;202202;210;569;152;425;22;72;62;149;84;221
421420;202202;609;1593;489;1371;40;132;303;825;343;957
421430;202202;105;328;78;262;12;42;16;47;28;89
421440;202202;689;1808;419;1292;81;251;179;536;260;787
421450;202202;513;1488;313;1043;51;186;43;144;94;330
421460;202202;383;1162;211;771;15;55;19;58;34;113
421470;202202;341;918;231;701;35;115;84;264;119;379
421480;202202;3019;7856;2093;6050;339;1157;934;2477;1273;3634
421490;202202;121;408;77;289;15;59;16;50;31;109
421500;202202;2320;6610;1632;5193;382;1445;461;1296;843;2741
421505;202202;323;857;273;786;25;93;192;532;217;625
421507;202202;459;1242;273;848;50;170;117;344;167;514
421510;202202;405;1082;281;804;35;120;146;361;181;481
421520;202202;517;1350;334;938;46;132;168;427;214;559
421530;202202;311;901;179;612;24;114;39;106;63;220
421535;202202;420;1076;263;785;34;125;143;395;177;520
421540;202202;342;776;191;550;29;103;70;184;99;287
421545;202202;678;1966;528;1708;98;376;271;821;369;1197
421550;202202;2254;5818;1827;5172;272;864;1100;3041;1372;3905
421555;202202;175;528;75;266;7;24;12;24;19;48
421560;202202;92;307;64;239;9;37;25;83;34;120
421565;202202;987;2450;692;2005;162;518;282;782;444;1300
421567;202202;514;1543;378;1195;108;384;114;335;222;719
421568;202202;346;993;238;739;42;153;92;262;134;415
421569;202202;158;444;78;250;6;24;49;153;55;177
421570;202202;1524;4095;1121;3264;223;732;437;1129;660;1861
421575;202202;326;909;247;701;34;99;133;358;167;457
421580;202202;4809;12667;3205;9482;441;1579;1296;3287;1737;4866
421590;202202;182;530;136;433;25;93;58;175;83;268
421600;202202;613;1585;431;1218;82;265;172;422;254;687
421605;202202;738;1902;545;1602;98;283;276;842;374;1125
421610;202202;1104;2886;750;2227;149;467;251;733;400;1200
421620;202202;4244;10986;2760;8380;538;1829;1021;2935;1559;4764
421625;202202;146;416;81;262;14;48;22;60;36;108
421630;202202;2899;7398;1924;5599;322;1073;747;1884;1069;2957
421635;202202;335;890;224;674;21;91;134;361;155;452
421640;202202;731;1921;541;1648;115;375;255;761;370;1136
421650;202202;2685;7148;1883;5721;420;1500;678;1852;1098;3352
421660;202202;12023;32269;8786;26108;1200;4177;4348;11806;5548;15983
421670;202202;833;2304;623;1823;97;335;311;857;408;1192
421680;202202;1452;3451;1178;3017;100;362;900;2129;1000;2491
421690;202202;1527;4228;1084;3339;222;748;365;1074;587;1822
421700;202202;609;1752;454;1423;103;361;142;403;245;764
421710;202202;214;652;114;366;15;56;42;118;57;174
421715;202202;140;356;106;287;18;57;71;182;89;239
421720;202202;2217;5818;1350;4016;303;996;414;1063;717;2059
421725;202202;285;684;167;487;26;91;77;192;103;283
421730;202202;467;1288;304;866;46;153;164;423;210;576
421740;202202;862;2373;598;1831;100;342;229;618;329;960
421750;202202;932;2161;465;1319;93;297;199;529;292;826
421755;202202;178;484;104;315;16;57;42;110;58;167
421760;202202;1111;2813;768;2218;151;500;288;726;439;1226
421770;202202;2616;6693;1895;5493;388;1104;810;2375;1198;3479
421775;202202;222;570;141;418;16;54;67;182;83;236
421780;202202;928;2626;621;1989;118;435;285;838;403;1273
421790;202202;921;2460;534;1726;104;355;231;724;335;1079
421795;202202;183;512;131;388;27;88;46;127;73;215
421800;202202;3115;8031;2353;6672;279;912;1448;3891;1727;4803
421810;202202;658;1767;460;1413;47;156;262;796;309;952
421820;202202;1090;3116;717;2233;127;448;264;705;391;1153
421825;202202;1531;3948;1371;3723;90;303;1077;2840;1167;3143
421830;202202;1907;5295;1537;4631;329;1098;538;1553;867;2651
421835;202202;249;604;172;483;33;119;80;200;113;319
421840;202202;217;687;163;574;28;115;43;133;71;248
421850;202202;405;1128;245;822;52;195;60;163;112;358
421860;202202;336;918;205;655;30;109;78;220;108;329
421870;202202;5053;12356;3831;10143;447;1447;2243;5344;2690;6791
421875;202202;331;962;150;469;24;79;34;89;58;168
421880;202202;720;1992;491;1492;92;310;155;449;247;759
421885;202202;260;697;173;510;29;82;82;228;111;310
421890;202202;965;2723;729;2269;112;442;442;1283;554;1725
421895;202202;433;1070;376;991;40;88;275;766;315;854
421900;202202;1131;2975;891;2493;112;384;449;1126;561;1510
421910;202202;339;975;228;714;38;143;55;138;93;281
421915;202202;431;1202;270;836;64;209;63;170;127;379
421917;202202;635;1422;367;1070;114;349;113;348;227;697
421920;202202;413;1220;301;996;112;367;107;373;219;740
421930;202202;2965;7329;1701;4994;339;1111;677;1757;1016;2868
421935;202202;444;1326;360;1154;61;201;224;712;285;913
421940;202202;399;1127;195;605;29;106;57;145;86;251
421950;202202;3349;8229;1996;5713;396;1254;570;1448;966;2702
421960;202202;186;451;101;298;15;56;34;79;49;135
421970;202202;2093;5254;1402;3887;231;751;637;1578;868;2329
421985;202202;332;887;224;682;28;89;98;280;126;369
422000;202202;2081;5153;1718;4622;125;429;1224;3241;1349;3670
430003;202202;604;1566;406;1215;75;233;198;589;273;822
430005;202202;291;771;199;612;17;58;112;330;129;388
430010;202202;1969;4430;1550;3798;281;680;921;2279;1202;2959
430020;202202;615;1369;465;1176;44;130;315;761;359;891
430030;202202;1078;2439;636;1662;120;311;289;722;409;1033
430040;202202;11247;25603;7185;18854;1839;4951;1689;4398;3528;9349
430045;202202;526;1254;386;1006;34;107;281;705;315;812
430047;202202;258;556;107;285;19;49;36;95;55;144
430050;202202;950;2325;580;1611;119;354;211;535;330;889
430055;202202;290;694;147;403;16;49;78;191;94;240
430057;202202;88;187;35;98;11;32;8;20;19;52
430060;202202;19996;50992;15948;44827;2626;7983;8642;23844;11268;31827
430063;202202;849;2290;708;2021;130;361;419;1194;549;1555
430064;202202;1213;3132;912;2561;149;439;491;1344;640;1783
430066;202202;103;214;74;171;8;25;61;131;69;156
430070;202202;759;1938;158;500;32;109;24;57;56;166
430080;202202;995;2402;618;1660;94;306;326;767;420;1073
430085;202202;995;2108;616;1520;84;219;310;736;394;955
430087;202202;916;2124;762;1923;58;165;553;1372;611;1537
430090;202202;486;1239;191;606;25;96;48;137;73;233
430100;202202;1034;2408;644;1694;122;362;204;473;326;835
430105;202202;1385;3513;964;2804;131;446;477;1347;608;1793
430107;202202;184;519;98;295;14;38;33;89;47;127
430110;202202;2434;5890;1833;5002;293;869;933;2467;1226;3336
430120;202202;1356;3756;930;2757;159;456;436;1268;595;1724
430130;202202;3839;8375;2874;7059;960;2296;704;2024;1664;4320
430140;202202;1108;2767;802;2228;108;341;456;1210;564;1551
430150;202202;607;1541;346;1037;75;235;101;302;176;537
430155;202202;251;633;131;388;28;88;29;73;57;161
430160;202202;22480;49747;17971;43597;1739;4582;11738;27985;13477;32567
430163;202202;3536;7840;2533;6347;83;297;1932;4707;2015;5004
430165;202202;337;820;121;376;13;36;23;62;36;98
430170;202202;1011;2616;385;1278;68;245;62;166;130;411
430175;202202;821;2141;721;1952;138;346;388;1072;526;1418
430180;202202;707;1690;548;1433;68;164;323;855;391;1019
430185;202202;734;1838;395;1125;112;282;73;212;185;494
430187;202202;869;1792;637;1511;77;170;430;1009;507;1179
430190;202202;1549;3784;1231;3303;229;667;621;1582;850;2249
430192;202202;132;347;54;156;10;28;13;31;23;59
430195;202202;465;1309;87;281;6;19;17;43;23;62
430200;202202;1195;3343;953;2914;303;958;281;902;584;1860
430205;202202;502;1203;453;1114;10;36;415;1003;425;1039
430210;202202;6913;17429;4748;13016;792;2375;1470;3215;2262;5590
430215;202202;350;867;223;622;32;95;99;278;131;373
430220;202202;689;1686;237;771;31;99;62;165;93;264
430222;202202;231;610;167;490;25;83;56;162;81;245
430223;202202;278;698;215;596;18;52;129;349;147;401
430225;202202;16;32;11;26;0;0;7;16;7;16
430230;202202;2124;5551;1768;5028;119;394;1363;3811;1482;4205
430235;202202;419;1134;277;843;51;169;73;184;124;353
430237;202202;557;1261;427;1058;20;65;335;811;355;876
430240;202202;1478;3353;844;2258;96;309;441;1065;537;1374
430245;202202;789;2077;631;1790;113;318;366;1052;479;1370
430250;202202;1029;2365;770;1977;289;781;131;293;420;1074
430258;202202;149;401;111;325;5;20;60;170;65;190
430260;202202;770;1910;540;1496;66;201;320;886;386;1087
430265;202202;244;690;166;545;27;83;66;227;93;310
430270;202202;3291;7630;2650;6681;303;878;1809;4403;2112;5281
430280;202202;5587;12442;4041;9943;692;1733;1980;4743;2672;6476
430290;202202;2419;5357;2000;4877;87;263;1651;3938;1738;4201
430300;202202;11355;26985;8716;22656;1195;3377;5043;12632;6238;16009
430310;202202;13879;33208;9875;26089;1174;3435;5273;12997;6447;16432
430320;202202;1115;2673;643;1775;55;161;401;1092;456;1253
430330;202202;744;1745;466;1222;60;166;209;503;269;669
430340;202202;676;1531;461;1200;60;158;297;744;357;902
430350;202202;9127;21408;7139;18147;673;1900;4733;11413;5406;13313
430355;202202;358;962;142;447;25;79;17;43;42;122
430360;202202;949;2201;647;1690;126;386;251;614;377;1000
430367;202202;374;805;226;566;42;126;118;271;160;397
430370;202202;569;1478;246;714;42;124;69;155;111;279
430380;202202;734;1755;377;1124;75;232;109;313;184;545
430390;202202;3794;8830;2470;6526;552;1570;391;799;943;2369
430400;202202;1109;2299;849;1953;85;220;496;1107;581;1327
430410;202202;591;1340;426;1087;36;105;305;754;341;859
430420;202202;3007;7484;2383;6263;345;1016;1458;3587;1803;4603
430430;202202;615;1515;290;872;59;187;64;188;123;375
430435;202202;1737;4202;1349;3587;212;595;724;1911;936;2506
430440;202202;4279;11152;3473;9861;283;885;2275;6439;2558;7324
430450;202202;7520;17735;6140;15434;1015;2788;3457;8208;4472;10996
430460;202202;38831;94366;29771;79813;3972;11855;16818;43264;20790;55119
430461;202202;239;618;86;254;15;57;37;87;52;144
430462;202202;338;862;186;569;37;121;51;139;88;260
430463;202202;7047;17813;5322;14747;964;3002;2639;6994;3603;9996
430465;202202;492;1202;398;1035;56;160;270;681;326;841
430466;202202;4973;11906;4025;10490;680;1842;2229;5570;2909;7412
430467;202202;528;1246;380;1031;47;155;217;538;264;693
430468;202202;1443;3395;1161;2994;91;289;865;2165;956;2454
430469;202202;657;1779;107;329;15;46;22;44;37;90
430470;202202;6226;15462;4252;12050;1140;3584;1264;3360;2404;6944
430471;202202;654;1765;543;1566;83;247;328;912;411;1159
430480;202202;677;1837;446;1361;64;209;118;303;182;512
430485;202202;182;462;85;244;12;29;24;65;36;94
430490;202202;482;1187;270;783;31;100;127;322;158;422
430495;202202;413;1084;279;841;44;149;129;360;173;509
430500;202202;1057;2628;749;2128;216;681;271;712;487;1393
430510;202202;30573;76240;22373;61240;3544;10806;10779;27219;14323;38025
430511;202202;382;1024;156;494;21;61;20;58;41;119
430512;202202;1100;2362;861;2012;176;411;381;893;557;1304
430513;202202;861;2051;428;1174;67;198;214;534;281;732
430515;202202;412;1106;304;895;41;136;169;494;210;630
430517;202202;1324;3689;1031;3054;147;434;620;1819;767;2253
430520;202202;1483;3582;837;2261;146;418;224;544;370;962
430530;202202;1038;2533;469;1356;73;228;138;379;211;607
430535;202202;3908;9641;2922;7928;417;1160;1534;3999;1951;5159
430537;202202;456;1328;389;1195;29;79;298;920;327;999
430540;202202;650;1524;379;1067;56;166;207;569;263;735
430543;202202;1106;1893;682;1408;132;227;262;622;394;849
430544;202202;809;2172;560;1645;138;430;206;570;344;1000
430545;202202;2664;6416;2028;5496;275;781;1253;3367;1528;4148
430550;202202;383;1051;283;842;55;180;107;294;162;474
430558;202202;168;383;66;182;6;16;23;62;29;78
430560;202202;303;696;163;466;24;73;63;166;87;239
430570;202202;936;2239;681;1795;116;376;340;783;456;1159
430580;202202;891;2161;653;1809;139;393;319;922;458;1315
430583;202202;204;501;46;134;1;3;11;25;12;28
430585;202202;239;581;131;365;25;81;47;114;72;195
430587;202202;219;576;165;485;16;56;69;196;85;252
430590;202202;1455;3415;1204;3041;89;268;941;2322;1030;2590
430593;202202;22;65;16;44;2;4;6;17;8;21
430595;202202;444;1101;127;397;13;40;26;60;39;100
430597;202202;472;1168;260;758;25;85;80;190;105;275
430600;202202;2122;5408;932;2641;146;410;232;598;378;1008
430605;202202;1435;3588;1064;2946;127;380;545;1477;672;1857
430607;202202;679;1481;494;1203;27;76;354;846;381;922
430610;202202;6481;14558;4493;11673;1203;3431;1192;3099;2395;6530
430613;202202;298;682;89;256;13;37;23;55;36;92
430620;202202;740;1743;568;1437;100;289;326;737;426;1026
430630;202202;457;1221;143;438;24;79;39;102;63;181
430632;202202;471;1192;215;608;35;91;91;250;126;341
430635;202202;629;1374;477;1125;27;70;372;866;399;936
430637;202202;482;1129;375;978;31;99;267;677;298;776
430640;202202;1194;3118;830;2398;123;387;365;952;488;1339
430642;202202;382;1017;277;792;44;137;135;361;179;498
430645;202202;166;388;75;198;13;39;26;54;39;93
430650;202202;1909;5014;1520;4391;427;1135;711;2237;1138;3372
430655;202202;324;771;198;540;28;91;104;247;132;338
430660;202202;5616;13697;4368;11752;735;2098;2275;6004;3010;8102
430670;202202;685;1594;522;1331;79;209;256;636;335;845
430673;202202;571;1265;263;715;41;117;111;276;152;393
430675;202202;263;757;70;237;12;42;11;32;23;74
430676;202202;5869;13970;4810;12418;581;1617;3124;7902;3705;9519
430680;202202;1158;2953;721;2100;217;633;210;542;427;1175
430690;202202;3261;8310;2617;7195;759;2122;1011;2772;1770;4894
430692;202202;224;666;178;589;10;36;139;472;149;508
430693;202202;1029;2626;649;1911;117;387;189;525;306;912
430695;202202;430;1047;268;729;29;81;147;380;176;461
430697;202202;483;1154;369;990;63;181;211;586;274;767
430700;202202;8621;20355;5594;14992;1129;3286;1559;3771;2688;7057
430705;202202;420;963;218;611;22;68;96;241;118;309
430710;202202;1851;3763;1309;3055;130;355;855;1930;985;2285
430720;202202;882;2031;454;1285;43;135;250;664;293;799
430730;202202;1068;2812;762;2246;91;266;394;1122;485;1388
430740;202202;709;1865;376;1176;60;194;113;359;173;553
430745;202202;444;1085;318;834;50;161;161;357;211;518
430750;202202;1665;3978;1159;3106;292;806;491;1270;783;2076
430755;202202;483;1162;329;863;29;83;183;440;212;523
430760;202202;2397;5685;1884;4935;368;1048;956;2386;1324;3434
430770;202202;7510;18053;5967;15780;630;1938;4017;10233;4647;12171
430780;202202;2155;5207;1406;3965;217;677;707;1916;924;2593
430781;202202;518;1366;322;930;82;235;111;274;193;509
430783;202202;365;823;232;622;27;86;138;352;165;438
430786;202202;36;119;24;87;4;15;4;17;8;32
430790;202202;5047;11924;3680;9645;348;1098;2302;5642;2650;6740
430800;202202;861;1878;660;1602;35;88;477;1130;512;1218
430805;202202;389;967;262;715;12;47;185;479;197;526
430807;202202;608;1458;370;1004;47;147;194;472;241;619
430810;202202;812;1899;384;1086;58;194;140;338;198;532
430820;202202;1323;3563;814;2534;123;416;279;790;402;1206
430825;202202;300;715;113;287;16;37;39;99;55;136
430830;202202;1929;5077;1581;4437;147;387;1107;3075;1254;3462
430840;202202;1149;2650;793;2096;112;274;521;1397;633;1671
430843;202202;189;446;94;256;5;13;33;81;38;94
430845;202202;518;1188;349;928;28;82;206;518;234;600
430850;202202;2514;6360;1778;5019;341;975;681;2019;1022;2994
430860;202202;1018;2385;511;1431;59;206;239;574;298;780
430865;202202;571;1415;387;1087;103;305;96;247;199;552
430870;202202;606;1563;278;848;43;134;80;212;123;346
430880;202202;1628;3570;1162;2871;135;363;736;1738;871;2101
430885;202202;175;467;96;304;13;40;55;172;68;212
430890;202202;1165;2765;779;2133;79;299;140;356;219;655
430900;202202;3352;6993;2395;5677;130;445;1737;3856;1867;4301
430905;202202;980;2365;676;1818;116;339;297;752;413;1091
430910;202202;2365;6187;1844;5157;275;881;923;2310;1198;3191
430912;202202;536;1467;382;1164;29;85;245;756;274;841
430915;202202;535;1550;389;1244;115;385;127;418;242;803
430920;202202;26670;65109;21264;56447;2438;7262;13746;35340;16184;42602
430925;202202;89;199;40;116;4;13;20;58;24;71
430930;202202;11963;27087;8286;21664;1257;3354;4234;11075;5491;14429
430940;202202;1165;2906;763;2128;151;448;278;701;429;1149
430950;202202;903;1929;587;1414;40;127;408;906;448;1033
430955;202202;419;1065;119;328;24;74;41;86;65;160
430957;202202;186;596;167;557;30;101;103;349;133;450
430960;202202;1490;3435;887;2378;180;528;382;947;562;1475
430965;202202;1644;3799;1293;3270;66;153;993;2559;1059;2712
430970;202202;411;953;233;628;31;88;124;306;155;394
430975;202202;547;1530;426;1264;77;250;196;569;273;819
430980;202202;431;944;255;653;21;66;136;313;157;379
430990;202202;629;1707;434;1283;72;237;191;546;263;783
430995;202202;587;1457;445;1233;61;173;247;666;308;839
431000;202202;1476;3426;670;1918;134;410;57;136;191;546
431010;202202;2650;6788;1912;5541;392;1237;650;1696;1042;2933
431020;202202;8778;18644;5369;13611;943;2729;2248;5084;3191;7813
431030;202202;373;1007;195;641;44;159;32;105;76;264
431033;202202;4267;9702;2888;7562;564;1494;1216;3120;1780;4614
431036;202202;338;734;78;227;8;26;23;50;31;76
431040;202202;966;2344;635;1791;61;220;347;898;408;1118
431041;202202;472;1062;341;866;40;102;194;483;234;585
431043;202202;363;887;226;639;38;129;116;309;154;438
431046;202202;111;282;44;131;7;20;10;25;17;45
431050;202202;1422;3334;1010;2685;180;465;507;1393;687;1858
431053;202202;729;1837;414;1220;74;249;142;362;216;611
431055;202202;646;1506;525;1313;33;84;400;987;433;1071
431057;202202;238;677;142;455;27;98;54;158;81;256
431060;202202;6222;14902;4293;11758;949;2819;1515;3975;2464;6794
431065;202202;435;1049;326;869;41;116;177;463;218;579
431070;202202;447;1162;279;811;63;209;69;185;132;394
431075;202202;237;662;144;453;31;112;46;146;77;258
431080;202202;618;1636;445;1286;75;236;170;456;245;692
431085;202202;841;2106;534;1457;52;156;286;749;338;905
431087;202202;451;1199;364;1027;46;129;217;602;263;731
431090;202202;428;986;180;535;29;93;44;136;73;229
431100;202202;3897;8255;2779;6834;254;697;1768;4243;2022;4940
431110;202202;1535;3410;1087;2640;189;507;543;1196;732;1703
431112;202202;677;1729;560;1528;61;199;378;971;439;1170
431113;202202;459;1173;385;1037;73;203;218;569;291;772
431115;202202;1014;2797;799;2408;66;255;535;1535;601;1790
431120;202202;2933;7267;2069;5675;492;1467;708;1806;1200;3273
431123;202202;397;1046;266;768;54;146;148;427;202;573
431125;202202;1116;2944;870;2492;251;713;426;1265;677;1978
431127;202202;205;554;74;234;6;21;12;35;18;56
431130;202202;3360;8107;2594;6949;303;868;1555;4099;1858;4967
431140;202202;6284;14597;3964;10360;495;1409;1734;3962;2229;5371
431142;202202;592;1442;455;1227;55;146;308;839;363;985
431150;202202;1118;2847;845;2382;145;436;426;1174;571;1610
431160;202202;728;1942;498;1456;107;323;146;418;253;741
431162;202202;593;1461;368;1055;31;109;204;534;235;643
431164;202202;187;436;53;165;5;12;9;27;14;39
431170;202202;489;1285;360;1031;97;285;110;303;207;588
431171;202202;780;1734;662;1593;122;273;440;1059;562;1332
431173;202202;482;1193;355;1018;95;318;140;375;235;693
431175;202202;1417;3193;924;2377;135;349;400;993;535;1342
431177;202202;907;2314;708;2008;106;350;462;1267;568;1617
431179;202202;350;756;107;311;21;66;34;99;55;165
431180;202202;2452;6054;1544;4302;336;990;457;1156;793;2146
431190;202202;639;1581;288;826;40;122;83;194;123;316
431198;202202;426;1196;353;1060;93;291;140;445;233;736
431200;202202;380;934;110;295;23;63;15;34;38;97
431205;202202;232;604;123;367;36;117;39;114;75;231
431210;202202;684;1544;558;1372;130;310;265;699;395;1009
431213;202202;282;722;217;600;11;29;121;326;132;355
431215;202202;665;1559;341;966;31;105;174;456;205;561
431217;202202;171;437;119;336;23;84;57;134;80;218
431220;202202;598;1502;381;1097;44;142;200;528;244;670
431225;202202;1633;3691;1284;3145;110;287;921;2227;1031;2514
431230;202202;740;1993;598;1700;96;311;349;926;445;1237
431235;202202;181;488;24;85;2;4;4;19;6;23
431237;202202;374;1140;303;983;51;197;147;442;198;639
431238;202202;34;96;28;83;5;16;14;35;19;51
431240;202202;5237;12274;4245;10746;412;1234;2828;6786;3240;8020
431242;202202;301;717;265;660;23;71;199;471;222;542
431244;202202;392;957;209;576;26;81;84;205;110;286
431245;202202;1417;3194;930;2375;65;172;526;1278;591;1450
431247;202202;299;721;185;499;29;94;90;212;119;306
431250;202202;1932;4608;1479;4024;317;796;813;2355;1130;3151
431260;202202;313;817;192;588;24;86;76;225;100;311
431261;202202;290;857;238;765;23;96;136;414;159;510
431262;202202;334;918;175;563;16;55;103;335;119;390
431265;202202;1689;3927;759;2147;106;341;238;580;344;921
431267;202202;255;635;167;454;11;34;117;299;128;333
431270;202202;3049;6602;1702;4348;336;884;607;1563;943;2447
431275;202202;145;388;87;257;21;65;32;82;53;147
431280;202202;247;657;92;292;13;42;14;33;27;75
431290;202202;377;1103;261;818;59;207;45;116;104;323
431295;202202;75;181;27;75;6;21;6;12;12;33
431300;202202;318;825;75;229;7;20;28;73;35;93
431301;202202;298;836;78;252;15;53;10;27;25;80
431303;202202;671;1673;429;1192;25;82;195;485;220;567
431306;202202;2476;5739;1588;4288;166;495;738;1811;904;2306
431308;202202;31;86;28;80;8;24;17;49;25;73
431310;202202;590;1535;429;1203;62;182;207;540;269;722
431320;202202;725;1940;431;1329;82;256;128;358;210;614
431330;202202;1914;4389;1014;2819;134;448;462;1148;596;1596
431333;202202;224;579;127;367;16;57;49;117;65;174
431335;202202;38;114;23;82;8;31;2;4;10;35
431337;202202;3217;7863;2550;6861;261;869;1775;4561;2036;5430
431339;202202;479;1188;358;984;77;198;163;451;240;649
431340;202202;20018;47481;14412;38327;2018;6016;7531;18764;9549;24780
431342;202202;451;999;335;816;34;77;251;609;285;686
431344;202202;423;1034;250;726;35;111;112;315;147;426
431346;202202;234;566;93;280;14;45;20;50;34;95
431349;202202;832;1976;544;1392;89;237;277;670;366;907
431350;202202;4822;11678;3739;9923;415;1266;2257;5727;2672;6993
431360;202202;613;1422;321;876;86;257;91;232;177;489
431365;202202;2325;5120;1857;4492;104;309;1484;3510;1588;3819
431370;202202;5225;11952;3921;9948;684;1830;2136;5384;2820;7214
431380;202202;956;2456;776;2164;95;273;498;1391;593;1664
431390;202202;2920;7010;1910;5253;192;653;1031;2488;1223;3141
431395;202202;1645;3698;1268;3150;179;446;798;1961;977;2407
431400;202202;320;880;187;587;38;122;41;113;79;235
431402;202202;965;2075;725;1717;85;213;511;1174;596;1387
431403;202202;221;601;170;500;31;99;74;202;105;301
431405;202202;5543;13892;4425;12080;691;2161;2316;5916;3007;8077
431406;202202;620;1653;441;1282;90;246;188;575;278;821
431407;202202;567;1444;422;1155;58;167;275;737;333;904
431410;202202;19761;47170;14069;37738;1696;5367;8181;20402;9877;25769
431413;202202;254;696;62;210;7;22;14;45;21;67
431415;202202;756;1809;503;1384;82;262;250;615;332;877
431417;202202;622;1332;415;1006;63;180;234;536;297;716
431420;202202;1788;3844;1381;3312;123;320;890;2060;1013;2380
431430;202202;624;1546;332;987;54;188;115;302;169;490
431440;202202;34120;76567;24771;62646;3855;10635;11622;27439;15477;38074
431442;202202;149;425;80;276;14;55;16;51;30;106
431445;202202;386;1061;114;362;10;30;18;43;28;73
431446;202202;302;838;232;706;30;100;129;379;159;479
431447;202202;822;2063;490;1401;86;248;148;428;234;676
431449;202202;852;2123;566;1573;101;271;246;670;347;941
431450;202202;2490;4870;1967;4140;49;116;1635;3341;1684;3457
431454;202202;41;129;32;107;8;29;15;45;23;74
431455;202202;625;1427;329;845;25;73;170;385;195;458
431460;202202;3157;7256;2222;5657;534;1384;772;1944;1306;3328
431470;202202;1499;4005;1117;3224;193;598;470;1320;663;1918
431475;202202;258;686;64;215;4;18;9;19;13;37
431477;202202;464;1151;285;806;47;128;108;282;155;410
431478;202202;230;603;58;176;10;29;6;15;16;44
431480;202202;3708;8886;2980;7780;657;1758;1558;4051;2215;5809
431490;202202;121465;275199;94254;234775;5703;17692;70590;168155;76293;185847
431500;202202;531;1309;408;1098;57;163;223;580;280;743
431505;202202;270;632;189;514;12;40;137;370;149;410
431507;202202;346;811;152;437;48;149;20;47;68;196
431510;202202;1798;4410;1258;3385;300;844;460;1243;760;2087
431513;202202;239;517;132;341;35;99;35;65;70;164
431514;202202;126;313;97;263;3;8;65;162;68;170
431515;202202;520;1235;393;1023;75;209;244;595;319;804
431517;202202;59;173;51;155;3;13;27;74;30;87
431520;202202;406;983;182;528;19;64;81;201;100;265
431530;202202;5540;11719;3449;8641;623;1543;1518;3739;2141;5282
431531;202202;222;517;151;392;22;57;57;141;79;198
431532;202202;580;1310;375;955;68;192;163;410;231;602
431535;202202;293;753;137;409;25;78;28;81;53;159
431540;202202;1880;5771;1742;5591;77;290;1412;4574;1489;4864
431545;202202;375;933;76;219;6;17;28;76;34;93
431550;202202;2335;5646;1715;4543;267;762;938;2357;1205;3119
431555;202202;711;1578;435;1121;44;129;260;663;304;792
431560;202202;27202;62604;18772;49693;3808;9800;7234;20075;11042;29875
431570;202202;4912;11088;4204;10092;308;847;3312;7675;3620;8522
431575;202202;370;877;309;788;78;162;165;437;243;599
431580;202202;617;1574;406;1167;44;148;223;609;267;757
431590;202202;708;1895;528;1527;116;318;194;554;310;872
431595;202202;397;1037;263;763;50;156;98;257;148;413
431600;202202;1680;3880;1228;3208;232;648;592;1509;824;2157
431610;202202;1511;3667;1045;2844;166;434;525;1475;691;1909
431620;202202;511;1265;265;717;53;160;128;310;181;470
431630;202202;1395;3372;691;1971;120;374;263;698;383;1072
431640;202202;7104;15811;6083;14541;500;1308;4615;11027;5115;12335
431642;202202;676;1515;422;1058;58;123;196;472;254;595
431643;202202;394;947;191;544;23;64;60;160;83;224
431645;202202;2130;4403;1695;3836;48;147;1451;3226;1499;3373
431647;202202;345;808;118;337;11;34;35;91;46;125
431650;202202;135;357;98;301;12;41;38;95;50;136
431660;202202;963;2463;475;1453;83;291;120;322;203;613
431670;202202;1293;2978;779;2068;139;387;365;887;504;1274
431673;202202;244;627;105;336;14;44;24;53;38;97
431675;202202;395;984;120;390;14;47;25;75;39;122
431680;202202;9446;22775;7153;18732;1329;3680;3543;8866;4872;12546
431690;202202;27416;64593;19574;51098;3056;8812;10148;25559;13204;34371
431695;202202;238;556;136;371;18;70;77;184;95;254
431697;202202;502;1140;392;977;51;120;243;617;294;737
431700;202202;1500;3624;1225;3161;175;405;720;1882;895;2287
431710;202202;14970;33686;10899;28088;1440;3908;6542;16716;7982;20624
431720;202202;7366;17324;4572;12343;1050;2956;1175;2892;2225;5848
431725;202202;36;84;27;69;6;20;14;30;20;50
431730;202202;4534;10334;2983;8009;572;1575;1316;3547;1888;5122
431740;202202;5776;13129;3953;10240;958;2791;1216;2855;2174;5646
431750;202202;8565;21282;6547;18159;1455;4280;2736;7439;4191;11719
431755;202202;339;903;94;304;13;45;22;60;35;105
431760;202202;5799;12663;4070;9982;425;1196;2589;6012;3014;7208
431770;202202;2148;4712;1648;4070;158;386;1212;2966;1370;3352
431775;202202;217;540;122;358;26;80;26;66;52;146
431780;202202;2338;5497;1542;4096;228;634;670;1748;898;2382
431790;202202;820;2101;544;1560;63;179;262;742;325;921
431795;202202;300;735;147;434;27;78;43;122;70;200
431800;202202;9045;20721;5848;15840;1531;4778;713;2007;2244;6785
431805;202202;294;723;70;243;5;13;4;10;9;23
431810;202202;3593;7977;2346;5816;343;892;1226;2872;1569;3764
431820;202202;2346;5955;1831;5154;461;1391;808;2267;1269;3658
431830;202202;9692;20614;7282;17432;2022;5511;1652;4140;3674;9651
431840;202202;2968;7209;2423;6383;251;696;1654;4351;1905;5047
431842;202202;510;1242;188;562;30;109;73;188;103;297
431843;202202;342;887;252;708;35;105;123;326;158;431
431844;202202;197;532;74;246;12;51;21;69;33;120
431845;202202;543;1378;379;1058;29;84;237;647;266;731
431846;202202;293;719;254;663;7;24;229;592;236;616
431848;202202;168;421;93;263;12;43;26;56;38;99
431849;202202;418;1010;92;263;8;24;19;40;27;64
431850;202202;4643;11864;3615;9986;818;2435;1345;3519;2163;5954
431860;202202;677;1562;380;1006;44;124;233;603;277;727
431861;202202;102;270;65;192;11;34;21;59;32;93
431862;202202;510;1554;423;1403;84;318;219;687;303;1005
431870;202202;24017;57701;19445;50880;1900;5725;12647;31837;14547;37562
431880;202202;4260;10539;3110;8580;374;1195;1677;4390;2051;5585
431890;202202;5208;12639;3391;9249;1033;2764;791;2306;1824;5070
431900;202202;1072;2625;704;1970;115;348;360;939;475;1287
431910;202202;829;1910;337;908;43;113;105;231;148;344
431912;202202;548;1387;439;1208;66;191;292;798;358;989
431915;202202;1180;2665;936;2294;41;104;711;1709;752;1813
431920;202202;1359;2973;1130;2684;35;87;977;2290;1012;2377
431930;202202;759;1896;522;1480;157;416;214;631;371;1047
431935;202202;90;235;65;187;11;36;20;48;31;84
431936;202202;329;885;202;576;36;101;96;263;132;364
431937;202202;156;384;99;279;15;43;43;111;58;154
431940;202202;3276;7391;2072;5307;148;426;1251;3050;1399;3476
431950;202202;2235;5514;1795;4825;391;1118;820;2146;1211;3264
431960;202202;3271;7656;2549;6422;718;1847;867;2126;1585;3973
431970;202202;417;1020;195;542;48;141;48;121;96;262
431971;202202;85;204;38;115;4;12;8;19;12;31
431973;202202;541;1643;415;1398;41;162;297;993;338;1155
431975;202202;119;240;33;89;6;21;8;16;14;37
431980;202202;1162;2793;923;2430;120;387;585;1425;705;1812
431990;202202;6446;14966;4746;12592;427;1369;2899;7429;3326;8798
432000;202202;14016;31745;10460;26431;1617;4374;5997;14690;7614;19064
432010;202202;2973;6720;2021;5197;400;1097;864;2069;1264;3166
432020;202202;1870;4769;1188;3357;269;809;374;1005;643;1814
432023;202202;575;1347;289;791;37;106;133;321;170;427
432026;202202;1089;2865;843;2398;242;687;316;934;558;1621
432030;202202;460;1037;263;687;19;46;159;382;178;428
432032;202202;354;873;246;657;21;67;143;346;164;413
432035;202202;711;1920;619;1768;166;438;304;926;470;1364
432040;202202;1168;2709;461;1383;60;214;195;523;255;737
432045;202202;183;488;120;362;20;64;54;151;74;215
432050;202202;605;1430;446;1162;65;204;236;596;301;800
432055;202202;735;1814;520;1436;172;465;151;418;323;883
432057;202202;179;471;149;400;8;21;85;208;93;229
432060;202202;463;1119;145;460;25;92;39;113;64;205
432065;202202;227;606;175;503;36;104;70;200;106;304
432067;202202;829;2251;711;1999;61;202;531;1440;592;1642
432070;202202;1835;4468;1318;3547;223;666;636;1597;859;2263
432080;202202;5392;12007;4113;10123;569;1616;2115;4968;2684;6584
432085;202202;419;1100;319;946;58;192;171;488;229;680
432090;202202;2717;6492;1642;4479;274;798;757;1925;1031;2723
432100;202202;1027;2500;524;1550;95;304;121;300;216;604
432110;202202;2311;5761;1703;4732;439;1303;325;860;764;2163
432120;202202;3717;9488;3027;8397;470;1422;1604;4267;2074;5689
432130;202202;2893;6902;2427;6228;385;1001;1450;3739;1835;4740
432132;202202;229;628;122;390;19;64;56;160;75;224
432135;202202;1083;2447;737;1867;73;190;512;1293;585;1483
432140;202202;1900;5255;1489;4484;175;606;992;2885;1167;3491
432143;202202;1602;4042;1225;3462;70;220;800;2219;870;2439
432145;202202;1912;4883;1275;3637;190;585;442;1067;632;1652
432146;202202;112;302;89;273;30;109;29;81;59;190
432147;202202;530;1382;321;978;106;331;73;218;179;549
432149;202202;483;1146;254;688;31;89;106;258;137;347
432150;202202;3828;9141;2916;7651;500;1391;1444;3653;1944;5044
432160;202202;6277;15308;4707;12920;1138;3263;1815;5022;2953;8285
432162;202202;241;531;42;122;8;24;13;25;21;49
432163;202202;164;385;32;86;2;8;6;8;8;16
432166;202202;689;1847;560;1602;100;333;221;571;321;904
432170;202202;1686;4400;1194;3548;208;670;544;1511;752;2181
432180;202202;3324;7615;1877;5008;289;853;844;1974;1133;2827
432183;202202;408;1142;301;914;57;221;124;338;181;559
432185;202202;865;2201;514;1528;71;231;245;698;316;929
432190;202202;2163;5069;1551;4143;135;432;1003;2513;1138;2945
432195;202202;1011;2513;682;1911;134;356;291;817;425;1173
432200;202202;3889;9223;2918;7771;282;806;1938;5064;2220;5870
432210;202202;430;1097;291;836;55;160;137;362;192;522
432215;202202;689;1865;619;1757;44;101;461;1335;505;1436
432218;202202;264;630;125;344;16;51;48;105;64;156
432220;202202;3931;8888;2858;7178;512;1281;1500;3699;2012;4980
432225;202202;123;322;88;256;10;32;53;150;63;182
432230;202202;832;1913;444;1212;56;171;201;503;257;674
432232;202202;537;1272;357;985;58;184;166;416;224;600
432234;202202;289;710;149;425;29;70;32;80;61;150
432235;202202;45;127;20;61;5;17;6;17;11;34
432237;202202;330;827;295;771;12;33;246;627;258;660
432240;202202;18220;42096;13524;36009;1295;3172;9137;24799;10432;27971
432250;202202;6354;17170;4789;14118;926;2904;2351;6872;3277;9776
432252;202202;501;1168;327;846;40;107;178;431;218;538
432253;202202;983;2752;693;2055;183;584;91;244;274;828
432254;202202;706;1633;222;648;30;77;39;100;69;177
432255;202202;108;280;62;184;9;29;28;78;37;107
432260;202202;5797;14167;4391;11620;987;2734;1935;4883;2922;7617
432270;202202;2300;5883;1903;5182;511;1513;714;1861;1225;3374
432280;202202;1502;3656;829;2405;123;388;294;724;417;1112
432285;202202;148;440;28;84;2;4;6;17;8;21
432290;202202;376;996;235;691;66;213;68;159;134;372
432300;202202;30541;72512;23290;61383;2430;7498;15326;38648;17756;46146
432310;202202;980;2446;724;1992;63;191;539;1463;602;1654
432320;202202;204;465;86;256;9;34;28;69;37;103
432330;202202;219;497;75;238;15;43;11;37;26;80
432335;202202;166;475;64;228;9;31;15;50;24;81
432340;202202;344;853;158;510;21;73;44;141;65;214
432345;202202;833;1726;720;1593;11;29;624;1349;635;1378
432350;202202;365;897;198;581;31;96;72;209;103;305
432360;202202;236;687;47;155;5;15;13;35;18;50
432370;202202;364;838;227;611;22;67;134;352;156;419
432375;202202;504;1205;382;972;88;225;182;464;270;689
432377;202202;169;511;40;135;0;0;9;19;9;19
432380;202202;2020;5317;1430;4263;211;669;743;2167;954;2836
500020;202202;3482;8249;2463;6650;210;687;1588;4148;1798;4835
500025;202202;1269;3053;817;2220;107;289;417;1087;524;1376
500060;202202;8840;24022;6191;18599;723;2340;3709;11250;4432;13590
500070;202202;5198;12535;3784;10244;686;1976;1789;4851;2475;6827
500080;202202;1757;4136;1097;2959;183;552;448;1098;631;1650
500085;202202;2203;5329;1582;4261;353;1031;777;1983;1130;3014
500090;202202;2296;5790;1587;4620;267;850;545;1705;812;2555
500100;202202;4113;10003;3170;8515;432;1346;1663;4213;2095;5559
500110;202202;10119;24444;7063;19781;1487;4272;2949;8807;4436;13079
500124;202202;2326;6390;1869;5672;284;865;1091;3384;1375;4249
500150;202202;1582;3381;1085;2716;173;477;580;1359;753;1836
500190;202202;5604;14073;3718;10509;742;2153;1236;3262;1978;5415
500200;202202;2967;6639;2052;5158;192;488;1319;3190;1511;3678
500210;202202;5309;11939;3793;9981;991;2529;1914;5134;2905;7663
500215;202202;1566;4122;1164;3407;95;313;702;2031;797;2344
500220;202202;3284;8581;2378;7039;382;1227;1120;3175;1502;4402
500230;202202;2234;4987;1741;4326;178;488;1219;2941;1397;3429
500240;202202;4523;12725;3349;10358;522;1728;1496;4699;2018;6427
500260;202202;3601;7473;2385;5872;219;649;1488;3441;1707;4090
500270;202202;157071;358851;101452;269254;14362;42558;43834;107169;58196;149727
500280;202202;1513;3680;1027;2946;162;493;528;1509;690;2002
500290;202202;4043;9517;2514;6912;362;1137;960;2334;1322;3471
500295;202202;4146;9712;2788;7401;454;1368;1265;2989;1719;4357
500310;202202;1086;2127;760;1734;128;264;428;984;556;1248
500315;202202;4374;11195;3538;10005;235;710;2708;7694;2943;8404
500320;202202;22371;57032;15674;46215;3725;11190;6070;19008;9795;30198
500325;202202;5955;12738;4211;10404;435;1099;2689;6601;3124;7700
500330;202202;7348;16077;4916;12668;492;1242;2706;7153;3198;8395
500345;202202;2264;5380;1556;4287;260;748;686;1848;946;2596
500348;202202;2576;6389;1940;5318;221;650;1222;3371;1443;4021
500350;202202;1372;3644;811;2485;104;326;310;910;414;1236
500370;202202;30307;75155;22371;62619;2600;8404;12374;33956;14974;42360
500375;202202;2840;7185;1963;5450;278;843;789;1977;1067;2820
500380;202202;3828;9235;2691;7368;761;2169;602;1713;1363;3882
500390;202202;694;1410;438;1103;59;166;256;638;315;804
500400;202202;1722;4271;1159;3197;219;695;430;1065;649;1760
500410;202202;2628;6099;1853;4981;201;499;1069;3015;1270;3514
500430;202202;3074;7220;2138;5866;302;849;955;2821;1257;3670
500440;202202;1723;3978;961;2718;145;425;363;1082;508;1507
500450;202202;1900;4509;1220;3361;237;642;365;959;602;1601
500460;202202;4058;10364;2499;7354;441;1442;767;2149;1208;3591
500470;202202;2729;7091;1770;5231;462;1479;465;1223;927;2702
500480;202202;2225;6657;1865;6096;145;514;1417;4686;1562;5200
500490;202202;1239;2767;756;2042;141;459;210;578;351;1037
500500;202202;4587;11660;3049;9271;889;2975;431;1402;1320;4377
500510;202202;752;1833;503;1399;35;110;317;837;352;947
500515;202202;1795;4525;1409;3929;184;578;848;2274;1032;2852
500520;202202;3722;10353;2887;8966;609;1904;1483;4801;2092;6705
500525;202202;1055;2924;845;2631;100;336;541;1669;641;2005
500540;202202;5480;13735;3365;10019;972;3213;532;1427;1504;4640
500560;202202;5811;15190;4676;13798;220;683;3902;11672;4122;12355
500568;202202;4893;10358;3062;7658;634;1597;1291;3104;1925;4701
500570;202202;8940;20146;6122;15657;879;2582;3067;7266;3946;9848
500580;202202;3453;8724;2561;7183;552;1586;1210;3415;1762;5001
500600;202202;3933;9487;2919;7903;601;1635;1181;3318;1782;4953
500620;202202;8792;22282;6150;17404;941;2888;2939;7899;3880;10787
500625;202202;578;1512;394;1162;57;188;147;407;204;595
500627;202202;865;2231;544;1678;95;302;177;522;272;824
500630;202202;8218;17879;4799;12474;906;2527;1618;4082;2524;6609
500635;202202;3097;9539;2394;8598;244;787;1690;6583;1934;7370
500640;202202;1972;4105;1314;3250;70;194;880;2099;950;2293
500660;202202;21805;52360;15177;42904;4594;13284;4812;14187;9406;27471
500690;202202;2856;7211;1921;5715;471;1593;761;2155;1232;3748
500710;202202;3474;8879;2628;7461;632;1991;913;2451;1545;4442
500720;202202;5656;13878;3853;10956;790;2390;1404;3960;2194;6350
500730;202202;1204;2867;683;1930;124;357;206;566;330;923
500740;202202;5214;12006;3453;9344;489;1463;1722;4444;2211;5907
500750;202202;1154;2797;815;2243;116;333;352;890;468;1223
500755;202202;1126;2849;700;2066;119;375;197;533;316;908
500769;202202;5757;13781;3326;9329;674;2018;553;1396;1227;3414
500770;202202;1486;3911;1042;3201;204;644;366;1118;570;1762
500780;202202;1314;3105;868;2400;174;566;262;640;436;1206
500790;202202;7936;20397;5986;16992;1147;3511;2616;7414;3763;10925
500793;202202;2245;5458;1651;4486;334;969;685;1738;1019;2707
500795;202202;2978;7077;2351;6256;141;368;1856;5123;1997;5491
500797;202202;862;2155;572;1626;162;464;188;554;350;1018
500800;202202;3842;8465;2445;6414;683;2016;479;1348;1162;3364
500830;202202;20577;49515;14416;38656;3004;8487;5297;13653;8301;22140
500840;202202;1568;3667;1007;2647;117;327;479;1171;596;1498
510010;202202;1998;4334;1399;3577;130;303;1000;2565;1130;2868
510020;202202;4556;11080;2533;7214;466;1451;772;1946;1238;3397
510025;202202;7649;17847;4978;13754;610;1904;2575;6822;3185;8726
510030;202202;3448;7278;2371;5697;250;642;1374;3143;1624;3785
510035;202202;1318;3346;878;2660;175;522;442;1468;617;1990
510040;202202;2622;5625;1976;4812;221;462;1300;3311;1521;3773
510050;202202;2438;4879;1681;3932;220;557;1125;2601;1345;3158
510060;202202;1520;3731;998;2814;185;553;266;701;451;1254
510080;202202;1614;4051;1124;3293;205;680;566;1577;771;2257
510100;202202;745;1650;543;1348;58;162;335;789;393;951
510120;202202;295;525;166;374;8;19;133;295;141;314
510125;202202;2287;5549;1837;4908;182;607;1060;2661;1242;3268
510130;202202;1690;4108;1193;3343;255;720;494;1420;749;2140
510140;202202;3322;8296;2275;6993;757;2551;880;2823;1637;5374
510160;202202;1980;4781;1506;4182;77;243;1273;3541;1350;3784
510170;202202;5390;13565;4129;11595;772;2370;2028;5582;2800;7952
510180;202202;16298;34990;11011;27698;2087;5499;4793;12808;6880;18307
510185;202202;1900;4821;1230;3856;529;1665;259;1090;788;2755
510190;202202;2407;6580;1575;5230;398;1476;383;1355;781;2831
510250;202202;19210;46332;14456;39310;2213;6487;8147;22494;10360;28981
510260;202202;1893;7940;1604;7459;254;1232;1000;5141;1254;6373
510263;202202;3689;10109;2408;7547;433;1553;514;1425;947;2978
510267;202202;6005;16678;3597;11379;665;2323;648;1753;1313;4076
510268;202202;1400;3495;1020;2868;142;419;476;1295;618;1714
510269;202202;1124;2945;739;2249;152;504;303;870;455;1374
510270;202202;3286;8971;2305;7310;362;1264;1011;3209;1373;4473
510279;202202;1987;5004;1197;3608;167;575;431;1183;598;1758
510285;202202;1221;3113;823;2426;204;647;278;777;482;1424
510300;202202;4147;10035;3147;8743;360;1024;2117;6046;2477;7070
510305;202202;1563;4186;1014;3169;206;665;259;863;465;1528
510310;202202;1076;2537;761;2047;189;516;280;790;469;1306
510320;202202;4108;9815;2944;7921;602;1706;898;2374;1500;4080
510325;202202;4644;13200;3374;10881;855;2901;1075;3528;1930;6429
510330;202202;2744;7976;1883;6517;407;1442;679;2719;1086;4161
510335;202202;5319;14898;4079;12892;655;2279;2147;6829;2802;9108
510336;202202;500;1363;370;1170;46;137;209;727;255;864
510337;202202;1565;4368;1042;3461;338;1205;327;1130;665;2335
510340;202202;104034;226189;71232;180434;14985;41811;28737;70291;43722;112102
510343;202202;1270;3098;844;2379;115;378;445;1167;560;1545
510345;202202;1344;3711;1036;3138;162;509;515;1519;677;2028
510350;202202;3350;8200;2303;6524;538;1624;909;2536;1447;4160
510360;202202;2201;4352;1402;3428;58;115;1015;2638;1073;2753
510370;202202;1894;5206;1428;4464;174;618;908;2882;1082;3500
510380;202202;649;1518;383;1085;64;209;173;484;237;693
510385;202202;1291;4202;966;3625;84;361;665;2592;749;2953
510390;202202;1461;3569;1004;3036;307;853;417;1451;724;2304
510395;202202;766;1626;521;1278;37;84;358;902;395;986
510410;202202;5396;14171;3972;11783;700;2095;2191;6727;2891;8822
510420;202202;2744;5438;1881;4318;83;194;1379;3152;1462;3346
510450;202202;619;1463;368;1036;81;242;103;272;184;514
510452;202202;900;2486;676;2075;81;283;423;1261;504;1544
510454;202202;1076;2847;836;2456;94;242;530;1655;624;1897
510455;202202;1052;2716;729;2139;130;443;307;822;437;1265
510460;202202;2113;5178;1565;4379;240;729;868;2281;1108;3010
510480;202202;5392;12610;3724;9656;636;1802;1634;4002;2270;5804
510490;202202;1875;4624;1414;4051;190;566;968;2768;1158;3334
510500;202202;1670;3981;1045;3027;214;663;335;951;549;1614
510510;202202;4178;11265;3014;9362;752;2516;1061;3422;1813;5938
510515;202202;5791;14208;3942;11078;819;2615;1431;3612;2250;6227
510517;202202;1605;3939;1094;3191;348;1096;295;831;643;1927
510520;202202;2460;4852;1388;3525;115;305;663;1826;778;2131
510523;202202;1365;3112;986;2557;122;347;657;1672;779;2019
510525;202202;8471;22350;6383;18430;968;3076;3039;8311;4007;11387
510530;202202;565;1450;416;1240;31;106;276;816;307;922
510550;202202;2717;7548;2053;6464;377;1249;1105;3432;1482;4681
510558;202202;2550;6623;1919;5704;248;676;995;3204;1243;3880
510560;202202;1803;5000;1144;3733;264;871;299;1038;563;1909
510562;202202;6455;15338;4780;12547;814;2115;2274;6229;3088;8344
510590;202202;3295;7993;2460;6924;167;491;1811;5233;1978;5724
510600;202202;1578;3346;1070;2631;127;320;603;1447;730;1767
510610;202202;2856;6637;1982;5522;316;988;1114;3071;1430;4059
510615;202202;3092;7318;2182;5917;283;839;1358;3680;1641;4519
510617;202202;1095;3186;876;2851;80;313;644;2126;724;2439
510618;202202;1337;3444;982;2892;193;624;491;1430;684;2054
510619;202202;831;2041;493;1455;73;207;107;282;180;489
510620;202202;1518;3365;761;2166;235;759;65;152;300;911
510621;202202;1731;4452;1051;3200;234;774;315;855;549;1629
510622;202202;5467;14628;3806;11286;1281;4070;666;1827;1947;5897
510623;202202;3049;7313;2248;6072;509;1487;859;2332;1368;3819
510624;202202;1726;4374;922;2919;119;424;207;580;326;1004
510625;202202;3524;8196;2107;5772;368;1128;657;1772;1025;2900
510626;202202;1578;3762;1039;2926;258;824;280;794;538;1618
510627;202202;695;1728;388;1154;82;264;119;376;201;640
510628;202202;1623;3556;1082;2872;233;668;498;1321;731;1989
510629;202202;1850;4977;1325;4060;255;823;445;1392;700;2215
510630;202202;3706;9874;2333;7405;522;1786;556;1888;1078;3674
510631;202202;650;1477;484;1238;20;42;377;990;397;1032
510637;202202;4040;9167;2900;7578;592;1649;1146;3053;1738;4702
510642;202202;6129;16413;4765;14442;912;3092;2688;8112;3600;11204
510645;202202;1134;2159;713;1650;161;335;361;874;522;1209
510650;202202;7697;18585;6072;16833;851;1548;4314;13367;5165;14915
510665;202202;1950;4175;1270;3115;261;581;515;1386;776;1967
510670;202202;470;981;283;728;37;90;157;413;194;503
510675;202202;6914;18287;4774;14404;1297;4332;1012;2943;2309;7275
510677;202202;2462;6113;1761;5111;243;814;1027;2928;1270;3742
510680;202202;773;1907;456;1354;92;310;119;299;211;609
510682;202202;1732;4768;1287;4072;392;1398;448;1358;840;2756
510685;202202;546;1503;394;1209;47;146;226;703;273;849
510700;202202;4569;10392;3206;8560;237;710;2464;6538;2701;7248
510704;202202;11999;27686;8234;21507;2064;5633;2371;5938;4435;11571
510706;202202;2445;6956;1717;5764;336;1163;754;2810;1090;3973
510710;202202;3206;7635;2088;5549;434;1189;703;1786;1137;2975
510715;202202;662;1392;473;1147;33;89;292;694;325;783
510718;202202;2528;5669;1547;4347;334;908;711;2311;1045;3219
510719;202202;502;1042;307;789;28;84;186;446;214;530
510720;202202;968;2164;653;1723;134;369;314;811;448;1180
510724;202202;957;2537;675;2013;93;312;356;993;449;1305
510726;202202;1090;1961;628;1417;62;139;343;794;405;933
510729;202202;659;1504;315;885;39;122;91;277;130;399
510730;202202;3288;7676;2261;6136;270;828;1251;3249;1521;4077
510735;202202;1256;3335;988;2966;82;279;776;2306;858;2585
510740;202202;1095;2594;732;1962;72;224;433;1086;505;1310
510757;202202;524;1650;408;1470;138;565;141;472;279;1037
510760;202202;49512;105686;31134;78857;6092;17054;11308;26515;17400;43569
510770;202202;4594;9978;3220;8268;242;528;2286;6125;2528;6653
510774;202202;402;978;294;817;42;113;178;497;220;610
510775;202202;716;1810;451;1383;109;358;112;318;221;676
510776;202202;702;1700;491;1306;85;265;241;628;326;893
510777;202202;1684;4319;1235;3744;134;472;875;2617;1009;3089
510779;202202;859;2221;653;1901;62;165;412;1267;474;1432
510780;202202;4364;10594;3259;9054;680;1762;1635;5022;2315;6784
510785;202202;2206;5595;1324;4041;346;1086;310;1032;656;2118
510787;202202;3319;9075;2182;6811;650;2094;240;717;890;2811
510788;202202;623;1410;424;1116;63;154;208;624;271;778
510790;202202;20910;51812;13924;39890;3558;10992;2535;6925;6093;17917
510792;202202;10647;28567;6862;21396;1533;5308;1451;4197;2984;9505
510794;202202;1314;3472;962;2920;297;1047;248;674;545;1721
510795;202202;10388;25790;7234;20405;1588;4892;2417;6512;4005;11404
510800;202202;1669;4227;1172;3450;376;1200;175;461;551;1661
510805;202202;1666;4478;1170;3606;248;860;487;1383;735;2243
510810;202202;728;1418;480;1106;149;297;211;538;360;835
510820;202202;870;1595;501;1152;29;63;303;689;332;752
510830;202202;1009;2266;778;1984;55;126;600;1591;655;1717
510835;202202;642;1496;430;1195;47;146;277;747;324;893
510840;202202;64922;133171;45967;110401;7662;17068;26276;66591;33938;83659
510850;202202;2076;4972;1334;3839;553;1774;128;292;681;2066
510860;202202;2791;6996;1819;5464;571;1845;363;1128;934;2973
510880;202202;847;2286;633;1914;140;429;211;657;351;1086
510885;202202;704;1648;475;1320;94;268;138;389;232;657
510890;202202;864;2338;665;2015;135;440;332;1016;467;1456
510895;202202;1473;3657;976;2830;154;539;458;1238;612;1777
520005;202202;3455;8562;2734;7635;801;1959;1215;3933;2016;5892
520010;202202;2925;7690;2148;6249;451;1467;828;2162;1279;3629
520013;202202;3709;9005;2511;6930;558;1528;812;2404;1370;3932
520015;202202;560;1356;416;1148;87;240;183;530;270;770
520017;202202;1357;3274;998;2754;211;618;446;1161;657;1779
520020;202202;513;1067;401;936;17;48;343;783;360;831
520025;202202;38363;101598;32875;94121;3998;12043;22728;65158;26726;77201
520030;202202;6909;16125;5713;14553;286;793;4561;11499;4847;12292
520050;202202;450;1053;278;753;34;79;159;447;193;526
520055;202202;2025;4765;1309;3385;218;520;603;1530;821;2050
520060;202202;1891;4732;1360;3838;295;950;370;1048;665;1998
520080;202202;2051;5108;1596;4511;279;719;831;2562;1110;3281
520082;202202;1021;2465;757;2036;104;287;365;1041;469;1328
520085;202202;1128;2696;901;2376;160;435;477;1241;637;1676
520090;202202;952;1806;681;1514;44;72;552;1247;596;1319
520110;202202;42371;109234;30173;89400;8992;29628;4280;12097;13272;41725
520120;202202;260;599;146;400;17;53;62;162;79;215
520130;202202;4337;10042;3386;8590;661;1709;1519;3875;2180;5584
520140;202202;50558;128625;36016;104373;12103;37077;5876;17803;17979;54880
520145;202202;664;1470;446;1155;93;255;224;538;317;793
520150;202202;710;1611;531;1396;75;207;282;733;357;940
520160;202202;961;2215;672;1723;128;285;257;706;385;991
520170;202202;5139;10311;3446;8384;209;602;2620;6311;2829;6913
520180;202202;2834;7119;2314;6389;300;981;1473;3921;1773;4902
520215;202202;1928;4491;1406;3715;252;683;704;1829;956;2512
520235;202202;811;1757;551;1393;84;222;296;761;380;983
520250;202202;1667;4087;1209;3362;382;1077;359;1142;741;2219
520260;202202;873;1993;556;1495;93;243;234;644;327;887
520280;202202;937;2056;739;1763;144;328;400;983;544;1311
520310;202202;1110;2298;723;1734;165;430;267;679;432;1109
520320;202202;1976;5096;1551;4436;160;478;940;2737;1100;3215
520330;202202;5266;13140;4042;11147;593;1900;2242;5908;2835;7808
520340;202202;2661;5651;1655;4291;174;374;988;2671;1162;3045
520350;202202;3202;7448;2283;6102;508;1329;1067;2948;1575;4277
520355;202202;2063;5444;1501;4372;446;1384;282;736;728;2120
520357;202202;884;2044;646;1691;34;72;506;1344;540;1416
520360;202202;824;2032;646;1754;117;330;265;724;382;1054
520380;202202;1548;3758;959;2707;150;436;384;1024;534;1460
520390;202202;1241;2746;783;2154;206;589;236;716;442;1305
520393;202202;703;1599;473;1239;64;179;202;507;266;686
520396;202202;972;2383;822;2163;43;113;584;1510;627;1623
520400;202202;1757;4111;1368;3597;105;298;1032;2708;1137;3006
520410;202202;2316;4878;1559;3773;209;570;886;2020;1095;2590
520420;202202;434;964;341;826;17;45;261;607;278;652
520425;202202;1714;4086;972;2680;268;793;182;473;450;1266
520430;202202;2605;5822;1581;4241;400;1169;181;457;581;1626
520440;202202;3246;7610;1884;5211;396;1222;475;1252;871;2474
520450;202202;14176;32499;9960;26385;2902;7808;2856;8024;5758;15832
520455;202202;802;2113;584;1779;150;463;185;593;335;1056
520460;202202;1138;2555;891;2242;75;160;698;1806;773;1966
520465;202202;962;2286;796;2063;65;210;626;1567;691;1777
520470;202202;2394;5721;1852;5026;483;1253;869;2582;1352;3835
520480;202202;983;2613;703;2142;163;541;266;791;429;1332
520485;202202;1688;4783;1369;4323;200;690;807;2461;1007;3151
520490;202202;4568;11852;3493;10194;692;2047;1867;5636;2559;7683
520495;202202;1754;3653;1348;3120;85;198;1037;2435;1122;2633
520500;202202;1748;4265;1308;3504;187;549;717;1876;904;2425
520505;202202;956;1963;722;1679;47;113;550;1256;597;1369
520510;202202;8766;20994;6264;17271;1130;3466;2625;7214;3755;10680
520520;202202;1337;3204;1025;2740;218;622;458;1229;676;1851
520530;202202;2743;7084;2050;5899;356;1055;1051;3147;1407;4202
520540;202202;3356;8491;2252;6404;420;1252;665;1784;1085;3036
520545;202202;1377;3290;1087;2847;230;595;543;1427;773;2022
520547;202202;1261;3166;977;2673;195;547;521;1418;716;1965
520549;202202;16365;41304;13721;37630;1586;4741;9586;25849;11172;30590
520551;202202;5209;13234;4397;12087;406;1280;3229;8691;3635;9971
520552;202202;982;2398;772;2102;150;405;430;1237;580;1642
520570;202202;597;1307;398;1004;85;189;171;439;256;628
520580;202202;2446;5274;1841;4578;208;531;1238;3088;1446;3619
520590;202202;1450;3416;1001;2708;242;670;361;960;603;1630
520620;202202;9310;23763;7460;21103;1530;4474;3989;11359;5519;15833
520630;202202;949;2269;685;1841;73;186;318;858;391;1044
520640;202202;2666;6239;2045;5214;416;1050;959;2519;1375;3569
520650;202202;1144;2430;818;1983;155;331;429;1112;584;1443
520660;202202;591;1409;324;935;50;152;92;275;142;427
520670;202202;1064;2745;898;2507;73;212;640;1767;713;1979
520680;202202;914;2088;725;1808;126;268;433;1106;559;1374
520690;202202;352;816;240;643;79;203;77;209;156;412
520710;202202;477;1111;339;888;18;44;224;565;242;609
520725;202202;1565;3625;1081;2812;133;401;644;1630;777;2031
520735;202202;960;2209;668;1744;159;359;264;733;423;1092
520740;202202;2756;5935;2096;5130;436;939;1117;2947;1553;3886
520750;202202;777;1768;558;1444;82;237;294;722;376;959
520753;202202;1430;3668;1079;3041;203;625;468;1244;671;1869
520760;202202;1528;3183;1300;2913;27;54;1193;2699;1220;2753
520780;202202;1630;3728;1184;3103;158;397;653;1698;811;2095
520790;202202;3713;8562;2633;6856;370;905;1445;3938;1815;4843
520800;202202;18787;46102;14830;40446;1938;5253;9362;26182;11300;31435
520810;202202;1420;2881;1096;2522;199;412;677;1729;876;2141
520815;202202;635;1895;478;1552;98;341;149;484;247;825
520830;202202;2035;4217;1455;3545;93;242;1160;2796;1253;3038
520840;202202;3128;7889;2531;7122;824;2533;907;2656;1731;5189
520850;202202;813;1872;625;1604;146;443;271;693;417;1136
520860;202202;8744;22299;6635;18864;1399;4227;2889;8016;4288;12243
520870;202202;136934;307944;97759;249805;17984;48225;43698;108165;61682;156390
520880;202202;9110;24961;7244;21634;1480;4683;3016;8903;4496;13586
520890;202202;4917;10962;3460;8764;523;1469;1745;4318;2268;5787
520910;202202;5138;12373;3400;9498;713;2151;1046;2824;1759;4975
520915;202202;801;2117;520;1535;111;358;177;482;288;840
520920;202202;4993;10667;3636;9018;672;1419;1979;5270;2651;6689
520929;202202;748;1725;584;1501;88;183;313;872;401;1055
520940;202202;1065;2731;829;2389;45;157;641;1820;686;1977
520945;202202;539;1157;380;946;26;65;245;601;271;666
520960;202202;1238;2736;966;2345;251;536;462;1254;713;1790
520970;202202;3327;8458;2559;7255;712;2177;602;1864;1314;4041
520980;202202;860;1950;637;1658;104;260;303;768;407;1028
520990;202202;3301;8120;2670;7342;310;814;1912;5327;2222;6141
520993;202202;1317;3043;887;2322;131;390;467;1182;598;1572
520995;202202;2719;6577;2081;5708;334;892;842;2440;1176;3332
521000;202202;10138;25620;6830;19586;1151;3527;2126;5921;3277;9448
521010;202202;4022;10102;3015;8395;376;1060;1643;4528;2019;5588
521015;202202;858;2069;618;1653;43;123;403;1036;446;1159
521020;202202;4211;10297;2578;7239;679;1991;458;1298;1137;3289
521030;202202;680;1399;513;1158;36;79;392;873;428;952
521040;202202;8824;20846;6648;17558;1376;3610;2821;7975;4197;11585
521056;202202;1024;2601;789;2250;222;603;275;850;497;1453
521060;202202;1147;2920;833;2334;155;439;330;932;485;1371
521080;202202;1221;2531;664;1704;98;270;328;780;426;1050
521090;202202;3385;8799;2292;6603;578;1829;300;873;878;2702
521100;202202;2090;4514;1566;3800;190;456;1051;2579;1241;3035
521120;202202;5327;12150;4075;10624;570;1191;1884;5856;2454;7047
521130;202202;1105;2458;565;1500;49;101;282;788;331;889
521140;202202;1606;3931;1218;3260;142;382;699;1820;841;2202
521150;202202;13939;29828;8985;22870;1629;4456;4204;10888;5833;15344
521160;202202;792;1581;544;1233;64;127;344;763;408;890
521170;202202;1187;2682;886;2235;93;268;509;1217;602;1485
521180;202202;8839;22693;7222;20047;1185;3614;3859;10400;5044;14014
521190;202202;12044;28780;7571;21625;1867;5631;2092;6016;3959;11647
521200;202202;775;1786;556;1461;58;151;336;865;394;1016
521205;202202;705;1640;547;1400;25;72;430;1055;455;1127
521210;202202;832;2121;481;1394;85;258;128;297;213;555
521220;202202;4152;9538;2872;7634;511;1487;1375;3666;1886;5153
521225;202202;437;899;325;776;49;110;217;527;266;637
521230;202202;1540;3749;1344;3503;503;1290;581;1632;1084;2922
521250;202202;37768;92584;30449;82341;8696;23574;13892;38573;22588;62147
521260;202202;590;1319;458;1130;74;191;268;644;342;835
521270;202202;2121;4902;1855;4597;129;288;1445;3662;1574;3950
521280;202202;1988;5136;1507;4364;320;985;667;1980;987;2965
521290;202202;596;1297;414;1070;46;143;267;663;313;806
521295;202202;1323;2800;1058;2517;130;242;809;2012;939;2254
521300;202202;2083;4937;1632;4303;292;724;997;2706;1289;3430
521305;202202;755;1708;541;1418;57;167;338;875;395;1042
521308;202202;5282;13350;3718;10550;342;1078;2296;6291;2638;7369
521310;202202;10299;25259;7285;20103;1254;3858;3546;9315;4800;13173
521340;202202;440;966;315;789;25;62;208;519;233;581
521350;202202;2209;5440;1696;4669;140;438;1228;3291;1368;3729
521370;202202;1361;3365;857;2534;256;824;143;458;399;1282
521375;202202;1533;3747;1065;2999;211;600;349;1079;560;1679
521377;202202;1609;3315;1194;2808;107;180;932;2319;1039;2499
521380;202202;6821;17486;4453;13187;689;1992;1045;3335;1734;5327
521385;202202;770;1765;586;1518;80;182;325;915;405;1097
521390;202202;740;1797;532;1473;148;445;118;354;266;799
521400;202202;3177;7121;2583;6429;240;560;1899;4820;2139;5380
521405;202202;1574;3898;1096;3037;133;378;621;1678;754;2056
521410;202202;969;2320;767;2003;140;340;427;1137;567;1477
521440;202202;1496;3489;1148;2990;344;894;482;1273;826;2167
521450;202202;4416;12491;3274;10327;868;2757;824;2746;1692;5503
521460;202202;6485;16060;4745;13061;1268;3612;1772;4860;3040;8472
521470;202202;803;2015;549;1548;59;176;261;676;320;852
521480;202202;504;1166;340;886;69;177;135;323;204;500
521483;202202;2582;5976;1834;4889;338;901;882;2399;1220;3300
521486;202202;1944;4485;1475;3828;123;245;1003;2637;1126;2882
521487;202202;446;1036;320;867;61;145;185;532;246;677
521490;202202;970;2517;730;2129;40;154;514;1439;554;1593
521500;202202;2330;5616;1790;4858;140;507;1242;3231;1382;3738
521520;202202;857;1914;652;1628;100;211;344;894;444;1105
521523;202202;13762;39200;11375;35565;3007;9831;4231;13476;7238;23307
521525;202202;1198;2688;921;2303;63;194;661;1604;724;1798
521530;202202;2546;6365;1610;4531;348;996;434;1184;782;2180
521540;202202;912;2274;644;1839;125;390;280;810;405;1200
521550;202202;1817;4430;1009;2846;183;544;285;822;468;1366
521560;202202;5640;13753;4034;11593;981;2603;1906;5993;2887;8596
521565;202202;744;1741;538;1413;75;202;268;699;343;901
521570;202202;3937;10353;2779;8180;602;2063;193;588;795;2651
521580;202202;552;1281;347;936;48;147;145;360;193;507
521590;202202;842;1804;621;1503;80;199;374;877;454;1076
521600;202202;463;1181;303;885;36;96;144;413;180;509
521630;202202;1856;3888;1184;2955;279;675;428;1080;707;1755
521640;202202;2144;4865;1438;3837;303;852;503;1310;806;2162
521645;202202;604;1506;386;1120;104;274;102;307;206;581
521680;202202;1425;3906;1109;3365;296;963;315;949;611;1912
521690;202202;595;1407;498;1280;71;203;324;825;395;1028
521710;202202;3787;8939;2510;6865;455;1393;804;1947;1259;3340
521720;202202;2592;5665;1730;4423;248;639;991;2551;1239;3190
521730;202202;4143;10886;3234;9427;881;2957;967;2459;1848;5416
521740;202202;4524;11277;3500;9781;1069;3069;993;2907;2062;5976
521760;202202;16516;42602;13093;37666;2856;8363;5896;18290;8752;26653
521770;202202;3599;8173;2456;6426;645;1741;652;1782;1297;3523
521800;202202;7416;18810;5460;15643;1334;3793;2240;7046;3574;10839
521805;202202;1057;2170;759;1803;165;360;413;1042;578;1402
521810;202202;751;1710;547;1430;104;258;318;865;422;1123
521830;202202;6233;16300;5038;14485;308;1110;3787;10633;4095;11743
521839;202202;963;2135;731;1769;77;223;500;1117;577;1340
521850;202202;7168;15820;4522;11884;1175;3023;905;2424;2080;5447
521860;202202;1772;4625;1235;3655;206;680;415;1148;621;1828
521870;202202;767;2061;560;1677;111;373;167;426;278;799
521878;202202;840;2061;600;1611;76;253;354;876;430;1129
521880;202202;21738;51824;15464;42241;3656;10305;6377;17308;10033;27613
521890;202202;3774;9243;2595;7233;692;1962;712;1873;1404;3835
521900;202202;1527;3482;813;2280;255;697;50;144;305;841
521910;202202;1567;3211;1133;2701;159;354;626;1558;785;1912
521920;202202;577;1448;426;1207;46;153;244;657;290;810
521925;202202;836;2111;617;1781;117;383;317;886;434;1269
521930;202202;6069;14033;4111;11171;1018;2316;1825;5488;2843;7804
521935;202202;1170;2689;816;2094;66;185;480;1168;546;1353
521940;202202;1462;3045;953;2358;169;443;483;1161;652;1604
521945;202202;734;1829;541;1502;86;238;296;842;382;1080
521950;202202;832;1927;593;1559;108;280;286;762;394;1042
521960;202202;777;1938;539;1506;61;204;304;779;365;983
521970;202202;3184;6983;2433;6095;239;498;1768;4691;2007;5189
521971;202202;830;1935;589;1569;147;373;187;492;334;865
521973;202202;1644;4084;1376;3735;58;141;1148;3128;1206;3269
521975;202202;13810;34777;11411;31505;1792;5085;7196;19953;8988;25038
521980;202202;2687;6009;2072;5223;137;325;1599;4121;1736;4446
521990;202202;1324;3382;1088;3014;226;673;557;1540;783;2213
522000;202202;3029;7564;2395;6752;469;1350;1346;4007;1815;5357
522005;202202;378;872;274;719;38;107;135;356;173;463
522010;202202;4701;11187;3451;9231;693;2001;1403;3624;2096;5625
522015;202202;1154;2877;866;2450;230;647;370;1077;600;1724
522020;202202;6010;13686;3997;10632;812;2105;1744;4868;2556;6973
522026;202202;900;2264;587;1749;105;363;176;453;281;816
522028;202202;548;1313;384;1040;95;288;142;365;237;653
522040;202202;3740;7892;2694;6521;262;693;1916;4536;2178;5229
522045;202202;20374;53525;15524;45517;3358;10595;5222;14832;8580;25427
522050;202202;1321;3232;921;2561;180;576;391;975;571;1551
522060;202202;3296;8301;2391;6864;342;935;1286;3771;1628;4706
522068;202202;2065;4893;1658;4414;91;214;1383;3730;1474;3944
522070;202202;831;1831;688;1640;23;51;598;1400;621;1451
522100;202202;878;2138;610;1698;68;194;328;880;396;1074
522108;202202;1216;2696;966;2348;45;142;803;1907;848;2049
522119;202202;2016;4591;1603;4072;252;613;903;2455;1155;3068
522130;202202;525;1251;398;1084;34;91;298;826;332;917
522140;202202;24740;61367;18030;49820;4072;11963;6209;16260;10281;28223
522145;202202;888;2082;635;1714;129;361;327;873;456;1234
522150;202202;1187;2763;831;2209;197;527;277;746;474;1273
522155;202202;1119;2738;877;2392;148;343;531;1512;679;1855
522157;202202;774;1634;636;1473;34;73;524;1237;558;1310
522160;202202;6459;15958;4231;12061;1194;3633;524;1638;1718;5271
522170;202202;2945;7304;2271;6330;278;781;1426;4037;1704;4818
522180;202202;645;1516;436;1121;84;222;128;339;212;561
522185;202202;23830;56114;17609;47773;6201;17926;4620;13675;10821;31601
522190;202202;870;1942;616;1533;129;339;279;660;408;999
522200;202202;2001;5340;1449;4365;372;1122;354;1089;726;2211
522205;202202;1863;4294;1402;3665;232;588;754;2008;986;2596
522220;202202;1406;3252;1051;2760;104;271;708;1907;812;2178
522230;202202;1392;3307;1130;2937;179;533;654;1690;833;2223
530010;202202;209597;546948;175300;497755;21680;68080;113364;314675;135044;382755
110001;202201;4349;11727;2944;9159;626;2084;1178;3721;1804;5805
110002;202201;14629;36480;10840;30297;2604;7702;3484;9875;6088;17577
110003;202201;694;1996;543;1690;148;479;200;584;348;1063
110004;202201;13625;33977;9399;26809;1745;5425;3304;9357;5049;14782
110005;202201;2708;6825;1929;5580;368;1061;641;1993;1009;3054
110006;202201;1795;4908;1138;3543;197;649;257;780;454;1429
110007;202201;1416;3542;927;2720;224;658;331;1129;555;1787
110008;202201;3799;9537;2798;8135;300;773;1865;5919;2165;6692
110009;202201;4870;13008;3146;9932;588;2036;1295;4060;1883;6096
110010;202201;8595;25499;6498;21706;1157;3786;3496;12624;4653;16410
110011;202201;7977;20398;5542;16190;1719;5212;1173;3564;2892;8776
110012;202201;17307;41883;10981;31358;2701;8162;1616;4825;4317;12987
110013;202201;5934;16357;4221;13073;1628;5298;745;2466;2373;7764
110014;202201;4225;10787;2932;8365;435;1362;1473;4086;1908;5448
110015;202201;6234;15508;3941;11278;753;2398;1245;3240;1998;5638
110018;202201;4165;10215;2543;7488;502;1570;716;2161;1218;3731
110020;202201;85405;194988;63496;166010;13567;33899;29945;85046;43512;118945
110025;202201;5726;13399;3903;10352;603;1721;2058;5374;2661;7095
110026;202201;580;1424;424;1199;91;281;179;564;270;845
110028;202201;7830;19121;4964;14146;1212;3832;807;2327;2019;6159
110029;202201;1711;4094;1035;2948;191;539;442;1277;633;1816
110030;202201;14410;32424;9135;24709;2210;6617;1529;4617;3739;11234
110032;202201;3752;10130;2332;7215;648;2019;571;1856;1219;3875
110033;202201;4000;11937;3072;10252;954;3259;1008;3636;1962;6895
110034;202201;3494;7993;2376;6470;667;1973;839;2597;1506;4570
110037;202201;1792;5117;1313;4255;276;895;608;2029;884;2924
110040;202201;3263;8683;2404;7172;529;1708;910;2646;1439;4354
110045;202201;5208;14428;3808;11946;906;3009;1452;4774;2358;7783
110050;202201;1905;4997;1314;3973;412;1412;233;655;645;2067
110060;202201;969;2778;678;2115;175;587;187;568;362;1155
110070;202201;1726;5142;1253;4120;358;1285;316;968;674;2253
110080;202201;7066;15910;5389;13917;864;2109;3338;9210;4202;11319
110090;202201;634;1681;442;1342;86;281;147;449;233;730
110092;202201;1394;3869;986;3111;173;537;506;1689;679;2226
110094;202201;3100;8803;2311;7310;899;3011;383;1298;1282;4309
110100;202201;1846;5229;1454;4509;397;1282;617;1978;1014;3260
110110;202201;1944;5047;1410;4228;437;1360;394;1303;831;2663
110120;202201;1401;3857;1074;3254;236;766;405;1228;641;1994
110130;202201;3080;7401;1882;5248;247;682;205;507;452;1189
110140;202201;2417;6755;1747;5463;362;1219;635;1984;997;3203
110143;202201;1467;3885;1067;3131;301;933;276;799;577;1732
110145;202201;1044;2633;619;1840;125;380;256;796;381;1176
110146;202201;539;1353;385;1116;62;151;207;644;269;795
110147;202201;829;2069;541;1529;83;258;234;593;317;851
110148;202201;1031;2735;517;1639;133;468;80;260;213;728
110149;202201;3591;9212;2436;7396;718;2278;723;2362;1441;4640
110150;202201;2973;7202;1958;5686;494;1554;609;2046;1103;3600
110155;202201;851;2393;616;1861;118;404;251;692;369;1096
110160;202201;1559;4580;1163;3727;298;996;328;1088;626;2084
110170;202201;2279;5647;1473;4194;196;627;857;2310;1053;2937
110175;202201;1994;5466;1399;4291;235;734;583;1841;818;2575
110180;202201;1564;4083;1121;3231;134;399;608;1732;742;2131
120001;202201;3643;10110;2971;9110;433;1418;1953;6113;2386;7531
120005;202201;2060;7562;1885;7325;153;641;1523;6054;1676;6695
120010;202201;5773;16148;4946;14971;382;1146;3852;11903;4234;13049
120013;202201;2497;8017;2206;7666;456;1517;1389;5209;1845;6726
120017;202201;2836;8309;2460;7753;346;1085;1636;5433;1982;6518
120020;202201;16301;58909;15046;56641;955;4215;12377;46754;13332;50969
120025;202201;3528;9175;2875;8416;253;747;2230;6632;2483;7379
120030;202201;6783;25888;6309;25064;418;2163;4988;20024;5406;22187
120032;202201;1898;7986;1816;7842;99;612;1577;6698;1676;7310
120033;202201;4484;15657;4188;15129;112;638;3686;13190;3798;13828
120034;202201;2979;10138;2574;9480;119;663;2165;7868;2284;8531
120035;202201;4141;15117;3907;14721;230;1124;3338;12447;3568;13571
120038;202201;3048;9102;2614;8422;362;1272;1742;5627;2104;6899
120039;202201;2163;8918;2028;8667;121;702;1666;7111;1787;7813
120040;202201;52060;150383;44956;139629;5258;17841;30464;95061;35722;112902
120042;202201;3722;12810;3457;12351;150;754;2949;10426;3099;11180
120043;202201;1623;6160;1439;5906;36;211;1320;5437;1356;5648
120045;202201;6529;16243;5619;15212;302;935;4811;12990;5113;13925
120050;202201;10114;34573;9286;33380;418;1998;7899;28491;8317;30489
120060;202201;10321;38232;9467;37012;406;2267;8339;32489;8745;34756
120070;202201;3599;10720;3141;10117;322;976;2296;7684;2618;8660
120080;202201;4875;14274;4352;13531;404;1311;3381;10704;3785;12015
130002;202201;3520;12634;3162;12136;195;622;2751;10875;2946;11497
130006;202201;2751;9465;2297;8723;286;1075;1589;6428;1875;7503
130008;202201;2931;9696;2585;9214;94;419;2204;7939;2298;8358
130010;202201;4168;11845;3515;11111;91;269;3184;10201;3275;10470
130014;202201;3856;10595;3006;9295;405;1292;1974;6258;2379;7550
130020;202201;3226;12133;2880;11638;134;745;2439;9877;2573;10622
130030;202201;12333;35412;11292;34221;296;833;10389;31791;10685;32624
130040;202201;4524;12682;3766;11710;372;1050;2947;9457;3319;10507
130050;202201;8128;28332;6831;26683;209;878;6199;24605;6408;25483
130060;202201;8255;31398;7083;29911;377;2217;6025;25234;6402;27451
130063;202201;7019;22141;6262;21323;170;775;5750;19647;5920;20422
130068;202201;4169;13462;3543;12637;185;990;2811;9950;2996;10940
130070;202201;8104;21694;6642;20117;369;956;5527;17301;5896;18257
130080;202201;8055;27047;7062;25937;423;1469;6172;23054;6595;24523
130083;202201;2987;9339;2658;8943;193;648;2208;7667;2401;8315
130090;202201;3959;11659;3522;11141;79;221;3228;10383;3307;10604
130100;202201;8408;24771;7093;23402;150;294;6644;22443;6794;22737
130110;202201;8845;24247;7191;22222;845;2271;5483;17856;6328;20127
130115;202201;5418;16660;4665;15817;140;434;4128;14278;4268;14712
130120;202201;14442;49932;12734;47693;932;3948;10515;39863;11447;43811
130130;202201;6157;17975;4742;16148;416;1387;3622;12659;4038;14046
130140;202201;7651;25792;6656;24663;297;1435;5740;21421;6037;22856
130150;202201;4014;14151;3774;13882;78;447;3511;12939;3589;13386
130160;202201;5969;19298;5134;18272;286;939;4457;16239;4743;17178
130165;202201;3417;12517;3213;12288;116;500;2924;11308;3040;11808
130170;202201;12823;35237;10384;32484;603;2080;8813;27941;9416;30021
130180;202201;4674;14838;4442;14583;42;248;4295;14065;4337;14313
130185;202201;20642;48158;16974;44255;1237;1757;14542;40058;15779;41815
130190;202201;20659;64888;16700;59216;1437;5280;12765;46506;14202;51786
130195;202201;2693;9284;2216;8670;100;452;1870;7381;1970;7833
130200;202201;3064;7858;2528;7179;76;310;2234;6304;2310;6614
130210;202201;1426;5239;1278;5056;107;587;1051;4082;1158;4669
130220;202201;2596;8189;2180;7687;77;296;1936;6946;2013;7242
130230;202201;5294;20280;4624;19369;201;1145;4068;17095;4269;18240
130240;202201;13799;38555;11269;35346;186;969;10338;32387;10524;33356
130250;202201;28157;80782;24167;76281;1184;3677;20522;66419;21706;70096
130255;202201;5190;16070;4473;14851;165;696;3683;12234;3848;12930
130260;202201;286772;751967;235494;682690;55761;157877;127936;391168;183697;549045
130270;202201;10634;35427;8820;32690;1348;4745;5842;22755;7190;27500
130280;202201;3809;14639;3500;14292;101;417;3271;13526;3372;13943
130290;202201;15206;46792;13377;44580;728;2436;11697;39598;12425;42034
130300;202201;5287;17120;4753;16425;195;943;4145;14341;4340;15284
130310;202201;7318;22168;6376;21020;312;1205;5470;18174;5782;19379
130320;202201;3731;11826;3130;11058;361;1245;2388;8727;2749;9972
130330;202201;5048;15235;4072;14087;196;828;3504;12188;3700;13016
130340;202201;26670;75844;22994;71747;851;2920;20418;64485;21269;67405
130350;202201;4277;14840;3859;14329;128;715;3449;12724;3577;13439
130353;202201;8523;21741;6932;19773;773;2016;5169;15405;5942;17421
130356;202201;5838;17498;4914;16102;757;2337;3178;11014;3935;13351
130360;202201;3287;10300;2742;9611;70;307;2498;8770;2568;9077
130370;202201;5935;23402;5093;22254;440;2324;3964;17424;4404;19748
130380;202201;7817;32295;7278;31518;495;2727;6206;26751;6701;29478
130390;202201;6745;26564;6029;25448;481;2220;5040;21502;5521;23722
130395;202201;2643;8074;2271;7502;172;599;1837;6105;2009;6704
130400;202201;3069;9011;2634;8444;87;259;2391;7782;2478;8041
130406;202201;11390;38224;9591;36085;1241;4727;7176;27947;8417;32674
130410;202201;4792;15975;4137;14946;1076;4030;2218;8330;3294;12360
130420;202201;15378;50706;12878;47630;871;4093;10370;38472;11241;42565
130423;202201;4779;14386;4195;13724;166;731;3762;12212;3928;12943
130426;202201;2943;11273;2718;11006;55;274;2537;10383;2592;10657
130430;202201;4725;12576;4071;11752;177;568;3583;10341;3760;10909
130440;202201;5490;16270;4626;15257;85;364;4331;14368;4416;14732
140002;202201;2487;7106;2172;6731;108;362;1858;5846;1966;6208
140005;202201;3419;9326;2974;8814;256;691;2437;7483;2693;8174
140010;202201;57663;150406;46843;134926;10835;32694;21984;65043;32819;97737
140015;202201;4217;11788;3591;11051;248;742;3089;9762;3337;10504
140017;202201;5614;14154;4978;13368;288;749;4271;11647;4559;12396
140020;202201;5543;15409;4795;14476;255;1003;4003;12036;4258;13039
140023;202201;2696;7664;2213;6987;200;639;1728;5591;1928;6230
140028;202201;2023;5139;1709;4755;89;283;1383;3878;1472;4161
140030;202201;5642;13940;5020;13231;215;393;4576;12315;4791;12708
140040;202201;2753;10381;2549;10120;90;517;2355;9266;2445;9783
140045;202201;2685;9695;2223;9072;358;1188;1512;6760;1870;7948
140047;202201;6709;18356;5628;16817;554;1788;4190;12703;4744;14491
140050;202201;1603;4601;1369;4272;151;430;1036;3351;1187;3781
140060;202201;1838;4649;1599;4327;97;256;1343;3702;1440;3958
140070;202201;2033;10222;1969;10117;127;850;1706;8670;1833;9520
150010;202201;49535;119678;44820;113727;876;2384;40595;102632;41471;105016
150013;202201;2123;5113;1795;4756;85;209;1518;4166;1603;4375
150020;202201;14960;43612;13796;42105;1222;3148;11514;36187;12736;39335
150030;202201;8931;33328;8085;32326;378;1704;7238;29171;7616;30875
150034;202201;4669;10760;3820;9736;204;469;3258;8470;3462;8939
150040;202201;17608;43327;15442;40967;1325;1595;13508;38188;14833;39783
150050;202201;7683;24995;7031;24157;127;529;6529;22655;6656;23184
150060;202201;23958;62612;19457;56017;2346;6892;13593;39803;15939;46695
150070;202201;8352;27758;7362;26601;188;859;6836;24757;7024;25616
150080;202201;99371;217866;82293;195157;20774;49354;26571;76066;47345;125420
150085;202201;8788;23839;7954;22875;122;428;7481;21665;7603;22093
150090;202201;11182;37082;10544;35937;567;2171;9004;30610;9571;32781
150095;202201;6681;17465;5897;16521;228;461;5327;15183;5555;15644
150100;202201;3052;10248;2704;9685;203;685;2163;7920;2366;8605
150110;202201;4482;17924;4171;17578;126;629;3913;16575;4039;17204
150120;202201;8568;25800;8086;25241;312;659;7330;23397;7642;24056
150125;202201;837;2052;618;1766;91;296;404;1161;495;1457
150130;202201;24471;67184;21113;62191;3615;9327;13726;43327;17341;52654
150140;202201;293145;640717;249572;583699;32446;69022;157891;380426;190337;449448
150145;202201;4586;13809;3857;12674;1046;3193;1918;7133;2964;10326
150150;202201;18614;44292;16182;41325;864;2224;13366;34279;14230;36503
150157;202201;3943;10264;3153;9245;299;849;2270;6924;2569;7773
150160;202201;3614;9405;3364;9053;373;921;2535;6912;2908;7833
150170;202201;27570;82566;24493;77616;3534;10285;16444;55060;19978;65345
150172;202201;5636;14420;4564;12977;282;697;3540;10381;3822;11078
150175;202201;1808;5357;1501;4828;216;713;960;3128;1176;3841
150178;202201;11529;28990;9422;26609;437;828;8205;23938;8642;24766
150180;202201;24871;80390;22573;77844;951;3054;20322;71292;21273;74346
150190;202201;7434;22855;6913;22235;184;796;6344;20349;6528;21145
150195;202201;5726;17018;5375;16508;187;658;4874;14956;5061;15614
150200;202201;6250;17727;5699;17120;28;127;5431;16367;5459;16494
150210;202201;29761;95375;27943;93129;1398;4365;24224;82657;25622;87022
150215;202201;9589;26029;8368;24195;1328;3811;5265;15650;6593;19461
150220;202201;13896;36964;12201;34649;976;2630;8962;25847;9938;28477
150230;202201;14071;37689;12495;35597;1191;2811;9017;26909;10208;29720
150240;202201;36574;95991;30856;86806;6481;18819;14179;39500;20660;58319
150250;202201;4501;16413;4193;16073;451;1726;3505;13710;3956;15436
150260;202201;2831;8701;2545;8287;112;393;2118;6949;2230;7342
150270;202201;9888;26846;7085;21928;1974;6375;2172;7142;4146;13517
150275;202201;7451;22252;6797;21373;181;757;6027;18838;6208;19595
150276;202201;2561;6503;2207;6068;271;612;1539;4696;1810;5308
150277;202201;5613;13831;4489;12546;423;1162;3364;9899;3787;11061
150280;202201;7561;28591;7292;28177;300;1327;6542;25406;6842;26733
150285;202201;3583;11999;3144;11320;214;863;2428;8862;2642;9725
150290;202201;11701;29882;10598;28707;453;703;9619;26760;10072;27463
150293;202201;10203;23960;8013;21167;1010;2432;5299;14649;6309;17081
150295;202201;8147;20842;5901;17780;1818;5471;2308;8063;4126;13534
150300;202201;2576;7269;2336;6980;29;107;2180;6536;2209;6643
150304;202201;4699;13055;3920;11875;553;1428;2693;8657;3246;10085
150307;202201;6362;19445;5826;18583;311;1044;4721;15159;5032;16203
150309;202201;7087;19647;5751;17492;734;2196;3702;11621;4436;13817
150310;202201;7922;29966;7515;29492;225;1153;6737;26713;6962;27866
150320;202201;9716;25669;8848;24440;389;1275;7056;19341;7445;20616
150330;202201;14857;44968;13798;43453;1237;3453;10544;34716;11781;38169
150340;202201;2668;7559;2362;7127;251;700;1743;5380;1994;6080
150345;202201;9417;25144;8429;23871;327;1054;7458;21095;7785;22149
150350;202201;9826;23713;8999;22682;553;1129;7750;19805;8303;20934
150360;202201;25730;67724;20543;61332;2260;4887;15090;48064;17350;52951
150370;202201;12180;34413;9967;31466;1096;2970;7347;24864;8443;27834
150375;202201;4025;15687;3663;15193;189;864;3251;13618;3440;14482
150380;202201;11817;28744;9704;26010;149;557;8593;22996;8742;23553
150390;202201;7966;30956;7122;29682;804;3039;5509;23912;6313;26951
150400;202201;7103;24196;6819;23710;171;701;6171;21435;6342;22136
150405;202201;9782;24649;8511;23157;459;960;7077;19752;7536;20712
150410;202201;2131;6255;1829;5766;188;543;1287;4174;1475;4717
150420;202201;44010;115821;34246;101870;7980;23363;15070;50884;23050;74247
150430;202201;8867;24703;8051;23683;653;1561;6686;20191;7339;21752
150440;202201;6274;18341;5698;17577;695;1848;4237;13656;4932;15504
150442;202201;30848;68132;25777;62132;2208;4865;19287;47037;21495;51902
150445;202201;7180;20482;6307;19224;176;579;5588;17064;5764;17643
150450;202201;5622;22369;5205;21824;365;1824;4515;18927;4880;20751
150460;202201;9141;28422;8351;27444;341;993;7237;24618;7578;25611
150470;202201;22731;57246;20387;54594;255;924;19385;51734;19640;52658
150475;202201;5733;16796;4883;15527;642;1795;3499;11626;4141;13421
150480;202201;14771;44573;13258;42417;1765;4634;9825;33326;11590;37960
150490;202201;9063;30129;8248;29097;425;1499;7094;25396;7519;26895
150495;202201;5921;18558;5623;18177;132;546;5146;16640;5278;17186
150497;202201;3006;9110;2431;8123;426;1443;1413;5014;1839;6457
150500;202201;3548;8691;3151;8133;217;530;2489;6390;2706;6920
150503;202201;5330;13198;3738;11155;1137;3288;1477;4882;2614;8170
150506;202201;11988;33326;10061;30718;1573;4137;7025;23199;8598;27336
150510;202201;11300;36982;9857;34515;1059;3525;7188;25942;8247;29467
150520;202201;8251;29604;7923;29208;179;1060;7339;26918;7518;27978
150530;202201;13283;43200;11498;40688;977;2903;8984;33010;9961;35913
150540;202201;5488;13901;4722;12793;229;598;4021;10890;4250;11488
150543;202201;7558;19797;6239;18173;396;1116;4987;15154;5383;16270
150548;202201;10900;32811;9789;31288;272;1046;8832;28235;9104;29281
150549;202201;2115;5896;1801;5457;60;198;1498;4583;1558;4781
150550;202201;22573;63329;18799;57421;4085;12647;8920;28679;13005;41326
150553;202201;38125;100829;30077;87347;6686;19703;14031;41933;20717;61636
150555;202201;2132;5383;1678;4684;155;332;1148;3403;1303;3735
150560;202201;2075;5836;1854;5434;218;620;1219;3666;1437;4286
150563;202201;2809;8040;2331;7226;395;1282;1398;4408;1793;5690
150565;202201;4802;14762;4286;13974;116;519;3619;11868;3735;12387
150570;202201;7087;20717;6611;20113;329;996;5766;17664;6095;18660
150580;202201;11451;42564;9770;40715;987;3452;7811;34501;8798;37953
150590;202201;8670;28888;7412;27397;169;964;6820;25144;6989;26108
150600;202201;10695;32943;9915;32006;189;816;9253;29901;9442;30717
150610;202201;3230;8603;2883;8088;101;386;2477;6854;2578;7240
150611;202201;3577;9384;3187;8862;84;286;2856;7906;2940;8192
150613;202201;15248;39802;11695;34062;1877;5922;6462;18629;8339;24551
150616;202201;4019;10731;2957;8945;568;1802;1406;4279;1974;6081
150618;202201;7550;20693;6165;18614;675;1989;3994;12541;4669;14530
150619;202201;7326;19249;6037;17514;275;721;5102;15013;5377;15734
150620;202201;7252;23267;6305;21744;612;1993;4442;15797;5054;17790
150630;202201;7113;17833;6490;17099;173;544;5860;15370;6033;15914
150635;202201;5590;14502;4719;13139;537;1405;3199;9052;3736;10457
150640;202201;2344;6784;2138;6526;33;105;1999;6156;2032;6261
150650;202201;12574;32835;10976;30428;2582;6697;5651;16834;8233;23531
150655;202201;5891;16484;5334;15683;152;525;4710;13823;4862;14348
150658;202201;4961;13644;3751;11649;735;2378;1974;6426;2709;8804
150660;202201;6220;16847;5508;15868;592;1653;3895;11396;4487;13049
150670;202201;10025;21508;7963;19186;521;957;6710;16797;7231;17754
150680;202201;76505;212038;60348;187483;12560;37827;30481;104685;43041;142512
150690;202201;2978;6999;2560;6529;108;210;2255;5885;2363;6095
150700;202201;6818;19102;6100;18199;340;926;5028;15316;5368;16242
150710;202201;3972;12817;3602;12250;237;812;2830;9783;3067;10595
150715;202201;5554;14754;4575;13339;226;628;3784;11121;4010;11749
150720;202201;7518;24572;6998;23832;386;1467;5945;20479;6331;21946
150730;202201;14011;40022;11961;37054;1277;4040;8982;28595;10259;32635
150740;202201;4360;11534;3824;10728;296;716;2956;8500;3252;9216
150745;202201;5556;15005;4511;13530;491;1502;3394;10362;3885;11864
150746;202201;1882;5236;1706;4994;68;194;1452;4272;1520;4466
150747;202201;5460;15714;4852;14827;437;1185;3690;11628;4127;12813
150750;202201;4017;11789;3317;10739;227;796;2530;8479;2757;9275
150760;202201;12501;35305;11321;33716;1442;3880;8300;25560;9742;29440
150770;202201;7233;24033;6727;23472;238;573;6152;22179;6390;22752
150775;202201;1175;2975;913;2642;109;340;634;1850;743;2190
150780;202201;4697;14052;4169;13436;143;378;3792;12538;3935;12916
150790;202201;6532;17116;5593;16118;374;727;4042;13655;4416;14382
150795;202201;15791;45571;13711;42507;2454;7293;8858;28642;11312;35935
150796;202201;4192;9617;3643;8997;154;336;3179;7962;3333;8298
150797;202201;4472;12945;3856;12109;219;495;3230;10432;3449;10927
150800;202201;14174;42681;12704;40799;1127;3485;10073;33179;11200;36664
150803;202201;8188;23503;7606;22669;314;995;6731;20127;7045;21122
150805;202201;3776;11044;3208;10249;237;720;2511;8252;2748;8972
150808;202201;6902;19106;5137;16224;1775;6038;1094;3896;2869;9934
150810;202201;22675;56030;17214;49553;3289;8951;9393;30464;12682;39415
150812;202201;6149;16195;5450;15124;368;1164;4299;11689;4667;12853
150815;202201;10431;29037;8714;27029;656;2005;7237;22922;7893;24927
150820;202201;13583;33765;11662;31447;1287;2458;9122;26077;10409;28535
150830;202201;12892;43628;11911;42453;762;2139;10202;38026;10964;40165
150835;202201;3127;9193;2720;8594;319;1051;1916;6046;2235;7097
150840;202201;8650;22792;7023;20326;1020;3283;4259;12170;5279;15453
160005;202201;1320;3397;1162;3208;53;178;1020;2822;1073;3000
160010;202201;2497;6551;2326;6366;23;111;2255;6120;2278;6231
160015;202201;3365;8760;3019;8351;56;176;2835;7853;2891;8029
160020;202201;2373;6960;2065;6575;195;543;1636;5441;1831;5984
160021;202201;1326;4680;1216;4549;72;328;959;3690;1031;4018
160023;202201;1447;4774;1296;4528;181;612;885;3256;1066;3868
160025;202201;1899;5620;1785;5494;31;76;1712;5308;1743;5384
160027;202201;9539;25339;8554;24113;524;1507;7215;20474;7739;21981
160030;202201;84049;224244;69187;204892;12516;34429;40722;130967;53238;165396
160040;202201;6259;20177;5691;19469;124;447;5322;18340;5446;18787
160050;202201;5440;15418;4318;13966;1260;3465;2165;8438;3425;11903
160053;202201;4330;12427;3874;11861;227;597;3201;10229;3428;10826
160055;202201;1092;2819;1058;2783;20;47;999;2640;1019;2687
160060;202201;28953;70306;24069;64852;1615;3887;19355;54523;20970;58410
160070;202201;3039;10655;2678;10119;237;835;2103;8318;2340;9153
160080;202201;3578;10663;3141;10181;41;173;2971;9678;3012;9851
170025;202201;707;1765;507;1450;84;232;273;819;357;1051
170030;202201;1321;3829;1047;3382;190;594;487;1621;677;2215
170035;202201;1594;3983;1185;3361;82;253;779;2173;861;2426
170040;202201;2050;5433;1646;4876;138;451;1075;3255;1213;3706
170070;202201;2039;4585;1457;3862;88;233;898;2482;986;2715
170100;202201;2572;7107;2129;6392;149;465;1429;4340;1578;4805
170105;202201;759;2108;542;1673;129;408;193;563;322;971
170110;202201;1076;3057;845;2661;87;332;497;1488;584;1820
170130;202201;1471;4067;1108;3429;146;502;630;1963;776;2465
170190;202201;1640;4206;1255;3624;248;846;605;1716;853;2562
170200;202201;2253;5143;1509;3958;216;563;693;1827;909;2390
170210;202201;28618;74485;22050;63963;6461;20151;4665;14413;11126;34564
170215;202201;1421;3673;1143;3293;51;189;912;2619;963;2808
170220;202201;6332;18738;5307;16947;1336;4035;2218;7992;3554;12027
170230;202201;1334;3736;1003;3112;290;916;257;837;547;1753
170240;202201;2828;7485;2285;6643;138;496;1697;4821;1835;5317
170255;202201;4187;11590;3061;9663;540;1739;1477;4804;2017;6543
170270;202201;986;2334;678;1896;80;213;388;1082;468;1295
170290;202201;3145;8796;2740;8276;172;471;2199;6823;2371;7294
170300;202201;2233;5634;1825;5050;159;423;1325;3686;1484;4109
170305;202201;716;1885;612;1720;67;183;345;994;412;1177
170307;202201;1088;3371;902;3036;96;347;568;1899;664;2246
170310;202201;1709;4115;1238;3395;160;482;659;1820;819;2302
170320;202201;1121;2836;852;2407;84;254;540;1558;624;1812
170330;202201;954;2817;863;2686;33;150;734;2230;767;2380
170360;202201;603;1517;440;1265;25;103;308;834;333;937
170370;202201;1391;3508;1017;2904;198;557;439;1261;637;1818
170380;202201;1983;5426;1531;4758;110;361;911;2954;1021;3315
170382;202201;577;1628;479;1468;27;115;364;1075;391;1190
170384;202201;1783;5881;1473;5318;295;1053;799;2982;1094;4035
170386;202201;1060;2810;685;2118;83;300;265;778;348;1078
170388;202201;785;2067;558;1686;72;235;260;769;332;1004
170389;202201;1058;3122;871;2808;68;247;608;1994;676;2241
170390;202201;1927;4168;1465;3624;31;80;1258;3163;1289;3243
170410;202201;656;1728;478;1434;35;135;326;936;361;1071
170460;202201;424;1099;352;987;37;119;253;700;290;819
170510;202201;989;2653;719;2196;43;200;464;1307;507;1507
170550;202201;7141;18254;5400;15573;1404;4321;1562;4707;2966;9028
170555;202201;1498;3870;1201;3432;115;269;592;1801;707;2070
170560;202201;1109;2965;853;2609;96;289;536;1713;632;2002
170600;202201;1438;3679;1143;3265;208;559;643;1921;851;2480
170610;202201;1751;4395;1321;3764;105;351;840;2356;945;2707
170625;202201;472;1204;325;928;34;80;141;385;175;465
170650;202201;1367;3837;1115;3445;117;401;716;2231;833;2632
170700;202201;3732;10603;2884;9034;554;1771;1322;4157;1876;5928
170710;202201;1631;4024;1283;3502;163;446;825;2290;988;2736
170720;202201;1884;4524;1455;3862;208;547;887;2383;1095;2930
170730;202201;1165;3002;881;2566;90;248;538;1588;628;1836
170740;202201;2214;6994;1919;6483;159;640;1417;4749;1576;5389
170755;202201;940;2450;670;2011;116;380;284;840;400;1220
170765;202201;1220;3033;879;2523;168;459;429;1266;597;1725
170770;202201;2003;5434;1630;4888;123;435;1197;3556;1320;3991
170820;202201;3825;10831;3001;9426;549;1760;1503;4860;2052;6620
170825;202201;1082;2414;893;2179;78;184;687;1670;765;1854
170830;202201;1456;3717;1183;3301;207;599;689;1921;896;2520
170900;202201;2946;8820;2501;8196;173;610;2049;6779;2222;7389
170930;202201;4064;10763;3150;9131;695;2107;1070;3128;1765;5235
170950;202201;12201;32693;8734;26642;2439;8029;1309;4425;3748;12454
170980;202201;515;1309;394;1124;47;155;231;632;278;787
171050;202201;1758;5308;1534;4944;67;275;1275;4089;1342;4364
171070;202201;1439;3914;1230;3611;251;638;665;2273;916;2911
171090;202201;1129;2777;889;2432;110;308;541;1484;651;1792
171110;202201;614;1583;432;1272;82;247;192;522;274;769
171150;202201;1169;2752;748;2067;56;176;479;1303;535;1479
171180;202201;838;2180;570;1701;91;258;266;794;357;1052
171190;202201;2096;6516;1823;6065;271;935;1163;3977;1434;4912
171195;202201;854;2601;676;2271;89;361;433;1412;522;1773
171200;202201;650;1750;490;1492;103;359;199;596;302;955
171215;202201;420;1096;341;969;38;126;224;628;262;754
171240;202201;841;2632;676;2344;39;229;467;1566;506;1795
171245;202201;830;2257;656;1932;61;201;427;1209;488;1410
171250;202201;1071;2790;783;2350;130;424;399;1212;529;1636
171270;202201;520;1750;415;1528;83;320;193;751;276;1071
171280;202201;945;2711;763;2402;66;240;494;1581;560;1821
171320;202201;4330;11644;3423;10121;537;1576;1583;4815;2120;6391
171330;202201;3006;7989;2349;6856;492;1455;1126;3354;1618;4809
171360;202201;1580;4264;1257;3808;113;304;874;2828;987;3132
171370;202201;768;1832;598;1599;38;115;441;1178;479;1293
171380;202201;1601;4224;1353;3896;155;378;970;2956;1125;3334
171395;202201;1112;2807;774;2233;57;204;529;1456;586;1660
171420;202201;2128;5839;1604;4877;260;820;790;2395;1050;3215
171430;202201;1147;3200;970;2899;54;177;687;1977;741;2154
171488;202201;2593;7108;2095;6330;325;1004;1242;3785;1567;4789
171500;202201;1012;2483;761;2105;62;172;508;1397;570;1569
171510;202201;872;2685;760;2486;45;196;561;1812;606;2008
171515;202201;524;1275;399;1094;35;114;255;648;290;762
171525;202201;778;2065;586;1749;50;191;374;1073;424;1264
171550;202201;366;1022;286;895;40;157;164;484;204;641
171570;202201;1198;3442;1018;3132;112;363;645;2036;757;2399
171575;202201;1837;4802;1224;3754;123;388;573;1762;696;2150
171610;202201;6266;16868;4739;14360;1006;3314;1274;4255;2280;7569
171620;202201;2843;7587;2416;6992;110;425;2028;5827;2138;6252
171630;202201;1120;2750;873;2429;65;177;642;1842;707;2019
171650;202201;2297;6260;1810;5492;438;1375;598;2025;1036;3400
171660;202201;2522;6128;1781;4949;193;506;1103;3088;1296;3594
171665;202201;1329;3611;1064;3197;172;544;554;1708;726;2252
171670;202201;2052;5278;1553;4479;213;649;810;2346;1023;2995
171700;202201;1269;3453;939;2871;103;339;550;1675;653;2014
171720;202201;837;2070;658;1801;42;118;496;1361;538;1479
171750;202201;1406;3815;970;3002;242;766;178;643;420;1409
171780;202201;1344;3254;1012;2782;73;237;751;2033;824;2270
171790;202201;1502;4643;1222;4077;188;642;639;2133;827;2775
171800;202201;784;2008;602;1747;69;236;363;1017;432;1253
171820;202201;12467;33758;9433;28754;2259;7243;2749;9033;5008;16276
171830;202201;1669;5050;1430;4651;162;572;909;3006;1071;3578
171840;202201;795;2031;621;1772;34;121;392;1112;426;1233
171845;202201;696;1616;539;1391;40;140;380;947;420;1087
171850;202201;1008;3149;858;2829;76;315;613;1979;689;2294
171855;202201;1124;3260;963;2972;66;212;640;1936;706;2148
171865;202201;490;1377;421;1273;56;193;253;734;309;927
171870;202201;885;2316;623;1863;62;186;349;1046;411;1232
171875;202201;1421;3874;1155;3468;37;173;907;2698;944;2871
171880;202201;1350;3785;1176;3559;37;123;946;2925;983;3048
171884;202201;1010;2775;764;2354;143;470;325;1032;468;1502
171886;202201;1581;4099;1154;3466;293;983;301;964;594;1947
171888;202201;715;1956;514;1596;30;127;313;938;343;1065
171889;202201;436;1261;324;1066;65;222;128;406;193;628
171890;202201;1273;3500;936;2965;131;406;576;1823;707;2229
171900;202201;587;1943;462;1673;75;264;209;800;284;1064
172000;202201;621;1763;519;1606;73;236;288;879;361;1115
172010;202201;1152;3630;1000;3370;101;374;659;2219;760;2593
172015;202201;399;1317;307;1149;56;213;134;510;190;723
172020;202201;3004;8037;2629;7565;161;502;1994;5955;2155;6457
172025;202201;753;2010;555;1698;44;138;390;1202;434;1340
172030;202201;1317;3798;1097;3442;69;246;819;2561;888;2807
172049;202201;1400;3259;930;2624;124;338;518;1552;642;1890
172065;202201;1536;3771;1223;3379;98;196;976;2870;1074;3066
172080;202201;2493;7123;2047;6363;125;455;1402;4319;1527;4774
172085;202201;498;1308;331;977;52;160;131;353;183;513
172090;202201;4399;10374;3466;9162;138;361;2737;7310;2875;7671
172093;202201;491;1426;354;1191;27;128;215;696;242;824
172097;202201;763;1921;538;1545;75;231;231;647;306;878
172100;202201;53849;128442;39936;107497;6731;19560;16599;45515;23330;65075
172110;202201;1733;5963;1494;5611;101;444;1171;4471;1272;4915
172120;202201;5435;15334;4310;13553;505;1737;2564;8167;3069;9904
172125;202201;426;1104;325;952;28;89;198;554;226;643
172130;202201;672;1605;519;1359;19;80;367;893;386;973
172208;202201;2790;6490;2248;5806;144;342;1736;4528;1880;4870
172210;202201;2845;6908;2200;6109;249;693;1412;4128;1661;4821
210005;202201;20235;55531;15340;47710;3609;11688;6906;22450;10515;34138
210010;202201;2015;5989;1829;5770;53;238;1631;5139;1684;5377
210015;202201;3516;10114;3062;9520;167;547;2561;8009;2728;8556
210020;202201;7611;17656;6491;16365;99;301;5992;15147;6091;15448
210030;202201;4864;15529;4464;14928;448;1438;3563;12186;4011;13624
210040;202201;2129;4643;1867;4332;65;155;1611;3663;1676;3818
210043;202201;6273;17345;5296;15991;367;1180;4232;12929;4599;14109
210047;202201;7003;20878;5715;19196;183;847;4928;16611;5111;17458
210050;202201;2335;7465;1864;6629;183;755;1321;4709;1504;5464
210055;202201;2077;6246;1892;5978;49;182;1676;5323;1725;5505
210060;202201;7853;27774;7025;26337;644;2596;5010;19245;5654;21841
210070;202201;7411;20075;6899;19427;48;199;6521;18326;6569;18525
210080;202201;4465;14541;4234;14297;50;280;3925;13333;3975;13613
210083;202201;5892;16189;4886;15104;131;386;4543;14195;4674;14581
210087;202201;3071;8312;2617;7708;149;482;2113;6230;2262;6712
210090;202201;9668;28996;9038;27945;566;1516;7677;23973;8243;25489
210095;202201;6931;21669;6332;20921;371;1284;5287;18047;5658;19331
210100;202201;7078;21233;6224;19818;538;1760;4631;14894;5169;16654
210110;202201;3000;9230;2755;8933;67;325;2464;7989;2531;8314
210120;202201;25400;65442;21169;60133;1820;3963;15243;45858;17063;49821
210125;202201;4613;12157;4028;11495;494;1145;3103;9260;3597;10405
210130;202201;4513;11307;3729;10348;103;266;3248;9058;3351;9324
210135;202201;1737;4558;1443;4136;48;133;1234;3564;1282;3697
210140;202201;21283;53765;16583;47787;2758;7495;10177;30549;12935;38044
210150;202201;4861;10999;4303;10261;120;329;3756;8805;3876;9134
210160;202201;18954;50722;16103;47232;1407;3855;12020;36687;13427;40542
210170;202201;16614;48470;15436;46993;594;1892;13845;42215;14439;44107
210173;202201;2345;8860;2211;8647;109;603;1903;7406;2012;8009
210177;202201;3569;9566;3095;8968;318;774;2483;7464;2801;8238
210180;202201;1470;3849;1284;3630;24;72;1169;3305;1193;3377
210190;202201;5736;14578;4876;13456;86;353;4221;11522;4307;11875
210193;202201;1413;3944;1240;3677;54;170;924;2776;978;2946
210197;202201;2210;6614;2026;6371;115;368;1718;5499;1833;5867
210200;202201;8242;25444;7306;23983;417;1642;5923;19386;6340;21028
210203;202201;7569;21483;6402;19950;359;1158;5209;16591;5568;17749
210207;202201;4111;9714;3200;8721;107;281;2688;7393;2795;7674
210210;202201;8113;25546;7377;24528;206;1085;6327;20942;6533;22027
210215;202201;2573;7987;2221;7478;187;876;1677;5583;1864;6459
210220;202201;6614;21710;6223;21144;164;1043;5575;18573;5739;19616
210230;202201;5657;16138;5135;15377;241;669;4531;13682;4772;14351
210232;202201;12213;36161;10033;32890;1511;4809;6615;23029;8126;27838
210235;202201;3513;10459;3104;9873;158;562;2616;8366;2774;8928
210237;202201;3478;9897;2885;9217;31;179;2709;8624;2740;8803
210240;202201;2735;8193;2511;7840;66;289;2070;6328;2136;6617
210250;202201;6125;17813;5548;17088;72;363;5073;15589;5145;15952
210255;202201;2767;8163;2385;7520;284;996;1596;4963;1880;5959
210260;202201;5706;16633;5023;15667;297;1039;4221;13208;4518;14247
210270;202201;5371;14070;4782;13333;81;398;4343;11990;4424;12388
210275;202201;3589;8950;3103;8369;129;392;2561;6910;2690;7302
210280;202201;6038;16303;4873;14591;226;965;3811;11217;4037;12182
210290;202201;8218;20212;7385;19198;130;389;6931;18029;7061;18418
210300;202201;34274;91269;27985;82316;3891;10857;17318;54692;21209;65549
210310;202201;3239;7985;2850;7448;72;194;2566;6706;2638;6900
210312;202201;2956;7004;2646;6673;14;70;2540;6376;2554;6446
210315;202201;3211;8590;2775;8107;98;258;2462;7375;2560;7633
210317;202201;4454;13575;4026;13077;94;468;3670;11871;3764;12339
210320;202201;22021;61655;20259;59403;354;1660;18483;53818;18837;55478
210325;202201;3761;10408;3197;9688;176;456;2724;8505;2900;8961
210330;202201;26186;69114;21135;62885;3497;8681;13806;44984;17303;53665
210340;202201;10879;29986;9717;28485;445;1460;8070;23866;8515;25326
210350;202201;9353;26245;8205;24848;148;560;7380;22395;7528;22955
210355;202201;4333;14080;3838;13314;133;592;3269;11394;3402;11986
210360;202201;14346;43129;12656;40564;634;2868;9606;30125;10240;32993
210370;202201;11725;25059;8960;22158;254;440;8210;20738;8464;21178
210375;202201;3476;9079;2632;7874;768;2374;952;3201;1720;5575
210380;202201;5689;14140;4897;13203;257;669;4169;11306;4426;11975
210390;202201;2977;9288;2760;8936;104;446;2420;7775;2524;8221
210400;202201;4673;13729;4112;13076;126;389;3701;11946;3827;12335
210405;202201;7528;19088;6149;17215;1055;2548;3714;11165;4769;13713
210407;202201;2165;6714;1841;6170;89;365;1470;4886;1559;5251
210408;202201;2785;9849;2589;9590;160;726;2091;7751;2251;8477
210409;202201;4068;13300;3699;12812;152;638;3096;10919;3248;11557
210410;202201;3715;10681;3147;9737;112;466;2550;7779;2662;8245
210420;202201;4029;12443;3603;11700;188;579;3039;9960;3227;10539
210430;202201;2337;6685;2068;6336;114;327;1750;5451;1864;5778
210440;202201;4593;11912;3989;11163;72;284;3665;10177;3737;10461
210450;202201;2426;6957;2084;6466;117;388;1723;5350;1840;5738
210455;202201;4790;12005;3678;10610;853;2460;1967;5983;2820;8443
210460;202201;3891;10873;3295;10103;75;321;2884;8816;2959;9137
210462;202201;1800;5193;1528;4776;59;185;1215;3827;1274;4012
210465;202201;2834;7972;2464;7465;121;515;2032;6026;2153;6541
210467;202201;6352;19038;5535;18000;272;1032;4703;15461;4975;16493
210470;202201;2039;5355;1526;4633;80;219;1199;3747;1279;3966
210480;202201;17821;50124;14860;46546;1535;3564;11019;37642;12554;41206
210490;202201;3733;9085;3000;8104;67;227;2577;6914;2644;7141
210500;202201;6602;24466;6092;23632;374;1821;5104;19684;5478;21505
210510;202201;6097;19571;5329;18757;122;544;4817;17189;4939;17733
210515;202201;3933;11179;3348;10478;197;656;2757;8834;2954;9490
210520;202201;2675;7545;2406;7190;88;337;2051;6081;2139;6418
210530;202201;55489;133691;43311;116185;7431;21453;15503;49429;22934;70882
210535;202201;3708;11418;3365;10926;123;498;2924;9519;3047;10017
210540;202201;15988;44057;13372;40394;1466;4079;9551;30187;11017;34266
210542;202201;7030;15911;5544;14254;488;997;4426;11898;4914;12895
210545;202201;2371;7068;2205;6812;46;200;1951;5974;1997;6174
210547;202201;3844;13165;3402;12381;222;882;2683;9901;2905;10783
210550;202201;6202;18342;4847;16187;411;1551;3374;11590;3785;13141
210560;202201;3963;11568;3508;10857;108;405;2998;9183;3106;9588
210565;202201;1558;4748;1297;4380;77;353;1021;3446;1098;3799
210570;202201;11222;29713;9977;28205;326;922;8877;25409;9203;26331
210580;202201;3227;8211;2564;7393;171;455;1812;5532;1983;5987
210590;202201;4461;12837;3878;12114;82;413;3488;10846;3570;11259
210592;202201;2775;7897;2550;7547;27;146;2215;6477;2242;6623
210594;202201;2657;6989;2078;6117;112;310;1562;4764;1674;5074
210596;202201;2942;9722;2625;9162;192;672;2074;7442;2266;8114
210598;202201;1940;5362;1788;5146;72;219;1569;4516;1641;4735
210600;202201;3176;8379;2613;7597;216;586;1856;5463;2072;6049
210610;202201;2961;7797;2524;7279;68;289;2202;6332;2270;6621
210620;202201;3022;7475;2488;6836;73;210;2220;6091;2293;6301
210630;202201;3288;10381;2965;9838;131;585;2463;8077;2594;8662
210632;202201;4960;14594;4375;13805;202;885;3641;11369;3843;12254
210635;202201;1812;6237;1710;6053;116;395;1380;4996;1496;5391
210637;202201;2685;8510;2295;7965;180;714;1735;6135;1915;6849
210640;202201;4840;16489;4534;16133;63;324;4217;15046;4280;15370
210650;202201;7565;21098;6849;20197;127;459;6142;18177;6269;18636
210660;202201;8534;24108;7659;22744;262;1085;6526;18997;6788;20082
210663;202201;2937;7807;2667;7500;183;362;2219;6498;2402;6860
210667;202201;2070;6522;1860;6223;52;188;1638;5571;1690;5759
210670;202201;5190;16136;4691;15369;112;515;4163;13583;4275;14098
210675;202201;5404;14024;4640;13082;350;827;3746;10947;4096;11774
210680;202201;5025;11457;4247;10559;122;208;3868;9712;3990;9920
210690;202201;7925;23587;6554;22048;305;1127;5788;19663;6093;20790
210700;202201;2894;7866;2314;7046;164;498;1708;5367;1872;5865
210710;202201;5337;15730;4721;14897;113;547;4219;13190;4332;13737
210720;202201;3241;10014;2849;9542;81;435;2541;8440;2622;8875
210725;202201;1395;4383;1215;4114;59;220;847;3003;906;3223
210730;202201;1356;3235;1151;2965;39;113;1007;2569;1046;2682
210735;202201;4948;13766;4212;12843;195;528;3644;11398;3839;11926
210740;202201;5451;13837;4689;12964;107;336;4044;11185;4151;11521
210745;202201;4650;12234;4289;11789;67;266;3928;10715;3995;10981
210750;202201;25191;63731;21928;59633;2376;5869;15306;43751;17682;49620
210760;202201;6171;15529;5153;14459;74;177;4857;13796;4931;13973
210770;202201;6561;16034;5663;15019;69;267;5331;14067;5400;14334
210780;202201;7913;23788;6899;22126;459;1514;5513;17803;5972;19317
210790;202201;4621;13788;4129;13148;193;448;3470;11424;3663;11872
210800;202201;5034;13245;4310;12293;78;329;3861;10912;3939;11241
210805;202201;4211;14603;3994;14285;158;666;3489;12518;3647;13184
210810;202201;5078;14337;4640;13781;381;919;3790;11649;4171;12568
210820;202201;7417;20464;6192;18545;648;1964;4012;12307;4660;14271
210825;202201;7466;21902;6710;20923;335;1027;5776;18355;6111;19382
210830;202201;8458;22628;7665;21692;445;1069;6610;19139;7055;20208
210840;202201;3324;8500;3008;8101;41;177;2713;7212;2754;7389
210845;202201;6720;17626;5943;16777;55;178;5662;16096;5717;16274
210850;202201;6419;20241;5255;18519;296;1273;4177;14831;4473;16104
210860;202201;22430;54313;18647;49744;1007;2230;15185;42291;16192;44521
210870;202201;7725;19163;6185;17440;144;427;5580;15731;5724;16158
210880;202201;4264;12789;3818;12248;171;732;3082;9833;3253;10565
210890;202201;4172;11571;3779;11130;324;742;3051;9284;3375;10026
210900;202201;5052;13986;3962;12061;1505;4733;853;3007;2358;7740
210905;202201;2182;5553;1837;5125;52;92;1682;4793;1734;4885
210910;202201;7493;22125;6207;20114;678;2283;4282;14001;4960;16284
210920;202201;3291;10425;2861;9866;86;434;2556;8739;2642;9173
210923;202201;1699;4740;1447;4358;94;305;1105;3320;1199;3625
210927;202201;5213;16430;4551;15637;476;1552;3387;12140;3863;13692
210930;202201;2652;8450;2323;7840;123;497;1852;6169;1975;6666
210940;202201;4088;11370;3795;11030;96;460;3481;9935;3577;10395
210945;202201;7383;19950;6590;19028;237;701;5642;16604;5879;17305
210950;202201;5561;14808;4313;13115;484;1178;3073;9960;3557;11138
210955;202201;1637;4849;1406;4486;314;921;800;2711;1114;3632
210960;202201;9771;27570;8487;25680;1604;4489;5293;17062;6897;21551
210970;202201;1481;4253;1205;3800;90;312;942;2928;1032;3240
210975;202201;1910;5561;1722;5275;131;423;1338;4116;1469;4539
210980;202201;10381;23432;9091;22103;95;230;8593;20971;8688;21201
210990;202201;18049;47809;13952;42602;1154;3108;10326;33029;11480;36137
211000;202201;15484;42741;12854;39506;1003;3062;9978;31849;10981;34911
211003;202201;6052;17014;5054;15825;148;529;4385;14053;4533;14582
211010;202201;6655;22669;5938;21771;117;539;5332;19842;5449;20381
211020;202201;8557;23933;7424;22662;222;819;6374;20066;6596;20885
211023;202201;2143;6667;1988;6466;83;322;1711;5527;1794;5849
211027;202201;3341;9907;3171;9650;193;563;2770;8495;2963;9058
211030;202201;3972;10736;3563;10234;272;683;2811;8296;3083;8979
211040;202201;4946;16820;4564;16182;123;659;4098;14459;4221;15118
211050;202201;9334;23592;8463;22484;142;493;7672;20365;7814;20858
211060;202201;7227;21189;6547;20277;163;706;5833;17980;5996;18686
211065;202201;2447;6346;2049;5859;93;249;1748;5074;1841;5323
211070;202201;8581;25192;7339;23383;348;1267;6175;19695;6523;20962
211080;202201;1380;3687;1116;3283;36;199;904;2532;940;2731
211085;202201;2281;6046;1922;5582;132;252;1604;4889;1736;5141
211090;202201;3297;8892;2970;8524;32;164;2759;7884;2791;8048
211100;202201;7009;17271;6489;16664;38;133;6079;15674;6117;15807
211102;202201;3381;10750;3079;10314;238;910;2534;8454;2772;9364
211105;202201;2487;7503;2084;6802;131;479;1566;5049;1697;5528
211107;202201;5051;15380;4314;14317;198;677;3400;11828;3598;12505
211110;202201;6466;16695;5115;14721;328;902;3938;11404;4266;12306
211120;202201;48015;113642;39693;103993;6160;14570;25691;71277;31851;85847
211125;202201;2141;6272;1806;5761;46;207;1538;4906;1584;5113
211130;202201;189094;437671;162803;404239;24173;52378;94452;254450;118625;306828
211140;202201;5209;14857;4569;14064;217;657;3869;12011;4086;12668
211150;202201;9969;25830;8396;23853;335;955;7122;20333;7457;21288
211153;202201;2612;7348;2104;6739;296;923;1400;4728;1696;5651
211157;202201;1265;3790;1071;3434;62;235;780;2488;842;2723
211160;202201;4746;12391;3766;11039;151;591;2973;8495;3124;9086
211163;202201;1635;5133;1485;4921;49;194;1313;4379;1362;4573
211167;202201;1710;5029;1593;4860;25;88;1480;4511;1505;4599
211170;202201;6952;16301;6455;15739;44;139;6156;14931;6200;15070
211172;202201;2751;7305;2400;6809;94;348;1954;5382;2048;5730
211174;202201;2955;8312;2681;8001;35;181;2529;7510;2564;7691
211176;202201;4480;12211;3509;10809;163;671;2880;8828;3043;9499
211178;202201;5380;11457;4620;10656;24;97;4477;10249;4501;10346
211180;202201;4367;13803;4010;13304;177;709;3354;11119;3531;11828
211190;202201;3254;9183;2750;8454;34;189;2485;7583;2519;7772
211195;202201;1504;4035;1283;3710;76;192;1078;3164;1154;3356
211200;202201;2304;6399;1842;5743;192;630;1306;4076;1498;4706
211210;202201;6406;19235;5761;18373;323;1257;4813;15294;5136;16551
211220;202201;40740;98279;33628;89720;2698;6953;25825;70041;28523;76994
211223;202201;5557;14264;4585;12990;392;1164;3339;9481;3731;10645
211227;202201;1819;5727;1605;5429;85;354;1270;4350;1355;4704
211230;202201;8572;23029;7344;21266;342;800;6144;18094;6486;18894
211240;202201;8106;25065;7613;24440;238;951;6932;22193;7170;23144
211245;202201;7464;18683;6543;17719;87;243;6212;16800;6299;17043
211250;202201;14218;42859;12841;40898;890;3143;10315;32901;11205;36044
211260;202201;8405;26244;7438;25005;202;942;6662;22504;6864;23446
211270;202201;10414;32395;8861;30355;413;1818;7189;24944;7602;26762
211280;202201;14202;35922;12799;34172;626;1453;11229;30458;11855;31911
211285;202201;2031;6217;1823;5947;123;438;1423;4724;1546;5162
211290;202201;7734;22583;6981;21591;263;944;5930;18368;6193;19312
211300;202201;7936;22448;6964;20888;393;1310;5528;16397;5921;17707
211400;202201;12417;33294;10163;30255;1189;3379;6870;21584;8059;24963
220005;202201;1998;4910;1817;4660;31;101;1555;3915;1586;4016
220010;202201;1541;4290;1262;3800;37;131;978;2926;1015;3057
220020;202201;4143;10535;3549;9727;109;386;3021;8194;3130;8580
220025;202201;2344;5141;2010;4663;30;82;1706;3845;1736;3927
220027;202201;1395;3314;1195;3050;26;93;1045;2621;1071;2714
220030;202201;3676;8789;3440;8486;108;286;3013;7369;3121;7655
220040;202201;7881;22927;6922;21167;1355;3816;3926;12543;5281;16359
220045;202201;1673;4680;1393;4237;29;145;1191;3543;1220;3688
220050;202201;4865;12846;4117;11902;65;308;3803;10899;3868;11207
220060;202201;2701;5301;2319;4864;19;49;2206;4603;2225;4652
220070;202201;2562;6266;2163;5708;72;164;1817;4767;1889;4931
220080;202201;788;2172;682;2025;21;82;590;1739;611;1821
220090;202201;1823;4255;1526;3834;113;151;1249;3275;1362;3426
220095;202201;769;1731;729;1691;30;46;651;1542;681;1588
220100;202201;1540;3972;1253;3544;30;121;1040;2835;1070;2956
220105;202201;2203;6460;1947;6004;114;400;1491;4566;1605;4966
220110;202201;3593;9648;3216;9023;41;205;2892;8012;2933;8217
220115;202201;2931;8104;2709;7827;77;230;2474;7139;2551;7369
220117;202201;1516;3461;1199;3034;7;28;1010;2498;1017;2526
220120;202201;14313;35838;13126;34415;81;342;12348;32260;12429;32602
220130;202201;1228;3099;1040;2847;13;65;942;2532;955;2597
220140;202201;2268;4563;1924;4169;54;139;1742;3734;1796;3873
220150;202201;6903;19266;6295;18251;147;594;5376;15331;5523;15925
220155;202201;1271;3494;1026;3060;27;97;741;2157;768;2254
220157;202201;1125;2634;951;2372;33;103;768;1873;801;1976
220160;202201;3023;8061;2594;7296;57;215;2098;5792;2155;6007
220170;202201;1696;4326;1442;3957;21;92;1272;3461;1293;3553
220173;202201;2334;6176;1887;5406;48;197;1481;4149;1529;4346
220177;202201;2180;5856;2074;5739;8;32;2052;5675;2060;5707
220180;202201;1196;2755;988;2427;6;29;787;1813;793;1842
220190;202201;7813;18210;6677;16710;379;925;5322;13567;5701;14492
220191;202201;1695;4816;1537;4554;83;292;1122;3251;1205;3543
220192;202201;2177;5546;1612;4583;44;153;1293;3613;1337;3766
220194;202201;1824;4991;1624;4688;47;168;1360;3891;1407;4059
220196;202201;2195;5465;1996;5174;30;139;1757;4464;1787;4603
220198;202201;1371;3531;1170;3280;9;24;1082;3059;1091;3083
220200;202201;5458;15349;4766;14456;79;362;4136;12525;4215;12887
220202;202201;2280;6170;1954;5652;35;171;1677;4765;1712;4936
220205;202201;2624;7336;2341;6833;63;247;1979;5695;2042;5942
220207;202201;808;2369;679;2150;57;202;463;1473;520;1675
220208;202201;1848;5396;1545;4862;157;509;998;3130;1155;3639
220209;202201;1697;4686;1473;4302;32;126;1220;3525;1252;3651
220210;202201;1915;4387;1675;4030;21;85;1472;3438;1493;3523
220211;202201;1821;4203;1673;4010;18;83;1479;3512;1497;3595
220213;202201;1938;4904;1684;4483;24;88;1383;3571;1407;3659
220217;202201;2420;6646;2268;6475;43;97;2106;6107;2149;6204
220220;202201;11739;28673;9923;26020;872;1788;6989;19187;7861;20975
220225;202201;1053;2689;867;2449;6;35;815;2278;821;2313
220230;202201;5951;14465;5087;13284;127;314;4435;11647;4562;11961
220240;202201;3321;9176;2908;8491;87;341;2427;7009;2514;7350
220245;202201;1930;4173;1450;3605;15;60;1321;3303;1336;3363
220250;202201;3177;8462;2790;7985;20;96;2619;7461;2639;7557
220253;202201;1771;4487;1527;4114;37;124;1314;3476;1351;3600
220255;202201;2113;4673;1827;4287;37;136;1601;3629;1638;3765
220260;202201;4961;14028;4322;12887;196;663;3454;10252;3650;10915
220265;202201;1521;4434;1382;4259;55;237;1175;3564;1230;3801
220270;202201;6218;19721;5877;19132;207;1101;4921;15542;5128;16643
220271;202201;1549;3892;1354;3620;21;92;1190;3149;1211;3241
220272;202201;1848;5173;1639;4790;61;210;1239;3503;1300;3713
220273;202201;1364;3699;1151;3325;49;180;877;2501;926;2681
220275;202201;2536;5568;2040;4913;41;83;1815;4367;1856;4450
220277;202201;2427;5675;2073;5189;43;123;1745;4288;1788;4411
220280;202201;1842;4003;1536;3622;32;76;1344;3126;1376;3202
220285;202201;1525;3666;1296;3398;10;42;1214;3157;1224;3199
220290;202201;7351;19353;5872;17340;422;1193;4341;13185;4763;14378
220300;202201;2136;5862;1722;5335;33;178;1439;4413;1472;4591
220310;202201;3304;8478;2612;7684;52;226;2248;6560;2300;6786
220320;202201;3267;9097;2544;7824;85;393;1995;5969;2080;6362
220323;202201;1770;4847;1388;4253;60;237;1157;3471;1217;3708
220325;202201;1305;3763;1116;3448;27;129;926;2808;953;2937
220327;202201;1693;4506;1491;4197;47;190;1233;3371;1280;3561
220330;202201;5036;11274;4310;10423;51;179;3952;9486;4003;9665
220335;202201;1770;5138;1606;4923;30;106;1444;4428;1474;4534
220340;202201;2015;5131;1548;4358;52;171;1044;2859;1096;3030
220342;202201;1265;3535;1141;3354;57;196;914;2666;971;2862
220345;202201;3262;7128;2500;6073;24;70;2257;5455;2281;5525
220350;202201;3559;8673;2858;7657;156;369;2072;5597;2228;5966
220360;202201;1324;3304;1054;2870;24;69;841;2267;865;2336
220370;202201;9220;25557;8422;24341;288;905;7192;20734;7480;21639
220375;202201;1719;4671;1520;4425;2;2;1454;4252;1456;4254
220380;202201;1606;3606;1332;3242;12;33;1182;2859;1194;2892
220385;202201;913;2083;751;1812;8;14;656;1563;664;1577
220390;202201;11717;28422;9247;24815;1886;4800;4255;12252;6141;17052
220400;202201;1622;3713;1247;3152;21;72;966;2349;987;2421
220410;202201;1236;3309;1020;2954;38;124;840;2406;878;2530
220415;202201;878;2185;739;1959;19;47;596;1562;615;1609
220420;202201;2109;5719;1706;4970;58;215;1308;3723;1366;3938
220430;202201;2817;6886;2561;6533;50;159;2283;5736;2333;5895
220435;202201;1942;4737;1671;4339;36;124;1425;3621;1461;3745
220440;202201;2828;7885;2415;7283;64;316;2126;6221;2190;6537
220450;202201;2715;6766;2220;6158;51;194;1939;5369;1990;5563
220455;202201;1358;4091;1301;4014;16;82;1179;3635;1195;3717
220460;202201;1099;2562;1025;2470;32;79;891;2122;923;2201
220465;202201;2559;7463;2257;7008;149;463;1778;5606;1927;6069
220470;202201;3935;10254;3519;9590;162;402;2813;7614;2975;8016
220480;202201;3006;7369;2449;6523;199;429;1707;4539;1906;4968
220490;202201;2599;6274;2247;5840;31;144;1959;5023;1990;5167
220500;202201;3414;7938;2920;7215;127;249;2228;5479;2355;5728
220510;202201;2831;7392;2294;6459;105;259;1844;5234;1949;5493
220515;202201;1795;4131;1663;3953;28;55;1472;3455;1500;3510
220520;202201;5378;13334;4869;12638;104;284;4189;10920;4293;11204
220525;202201;1552;3619;1327;3347;10;46;1225;3072;1235;3118
220527;202201;1467;3757;1283;3501;25;82;1130;3097;1155;3179
220530;202201;1621;3760;1389;3472;41;101;1259;3158;1300;3259
220535;202201;884;2308;825;2221;39;119;667;1774;706;1893
220540;202201;3442;10472;3205;10021;163;540;2664;8325;2827;8865
220545;202201;1556;4406;1427;4211;53;218;1223;3562;1276;3780
220550;202201;9175;27402;8207;25713;421;1541;6324;19519;6745;21060
220551;202201;1524;4047;1364;3799;25;106;1121;3060;1146;3166
220552;202201;1784;4908;1440;4308;25;136;1167;3371;1192;3507
220553;202201;1993;4680;1662;4257;36;76;1451;3754;1487;3830
220554;202201;990;2405;755;2043;47;121;542;1443;589;1564
220555;202201;2696;7164;2351;6737;44;182;1995;5851;2039;6033
220556;202201;1318;3623;1162;3340;41;175;891;2467;932;2642
220557;202201;1844;5314;1534;4662;103;360;1097;3247;1200;3607
220558;202201;1515;3797;1201;3365;19;87;1028;2834;1047;2921
220559;202201;1913;4544;1629;4114;35;63;1335;3386;1370;3449
220560;202201;1902;4075;1576;3677;30;69;1447;3387;1477;3456
220570;202201;8060;22605;7364;21647;397;1156;6070;17909;6467;19065
220580;202201;7306;19062;6633;18030;99;289;5976;16188;6075;16477
220585;202201;2218;6628;1838;5966;34;128;1543;5005;1577;5133
220590;202201;1527;3870;1253;3479;85;219;947;2651;1032;2870
220595;202201;2877;7344;2620;7017;34;125;2343;6235;2377;6360
220600;202201;1629;3323;1394;3053;26;49;1262;2755;1288;2804
220605;202201;1661;4703;1433;4310;26;141;1170;3405;1196;3546
220610;202201;2881;8158;2698;7893;22;120;2534;7387;2556;7507
220620;202201;8518;24736;7806;23784;142;725;7164;21607;7306;22332
220630;202201;398;1139;309;985;20;69;210;654;230;723
220635;202201;1944;5519;1737;5104;38;182;1409;4006;1447;4188
220640;202201;2534;6836;2173;6345;72;287;1793;5176;1865;5463
220650;202201;2355;6017;2043;5558;64;175;1646;4493;1710;4668
220660;202201;2700;8193;2289;7532;73;340;1898;6158;1971;6498
220665;202201;1326;3853;1123;3528;35;166;949;2913;984;3079
220667;202201;1731;5072;1561;4775;60;228;1278;3866;1338;4094
220669;202201;1741;4963;1667;4852;45;180;1500;4281;1545;4461
220670;202201;2352;5782;1880;5135;25;106;1636;4453;1661;4559
220672;202201;3477;8191;2840;7434;75;292;2566;6622;2641;6914
220675;202201;1395;3640;1248;3386;38;92;1017;2759;1055;2851
220680;202201;2967;7523;2825;7340;136;250;2536;6739;2672;6989
220690;202201;1677;4238;1473;3934;79;226;1154;3073;1233;3299
220695;202201;990;2602;925;2489;17;46;810;2159;827;2205
220700;202201;11491;25985;9367;23197;430;1024;7295;17852;7725;18876
220710;202201;971;2510;731;2088;24;81;559;1545;583;1626
220720;202201;2289;5156;2066;4867;24;91;1840;4261;1864;4352
220730;202201;1383;3719;1185;3412;21;99;1007;2837;1028;2936
220735;202201;1071;2350;836;2001;28;66;681;1598;709;1664
220740;202201;1467;3611;1177;3232;38;103;984;2741;1022;2844
220750;202201;4238;10028;3747;9349;101;308;3419;8433;3520;8741
220755;202201;1528;3466;1278;3106;21;74;1067;2527;1088;2601
220760;202201;3399;8619;2976;8063;55;189;2779;7530;2834;7719
220770;202201;26258;73829;22520;67715;5769;17592;9617;30456;15386;48048
220775;202201;1281;3063;1141;2892;8;31;1102;2773;1110;2804
220777;202201;1714;4171;1340;3612;73;157;1001;2766;1074;2923
220779;202201;1325;3344;1149;3087;28;95;989;2619;1017;2714
220780;202201;6363;14914;5496;13662;232;677;4454;10888;4686;11565
220785;202201;1609;3388;1426;3160;9;27;1368;3010;1377;3037
220790;202201;11014;29572;9923;28042;216;962;8467;23649;8683;24611
220793;202201;1019;2513;818;2178;12;20;686;1841;698;1861
220795;202201;1499;3672;1331;3457;25;85;1173;3044;1198;3129
220800;202201;20672;43225;17738;39433;955;1819;13958;30887;14913;32706
220810;202201;3232;8597;2729;7750;51;149;2278;6418;2329;6567
220820;202201;5576;13611;4888;12626;305;641;3840;10024;4145;10665
220830;202201;7729;19473;6922;18349;263;809;5758;15036;6021;15845
220840;202201;13328;37956;11272;34044;2197;6152;6088;18941;8285;25093
220850;202201;3324;9857;2980;9434;68;299;2675;8486;2743;8785
220855;202201;792;1829;695;1707;14;55;632;1534;646;1589
220860;202201;1140;2669;1000;2462;19;71;923;2240;942;2311
220865;202201;2530;6512;1966;5536;62;259;1483;4038;1545;4297
220870;202201;3359;8566;2791;7839;35;155;2567;7191;2602;7346
220880;202201;5781;13004;4998;12047;60;239;4645;11062;4705;11301
220885;202201;1532;4260;1268;3851;72;212;985;3041;1057;3253
220887;202201;1674;3456;1408;3122;15;30;1308;2887;1323;2917
220890;202201;1471;4277;1284;4024;52;172;1066;3377;1118;3549
220900;202201;2166;4894;1815;4446;34;82;1604;3901;1638;3983
220910;202201;1699;4303;1452;3945;90;197;1185;3277;1275;3474
220915;202201;1034;2660;840;2326;17;66;624;1663;641;1729
220920;202201;1583;4628;1369;4357;77;282;1139;3648;1216;3930
220930;202201;1947;4891;1626;4459;15;61;1524;4150;1539;4211
220935;202201;1155;3237;945;2791;22;98;615;1725;637;1823
220937;202201;1621;4050;1390;3690;29;105;1123;2923;1152;3028
220940;202201;1727;4472;1400;3914;29;135;1130;3076;1159;3211
220945;202201;535;1688;428;1493;19;102;311;1068;330;1170
220950;202201;1486;3332;1008;2628;20;60;796;2002;816;2062
220955;202201;1708;4197;1427;3728;19;70;1237;3186;1256;3256
220960;202201;834;2058;617;1696;34;111;430;1122;464;1233
220965;202201;1918;4958;1675;4612;32;147;1450;3916;1482;4063
220970;202201;2138;4813;1595;4028;23;68;1367;3400;1390;3468
220975;202201;734;1939;632;1818;13;75;562;1571;575;1646
220980;202201;1237;3318;1101;3138;30;116;938;2644;968;2760
220985;202201;1432;3434;1250;3170;51;129;1041;2586;1092;2715
220987;202201;1584;4464;1403;4157;58;216;1157;3371;1215;3587
220990;202201;1768;4755;1548;4429;22;114;1311;3704;1333;3818
220995;202201;1285;3505;1064;3107;27;90;826;2395;853;2485
220997;202201;2503;7297;2305;6983;58;232;2050;6143;2108;6375
221000;202201;4793;12542;4204;11708;94;395;3627;10004;3721;10399
221005;202201;1592;3960;1443;3711;21;100;1254;3134;1275;3234
221010;202201;1357;2861;1065;2504;14;32;932;2157;946;2189
221020;202201;1657;4847;1501;4585;28;118;1178;3571;1206;3689
221030;202201;1748;4074;1495;3770;29;87;1302;3340;1331;3427
221035;202201;1664;4069;1450;3784;21;29;1300;3447;1321;3476
221037;202201;771;1986;648;1782;9;44;488;1263;497;1307
221038;202201;556;1497;429;1277;21;65;296;876;317;941
221039;202201;913;2421;768;2186;30;130;613;1691;643;1821
221040;202201;4646;12814;4064;11832;178;537;3324;9680;3502;10217
221050;202201;4324;10478;3851;9887;68;237;3527;8996;3595;9233
221060;202201;9568;25599;7938;22960;369;973;6305;18418;6674;19391
221062;202201;1207;3718;1046;3465;38;180;849;2770;887;2950
221063;202201;1193;3098;1036;2877;57;201;834;2264;891;2465
221065;202201;2824;6965;2476;6386;18;64;2180;5554;2198;5618
221070;202201;3633;10719;2955;9327;349;1064;1843;5926;2192;6990
221080;202201;3756;8842;3098;7870;57;199;2584;6445;2641;6644
221090;202201;1491;3643;1234;3248;15;63;1058;2735;1073;2798
221093;202201;1601;4141;1476;3909;131;284;1074;2825;1205;3109
221095;202201;942;2374;801;2167;16;56;677;1798;693;1854
221097;202201;907;2247;693;1885;19;61;521;1341;540;1402
221100;202201;130985;331850;110392;298698;8902;27276;76599;200370;85501;227646
221110;202201;10504;29941;9623;28802;160;791;8736;25922;8896;26713
221120;202201;5090;13755;4544;12944;128;410;3999;11409;4127;11819
221130;202201;6074;14608;4717;12163;688;1718;2797;7055;3485;8773
221135;202201;1993;4711;1778;4444;43;110;1579;3986;1622;4096
221140;202201;1474;3251;1244;2968;16;60;1130;2642;1146;2702
221150;202201;1163;2807;923;2406;30;132;718;1755;748;1887
221160;202201;773;1859;684;1746;35;60;546;1419;581;1479
221170;202201;1060;2895;972;2742;10;42;856;2367;866;2409
230010;202201;3277;8209;2704;7256;40;146;2244;5858;2284;6004
230015;202201;3370;10317;2980;9557;146;575;2138;6812;2284;7387
230020;202201;13780;42044;12925;40814;416;1798;11226;35210;11642;37008
230030;202201;13605;32791;11426;29992;237;724;9942;26053;10179;26777
230040;202201;4814;11833;3998;10536;58;252;3392;8788;3450;9040
230050;202201;2836;8538;2205;7144;283;928;1069;3327;1352;4255
230060;202201;2560;6684;2055;5809;37;151;1648;4556;1685;4707
230070;202201;4596;11219;3699;9661;288;748;2554;6642;2842;7390
230075;202201;9704;29575;8867;28156;541;1990;7020;22107;7561;24097
230080;202201;3262;6625;2489;5694;5;16;2300;5264;2305;5280
230090;202201;4816;11197;4077;10054;175;447;3352;8163;3527;8610
230100;202201;20672;49794;18125;46527;1282;3385;13435;34400;14717;37785
230110;202201;13493;38604;11351;34550;1550;4830;6392;19413;7942;24243
230120;202201;8441;21415;7401;19804;425;1166;5713;15168;6138;16334
230125;202201;3404;8619;2765;7649;95;350;2179;5865;2274;6215
230130;202201;6183;17911;5080;15611;416;1277;3438;10466;3854;11743
230140;202201;3663;10587;3117;9516;99;462;2411;7125;2510;7587
230150;202201;1759;4991;1470;4395;177;495;923;2790;1100;3285
230160;202201;7021;17029;6072;15658;126;446;5214;13200;5340;13646
230170;202201;6904;18685;5682;16286;413;1120;4010;11354;4423;12474
230180;202201;1769;4685;1497;4175;19;94;1231;3316;1250;3410
230185;202201;4752;12798;4048;11663;277;876;3036;8761;3313;9637
230190;202201;15204;42669;12841;38400;1241;3957;8077;23759;9318;27716
230195;202201;5896;16366;5396;15507;340;978;4173;11941;4513;12919
230200;202201;5276;14060;4428;12540;184;591;3410;9460;3594;10051
230205;202201;4772;12684;4185;11858;218;724;3333;9258;3551;9982
230210;202201;11296;25392;9580;23179;417;1131;7652;18160;8069;19291
230220;202201;15325;36954;13470;34387;619;1696;11172;28152;11791;29848
230230;202201;7531;20876;6762;19386;406;1188;5212;14779;5618;15967
230240;202201;14016;35690;12085;32479;301;1296;10012;26141;10313;27437
230250;202201;9481;25352;8776;24301;235;854;7190;19297;7425;20151
230260;202201;16106;44580;14000;41042;2096;5948;8169;24358;10265;30306
230270;202201;8201;20878;6353;17577;661;1695;4026;11390;4687;13085
230280;202201;21363;54746;17652;48746;467;2029;14020;37149;14487;39178
230290;202201;5275;13963;4381;12341;194;561;3437;9551;3631;10112
230300;202201;5286;13287;4789;12620;97;291;4251;11160;4348;11451
230310;202201;5069;13870;4292;12520;171;606;3074;8782;3245;9388
230320;202201;8372;23300;7024;20935;253;1055;5469;15907;5722;16962
230330;202201;5097;13260;4056;11350;131;490;3112;8454;3243;8944
230340;202201;4069;12057;3517;10978;194;714;2555;7786;2749;8500
230350;202201;19585;50713;17145;47259;857;2837;12220;33435;13077;36272
230360;202201;3223;8096;2559;6979;137;416;1848;4938;1985;5354
230365;202201;3264;7728;2690;6898;55;249;2323;5849;2378;6098
230370;202201;66940;172943;57669;159967;5458;16203;40164;110253;45622;126456
230380;202201;6810;17998;5412;15505;143;569;4049;11253;4192;11822
230390;202201;3683;10262;3183;9478;97;409;2506;7336;2603;7745
230393;202201;3678;10127;2931;8657;105;557;2293;6461;2398;7018
230395;202201;6134;16226;5306;14876;427;1184;3674;10329;4101;11513
230400;202201;6033;15577;5356;14538;100;481;4371;11469;4471;11950
230410;202201;14215;40827;11771;36499;898;3063;8212;25532;9110;28595
230420;202201;31588;82578;26089;73546;2640;7866;15851;44044;18491;51910
230423;202201;5105;14474;4480;13295;262;863;3379;9879;3641;10742
230425;202201;6199;18139;5709;17206;485;1533;4124;12326;4609;13859
230426;202201;2992;7522;2218;6092;45;178;1678;4494;1723;4672
230427;202201;2010;5372;1490;4352;109;368;909;2511;1018;2879
230428;202201;10784;27473;9324;25388;1373;3687;5556;14996;6929;18683
230430;202201;5223;14081;4153;12263;152;581;3146;9095;3298;9676
230435;202201;6784;16462;5679;14602;651;1575;3582;9185;4233;10760
230440;202201;468845;1097433;396595;996673;28462;78956;282145;693322;310607;772278
230445;202201;4482;11607;3664;10225;198;583;2517;6827;2715;7410
230450;202201;3885;10620;3396;9933;200;844;2571;7244;2771;8088
230460;202201;2268;6049;1971;5587;56;229;1662;4646;1718;4875
230465;202201;4558;12041;3856;10729;134;487;2960;7901;3094;8388
230470;202201;11995;37836;10810;35732;823;3284;7832;25428;8655;28712
230480;202201;1582;4402;1320;3940;72;310;989;2813;1061;3123
230490;202201;2894;7660;2466;6888;190;623;1620;4251;1810;4874
230495;202201;6297;17324;5560;16073;654;1876;3509;10245;4163;12121
230500;202201;9830;30312;8701;28313;311;1293;7071;22987;7382;24280
230510;202201;1793;4925;1434;4215;158;492;825;2352;983;2844
230520;202201;5145;13399;4462;12266;401;979;3167;8706;3568;9685
230523;202201;16746;47464;13530;40988;2932;8801;4062;12728;6994;21529
230526;202201;4144;10982;3542;10019;206;607;2631;7495;2837;8102
230530;202201;5967;17846;5037;16127;714;2304;3281;10546;3995;12850
230533;202201;5024;10999;4094;9608;76;211;3485;8003;3561;8214
230535;202201;5534;14976;4694;13598;342;1089;3169;9194;3511;10283
230540;202201;16705;44231;14352;40800;349;1285;11870;33497;12219;34782
230550;202201;23280;58154;18918;51077;1402;3972;12915;34234;14317;38206
230560;202201;8377;19882;6800;17483;89;308;5842;14922;5931;15230
230565;202201;3276;8772;2737;7802;123;465;2134;5959;2257;6424
230570;202201;3606;8919;3073;8197;85;272;2523;6681;2608;6953
230580;202201;12339;29820;10632;27454;459;1057;8745;22656;9204;23713
230590;202201;9969;26939;8326;24062;521;1672;6165;17412;6686;19084
230600;202201;4109;9843;3244;8392;145;339;2198;5755;2343;6094
230610;202201;7250;18964;6444;17647;383;1133;5222;14159;5605;15292
230620;202201;2251;5817;1782;4958;101;329;1149;3069;1250;3398
230625;202201;9450;24857;8090;22510;1898;5366;3418;9552;5316;14918
230630;202201;12398;33443;10921;30753;1080;2830;7436;21072;8516;23902
230640;202201;29406;85333;26666;81049;1154;4842;21817;64971;22971;69813
230650;202201;5728;14614;4847;13160;122;532;4024;10563;4146;11095
230655;202201;9817;31758;9242;30820;583;2147;7667;25607;8250;27754
230660;202201;6354;18298;5156;16223;181;918;4152;12794;4333;13712
230670;202201;6605;15009;4834;12289;145;415;3838;9507;3983;9922
230680;202201;2931;7591;2468;6800;129;333;1807;4963;1936;5296
230690;202201;7618;21587;6536;19571;409;1420;4305;12657;4714;14077
230700;202201;11246;27039;9148;23345;439;1121;6872;17163;7311;18284
230710;202201;7283;22136;6400;20331;552;1802;4444;14012;4996;15814
230720;202201;2064;5811;1711;5165;97;326;1223;3599;1320;3925
230725;202201;4665;12925;4201;12158;371;1185;2800;7963;3171;9148
230730;202201;63762;161690;50642;142765;11246;31639;19054;57594;30300;89233
230740;202201;6522;17502;5510;15896;180;606;4429;12744;4609;13350
230750;202201;9042;23167;7538;20739;178;676;6053;16203;6231;16879
230760;202201;12167;30418;10612;28137;421;1437;8175;21056;8596;22493
230763;202201;5357;13829;4461;12302;116;538;3625;9643;3741;10181
230765;202201;44193;114170;37106;103348;4534;13473;21620;58877;26154;72350
230770;202201;28700;65096;24278;59499;1847;4585;17981;43567;19828;48152
230780;202201;6887;23114;6281;21717;787;2754;3838;13541;4625;16295
230790;202201;3254;8858;2925;8354;115;491;2287;6294;2402;6785
230800;202201;9084;27062;8010;25001;991;3225;4857;14885;5848;18110
230810;202201;11752;34173;10553;32288;448;1684;8355;25139;8803;26823
230820;202201;3848;11755;3210;10437;266;1073;2077;6411;2343;7484
230830;202201;8095;21144;6900;19241;137;589;5731;15535;5868;16124
230835;202201;4499;10326;3522;8852;108;311;2839;7018;2947;7329
230837;202201;3486;9802;3130;9222;99;416;2566;7376;2665;7792
230840;202201;10306;28429;8908;26101;746;2165;6636;19384;7382;21549
230850;202201;10587;28774;8938;25720;422;1399;6700;18948;7122;20347
230860;202201;5989;14082;4984;12686;70;205;4391;11060;4461;11265
230870;202201;17564;40791;15171;36958;483;1309;12480;29820;12963;31129
230880;202201;2230;6459;2050;6184;58;281;1634;4796;1692;5077
230890;202201;4777;14662;4367;13915;289;1017;3291;10350;3580;11367
230900;202201;3372;9128;2933;8351;157;549;2100;5751;2257;6300
230910;202201;3478;8814;2785;7785;70;276;2251;6290;2321;6566
230920;202201;5215;13745;4348;12395;114;456;3440;9561;3554;10017
230930;202201;7341;19504;6091;17340;304;874;4240;11963;4544;12837
230940;202201;8814;21147;7685;19498;163;431;6578;16550;6741;16981
230945;202201;7041;19211;6040;17417;292;1027;4381;12279;4673;13306
230950;202201;6647;16023;5895;15026;124;327;5097;13011;5221;13338
230960;202201;14519;39652;12784;36549;1950;5638;6784;19151;8734;24789
230970;202201;15714;39551;13391;36112;1236;3486;8985;23837;10221;27323
230980;202201;3033;8160;2673;7565;279;727;1862;5387;2141;6114
230990;202201;1776;4796;1467;4208;74;296;1058;2897;1132;3193
231000;202201;2748;7054;2223;6067;72;230;1671;4389;1743;4619
231010;202201;4018;8735;3185;7390;23;112;2830;6381;2853;6493
231020;202201;9133;26188;8159;24441;1054;2995;5321;16214;6375;19209
231025;202201;8308;21254;7295;19658;566;1480;5536;14898;6102;16378
231030;202201;7908;22545;6290;19301;837;2550;3560;10880;4397;13430
231040;202201;3238;8606;2805;7842;95;313;2274;6188;2369;6501
231050;202201;12885;31020;10676;27313;488;1336;8284;20593;8772;21929
231060;202201;3098;8366;2754;7838;59;208;2319;6558;2378;6766
231070;202201;8676;23792;7508;21804;566;1859;5274;15012;5840;16871
231080;202201;4204;11390;3551;10343;158;650;2701;7703;2859;8353
231085;202201;7385;17045;5915;15364;209;520;4768;12398;4977;12918
231090;202201;4799;12060;3582;9794;136;508;2475;6512;2611;7020
231095;202201;2387;6834;1913;5870;183;565;1283;3923;1466;4488
231100;202201;3375;9401;2790;8336;120;473;2118;6231;2238;6704
231110;202201;4028;11175;3711;10614;171;546;2825;7913;2996;8459
231120;202201;2543;6981;2132;6294;101;338;1577;4613;1678;4951
231123;202201;2041;5114;1700;4542;91;264;1228;3237;1319;3501
231126;202201;5977;15645;4937;13747;279;740;3589;9907;3868;10647
231130;202201;23741;56771;19780;51918;1110;3563;15179;39057;16289;42620
231135;202201;4436;12016;3675;10598;185;630;2626;7465;2811;8095
231140;202201;17954;48386;14622;42921;702;2740;10698;30548;11400;33288
231150;202201;6463;16689;4780;13534;679;1948;2098;6079;2777;8027
231160;202201;6755;20014;6027;18705;604;1824;3774;11927;4378;13751
231170;202201;4974;13506;4170;12026;250;826;2988;8289;3238;9115
231180;202201;16020;42969;13216;37424;2359;6674;6429;18074;8788;24748
231190;202201;4312;11538;3536;10191;98;381;2736;7734;2834;8115
231195;202201;5493;15575;4577;13779;295;987;3377;10038;3672;11025
231200;202201;8404;24397;7359;22436;197;986;5946;17536;6143;18522
231210;202201;5240;14555;4460;13263;166;666;3488;10109;3654;10775
231220;202201;13935;33364;11095;28292;449;1233;8338;20489;8787;21722
231230;202201;9785;30042;8653;28007;650;2363;6391;20663;7041;23026
231240;202201;12636;35208;11218;32677;1432;4176;7260;21106;8692;25282
231250;202201;2258;5512;1524;3975;95;237;929;2352;1024;2589
231260;202201;3489;9279;3050;8604;276;697;2143;6183;2419;6880
231270;202201;6829;17093;5551;15051;169;641;4215;11083;4384;11724
231280;202201;1887;5569;1702;5249;92;291;1295;3961;1387;4252
231290;202201;40167;115162;33902;103402;4662;14746;17817;53170;22479;67916
231300;202201;4467;11748;3532;9957;124;427;2476;6750;2600;7177
231310;202201;8160;19928;6553;17081;478;1310;4620;11733;5098;13043
231320;202201;8020;21431;6302;18448;126;518;4969;14413;5095;14931
231325;202201;2692;6604;2233;5950;150;341;1633;4385;1783;4726
231330;202201;10719;29939;9042;26783;1467;3924;5319;16358;6786;20282
231335;202201;5937;15264;5019;13833;84;386;4395;11984;4479;12370
231340;202201;19962;57595;18062;54407;1133;3570;13932;42217;15065;45787
231350;202201;16802;44341;15371;42320;274;1067;13896;37916;14170;38983
231355;202201;4800;13452;4339;12627;200;685;3488;9964;3688;10649
231360;202201;8424;24061;7318;22232;313;1078;5830;17559;6143;18637
231370;202201;2300;6123;1855;5347;46;149;1419;4061;1465;4210
231375;202201;4437;13384;4067;12794;106;478;3460;10766;3566;11244
231380;202201;6351;16554;5733;15715;185;550;4777;13137;4962;13687
231390;202201;3712;10238;3321;9592;124;517;2525;7051;2649;7568
231395;202201;4501;12399;3776;11288;280;851;2599;7690;2879;8541
231400;202201;10348;28695;8674;25680;324;1376;6641;19182;6965;20558
231410;202201;16154;47086;14798;44976;716;2364;12084;36647;12800;39011
240010;202201;2797;7002;2210;5989;285;752;1206;3249;1491;4001
240020;202201;13863;36741;11642;32927;764;2510;7847;21813;8611;24323
240030;202201;3427;7611;3078;7108;106;300;2716;6162;2822;6462
240040;202201;879;2448;742;2201;26;108;504;1421;530;1529
240050;202201;3639;9354;2920;8073;57;194;2249;6071;2306;6265
240060;202201;1531;3878;1247;3369;25;96;1009;2653;1034;2749
240070;202201;2638;7035;2349;6449;171;496;1723;4591;1894;5087
240080;202201;3144;8112;2522;7041;90;319;1873;5152;1963;5471
240090;202201;2403;5739;1963;5017;23;64;1650;4147;1673;4211
240100;202201;11390;26373;9188;22658;207;696;7364;17447;7571;18143
240110;202201;4852;13264;4081;11882;169;660;3056;8657;3225;9317
240120;202201;3644;9769;3025;9004;210;664;2219;6647;2429;7311
240130;202201;4137;8044;3384;7087;31;75;3064;6349;3095;6424
240140;202201;1938;5632;1654;5114;177;607;1111;3391;1288;3998
240145;202201;7182;19120;5883;16956;757;2279;3651;10496;4408;12775
240150;202201;1053;2876;923;2621;57;192;724;2003;781;2195
240160;202201;1570;4494;1314;4023;35;145;1004;3067;1039;3212
240165;202201;1033;2707;867;2403;24;100;727;1962;751;2062
240170;202201;2950;7394;2503;6639;267;706;1656;4361;1923;5067
240180;202201;3262;9311;2653;8111;584;1723;1234;3944;1818;5667
240185;202201;1341;4021;1239;3848;48;184;1053;3237;1101;3421
240190;202201;1170;3179;998;2915;19;85;825;2420;844;2505
240200;202201;12304;29473;9953;25629;1039;2744;5962;15013;7001;17757
240210;202201;3532;8287;2869;7237;44;209;2448;5948;2492;6157
240220;202201;7800;22818;7019;21624;410;1585;5595;17091;6005;18676
240230;202201;6243;15201;4985;13170;208;556;3904;10342;4112;10898
240240;202201;1918;5340;1297;3983;141;451;454;1254;595;1705
240250;202201;3235;8024;2806;7430;58;218;2449;6385;2507;6603
240260;202201;14400;41646;12477;38523;2760;8125;6781;22123;9541;30248
240270;202201;2587;7248;2244;6685;114;364;1679;5087;1793;5451
240280;202201;1815;4470;1512;3982;67;194;1190;3092;1257;3286
240290;202201;1258;3536;1030;3070;34;154;740;2081;774;2235
240300;202201;2455;6052;1802;4902;97;285;1117;2976;1214;3261
240310;202201;9009;23182;7173;20002;870;2478;3855;10580;4725;13058
240320;202201;2162;5675;1592;4598;71;254;1129;3125;1200;3379
240325;202201;35405;89574;28840;78799;4099;11893;15317;40971;19416;52864
240330;202201;1936;5056;1501;4261;57;208;1059;2884;1116;3092
240340;202201;2186;4720;1782;4135;40;114;1494;3359;1534;3473
240350;202201;2485;5890;2212;5583;33;109;2049;5161;2082;5270
240360;202201;10861;28413;9694;26656;1139;2960;6555;18359;7694;21319
240370;202201;2255;5407;1746;4463;91;251;1242;3040;1333;3291
240375;202201;993;2413;827;2136;26;95;660;1641;686;1736
240380;202201;2401;6503;1850;5355;155;425;1057;3017;1212;3442
240390;202201;1103;2573;804;2030;31;71;521;1218;552;1289
240400;202201;1622;3781;1236;3143;35;138;888;2104;923;2242
240410;202201;619;1757;512;1555;44;154;331;965;375;1119
240420;202201;5011;16449;4459;15353;425;1827;2892;9650;3317;11477
240430;202201;3771;9164;3137;8103;128;449;2444;6086;2572;6535
240440;202201;2771;5958;2377;5414;136;280;1940;4394;2076;4674
240450;202201;4769;12523;3798;10790;354;1155;2266;6173;2620;7328
240460;202201;3530;9028;3167;8470;217;616;2612;6974;2829;7590
240470;202201;3788;11118;2886;9267;475;1445;1485;4945;1960;6390
240480;202201;631;1645;426;1208;24;65;218;588;242;653
240485;202201;2350;6266;1897;5483;131;375;1316;3831;1447;4206
240490;202201;1721;4193;1348;3543;74;175;981;2576;1055;2751
240500;202201;2239;5936;1940;5433;103;291;1546;4332;1649;4623
240510;202201;1772;4587;1528;4221;74;236;1228;3348;1302;3584
240520;202201;1684;3774;1284;3240;92;194;956;2489;1048;2683
240530;202201;2518;6516;2263;6123;74;240;1913;5068;1987;5308
240540;202201;2479;5899;2192;5472;57;157;1923;4782;1980;4939
240550;202201;799;2059;714;1910;15;60;620;1623;635;1683
240560;202201;3485;8552;2966;7876;196;504;2306;6157;2502;6661
240570;202201;2981;7554;2044;5591;297;817;768;1985;1065;2802
240580;202201;8728;24651;7702;22854;572;1681;6153;18361;6725;20042
240590;202201;865;1991;759;1827;9;22;616;1452;625;1474
240600;202201;1941;5020;1451;4057;58;185;988;2642;1046;2827
240610;202201;4746;11866;4092;10747;156;471;3173;8123;3329;8594
240615;202201;1365;3374;1097;2927;96;253;788;2054;884;2307
240620;202201;1946;5206;1670;4753;85;272;1360;3855;1445;4127
240630;202201;2323;5965;2090;5594;239;452;1475;4156;1714;4608
240640;202201;1012;2584;803;2244;24;94;602;1636;626;1730
240650;202201;4391;11930;3743;10647;248;744;2742;7713;2990;8457
240660;202201;3355;8078;3002;7631;54;179;2764;6976;2818;7155
240670;202201;2709;7116;2182;6102;141;451;1484;4015;1625;4466
240680;202201;1715;4318;1388;3776;49;162;1065;2793;1114;2955
240690;202201;1174;2736;928;2331;24;95;753;1810;777;1905
240700;202201;2620;7316;2131;6440;89;329;1634;4870;1723;5199
240710;202201;18112;44024;15429;39691;1393;3724;10754;27108;12147;30832
240720;202201;5682;13466;4891;12370;487;1187;3487;8837;3974;10024
240725;202201;1214;3323;934;2804;43;139;637;1856;680;1995
240730;202201;2443;6482;1959;5571;63;211;1496;4189;1559;4400
240740;202201;2037;5315;1646;4551;60;216;1169;3055;1229;3271
240750;202201;2412;7501;2044;6720;246;889;1186;3922;1432;4811
240760;202201;1813;3936;1316;3206;74;107;1036;2555;1110;2662
240770;202201;3499;9230;2940;8459;126;441;2422;6900;2548;7341
240780;202201;5095;13691;4255;12330;533;1524;2789;8187;3322;9711
240790;202201;954;2560;783;2263;23;101;597;1662;620;1763
240800;202201;54954;125046;43515;108410;5168;12784;25270;61955;30438;74739
240810;202201;100775;246880;86687;224932;7764;21729;60905;154338;68669;176067
240820;202201;6369;18072;5574;16676;664;2010;3630;11007;4294;13017
240830;202201;9257;25533;8187;23941;330;1240;6684;19358;7014;20598
240840;202201;1152;2782;935;2457;27;82;665;1692;692;1774
240850;202201;1547;4027;1102;3111;90;262;624;1686;714;1948
240860;202201;1459;3712;1108;3105;17;77;868;2330;885;2407
240870;202201;1156;2819;880;2363;114;289;520;1423;634;1712
240880;202201;1380;4206;1205;3871;96;376;898;2836;994;3212
240890;202201;4939;12791;3871;10868;440;1368;2154;5740;2594;7108
240895;202201;3116;9075;2845;8644;252;726;2248;7004;2500;7730
240910;202201;3764;9652;3188;8667;66;240;2623;6953;2689;7193
240920;202201;1083;2644;871;2325;71;144;550;1496;621;1640
240930;202201;3882;8503;3206;7672;205;329;2392;6050;2597;6379
240933;202201;1747;4159;1473;3776;42;173;1289;3229;1331;3402
240940;202201;6958;16170;5503;13803;648;1592;3356;8180;4004;9772
240950;202201;1169;3312;1019;3048;43;174;825;2393;868;2567
240960;202201;722;2121;648;1980;14;53;521;1551;535;1604
240970;202201;2024;4982;1643;4362;57;218;1359;3504;1416;3722
240980;202201;3619;10116;3222;9448;90;397;2683;7714;2773;8111
240990;202201;2860;7501;2533;6917;202;652;1884;4936;2086;5588
241000;202201;1006;2525;790;2145;18;55;598;1570;616;1625
241010;202201;3090;9255;2797;8668;172;635;2145;6545;2317;7180
241020;202201;2287;5833;1747;4797;77;250;1238;3260;1315;3510
241025;202201;1880;5180;1528;4580;50;212;1122;3285;1172;3497
241030;202201;2609;7962;2128;6982;215;675;1386;4569;1601;5244
241040;202201;2329;7116;2046;6639;76;367;1589;5138;1665;5505
241050;202201;1481;4000;1194;3486;37;131;868;2479;905;2610
241060;202201;848;2248;738;2029;36;119;523;1393;559;1512
241070;202201;756;1928;629;1729;14;43;492;1310;506;1353
241080;202201;1204;3303;937;2771;29;102;667;1950;696;2052
241090;202201;2181;5965;1768;5265;72;326;1353;3922;1425;4248
241100;202201;1300;3410;993;2807;41;111;680;1862;721;1973
241105;202201;1014;2962;829;2625;193;667;360;1132;553;1799
241110;202201;1051;2807;796;2289;56;158;508;1395;564;1553
241120;202201;8043;22047;6783;19926;806;2332;4255;12842;5061;15174
241140;202201;3622;9216;2819;7656;128;400;2082;5492;2210;5892
241142;202201;837;2201;629;1825;29;95;386;1073;415;1168
241150;202201;6369;15663;5643;14555;206;522;4532;11579;4738;12101
241160;202201;1315;3425;1039;2939;158;498;606;1628;764;2126
241170;202201;1454;3567;1224;3178;36;117;1006;2518;1042;2635
241180;202201;1146;2795;850;2257;85;232;441;1133;526;1365
241190;202201;1263;3135;1061;2756;18;63;777;1936;795;1999
241200;202201;22806;55710;20036;51391;2294;6087;13206;33159;15500;39246
241210;202201;1626;4089;1198;3291;105;313;703;1891;808;2204
241220;202201;9983;27355;8816;25490;1655;4801;4692;13875;6347;18676
241230;202201;2998;7815;2654;7293;112;350;2205;5999;2317;6349
241240;202201;1348;3631;870;2626;97;302;308;919;405;1221
241250;202201;6150;16576;4989;14527;198;888;3784;10557;3982;11445
241255;202201;2604;7493;2294;6900;134;497;1732;5094;1866;5591
241260;202201;5356;13284;4305;11612;131;452;3458;9142;3589;9594
241270;202201;1760;4942;1469;4397;126;380;1030;3082;1156;3462
241280;202201;2399;5672;2075;5107;57;168;1772;4271;1829;4439
241290;202201;3517;8298;2587;6837;63;209;2044;5256;2107;5465
241300;202201;1622;4163;1319;3654;37;130;891;2390;928;2520
241310;202201;2354;5501;2032;5053;60;130;1777;4457;1837;4587
241320;202201;1032;3200;892;2944;93;348;585;1911;678;2259
241330;202201;1882;4632;1485;4111;15;76;1311;3614;1326;3690
241335;202201;3744;9943;3285;9137;116;377;2713;7443;2829;7820
241340;202201;1701;4548;1361;3899;193;632;699;1898;892;2530
241350;202201;2333;6088;2031;5559;120;350;1578;4245;1698;4595
241355;202201;1468;3783;1196;3272;31;77;900;2433;931;2510
241360;202201;2221;5510;1663;4426;58;157;1227;3173;1285;3330
241370;202201;1491;3851;1173;3217;77;237;819;2149;896;2386
241380;202201;762;1941;602;1666;68;181;324;883;392;1064
241390;202201;2903;8148;2579;7668;165;509;2028;6061;2193;6570
241400;202201;3929;10388;3471;9725;189;611;2746;7628;2935;8239
241410;202201;2651;7557;2173;6613;256;801;1310;3980;1566;4781
241415;202201;1896;5082;1597;4525;55;209;1240;3407;1295;3616
241420;202201;2763;7971;2451;7453;377;1291;1575;4739;1952;6030
241430;202201;666;1691;476;1312;16;44;318;833;334;877
241440;202201;8524;24834;7652;23336;350;1218;6144;18677;6494;19895
241445;202201;1407;3211;1229;2979;51;86;1076;2675;1127;2761
241450;202201;3092;7071;2595;6301;269;574;1919;4692;2188;5266
241460;202201;4196;10854;3395;9260;207;586;2357;6230;2564;6816
241470;202201;1489;3829;1231;3442;30;106;1027;2865;1057;2971
241475;202201;1342;3523;1065;3027;27;119;805;2167;832;2286
241480;202201;3209;9557;2661;8411;723;2238;1001;3486;1724;5724
241490;202201;779;1720;589;1457;13;35;445;1075;458;1110
241500;202201;824;2246;751;2161;3;10;710;2060;713;2070
250010;202201;2812;8038;2357;7117;68;275;1744;5135;1812;5410
250020;202201;1767;4474;1313;3640;68;140;944;2614;1012;2754
250030;202201;7254;19305;6390;18010;549;1675;4850;13492;5399;15167
250040;202201;4687;13076;4102;12060;362;1168;3016;8660;3378;9828
250050;202201;3938;9999;3558;9513;137;416;3043;8114;3180;8530
250053;202201;1359;3609;1242;3443;84;255;957;2613;1041;2868
250057;202201;749;2404;688;2314;9;47;636;2155;645;2202
250060;202201;6037;14937;5441;14195;298;771;4576;11951;4874;12722
250070;202201;4318;11541;3618;10386;54;236;2933;8207;2987;8443
250073;202201;843;2134;687;1892;12;35;559;1507;571;1542
250077;202201;2600;6302;2008;5383;46;168;1617;4244;1663;4412
250080;202201;5596;12983;4718;11891;63;260;4231;10496;4294;10756
250090;202201;3711;8468;3246;7870;72;207;2828;6735;2900;6942
250100;202201;3790;11044;3422;10412;133;543;2732;8099;2865;8642
250110;202201;5189;13936;4702;13267;277;958;3673;10249;3950;11207
250115;202201;796;1876;598;1578;14;54;466;1205;480;1259
250120;202201;2025;5641;1702;5123;35;172;1370;4072;1405;4244
250130;202201;6005;15427;5085;14167;68;360;4387;12022;4455;12382
250135;202201;1361;3527;1196;3255;15;58;1050;2833;1065;2891
250140;202201;2411;6730;2241;6524;96;357;1958;5684;2054;6041
250150;202201;5031;15012;4531;14207;174;729;3677;11303;3851;12032
250153;202201;1467;3756;1227;3412;32;105;973;2683;1005;2788
250157;202201;2110;5633;1877;5254;61;224;1524;4185;1585;4409
250160;202201;4190;9909;3358;8797;87;225;2892;7586;2979;7811
250170;202201;2036;5051;1839;4783;29;104;1604;4106;1633;4210
250180;202201;22682;51597;19459;47576;699;2231;15862;37670;16561;39901
250190;202201;4514;11333;3820;10354;281;796;2854;7610;3135;8406
250200;202201;2405;5555;2058;5121;63;167;1796;4416;1859;4583
250205;202201;924;2764;788;2548;16;70;629;2023;645;2093
250210;202201;1607;4701;1442;4453;47;231;1167;3530;1214;3761
250215;202201;1757;4557;1485;4184;96;297;879;2512;975;2809
250220;202201;697;1887;553;1667;33;122;374;1109;407;1231
250230;202201;1808;3941;1284;3193;21;75;1031;2502;1052;2577
250240;202201;2625;7365;2308;6822;44;169;1992;5835;2036;6004
250250;202201;4924;13043;4319;12208;130;394;3665;10460;3795;10854
250260;202201;1754;4784;1481;4304;52;145;1165;3390;1217;3535
250270;202201;1280;3747;1170;3611;66;241;906;2853;972;3094
250280;202201;3826;9660;3440;9144;154;357;2741;7344;2895;7701
250290;202201;1704;4306;1454;3937;20;68;1165;3112;1185;3180
250300;202201;5823;14825;5243;14145;148;674;4519;11818;4667;12492
250310;202201;1278;3421;1071;3092;46;147;803;2304;849;2451
250320;202201;13555;28831;11780;26841;192;546;10794;24284;10986;24830
250330;202201;2598;6800;2187;6245;104;323;1825;5153;1929;5476
250340;202201;1271;3024;1119;2830;11;39;1023;2570;1034;2609
250350;202201;4330;11708;3819;10848;267;641;3035;8816;3302;9457
250355;202201;2204;6197;1970;5897;27;128;1794;5374;1821;5502
250360;202201;1962;5048;1760;4785;32;134;1514;4047;1546;4181
250370;202201;14993;36382;12525;32753;234;847;10752;27614;10986;28461
250375;202201;1329;3197;1080;2905;5;21;1021;2755;1026;2776
250380;202201;1734;4224;1593;4055;26;115;1430;3533;1456;3648
250390;202201;1982;4879;1669;4408;66;182;1366;3577;1432;3759
250400;202201;75620;180268;57354;152871;15833;42913;18487;53270;34320;96183
250403;202201;2012;5182;1792;4934;56;313;1462;3837;1518;4150
250407;202201;1479;3335;1143;2833;126;248;728;1951;854;2199
250410;202201;750;1898;646;1726;11;38;531;1371;542;1409
250415;202201;2007;5347;1759;4973;38;143;1512;4241;1550;4384
250420;202201;1269;3368;1135;3190;22;72;1038;2913;1060;2985
250430;202201;6784;16101;5773;14787;151;483;4781;11971;4932;12454
250435;202201;1699;4613;1363;4069;18;86;1027;3011;1045;3097
250440;202201;4880;12575;4230;11761;77;227;3756;10404;3833;10631
250450;202201;1884;4823;1546;4366;39;136;1271;3610;1310;3746
250460;202201;7849;20307;6953;19077;403;1164;5566;15244;5969;16408
250470;202201;1746;4283;1438;3814;42;131;1155;2980;1197;3111
250480;202201;4169;11107;3534;10344;39;137;3143;9275;3182;9412
250485;202201;768;1672;582;1420;48;96;409;977;457;1073
250490;202201;5324;12301;4733;11638;108;388;4279;10327;4387;10715
250500;202201;2120;5661;1898;5292;55;178;1564;4327;1619;4505
250510;202201;5838;13988;5015;12888;81;197;4387;11352;4468;11549
250520;202201;2065;5251;1767;4855;100;314;1360;3678;1460;3992
250523;202201;2272;5485;2005;5143;87;349;1690;4189;1777;4538
250527;202201;1823;4402;1648;4211;20;65;1487;3781;1507;3846
250530;202201;705;1738;606;1597;21;41;519;1362;540;1403
250535;202201;1465;4084;1318;3830;33;145;1058;2980;1091;3125
250540;202201;3356;7160;2819;6574;90;159;2515;5954;2605;6113
250550;202201;825;2563;732;2386;27;116;530;1699;557;1815
250560;202201;1884;5003;1648;4667;40;153;1394;3861;1434;4014
250570;202201;2908;8213;2498;7491;109;367;1959;5809;2068;6176
250580;202201;1114;2818;985;2642;46;193;840;2181;886;2374
250590;202201;965;2408;857;2254;19;65;750;1927;769;1992
250600;202201;8478;21778;7061;19895;242;815;5642;15738;5884;16553
250610;202201;3181;8637;2857;8174;107;403;2395;6814;2502;7217
250620;202201;922;2262;792;2052;28;88;582;1476;610;1564
250625;202201;2553;7118;2289;6704;48;226;1970;5645;2018;5871
250630;202201;11451;29753;9532;26602;856;2640;6519;17678;7375;20318
250640;202201;3843;9863;3443;9348;83;368;3057;8165;3140;8533
250650;202201;1110;2502;921;2256;11;49;817;1954;828;2003
250660;202201;1727;4100;1385;3642;31;110;1143;2905;1174;3015
250670;202201;2516;7478;2295;7101;55;231;2013;6126;2068;6357
250680;202201;6290;14100;5648;13379;48;189;5308;12399;5356;12588
250690;202201;7351;15990;6232;14644;83;228;5552;12898;5635;13126
250700;202201;4803;12974;4213;12108;635;1744;2706;7942;3341;9686
250710;202201;4590;12908;4016;12106;279;918;3012;9081;3291;9999
250720;202201;3023;7778;2704;7340;35;172;2451;6592;2486;6764
250730;202201;4604;11568;4047;10822;132;513;3420;8890;3552;9403
250740;202201;2139;5089;1773;4615;88;233;1400;3653;1488;3886
250750;202201;118924;279463;102098;256462;7199;19912;76698;188834;83897;208746
250760;202201;2689;6285;2367;5789;56;186;2050;4877;2106;5063
250770;202201;4300;12429;3849;11841;343;1098;2899;9020;3242;10118
250780;202201;1928;4897;1635;4387;52;171;1317;3455;1369;3626
250790;202201;2720;7627;2366;7122;92;388;1815;5332;1907;5720
250800;202201;2640;6681;2317;6172;90;214;1905;5078;1995;5292
250810;202201;1432;3532;1201;3218;46;103;1009;2735;1055;2838
250820;202201;2061;5589;1892;5403;41;173;1722;4874;1763;5047
250830;202201;6530;18573;5394;16336;236;878;3742;10887;3978;11765
250840;202201;811;2486;705;2286;32;120;532;1740;564;1860
250850;202201;1919;5400;1714;5048;38;179;1433;4121;1471;4300
250855;202201;1123;3020;984;2810;45;140;792;2237;837;2377
250860;202201;3683;10214;3079;9231;443;1330;1775;5348;2218;6678
250870;202201;1095;2888;929;2626;34;122;747;2091;781;2213
250880;202201;1749;4297;1458;3876;99;269;1114;2947;1213;3216
250890;202201;11335;27102;10015;25420;363;1463;8386;20294;8749;21757
250900;202201;3179;8180;2773;7500;70;237;2377;6302;2447;6539
250905;202201;2677;7100;2478;6836;42;154;2265;6240;2307;6394
250910;202201;6800;15819;5658;14551;94;304;5015;12919;5109;13223
250915;202201;2327;5177;1661;4467;26;60;1471;4020;1497;4080
250920;202201;3820;9265;3384;8633;175;431;2778;6980;2953;7411
250930;202201;2481;6429;2235;6119;45;211;1959;5235;2004;5446
250933;202201;1350;3710;1181;3410;39;166;943;2642;982;2808
250937;202201;774;2038;647;1835;26;82;515;1480;541;1562
250939;202201;2098;5094;1848;4787;64;166;1495;3843;1559;4009
250940;202201;4276;10939;3763;10283;24;75;3395;9286;3419;9361
250950;202201;1851;4631;1500;4175;35;138;1220;3338;1255;3476
250960;202201;1205;3428;1056;3179;34;162;866;2539;900;2701
250970;202201;8822;22069;7767;20403;205;672;6467;16598;6672;17270
250980;202201;2592;6527;2355;6195;25;122;2084;5342;2109;5464
250990;202201;2210;6433;1864;5853;76;331;1414;4371;1490;4702
251000;202201;2168;5912;1761;5224;49;206;1424;4199;1473;4405
251010;202201;2794;7531;2533;7130;28;114;2265;6394;2293;6508
251020;202201;1719;4590;1544;4326;33;139;1341;3691;1374;3830
251030;202201;1122;2861;924;2518;54;139;625;1696;679;1835
251040;202201;2023;5300;1722;4814;37;156;1453;3997;1490;4153
251050;202201;1110;2965;930;2629;52;187;682;1841;734;2028
251060;202201;1174;2405;899;2066;19;50;684;1565;703;1615
251065;202201;521;1370;393;1135;11;43;281;774;292;817
251070;202201;801;1967;669;1781;18;65;572;1488;590;1553
251080;202201;21046;50595;17237;45041;2572;6578;10397;27744;12969;34322
251090;202201;3032;8415;2590;7658;74;247;2058;6049;2132;6296
251100;202201;870;2666;766;2469;28;128;604;1865;632;1993
251110;202201;1913;4838;1620;4327;78;181;1220;3240;1298;3421
251120;202201;8349;21772;7052;20207;369;1226;5495;15735;5864;16961
251130;202201;4346;9044;3850;8491;51;131;3542;7733;3593;7864
251140;202201;4545;12249;4041;11553;71;280;3346;9476;3417;9756
251150;202201;2876;8007;2638;7625;69;333;2277;6430;2346;6763
251160;202201;2402;6621;2082;6153;33;177;1814;5254;1847;5431
251170;202201;1798;4512;1589;4254;25;100;1445;3815;1470;3915
251180;202201;2797;7193;2303;6507;134;371;1689;4762;1823;5133
251190;202201;4708;11877;4249;11368;54;282;3868;10154;3922;10436
251200;202201;4700;13088;4141;12388;85;323;3637;10932;3722;11255
251203;202201;1059;3265;964;3046;34;140;724;2229;758;2369
251207;202201;1209;3148;921;2684;27;117;645;1834;672;1951
251210;202201;8636;20487;7087;18408;370;826;5326;14150;5696;14976
251220;202201;1373;3103;1043;2679;82;156;780;2076;862;2232
251230;202201;5064;13551;4376;12358;130;454;3508;9645;3638;10099
251240;202201;3924;10517;3309;9474;167;477;2462;6961;2629;7438
251250;202201;11957;30297;10538;27937;519;1528;8192;21007;8711;22535
251260;202201;547;1437;495;1359;20;93;397;1052;417;1145
251270;202201;4549;13687;4070;13027;162;585;3306;10801;3468;11386
251272;202201;1375;3673;1263;3529;55;215;1065;2903;1120;3118
251274;202201;966;2587;789;2277;47;172;536;1475;583;1647
251275;202201;1406;3624;1187;3265;52;186;932;2485;984;2671
251276;202201;1405;3701;1220;3450;33;161;987;2697;1020;2858
251278;202201;656;1693;592;1597;33;102;470;1262;503;1364
251280;202201;2491;6333;2273;6027;63;203;1949;5070;2012;5273
251290;202201;6919;14906;6342;14241;165;497;5717;12527;5882;13024
251300;202201;927;2641;835;2504;15;72;716;2131;731;2203
251310;202201;3041;8139;2652;7564;65;315;2207;6148;2272;6463
251315;202201;1922;5715;1742;5371;120;384;1344;4120;1464;4504
251320;202201;1746;4476;1295;3702;39;143;982;2756;1021;2899
251330;202201;2278;5109;1868;4631;33;95;1649;4100;1682;4195
251335;202201;1192;3189;1069;3010;26;117;955;2632;981;2749
251340;202201;4113;9288;3295;8245;123;334;2605;6474;2728;6808
251350;202201;1144;3136;1050;2990;31;112;876;2455;907;2567
251360;202201;2008;5300;1620;4758;29;105;1334;3890;1363;3995
251365;202201;834;2119;657;1796;9;32;526;1410;535;1442
251370;202201;26593;67628;22874;62468;3192;8183;14170;39753;17362;47936
251380;202201;1429;3689;1223;3366;20;100;1054;2823;1074;2923
251385;202201;835;2065;651;1739;20;54;475;1228;495;1282
251390;202201;6791;19040;6007;17848;512;1603;4159;12401;4671;14004
251392;202201;1096;2859;927;2596;34;111;739;2051;773;2162
251394;202201;703;1908;567;1672;47;140;398;1164;445;1304
251396;202201;718;1882;609;1698;26;79;415;1128;441;1207
251398;202201;1093;2693;783;2156;23;80;582;1555;605;1635
251400;202201;1435;3195;1141;2808;28;112;935;2210;963;2322
251410;202201;1689;3762;1362;3309;18;76;1163;2720;1181;2796
251420;202201;2187;5369;1800;4924;38;141;1439;3867;1477;4008
251430;202201;1633;4782;1476;4516;45;190;1274;3872;1319;4062
251440;202201;1152;3131;931;2726;42;121;728;2163;770;2284
251445;202201;1695;4528;1564;4350;28;116;1358;3707;1386;3823
251450;202201;4596;13200;4105;12439;94;428;3477;10417;3571;10845
251455;202201;937;2724;860;2589;24;109;706;2076;730;2185
251460;202201;1008;2719;849;2479;47;155;653;1889;700;2044
251465;202201;501;1389;427;1251;13;54;327;924;340;978
251470;202201;1280;3404;961;2768;111;337;529;1461;640;1798
251480;202201;1113;2771;890;2389;25;101;693;1776;718;1877
251490;202201;2107;5278;1696;4730;67;200;1291;3612;1358;3812
251500;202201;2102;5668;1936;5466;32;122;1749;4925;1781;5047
251510;202201;2866;8179;2392;7275;107;412;1663;4895;1770;5307
251520;202201;1143;2804;883;2360;75;179;586;1527;661;1706
251530;202201;15557;35899;12575;32228;138;702;11194;28174;11332;28876
251540;202201;3294;8914;2962;8344;58;230;2541;7032;2599;7262
251550;202201;4316;9391;3473;8391;118;219;2918;7076;3036;7295
251560;202201;603;1779;544;1694;43;176;400;1185;443;1361
251570;202201;1007;2751;831;2406;23;119;671;1879;694;1998
251580;202201;2101;4906;1882;4596;34;133;1619;3808;1653;3941
251590;202201;1734;4051;1466;3736;51;147;1263;3157;1314;3304
251593;202201;1015;2871;912;2696;82;262;613;1775;695;2037
251597;202201;2225;6012;1994;5704;14;74;1807;5122;1821;5196
251600;202201;6692;17531;5848;16262;234;734;4829;13249;5063;13983
251610;202201;3352;9206;2932;8469;222;631;2088;6073;2310;6704
251615;202201;1409;3336;1130;2925;19;62;930;2331;949;2393
251620;202201;20792;45103;16074;39400;168;471;14056;34554;14224;35025
251630;202201;5389;11877;4335;10435;239;508;3306;7840;3545;8348
251640;202201;2390;6164;2137;5779;27;129;1930;5128;1957;5257
251650;202201;4492;11134;3898;10390;114;384;3400;8974;3514;9358
251660;202201;3843;10977;3396;10220;72;326;2837;8414;2909;8740
251670;202201;4423;11900;3914;11214;52;252;3533;10031;3585;10283
251675;202201;821;2001;748;1916;57;148;591;1501;648;1649
251680;202201;2825;6963;2375;6387;51;155;1998;5370;2049;5525
251690;202201;3472;9275;2981;8452;99;317;2282;6424;2381;6741
251700;202201;2381;6344;1976;5816;48;196;1678;4834;1726;5030
251710;202201;861;2125;619;1659;47;148;359;890;406;1038
251720;202201;1419;3868;1136;3388;22;102;884;2563;906;2665
251740;202201;638;1741;515;1522;38;126;360;1031;398;1157
260005;202201;32104;65845;26745;59145;1671;3723;20907;45251;22578;48974
260010;202201;11082;27917;9172;24896;615;1694;5581;15214;6196;16908
260020;202201;7364;16423;6140;14697;96;410;5275;12378;5371;12788
260030;202201;7357;17983;6195;16339;123;469;5132;13318;5255;13787
260040;202201;8231;19883;6994;18197;458;1095;5186;13764;5644;14859
260050;202201;14918;37138;12427;34402;220;754;11519;31919;11739;32673
260060;202201;4527;10489;3922;9573;303;607;2990;7455;3293;8062
260070;202201;11582;27669;9986;25422;304;1107;8231;20368;8535;21475
260080;202201;6929;15311;6011;14128;120;361;5095;11775;5215;12136
260090;202201;5184;12618;4562;11791;253;699;3673;9462;3926;10161
260100;202201;3191;8261;2693;7550;56;263;2279;6292;2335;6555
260105;202201;5347;14137;4816;13442;129;532;4154;11393;4283;11925
260110;202201;23799;63650;21233;59987;820;2912;17859;49625;18679;52537
260120;202201;15864;39669;13482;36315;1315;3434;9363;25372;10678;28806
260130;202201;3450;8178;3042;7608;136;338;2429;5948;2565;6286
260140;202201;13938;29765;12091;27621;424;1132;10511;23619;10935;24751
260150;202201;3820;8523;3324;7923;84;227;2976;7061;3060;7288
260160;202201;6965;17291;5922;16042;96;320;5410;14750;5506;15070
260170;202201;22688;50741;19469;46511;867;2156;15912;37472;16779;39628
260180;202201;3800;9561;3278;8863;78;283;2858;7618;2936;7901
260190;202201;20147;38486;17078;34945;210;580;15345;30770;15555;31350
260200;202201;11915;27386;10292;25326;446;1025;8895;22032;9341;23057
260210;202201;12409;33303;10517;30290;392;1334;8485;24315;8877;25649
260220;202201;11967;26299;11083;25221;203;535;9976;22393;10179;22928
260230;202201;11885;27327;10318;25314;221;678;8811;21281;9032;21959
260240;202201;2968;8499;2585;7780;85;349;2028;6013;2113;6362
260250;202201;2504;6023;2173;5534;99;249;1786;4489;1885;4738
260260;202201;13999;34197;12458;31942;502;1446;10114;25575;10616;27021
260270;202201;4919;10963;4345;10311;91;359;3806;8838;3897;9197
260280;202201;13277;38432;11979;36615;379;1758;10399;31190;10778;32948
260290;202201;44711;107946;38722;99686;3562;9320;27618;70731;31180;80051
260300;202201;10506;26876;9106;24973;226;879;7793;21233;8019;22112
260310;202201;6061;14341;5379;13519;294;632;4283;10980;4577;11612
260320;202201;8309;22981;7090;20982;206;730;5891;17345;6097;18075
260330;202201;2730;8006;2386;7328;68;269;1921;5736;1989;6005
260340;202201;2225;5678;1937;5266;38;163;1713;4549;1751;4712
260345;202201;28726;69855;24301;63727;3015;8330;14577;37272;17592;45602
260350;202201;6129;13517;5290;12574;42;141;4823;11372;4865;11513
260360;202201;2739;6764;2467;6290;59;196;1830;4559;1889;4755
260370;202201;5939;16230;5132;14907;205;719;4037;11543;4242;12262
260380;202201;5403;15101;4631;13868;185;665;3592;10604;3777;11269
260390;202201;5060;14461;4182;12745;212;707;2847;8484;3059;9191
260392;202201;3785;11229;3437;10799;94;544;2917;9124;3011;9668
260400;202201;20792;45349;18014;41770;420;1271;14711;32676;15131;33947
260410;202201;82333;190480;65728;168094;11830;30711;31602;83417;43432;114128
260415;202201;4732;11943;4078;10934;65;264;3445;9060;3510;9324
260420;202201;13279;26818;11302;24660;82;285;10597;22908;10679;23193
260430;202201;2992;8882;2552;8045;158;566;1758;5476;1916;6042
260440;202201;4160;9929;3695;9289;50;190;3258;8040;3308;8230
260450;202201;6051;14614;5415;13796;261;543;4619;11886;4880;12429
260460;202201;5726;15996;4887;14572;439;1498;3148;9177;3587;10675
260470;202201;5172;13060;4390;12175;68;205;4042;11292;4110;11497
260480;202201;4365;10822;3696;9908;285;800;2647;7160;2932;7960
260490;202201;5688;12610;5014;11672;30;139;4605;10539;4635;10678
260500;202201;6481;15426;5573;14171;412;971;4086;10431;4498;11402
260510;202201;10871;25342;9151;22973;116;448;8165;20232;8281;20680
260515;202201;4817;12189;3805;10388;161;510;2717;7083;2878;7593
260520;202201;17617;39466;15358;36667;557;1503;13015;30583;13572;32086
260530;202201;10466;28872;8903;26523;140;664;7755;22809;7895;23473
260540;202201;7757;16200;6872;15109;95;263;6305;13714;6400;13977
260545;202201;94;270;63;198;7;28;24;69;31;97
260550;202201;3453;8951;2806;7897;147;493;1988;5435;2135;5928
260560;202201;6268;15618;5267;14173;131;489;4463;11826;4594;12315
260570;202201;8630;21554;7651;20262;283;850;6463;16957;6746;17807
260580;202201;4825;11005;4342;10380;31;116;3998;9496;4029;9612
260590;202201;7584;15976;6440;14727;155;394;5702;13013;5857;13407
260600;202201;34469;84646;28385;75733;1054;3342;22143;57641;23197;60983
260610;202201;8085;20059;7203;18929;390;1096;5514;14424;5904;15520
260620;202201;19124;45938;16937;42964;1178;3380;13077;32397;14255;35777
260630;202201;2561;6637;2094;5927;48;171;1725;4782;1773;4953
260640;202201;24538;51998;20764;47736;632;1571;17627;39986;18259;41557
260650;202201;6668;16490;5370;14917;505;910;4344;12528;4849;13438
260660;202201;7583;18730;6627;17520;253;818;5765;15022;6018;15840
260670;202201;2442;6163;1993;5466;68;190;1463;3902;1531;4092
260680;202201;31767;72480;26995;66001;1874;4760;19559;46895;21433;51655
260690;202201;3737;9397;3120;8454;77;276;2475;6649;2552;6925
260700;202201;6964;17972;6447;17404;21;88;6250;16930;6271;17018
260710;202201;1482;3674;1264;3359;56;192;1005;2639;1061;2831
260720;202201;28651;65091;24593;60140;1948;4697;18601;45920;20549;50617
260730;202201;8605;23334;7510;21852;202;802;6474;18550;6676;19352
260740;202201;1410;3889;1186;3535;23;84;939;2845;962;2929
260750;202201;8050;20266;6480;18312;157;418;5773;16572;5930;16990
260760;202201;6602;14359;5739;13367;120;335;5043;11685;5163;12020
260765;202201;9054;24395;7934;22890;431;1691;5857;16468;6288;18159
260770;202201;4225;10242;3505;9095;112;357;2816;7170;2928;7527
260775;202201;5827;14618;5131;13629;177;632;4161;10671;4338;11303
260780;202201;3984;11259;3574;10623;346;1258;2370;6831;2716;8089
260790;202201;136086;291368;114223;264201;14019;31547;77899;178868;91918;210415
260795;202201;3288;7887;2833;7311;91;259;2317;5996;2408;6255
260800;202201;6019;12956;5472;12252;164;432;4837;10542;5001;10974
260805;202201;3955;10563;3374;9604;182;597;2545;7120;2727;7717
260810;202201;7158;18217;6287;16653;347;919;4910;12701;5257;13620
260820;202201;4822;10708;4289;10106;70;258;3657;8483;3727;8741
260825;202201;3210;9025;2830;8383;123;408;2181;6383;2304;6791
260830;202201;4613;12667;3868;11399;408;1124;2629;7887;3037;9011
260840;202201;4647;11208;4180;10596;186;474;3623;9114;3809;9588
260845;202201;4959;12315;4405;11416;227;644;3394;8584;3621;9228
260850;202201;5532;14278;4658;12698;344;1060;3124;8150;3468;9210
260860;202201;3691;9978;3190;9140;84;332;2621;7296;2705;7628
260870;202201;4829;10937;4139;10106;60;249;3759;9044;3819;9293
260875;202201;8285;18823;6785;16677;529;1245;4913;12166;5442;13411
260880;202201;10454;28012;9147;25868;334;1071;7484;20953;7818;22024
260890;202201;14275;34426;12362;31663;763;2080;9036;22610;9799;24690
260900;202201;5977;15784;4975;14409;299;1007;3513;10033;3812;11040
260910;202201;3521;9081;3082;8450;102;358;2469;6684;2571;7042
260915;202201;5244;14929;4604;14211;57;283;4238;13107;4295;13390
260920;202201;3743;8392;3208;7825;79;188;2850;6949;2929;7137
260930;202201;4435;12480;3828;11446;178;696;3008;8729;3186;9425
260940;202201;16275;36704;14193;33878;1011;2458;10909;25586;11920;28044
260950;202201;7793;19731;6338;17368;313;1154;4331;11190;4644;12344
260960;202201;80578;169564;66256;151994;6080;13877;46372;104460;52452;118337
260970;202201;6251;15366;5558;14437;423;825;4178;11130;4601;11955
260980;202201;4938;13709;4333;12964;58;202;3982;12004;4040;12206
260990;202201;19533;50291;16558;46297;708;2329;13307;36642;14015;38971
261000;202201;17957;39762;15184;36359;419;1271;12567;29405;12986;30676
261010;202201;2477;6202;2154;5784;80;217;1864;5018;1944;5235
261020;202201;7172;17685;6282;16281;293;838;5191;13133;5484;13971
261030;202201;4363;12127;3849;11255;132;526;3079;8738;3211;9264
261040;202201;5887;15988;4830;14085;185;675;3749;10645;3934;11320
261050;202201;8840;20997;8029;19842;233;539;6728;16442;6961;16981
261060;202201;15545;36947;13534;34587;279;928;11514;29013;11793;29941
261070;202201;72889;152967;61013;137812;3578;8130;46738;103409;50316;111539
261080;202201;7303;16598;6621;15784;101;224;6195;14721;6296;14945
261090;202201;21140;47613;18828;44638;391;1255;16616;38690;17007;39945
261100;202201;9335;23960;8182;22306;546;1495;6256;17016;6802;18511
261110;202201;74935;199205;63478;179148;7596;23048;39987;111124;47583;134172
261120;202201;3912;9371;3406;8683;76;197;2952;7488;3028;7685
261130;202201;7840;18290;6898;17066;114;377;6103;14947;6217;15324
261140;202201;3942;8802;3523;8244;191;481;2807;6473;2998;6954
261150;202201;5837;14357;5173;13406;126;348;4482;11514;4608;11862
261153;202201;2097;6016;1752;5371;79;258;1201;3685;1280;3943
261160;202201;241326;531385;199751;476661;43316;101278;99373;241490;142689;342768
261170;202201;7387;16509;6492;15368;188;449;5572;12973;5760;13422
261180;202201;10141;24208;8892;22629;465;1058;6732;17312;7197;18370
261190;202201;4933;13655;4440;12882;174;787;3636;10233;3810;11020
261200;202201;3689;8019;3256;7457;143;355;2764;6226;2907;6581
261210;202201;2051;4810;1763;4410;47;141;1502;3674;1549;3815
261220;202201;15508;40503;13218;36595;1346;3951;8599;23327;9945;27278
261230;202201;4311;11726;3589;10791;48;183;3031;9195;3079;9378
261240;202201;6193;14193;5480;13140;279;679;4568;10792;4847;11471
261245;202201;4077;10806;3389;9627;84;392;2736;7490;2820;7882
261247;202201;3335;9288;2766;8298;187;547;1960;5879;2147;6426
261250;202201;26220;56397;22970;52673;3090;6408;16349;38939;19439;45347
261255;202201;4435;12388;3640;10877;163;636;2819;8219;2982;8855
261260;202201;14497;35588;12710;33331;299;1142;11376;29384;11675;30526
261270;202201;4939;11273;4334;10552;154;393;3704;8920;3858;9313
261280;202201;2698;7242;2370;6719;72;271;1903;5264;1975;5535
261290;202201;3148;7746;2629;7166;85;285;2174;5950;2259;6235
261300;202201;13984;36287;12006;33135;439;1685;9435;25238;9874;26923
261310;202201;10162;24084;8771;22254;548;1527;6739;16730;7287;18257
261320;202201;6621;17562;5738;16162;74;355;4928;13663;5002;14018
261330;202201;6204;14302;5610;13559;95;381;4981;11737;5076;12118
261340;202201;4686;12232;4102;11505;105;427;3564;9867;3669;10294
261350;202201;9246;26347;8145;24512;191;746;6586;19680;6777;20426
261360;202201;9007;20321;7631;18409;256;718;6231;14596;6487;15314
261370;202201;26377;62722;22390;57499;2152;5395;15314;39436;17466;44831
261380;202201;4528;12609;4012;11763;415;1317;2823;8199;3238;9516
261390;202201;18216;49421;15455;45165;1117;3726;10699;30805;11816;34531
261400;202201;5072;14970;4454;13734;241;884;3376;10169;3617;11053
261410;202201;10541;24888;8710;22191;290;984;7218;17851;7508;18835
261420;202201;8012;22601;7261;21714;565;2068;5625;16681;6190;18749
261430;202201;3901;10125;3331;9276;65;305;2859;7753;2924;8058
261440;202201;1546;4453;1289;3973;60;267;933;2757;993;3024
261450;202201;15452;40354;13643;37680;306;1020;11181;30959;11487;31979
261460;202201;8493;21699;7406;20055;257;807;6132;16428;6389;17235
261470;202201;4352;10465;3761;9658;43;187;3233;8244;3276;8431
261480;202201;5716;16376;4913;15063;249;928;3854;11579;4103;12507
261485;202201;5540;14801;4870;13817;350;1152;3698;10342;4048;11494
261500;202201;6751;16203;5896;15055;457;960;4147;11080;4604;12040
261510;202201;1983;5669;1725;5258;84;309;1334;4074;1418;4383
261520;202201;2493;7302;2244;6822;89;323;1698;5114;1787;5437
261530;202201;13203;36275;10845;32264;892;3264;6189;17417;7081;20681
261540;202201;9514;25287;8666;24117;1648;4124;4850;14607;6498;18731
261550;202201;3991;10165;3481;9395;219;685;2600;6842;2819;7527
261560;202201;8723;24047;7593;22415;344;1193;6084;17866;6428;19059
261570;202201;3750;9741;2990;8513;192;629;2082;5820;2274;6449
261580;202201;7303;18414;6315;17077;100;466;5735;15318;5835;15784
261590;202201;2954;7143;2411;6378;97;315;1852;4828;1949;5143
261600;202201;5974;13680;5102;12465;244;555;3941;9526;4185;10081
261610;202201;2270;6416;1831;5621;152;495;1205;3688;1357;4183
261618;202201;2713;6426;2380;5965;144;382;1918;4712;2062;5094
261620;202201;4499;12243;4114;11686;534;1402;3029;8790;3563;10192
261630;202201;6471;17721;5516;15961;421;1401;3671;10226;4092;11627
261640;202201;41076;86821;35229;79835;1976;3588;27788;64128;29764;67716
261650;202201;4556;10509;3878;9675;194;489;3018;7492;3212;7981
270010;202201;4699;15062;4050;13978;166;865;3283;11057;3449;11922
270020;202201;4329;10092;3817;9467;118;448;3337;8000;3455;8448
270030;202201;36451;95972;30716;87052;2483;7351;22608;63484;25091;70835
270040;202201;11594;29193;10009;27335;303;1151;8629;23274;8932;24425
270050;202201;5818;13057;4942;12082;243;491;4355;10748;4598;11239
270060;202201;2381;5896;2007;5456;130;350;1608;4389;1738;4739
270070;202201;5026;13407;4374;12518;107;496;3763;10499;3870;10995
270080;202201;1570;4099;1332;3718;48;153;1044;2826;1092;2979
270090;202201;1883;5539;1710;5214;50;217;1446;4319;1496;4536
270100;202201;6336;14894;5519;13762;155;506;4784;11663;4939;12169
270110;202201;3535;7797;2886;7054;171;302;2333;5987;2504;6289
270120;202201;2730;7292;2375;6824;74;311;1996;5622;2070;5933
270130;202201;5412;13490;4696;12638;144;446;4053;10888;4197;11334
270135;202201;2130;4971;1806;4615;28;123;1672;4235;1700;4358
270140;202201;10089;23127;8156;20522;342;1101;6443;15499;6785;16600
270150;202201;2741;8143;2492;7799;17;91;2351;7335;2368;7426
270160;202201;6181;16457;5284;15413;154;523;4801;14001;4955;14524
270170;202201;3524;9979;2978;9234;191;895;2262;6723;2453;7618
270180;202201;2423;7217;2227;6975;39;205;2032;6300;2071;6505
270190;202201;1950;5211;1741;4962;26;124;1602;4537;1628;4661
270200;202201;2715;7803;2364;7308;176;526;1735;5433;1911;5959
270210;202201;6040;13771;5136;12750;58;241;4764;11672;4822;11913
270220;202201;1768;4397;1426;3912;131;416;993;2640;1124;3056
270230;202201;10472;27036;8828;24600;757;2131;6535;18143;7292;20274
270235;202201;6349;18755;5527;17476;179;700;4667;14629;4846;15329
270240;202201;12564;31988;10486;29231;861;2527;7905;22115;8766;24642
270250;202201;3084;7258;2733;6767;174;412;2283;5637;2457;6049
270255;202201;4804;13115;3805;11386;118;477;2975;8702;3093;9179
270260;202201;5738;16686;5207;15813;96;513;4577;13636;4673;14149
270270;202201;1106;2765;922;2543;91;237;712;1966;803;2203
270280;202201;4147;9570;3335;8579;230;526;2700;6925;2930;7451
270290;202201;8376;25143;7578;23910;145;735;6785;21148;6930;21883
270300;202201;4544;11369;3553;10294;177;490;2832;8376;3009;8866
270310;202201;7535;20118;6475;18539;119;569;5676;15894;5795;16463
270320;202201;5841;16694;5082;15279;271;968;3844;11184;4115;12152
270330;202201;4406;13455;3897;12706;219;964;3172;10248;3391;11212
270340;202201;1746;4400;1477;4043;52;128;1273;3464;1325;3592
270350;202201;2011;4483;1631;4045;109;294;1254;3084;1363;3378
270360;202201;2903;6886;2605;6554;50;148;2465;6173;2515;6321
270370;202201;1509;4398;1382;4175;36;175;1195;3555;1231;3730
270375;202201;3349;7565;2830;7001;19;65;2671;6613;2690;6678
270380;202201;5924;15621;5049;14554;457;1271;3800;11191;4257;12462
270390;202201;1294;3161;1034;2859;15;71;880;2447;895;2518
270400;202201;7073;17409;5965;15815;186;542;4935;12919;5121;13461
270410;202201;5049;13925;4395;12956;120;467;3757;11001;3877;11468
270420;202201;6262;17466;5654;16600;128;612;4996;14362;5124;14974
270430;202201;153383;346735;121424;306591;19612;50678;66534;170036;86146;220714
270440;202201;5028;13007;4377;12212;99;408;3905;10783;4004;11191
270450;202201;7761;19738;6835;18624;299;822;5796;16016;6095;16838
270460;202201;3944;8559;3367;7872;95;238;3106;7213;3201;7451
270470;202201;12174;32027;10655;29959;524;1687;8616;24148;9140;25835
270480;202201;3155;7991;2675;7339;116;414;2218;5958;2334;6372
270490;202201;1001;2635;873;2480;42;150;722;2016;764;2166
270500;202201;5266;15184;4703;14265;212;801;3873;11535;4085;12336
270510;202201;6184;15438;5205;14228;315;1091;4099;10850;4414;11941
270520;202201;4434;11930;3571;10556;721;2235;1639;4984;2360;7219
270530;202201;1413;3909;1204;3586;67;180;864;2606;931;2786
270540;202201;2453;6468;2084;5992;55;228;1820;5174;1875;5402
270550;202201;7276;17845;5813;16249;478;1307;4513;12825;4991;14132
270560;202201;3196;7908;2705;7248;130;412;2213;5854;2343;6266
270570;202201;4917;12484;4258;11548;244;625;3510;9474;3754;10099
270580;202201;2484;6645;2247;6320;111;324;1959;5480;2070;5804
270590;202201;1643;4859;1514;4682;15;84;1440;4434;1455;4518
270600;202201;2975;8766;2701;8357;66;304;2415;7373;2481;7677
270610;202201;3866;9842;3373;9209;83;244;3009;8153;3092;8397
270620;202201;1354;3862;1252;3682;29;128;1092;3113;1121;3241
270630;202201;18952;44320;16392;40876;678;2068;13934;34056;14612;36124
270640;202201;5871;15923;5150;14813;183;713;4344;12255;4527;12968
270642;202201;2682;8342;2371;7869;157;683;1844;6003;2001;6686
270644;202201;3967;9507;3302;8656;297;674;2534;6785;2831;7459
270650;202201;3511;9703;3076;9128;211;752;2502;7365;2713;8117
270660;202201;2097;5196;1802;4797;83;294;1412;3670;1495;3964
270670;202201;18482;40110;15570;36624;379;1152;13622;31212;14001;32364
270680;202201;6038;13637;5410;12962;54;115;5159;12401;5213;12516
270690;202201;10257;24255;8619;22197;302;921;7139;18136;7441;19057
270700;202201;571;1676;502;1571;47;166;369;1127;416;1293
270710;202201;6130;17293;5423;16228;320;1085;4366;12951;4686;14036
270720;202201;3960;10846;3526;10142;75;353;3155;8908;3230;9261
270730;202201;8695;18405;7629;17285;853;1037;6144;15279;6997;16316
270740;202201;2504;6394;2210;6052;89;288;1871;5078;1960;5366
270750;202201;6104;15276;5352;14351;115;445;4791;12748;4906;13193
270760;202201;3566;9592;3011;8852;66;294;2534;7370;2600;7664
270770;202201;23017;55043;18766;49764;2728;6608;12002;33130;14730;39738
270780;202201;1984;5061;1849;4887;44;157;1676;4375;1720;4532
270790;202201;1823;4655;1545;4282;97;296;1206;3319;1303;3615
270800;202201;11901;30794;10770;29211;408;1386;9253;24867;9661;26253
270810;202201;3629;9675;2910;8570;178;645;2118;6090;2296;6735
270820;202201;1715;4911;1462;4511;52;252;1187;3589;1239;3841
270830;202201;5587;12765;4539;11505;114;491;3849;9483;3963;9974
270840;202201;8962;25774;7934;24295;210;1018;6933;20842;7143;21860
270850;202201;9412;21451;8326;20184;471;1341;7186;17178;7657;18519
270860;202201;15634;33321;12522;29853;505;1188;10388;24655;10893;25843
270870;202201;2427;6550;1998;5863;212;574;1390;4204;1602;4778
270880;202201;8373;24259;7499;22973;224;981;6299;18951;6523;19932
270890;202201;3460;8982;2951;8269;257;741;2013;5629;2270;6370
270895;202201;3487;9977;3162;9563;68;368;2851;8455;2919;8823
270900;202201;1821;4568;1397;3903;30;101;1114;3087;1144;3188
270910;202201;4374;12004;3785;11122;110;390;3190;9253;3300;9643
270915;202201;10319;27956;8413;24978;637;2304;5983;17269;6620;19573
270920;202201;6410;17381;5829;16499;95;498;5157;14179;5252;14677
270930;202201;18822;41609;14701;36868;1666;3405;10654;28038;12320;31443
270940;202201;6896;17425;5821;16160;203;906;4728;12694;4931;13600
280010;202201;702;1935;569;1668;25;113;404;1091;429;1204
280020;202201;5315;12914;4517;11720;342;864;3324;8556;3666;9420
280030;202201;87885;195510;71727;173430;12436;29449;39153;96382;51589;125831
280040;202201;3228;8330;2830;7756;223;680;2089;5645;2312;6325
280050;202201;4473;12178;3820;11163;660;1950;2167;6321;2827;8271
280060;202201;7258;17449;5860;15441;948;2536;3177;8634;4125;11170
280067;202201;7647;17734;6536;16062;335;760;4925;11925;5260;12685
280070;202201;1933;5638;1795;5425;120;373;1500;4508;1620;4881
280100;202201;4393;10991;3713;9956;377;973;2574;6951;2951;7924
280110;202201;1600;3931;1391;3631;19;81;1263;3231;1282;3312
280120;202201;8187;22109;7273;20686;807;2093;5331;15452;6138;17545
280130;202201;9589;21684;8425;20117;390;1050;6909;16396;7299;17446
280140;202201;6132;13698;5430;12749;376;806;4391;10409;4767;11215
280150;202201;4485;10833;3919;10079;393;923;3012;7824;3405;8747
280160;202201;1317;3556;1124;3253;102;362;793;2206;895;2568
280170;202201;5570;13869;4999;13158;222;636;4146;10863;4368;11499
280190;202201;1457;2997;1305;2804;42;116;1144;2395;1186;2511
280200;202201;1376;3466;1149;3157;71;216;893;2402;964;2618
280210;202201;18807;43539;16393;40192;1686;4029;11136;27197;12822;31226
280220;202201;1784;4612;1504;4252;51;184;1254;3499;1305;3683
280230;202201;4614;11126;3822;9955;287;661;2740;7151;3027;7812
280240;202201;3514;9029;3126;8455;52;261;2722;7182;2774;7443
280250;202201;991;2250;833;2024;54;154;633;1486;687;1640
280260;202201;2435;5551;2144;5197;45;120;1963;4767;2008;4887
280270;202201;2592;6756;2299;6333;144;430;1894;5198;2038;5628
280280;202201;4282;12285;3818;11616;452;1193;2771;8740;3223;9933
280290;202201;20602;50650;17796;46797;1528;4147;12213;32238;13741;36385
280300;202201;13740;29986;12069;28199;1519;2045;8776;22814;10295;24859
280310;202201;1493;3725;1255;3347;42;131;962;2506;1004;2637
280320;202201;9309;23933;8078;22140;821;2344;5746;15507;6567;17851
280330;202201;5052;11970;4287;10925;298;742;3258;8245;3556;8987
280340;202201;5805;11818;4835;10755;222;386;4265;9594;4487;9980
280350;202201;28822;63928;25436;59549;1059;2747;20746;47619;21805;50366
280360;202201;5998;16078;5296;14975;615;1892;3439;9733;4054;11625
280370;202201;2451;5547;2013;4836;74;148;1606;3784;1680;3932
280380;202201;1112;2790;941;2574;72;170;678;1874;750;2044
280390;202201;4016;9247;3422;8363;207;424;2740;6695;2947;7119
280400;202201;4277;10042;3742;9343;464;976;2632;6786;3096;7762
280410;202201;2778;7094;2342;6448;224;597;1472;3992;1696;4589
280420;202201;4655;11745;4287;11301;71;268;3963;10368;4034;10636
280430;202201;2305;5308;2032;4954;75;240;1692;4021;1767;4261
280440;202201;4611;11597;4081;10810;128;499;3518;9051;3646;9550
280445;202201;2514;6194;2257;5771;59;193;1775;4374;1834;4567
280450;202201;10664;24633;9279;22799;2028;4766;4699;12170;6727;16936
280460;202201;7416;16630;6728;15709;354;802;5796;13418;6150;14220
280470;202201;1805;4891;1533;4390;96;299;1134;3194;1230;3493
280480;202201;49109;112314;42776;103699;3627;9238;31117;73758;34744;82996
280490;202201;3964;10961;3358;9932;146;587;2557;7291;2703;7878
280500;202201;1108;2487;961;2301;23;70;826;1935;849;2005
280510;202201;2976;6784;2576;6252;79;244;2111;4959;2190;5203
280520;202201;1888;4408;1654;4091;99;209;1321;3253;1420;3462
280530;202201;2529;6157;2212;5726;135;350;1744;4498;1879;4848
280540;202201;9233;23975;8377;22780;282;914;7347;19785;7629;20699
280550;202201;7135;15840;5962;14223;140;511;5049;11625;5189;12136
280560;202201;8004;20734;7516;20031;142;533;6762;17709;6904;18242
280570;202201;6860;16028;5568;14463;326;858;4147;10855;4473;11713
280580;202201;6101;15246;5346;14176;434;1077;4113;10949;4547;12026
280590;202201;3026;6754;2599;6255;143;456;2065;4743;2208;5199
280600;202201;4155;10169;3698;9533;189;505;2830;7213;3019;7718
280610;202201;2825;6439;2519;6046;109;280;2141;5038;2250;5318
280620;202201;6008;13794;5196;12757;371;803;3948;9853;4319;10656
280630;202201;4337;11119;3995;10667;199;578;3340;8895;3539;9473
280640;202201;2570;6477;2263;6136;34;129;2076;5621;2110;5750
280650;202201;1299;3304;1076;2987;84;261;789;2105;873;2366
280660;202201;4006;8324;3464;7705;157;277;2993;6716;3150;6993
280670;202201;21174;47023;18368;43440;1356;3255;14157;33265;15513;36520
280680;202201;3041;6920;2615;6315;222;424;1925;4702;2147;5126
280690;202201;1010;2371;861;2187;32;109;718;1762;750;1871
280700;202201;1270;3002;1097;2759;37;111;888;2186;925;2297
280710;202201;16593;35487;14115;32696;760;1336;12113;28581;12873;29917
280720;202201;2842;6242;2364;5685;86;218;1822;4510;1908;4728
280730;202201;1135;2842;997;2633;79;236;743;1885;822;2121
280740;202201;16194;36250;14008;33063;882;2189;10659;24453;11541;26642
280750;202201;3835;10243;3337;9407;202;606;2452;6822;2654;7428
280760;202201;7237;17843;6297;16500;697;1544;4223;11488;4920;13032
290010;202201;3367;6828;2220;5104;6;18;1858;4103;1864;4121
290020;202201;5787;14492;5283;13883;269;603;4603;12267;4872;12870
290030;202201;5108;10967;4161;9947;186;386;3546;8600;3732;8986
290035;202201;5641;11611;4620;10316;288;520;3697;8327;3985;8847
290040;202201;4964;10940;4235;10077;508;737;3187;8226;3695;8963
290050;202201;2208;6812;1880;6154;115;444;1330;4252;1445;4696
290060;202201;1497;3315;1121;2775;122;310;749;1819;871;2129
290070;202201;41776;86704;36270;80016;1930;4348;29015;62986;30945;67334
290080;202201;5849;16224;5090;15128;476;1488;3667;10996;4143;12484
290090;202201;2310;4276;1647;3569;22;62;1500;3227;1522;3289
290100;202201;10788;26507;8814;23713;1336;3289;5047;14172;6383;17461
290110;202201;5886;14477;5209;13457;584;1421;3507;9108;4091;10529
290115;202201;4345;12256;3715;11177;265;825;2908;8744;3173;9569
290120;202201;7027;16622;5881;15046;160;549;5028;12637;5188;13186
290130;202201;5064;11753;3965;10327;202;515;3044;7980;3246;8495
290135;202201;4723;10585;3888;9261;133;353;3145;7232;3278;7585
290140;202201;4775;12008;3723;10657;115;453;3189;9081;3304;9534
290150;202201;2819;6702;2419;6240;137;330;1920;4984;2057;5314
290160;202201;3849;8105;3432;7546;181;361;2895;6314;3076;6675
290170;202201;3615;8709;3208;8277;94;240;2922;7578;3016;7818
290180;202201;3236;8404;2695;7552;75;293;2265;6270;2340;6563
290190;202201;4772;12137;4231;11428;118;437;3608;9588;3726;10025
290195;202201;2551;6027;2050;5381;46;179;1761;4585;1807;4764
290200;202201;4489;11895;3600;10399;153;517;2743;7805;2896;8322
290205;202201;3825;9258;3422;8689;180;531;2743;6831;2923;7362
290210;202201;13935;36261;12360;33901;795;2101;9951;27381;10746;29482
290220;202201;3194;7257;2812;6782;107;290;2380;5708;2487;5998
290225;202201;3406;6976;2596;6133;73;155;2316;5467;2389;5622
290230;202201;3011;7061;2772;6779;66;140;2491;6141;2557;6281
290240;202201;4004;9579;3180;8589;77;292;2731;7339;2808;7631
290250;202201;4184;11680;3468;10639;108;367;2892;8998;3000;9365
290260;202201;5780;13583;4893;12327;224;647;4129;10187;4353;10834
290265;202201;3756;10508;3071;9262;193;646;2196;6538;2389;7184
290270;202201;11415;37655;10576;36264;613;2589;8536;29123;9149;31712
290280;202201;6573;18980;5695;17272;319;1151;4178;12452;4497;13603
290290;202201;10589;29734;8697;26382;709;2448;6020;17978;6729;20426
290300;202201;4544;11786;3355;9602;212;671;2381;6718;2593;7389
290310;202201;1898;4148;1523;3712;32;120;1336;3188;1368;3308
290320;202201;28033;69187;22759;61520;4158;10611;12615;35521;16773;46132
290323;202201;4140;10561;3560;9670;117;323;2770;7564;2887;7887
290327;202201;4567;12421;3936;11272;331;858;2824;8060;3155;8918
290330;202201;2540;4939;2012;4379;33;50;1818;4012;1851;4062
290340;202201;6406;14906;4911;13137;461;1118;3692;10072;4153;11190
290350;202201;5123;13773;4270;12342;285;821;3045;8800;3330;9621
290360;202201;5254;13166;4604;12332;112;318;4033;10827;4145;11145
290370;202201;5508;12868;4064;10985;154;460;2961;8004;3115;8464
290380;202201;6137;15358;5102;13975;147;360;4406;12180;4553;12540
290390;202201;15898;43225;13198;38980;1318;3917;8928;26669;10246;30586
290395;202201;3225;8639;2578;7554;77;346;1990;5729;2067;6075
290400;202201;4075;10513;3310;9292;134;476;2568;7038;2702;7514
290405;202201;4967;13737;4238;12513;323;977;2966;8874;3289;9851
290410;202201;6065;15736;4654;13541;165;613;3569;10179;3734;10792
290420;202201;3405;8778;2817;7875;90;285;2293;6318;2383;6603
290430;202201;3695;9148;3068;8210;167;542;2323;5992;2490;6534
290440;202201;3054;7228;2219;5954;144;331;1579;4343;1723;4674
290450;202201;3917;9131;3114;7972;157;403;2516;6334;2673;6737
290460;202201;13360;36033;11268;32286;2215;6336;5003;14490;7218;20826
290470;202201;5075;11477;3771;9710;454;1152;2261;5932;2715;7084
290475;202201;7054;19628;5943;17751;103;522;4992;14672;5095;15194
290480;202201;1958;4696;1603;4194;64;236;1190;2966;1254;3202
290485;202201;4945;13725;4345;12898;120;565;3727;10909;3847;11474
290490;202201;9928;22127;8996;20896;341;879;7473;17310;7814;18189
290500;202201;4524;12847;3623;11052;566;1775;1629;4894;2195;6669
290510;202201;3812;8959;3198;8181;65;225;2867;7257;2932;7482
290515;202201;3809;10367;3312;9680;43;137;3006;8910;3049;9047
290520;202201;12902;34810;10126;29638;712;2125;6279;18061;6991;20186
290530;202201;5230;14531;4408;13224;115;477;3741;11134;3856;11611
290540;202201;3737;9311;3388;8936;43;147;3178;8363;3221;8510
290550;202201;4485;11437;3924;10787;31;111;3616;10053;3647;10164
290560;202201;6661;16682;5086;14441;372;1320;3463;9533;3835;10853
290570;202201;47390;112891;42136;106432;1911;5189;35035;87567;36946;92756
290580;202201;8904;23911;7708;22236;752;1963;5648;16926;6400;18889
290590;202201;7393;22107;6244;20097;193;759;5075;16439;5268;17198
290600;202201;20512;54784;17802;50487;861;2444;14304;40640;15165;43084
290610;202201;2730;8155;2169;7043;99;378;1530;4930;1629;5308
290620;202201;6469;17900;5621;16543;247;713;4714;13909;4961;14622
290630;202201;10174;23078;8171;20551;677;1591;6276;16036;6953;17627
290640;202201;2971;7196;2299;6260;189;385;1632;4663;1821;5048
290650;202201;14471;34155;12923;32432;1657;3749;9889;25505;11546;29254
290660;202201;4030;9945;3307;8839;89;242;2517;6800;2606;7042
290670;202201;7707;19282;6618;17641;301;847;5395;14385;5696;15232
290680;202201;11727;31099;9813;28332;288;1263;8165;23192;8453;24455
290682;202201;5084;12579;4437;11734;186;397;3755;10037;3941;10434
290685;202201;3800;8216;2795;6810;388;761;1574;4168;1962;4929
290687;202201;7266;18377;5985;16339;700;1768;4024;11158;4724;12926
290689;202201;3041;8087;2338;6861;243;782;1543;4555;1786;5337
290690;202201;5785;14488;4706;13027;236;783;3572;9712;3808;10495
290700;202201;3137;7442;2810;7042;47;184;2550;6324;2597;6508
290710;202201;9130;24027;7827;22262;243;789;6671;18992;6914;19781
290720;202201;20022;52301;18202;49564;858;2843;15007;40135;15865;42978
290730;202201;7352;17013;6306;15807;278;587;5054;12739;5332;13326
290740;202201;1138;2867;909;2526;23;77;793;2173;816;2250
290750;202201;13101;30029;11442;27498;528;1415;9076;21010;9604;22425
290755;202201;2186;5916;1757;5166;121;333;1214;3609;1335;3942
290760;202201;4024;11288;3322;10018;242;637;2281;7045;2523;7682
290770;202201;2814;8437;2578;8155;75;240;2178;7051;2253;7291
290780;202201;8452;20495;7297;18995;326;735;5728;15201;6054;15936
290790;202201;5288;13647;4601;12664;194;525;3843;10650;4037;11175
290800;202201;7514;14709;5315;12192;244;482;4161;9550;4405;10032
290810;202201;5622;14042;4585;12565;148;414;3530;9875;3678;10289
290820;202201;5475;13766;4966;13065;318;769;3737;9935;4055;10704
290830;202201;4746;10799;4190;10029;62;220;3557;8199;3619;8419
290840;202201;18883;47619;16170;43540;1793;4082;11227;31424;13020;35506
290850;202201;8281;17835;7338;16836;229;479;6449;14863;6678;15342
290860;202201;6564;17700;5712;16732;284;778;4811;14407;5095;15185
290870;202201;5151;13517;3946;11284;273;774;2672;7630;2945;8404
290880;202201;1544;3605;1254;3241;152;331;773;2163;925;2494
290890;202201;9940;19434;8905;18302;161;353;8332;17033;8493;17386
290900;202201;2621;6586;2042;5605;131;369;1299;3504;1430;3873
290910;202201;5529;12611;4213;10663;50;144;3616;9068;3666;9212
290920;202201;5582;13368;4957;12631;126;184;4592;11967;4718;12151
290930;202201;7934;21450;6435;18890;237;921;4990;14304;5227;15225
290940;202201;3812;10395;3224;9545;166;580;2612;7700;2778;8280
290950;202201;1540;3759;1258;3336;89;231;891;2363;980;2594
290960;202201;6203;15006;5540;14206;222;536;4692;12002;4914;12538
290970;202201;3363;9770;2765;8686;123;476;2163;6775;2286;7251
290980;202201;13961;31643;11867;28634;816;1954;7967;18674;8783;20628
290990;202201;10096;26254;8989;24540;304;1211;7588;20084;7892;21295
291000;202201;3613;8905;2779;7862;119;375;2284;6505;2403;6880
291005;202201;16801;39858;14924;37517;925;2312;12328;30800;13253;33112
291010;202201;3242;9558;2627;8246;156;556;1710;5224;1866;5780
291020;202201;1364;3203;1116;2796;32;102;819;1920;851;2022
291030;202201;2701;6264;1944;5025;136;328;1256;3144;1392;3472
291040;202201;5787;15142;4769;13717;210;711;3777;10844;3987;11555
291050;202201;9400;22160;8184;20546;826;2040;6125;15210;6951;17250
291060;202201;7645;20248;6609;18889;362;1321;5236;14766;5598;16087
291070;202201;17238;44283;14424;39889;404;1505;11916;32537;12320;34042
291072;202201;28585;67581;21462;56263;3126;8578;11438;29343;14564;37921
291075;202201;5899;13895;5350;13067;105;291;4556;10850;4661;11141
291077;202201;1788;4563;1392;3875;64;133;989;2752;1053;2885
291080;202201;129608;300625;104415;266895;24252;58336;43209;117410;67461;175746
291085;202201;6018;14580;4928;12966;174;530;4164;10841;4338;11371
291090;202201;2248;4058;1683;3435;29;64;1462;2934;1491;2998
291100;202201;3484;7238;2426;6005;87;257;1918;4682;2005;4939
291110;202201;6400;18298;5419;16669;245;1068;4335;12871;4580;13939
291120;202201;8466;19429;7196;17853;293;844;5756;14091;6049;14935
291125;202201;2412;4116;1831;3469;64;109;1552;2931;1616;3040
291130;202201;3477;9535;2605;7884;79;372;1982;5773;2061;6145
291140;202201;5175;13270;3801;10894;455;1171;2374;6778;2829;7949
291150;202201;2712;5611;2089;4926;7;19;1992;4691;1999;4710
291160;202201;5434;14327;4551;13092;398;1248;3119;8895;3517;10143
291165;202201;2288;6088;1701;4943;37;161;1224;3427;1261;3588
291170;202201;23234;56283;19485;50132;1142;3117;13241;33167;14383;36284
291180;202201;7092;15249;5300;12929;186;517;4399;10621;4585;11138
291185;202201;3353;8411;2974;7845;151;395;2361;6235;2512;6630
291190;202201;8356;19443;6959;17704;216;633;5754;14603;5970;15236
291200;202201;2981;7888;2211;6435;76;279;1458;4056;1534;4335
291210;202201;7922;15979;5877;13668;343;718;4403;10317;4746;11035
291220;202201;4798;12521;4350;11888;294;826;3381;9238;3675;10064
291230;202201;4886;9911;3731;8657;47;89;3416;7972;3463;8061
291240;202201;4423;10992;3742;9881;64;224;3212;8362;3276;8586
291250;202201;3587;10128;2809;8743;191;594;1802;5632;1993;6226
291260;202201;1579;3528;1310;3190;27;77;1097;2668;1124;2745
291270;202201;6062;14570;4794;12804;366;909;3647;9860;4013;10769
291280;202201;2940;6785;2201;5763;200;486;1441;3715;1641;4201
291290;202201;5989;15342;4606;13252;372;1191;3148;8945;3520;10136
291300;202201;4139;10669;3287;9293;119;415;2548;7015;2667;7430
291310;202201;5481;14039;4715;12701;160;484;4006;10678;4166;11162
291320;202201;6796;17653;5347;15163;949;2480;3011;8850;3960;11330
291330;202201;2032;4911;1697;4372;66;196;1323;3316;1389;3512
291340;202201;4640;11421;3739;9923;156;413;2736;7226;2892;7639
291345;202201;3054;8662;2749;8214;108;376;2303;6871;2411;7247
291350;202201;7481;17376;5838;15419;106;275;5104;13613;5210;13888
291360;202201;41425;89291;33104;79585;3144;7098;22854;56286;25998;63384
291370;202201;8736;22810;7750;21322;542;1649;5903;15872;6445;17521
291380;202201;3965;9906;3501;9289;107;393;3032;7929;3139;8322
291390;202201;13761;28497;10554;24989;376;915;8879;20951;9255;21866
291400;202201;16016;37111;13395;33340;1357;3046;9261;23655;10618;26701
291410;202201;3221;8166;2524;6996;61;210;1887;5130;1948;5340
291420;202201;2064;4837;1606;4281;27;104;1432;3805;1459;3909
291430;202201;2882;7745;2490;7097;101;409;1967;5452;2068;5861
291440;202201;6905;18893;5985;17435;354;1059;4657;13679;5011;14738
291450;202201;11010;24015;9098;21864;119;192;8213;20037;8332;20229
291460;202201;17190;43182;15101;40186;707;2174;11703;30685;12410;32859
291465;202201;9579;22767;7503;20402;171;700;6500;17532;6671;18232
291470;202201;19446;40919;16327;37361;934;1994;12484;29043;13418;31037
291480;202201;48590;101412;37045;86341;3512;8125;22866;52188;26378;60313
291490;202201;6096;14517;5296;13628;118;380;4828;12361;4946;12741
291500;202201;5502;12620;4607;11462;76;227;4268;10636;4344;10863
291510;202201;4729;10993;3522;9475;54;270;3000;7966;3054;8236
291520;202201;4900;10606;3747;9132;246;603;2930;7104;3176;7707
291530;202201;2525;5451;1836;4590;189;417;1264;3291;1453;3708
291535;202201;3742;10440;3205;9484;213;542;2466;7519;2679;8061
291540;202201;2350;5031;1640;4196;63;167;1377;3516;1440;3683
291550;202201;6567;13899;5071;12054;459;947;3560;8573;4019;9520
291560;202201;19449;44703;14329;38082;1780;4291;8641;23852;10421;28143
291570;202201;2477;5636;1911;4970;67;164;1617;4306;1684;4470
291580;202201;6950;16971;5480;15048;316;950;4092;11104;4408;12054
291590;202201;2453;5540;2162;5216;59;213;1963;4642;2022;4855
291600;202201;5860;12908;4567;11006;387;983;3206;7490;3593;8473
291610;202201;6123;15121;5501;14445;69;251;5070;13257;5139;13508
291620;202201;3324;7150;2517;6279;154;355;1957;4975;2111;5330
291630;202201;3767;7680;2857;6549;169;368;2323;5287;2492;5655
291640;202201;18179;41791;13951;35889;1448;3816;7828;19836;9276;23652
291650;202201;9640;22899;8498;21563;480;959;7304;18824;7784;19783
291660;202201;2160;5124;1588;4270;103;384;1088;2743;1191;3127
291670;202201;2159;5499;1811;4999;137;348;1325;3726;1462;4074
291680;202201;4409;10200;3587;9049;384;931;2425;6193;2809;7124
291685;202201;5138;11974;4127;10619;203;436;3217;8423;3420;8859
291690;202201;4360;9196;3089;7409;287;559;2344;5671;2631;6230
291700;202201;9379;25692;8305;23896;293;1113;6950;19557;7243;20670
291710;202201;5830;12891;4421;10988;317;791;3275;8026;3592;8817
291720;202201;4707;13582;3936;12104;714;2178;2228;6900;2942;9078
291730;202201;6928;16342;5996;15140;277;749;5066;12727;5343;13476
291733;202201;3070;7471;2594;6847;138;304;1935;5368;2073;5672
291735;202201;3078;7980;2442;6888;77;196;1871;5280;1948;5476
291740;202201;4236;10590;3112;8518;123;292;2172;5912;2295;6204
291750;202201;22346;50251;18398;44563;2070;4468;12322;30569;14392;35037
291760;202201;11655;31424;9237;27709;2763;9155;2865;8617;5628;17772
291770;202201;7944;20231;6664;18074;295;995;5170;13527;5465;14522
291780;202201;5494;14015;4958;13298;104;358;4341;11515;4445;11873
291790;202201;3046;7780;2776;7444;207;509;2211;6008;2418;6517
291800;202201;34406;80822;26636;69927;4079;10059;14396;38446;18475;48505
291810;202201;11157;25275;9494;23316;459;965;7896;19748;8355;20713
291820;202201;4110;10340;3581;9662;115;347;2900;7830;3015;8177
291830;202201;4905;10863;4013;9676;172;347;3255;7857;3427;8204
291835;202201;7045;20140;5664;17624;481;1525;3918;12346;4399;13871
291840;202201;50639;133957;44308;124445;3635;11287;32967;91868;36602;103155
291845;202201;2922;6980;2356;6307;86;241;2023;5462;2109;5703
291850;202201;4536;11923;3813;10784;134;369;3149;8959;3283;9328
291855;202201;2362;4404;1849;3844;27;63;1708;3541;1735;3604
291860;202201;2393;6088;1676;4745;43;145;1107;3032;1150;3177
291870;202201;1392;3359;954;2605;40;122;670;1794;710;1916
291875;202201;3174;9217;2737;8332;80;350;2044;6017;2124;6367
291880;202201;5983;16077;5151;14754;262;713;3889;11249;4151;11962
291890;202201;1766;3482;1166;2785;173;376;734;1752;907;2128
291900;202201;1442;3240;1101;2745;30;99;882;2135;912;2234
291905;202201;2541;6341;2107;5699;85;302;1644;4291;1729;4593
291910;202201;3413;7888;2900;7276;73;170;2543;6511;2616;6681
291915;202201;7812;21185;6381;18823;244;748;4807;14382;5051;15130
291920;202201;31393;75948;27136;70370;1767;5449;20739;52357;22506;57806
291930;202201;2663;6704;2298;6214;199;517;1682;4617;1881;5134
291940;202201;4206;10180;2877;8021;249;645;1742;4841;1991;5486
291950;202201;9738;28603;8204;25785;353;1340;5753;17901;6106;19241
291955;202201;17459;41962;15617;39634;1127;3015;12682;32144;13809;35159
291960;202201;3757;8625;3157;7856;192;361;2544;6483;2736;6844
291970;202201;4949;11786;4156;10826;162;498;3191;8295;3353;8793
291980;202201;10882;29047;8819;25642;857;2181;6027;17926;6884;20107
291990;202201;2478;6141;2035;5608;31;126;1879;5160;1910;5286
291992;202201;4411;10044;3679;9134;222;474;3013;7607;3235;8081
291995;202201;2371;6046;1951;5397;81;287;1532;4126;1613;4413
292000;202201;2841;6349;2322;5733;77;247;1910;4698;1987;4945
292010;202201;6128;13746;5003;12151;104;382;4301;10172;4405;10554
292020;202201;5120;13593;4324;12277;166;621;3459;9498;3625;10119
292030;202201;2148;6066;1918;5665;131;408;1268;3661;1399;4069
292040;202201;4874;11626;3833;10135;195;493;3019;8054;3214;8547
292045;202201;4406;10737;3326;9186;32;102;3003;8403;3035;8505
292050;202201;7048;18622;5747;16454;309;1059;3840;10799;4149;11858
292060;202201;12440;27079;11544;25986;309;730;10411;23052;10720;23782
292070;202201;6099;15115;5317;14200;277;779;4613;12242;4890;13021
292080;202201;3648;8201;3022;7413;45;152;2782;6769;2827;6921
292090;202201;4805;10043;3432;8394;174;464;2718;6589;2892;7053
292100;202201;13764;31019;11822;28664;1873;4180;7191;18254;9064;22434
292105;202201;3856;9147;3360;8493;50;184;2875;7217;2925;7401
292110;202201;6682;15051;4800;12300;752;1916;2826;7194;3578;9110
292120;202201;7645;18603;6345;16467;403;1020;4747;12134;5150;13154
292130;202201;3675;8458;3051;7702;177;511;2348;5883;2525;6394
292140;202201;5952;12713;5068;11495;145;339;4473;10043;4618;10382
292145;202201;2784;7207;2338;6477;98;240;1864;5196;1962;5436
292150;202201;16117;40681;13993;37344;343;1377;11756;30657;12099;32034
292160;202201;3201;7425;2437;6461;48;128;1983;5525;2031;5653
292170;202201;9583;23824;8083;21498;389;1254;6341;16440;6730;17694
292180;202201;3154;8196;2350;6741;138;429;1517;4254;1655;4683
292190;202201;3093;7819;2638;7169;190;521;1984;5459;2174;5980
292200;202201;9906;23002;7507;19715;1376;3516;3840;10533;5216;14049
292205;202201;3962;10639;3444;9890;92;343;2973;8501;3065;8844
292210;202201;7054;15444;5731;13805;90;315;5228;12490;5318;12805
292220;202201;2366;5256;2051;4798;76;183;1605;3636;1681;3819
292225;202201;3478;9625;3078;9049;69;313;2718;7848;2787;8161
292230;202201;9523;21543;8540;20321;179;568;7495;17545;7674;18113
292240;202201;5134;14192;4504;13089;272;786;3261;9436;3533;10222
292250;202201;6414;15499;5779;14609;265;723;4660;11594;4925;12317
292260;202201;3491;8899;3111;8416;68;216;2743;7404;2811;7620
292265;202201;3794;9686;3146;8715;69;302;2606;7035;2675;7337
292270;202201;4513;9953;3582;8853;95;261;2983;7349;3078;7610
292273;202201;3025;6189;2421;5468;124;188;1757;4229;1881;4417
292275;202201;1750;4432;1397;3967;68;207;1074;3075;1142;3282
292280;202201;2859;6394;2317;5775;106;188;1957;5025;2063;5213
292285;202201;2799;6371;2235;5626;71;167;1864;4706;1935;4873
292290;202201;8132;20087;6423;17733;171;538;5353;14743;5524;15281
292300;202201;11096;26542;8826;23602;829;2336;6252;16772;7081;19108
292303;202201;3179;8607;2744;7941;105;260;2313;6766;2418;7026
292305;202201;2377;6206;2176;5934;53;218;1955;5249;2008;5467
292310;202201;7505;17478;6518;16292;96;359;5844;14370;5940;14729
292320;202201;6492;16852;5192;14580;200;717;3980;10856;4180;11573
292330;202201;3025;6161;2487;5572;145;253;1981;4607;2126;4860
292335;202201;5196;12928;4587;12045;197;433;3902;10382;4099;10815
292340;202201;5714;15688;4735;13866;234;711;3494;10125;3728;10836
292350;202201;2717;7039;2278;6460;117;351;1855;5271;1972;5622
292360;202201;5355;13630;4481;12200;207;604;3297;8861;3504;9465
292370;202201;10986;25106;9426;23092;117;420;8794;21286;8911;21706
292380;202201;7276;19645;6504;18312;398;1177;5041;14049;5439;15226
292390;202201;5127;9166;3835;7700;80;156;3482;6934;3562;7090
292400;202201;24156;65366;20910;60431;1805;5434;14897;43217;16702;48651
292405;202201;4867;11282;4105;10133;101;289;3479;8425;3580;8714
292410;202201;2381;5402;2006;4931;47;139;1816;4444;1863;4583
292420;202201;4212;10928;3775;10315;87;367;3354;8954;3441;9321
292430;202201;5332;15148;4100;12936;319;1137;2788;8745;3107;9882
292440;202201;9170;27858;8439;26797;146;738;7582;23973;7728;24711
292450;202201;4431;11902;3459;10100;113;377;2713;7861;2826;8238
292460;202201;5893;14492;4925;12994;184;514;4021;10438;4205;10952
292465;202201;2882;6984;2459;6459;184;337;1661;4785;1845;5122
292467;202201;2136;5589;1893;5274;264;614;1350;3950;1614;4564
292470;202201;3179;7784;2452;6667;86;200;1867;5110;1953;5310
292480;202201;6773;15185;5525;13692;76;264;5058;12409;5134;12673
292490;202201;2699;6044;2278;5472;99;206;1881;4491;1980;4697
292500;202201;7535;18809;6049;16400;337;999;4340;11605;4677;12604
292510;202201;14810;37011;11603;32127;648;1999;8392;23091;9040;25090
292520;202201;7925;18814;7020;17506;331;952;5740;14048;6071;15000
292525;202201;6597;14884;5418;13566;85;228;4881;12296;4966;12524
292530;202201;33419;83543;26723;73011;4866;13681;14095;38404;18961;52085
292540;202201;4774;8406;3788;7365;92;163;3482;6774;3574;6937
292550;202201;8615;21594;6606;19230;483;1346;4785;14759;5268;16105
292560;202201;4713;11491;3983;10498;167;499;3002;7817;3169;8316
292570;202201;3979;9947;3325;8819;65;249;2825;7291;2890;7540
292575;202201;7054;19690;6473;18945;505;1400;5123;15193;5628;16593
292580;202201;8118;19552;6713;17530;122;412;5778;14854;5900;15266
292590;202201;7795;20138;6564;18001;317;1036;5307;14267;5624;15303
292593;202201;3031;7345;2523;6506;73;208;2123;5422;2196;5630
292595;202201;5881;14831;5057;13821;151;515;4370;11857;4521;12372
292600;202201;12079;30745;10506;28463;495;1254;8477;23038;8972;24292
292610;202201;4774;11432;4099;10333;136;323;3294;8263;3430;8586
292620;202201;6947;17992;5704;16506;143;365;5187;15271;5330;15636
292630;202201;9710;22319;7864;19480;887;1997;5061;12733;5948;14730
292640;202201;8720;24328;7533;22448;336;1123;5439;16324;5775;17447
292650;202201;4615;11163;4112;10515;70;277;3782;9529;3852;9806
292660;202201;12007;31384;10198;28765;665;1834;7650;21795;8315;23629
292665;202201;2272;6459;1947;6037;64;215;1616;5092;1680;5307
292670;202201;3760;9937;2932;8426;146;468;2016;5667;2162;6135
292680;202201;4349;10815;3455;9299;132;382;2670;6969;2802;7351
292690;202201;2811;7007;1953;5634;206;523;1234;3683;1440;4206
292700;202201;10914;28044;9523;25939;729;1731;6896;19187;7625;20918
292710;202201;2965;8197;2765;7944;44;147;2565;7376;2609;7523
292720;202201;9682;21855;8187;20147;414;852;6648;16647;7062;17499
292730;202201;5424;11760;4949;11064;296;496;4144;9425;4440;9921
292740;202201;362173;826203;317127;765176;36112;87491;218079;520994;254191;608485
292750;202201;6903;16949;6101;15862;228;611;5054;13211;5282;13822
292760;202201;4266;11485;3738;10604;192;620;2866;7988;3058;8608
292770;202201;7196;17504;5875;15745;733;1913;4121;11259;4854;13172
292780;202201;2285;4283;1717;3622;55;141;1417;2843;1472;2984
292790;202201;4189;8568;3175;7478;145;354;2691;6329;2836;6683
292800;202201;12093;29306;10366;26732;456;1227;8559;21904;9015;23131
292805;202201;4011;9056;3171;8007;113;294;2577;6455;2690;6749
292810;202201;12259;29107;9867;25481;531;1401;7626;19249;8157;20650
292820;202201;7657;20589;5627;17212;333;1292;4085;12187;4418;13479
292830;202201;3101;7073;2645;6531;96;222;2276;5673;2372;5895
292840;202201;9677;23872;8213;21953;155;579;7324;19279;7479;19858
292850;202201;2813;6900;2388;6297;228;542;1661;4413;1889;4955
292860;202201;18104;37955;16370;35967;554;1191;14251;31100;14805;32291
292870;202201;21422;49295;18690;45615;1094;2679;13658;32621;14752;35300
292880;202201;12312;32080;10557;29487;385;1418;8342;22510;8727;23928
292890;202201;7905;20512;6983;19223;156;601;6218;16984;6374;17585
292895;202201;3452;6909;2612;5698;107;201;2134;4620;2241;4821
292900;202201;2874;7342;2620;6978;58;237;2206;5715;2264;5952
292905;202201;4735;11512;3796;10128;106;338;2978;7817;3084;8155
292910;202201;5140;13388;4706;12798;164;476;3777;10117;3941;10593
292920;202201;10469;27679;9749;26733;266;999;8568;23182;8834;24181
292925;202201;5631;15481;4712;13824;301;914;3391;9914;3692;10828
292930;202201;7013;19440;6125;17886;569;1852;4006;11483;4575;13335
292935;202201;2709;6235;2138;5603;21;91;1934;5082;1955;5173
292937;202201;2954;7210;2527;6664;146;364;1881;5059;2027;5423
292940;202201;3236;7725;2591;6781;260;582;1791;4839;2051;5421
292950;202201;10170;24987;8906;23209;469;1173;6897;17786;7366;18959
292960;202201;5721;13186;4806;11914;161;350;3872;9544;4033;9894
292970;202201;4108;11121;3649;10471;105;378;3058;8835;3163;9213
292975;202201;4637;9688;4132;9133;103;202;3790;8404;3893;8606
292980;202201;3881;8512;3196;7548;69;216;2768;6410;2837;6626
292990;202201;12439;32706;10452;29372;500;1642;8035;22023;8535;23665
293000;202201;2919;6687;2518;6088;65;216;2043;4893;2108;5109
293010;202201;19879;48291;16157;42770;1671;4525;10743;28345;12414;32870
293015;202201;9448;27191;7536;23604;547;1774;5282;16759;5829;18533
293020;202201;10459;29158;9427;27710;164;641;8518;25084;8682;25725
293030;202201;5561;14058;4280;12111;197;519;2967;8647;3164;9166
293040;202201;4795;11736;4002;10643;78;283;3536;9332;3614;9615
293050;202201;24950;57070;22030;52871;1229;2914;17014;40296;18243;43210
293060;202201;4027;10137;3262;8728;209;602;2367;6128;2576;6730
293070;202201;28237;64338;25112;60510;1907;4642;19554;46889;21461;51531
293075;202201;3984;11603;3475;10783;97;479;2954;9100;3051;9579
293076;202201;3755;8757;3423;8378;77;154;3055;7566;3132;7720
293077;202201;6942;18198;5622;16190;583;1718;3546;10740;4129;12458
293080;202201;5059;14296;4311;13016;107;504;3533;10460;3640;10964
293090;202201;3411;9628;2651;8355;202;634;1836;5816;2038;6450
293100;202201;6253;15787;5191;13957;244;607;4127;11081;4371;11688
293105;202201;4128;12450;3598;11396;232;761;2557;8059;2789;8820
293110;202201;2608;6108;2195;5536;66;202;1821;4503;1887;4705
293120;202201;5064;12553;4597;11870;250;463;3868;10150;4118;10613
293130;202201;3947;10423;3422;9767;70;306;3043;8607;3113;8913
293135;202201;33521;75430;25027;64350;4139;11039;11710;30583;15849;41622
293140;202201;2790;5584;2454;5188;71;113;2163;4536;2234;4649
293150;202201;5599;16242;4639;14513;337;1169;3267;10167;3604;11336
293160;202201;4075;9559;3511;8947;229;405;2980;7947;3209;8352
293170;202201;5428;10589;4762;9799;73;181;4296;8758;4369;8939
293180;202201;4795;12784;4000;11369;86;370;3265;9023;3351;9393
293190;202201;15773;39829;13814;37114;145;636;12422;33065;12567;33701
293200;202201;9594;21995;7825;19268;219;662;6577;15930;6796;16592
293210;202201;5637;13998;4842;12829;359;894;3709;9889;4068;10783
293220;202201;5823;13811;4363;11476;652;1671;2518;6630;3170;8301
293230;202201;4393;10382;3281;8916;244;648;2385;6571;2629;7219
293240;202201;4918;12147;3982;10679;159;296;3008;8450;3167;8746
293245;202201;4150;10702;3776;10168;144;433;3238;8621;3382;9054
293250;202201;6363;14333;5175;12796;226;604;4199;10284;4425;10888
293260;202201;5151;12789;4253;11418;184;401;3049;8282;3233;8683
293270;202201;7853;16476;6242;14760;520;685;5038;12706;5558;13391
293280;202201;4843;12119;4239;11282;257;611;3322;8945;3579;9556
293290;202201;17515;46051;15643;43243;1518;4274;11306;31227;12824;35501
293300;202201;6514;14836;5656;13617;388;882;4245;10193;4633;11075
293305;202201;4538;10371;3936;9625;50;133;3594;8783;3644;8916
293310;202201;2373;5719;2013;5171;39;133;1652;4151;1691;4284
293315;202201;4570;10107;3773;8963;177;352;3164;7498;3341;7850
293317;202201;3005;6543;2671;6080;195;351;2086;4747;2281;5098
293320;202201;13227;30154;11789;28584;156;531;10839;26037;10995;26568
293325;202201;1921;4556;1527;4058;179;469;1040;2779;1219;3248
293330;202201;72051;187049;59734;166780;8321;24691;33137;90138;41458;114829
293340;202201;2341;6320;1926;5606;149;463;1307;3773;1456;4236
293345;202201;3999;10096;3208;8913;319;646;2184;6548;2503;7194
293350;202201;6754;18482;5790;17323;86;321;5245;15874;5331;16195
293360;202201;16499;39158;14194;36138;231;1036;12826;32009;13057;33045
310010;202201;1064;2305;717;1850;70;188;286;705;356;893
310020;202201;3172;8066;2452;6846;453;1305;905;2406;1358;3711
310030;202201;2053;5574;1598;4794;204;691;1079;3145;1283;3836
310040;202201;920;2303;730;1984;69;235;402;969;471;1204
310050;202201;1619;4569;1375;4195;96;384;965;2859;1061;3243
310060;202201;3443;9175;2964;8547;121;431;2436;6985;2557;7416
310070;202201;350;786;257;658;8;21;192;485;200;506
310080;202201;771;2009;565;1645;68;221;299;837;367;1058
310090;202201;5284;12864;4383;11452;191;609;3481;8891;3672;9500
310100;202201;3930;9993;3341;9082;99;400;2837;7499;2936;7899
310110;202201;5118;12804;3987;10936;603;1872;2250;5893;2853;7765
310120;202201;691;1597;453;1226;51;168;266;651;317;819
310130;202201;399;1003;344;923;16;60;279;727;295;787
310140;202201;325;863;243;750;49;175;112;318;161;493
310150;202201;6500;15858;4958;13192;481;1553;2720;6747;3201;8300
310160;202201;9999;23641;7605;19925;1108;3129;3505;8992;4613;12121
310163;202201;1234;3502;985;3018;191;648;338;941;529;1589
310170;202201;10403;24815;8442;21907;698;1814;6082;15788;6780;17602
310180;202201;2098;4842;1535;3974;140;445;1005;2492;1145;2937
310190;202201;2972;8208;2460;7330;573;1872;565;1614;1138;3486
310200;202201;2247;6144;1702;5182;208;725;913;2690;1121;3415
310205;202201;1187;3130;954;2767;122;368;591;1737;713;2105
310210;202201;2690;7009;2209;6158;123;389;1577;4245;1700;4634
310220;202201;1329;3466;1028;2893;81;243;683;1851;764;2094
310230;202201;2409;6361;1961;5559;212;696;1272;3388;1484;4084
310240;202201;1105;3105;950;2853;62;233;662;1912;724;2145
310250;202201;1164;2908;955;2590;43;126;729;1932;772;2058
310260;202201;3609;8951;2476;6979;613;2027;915;2158;1528;4185
310270;202201;2988;6822;2405;6063;81;235;2045;5139;2126;5374
310280;202201;2741;6053;2212;5333;146;422;1556;3570;1702;3992
310285;202201;1973;6019;1659;5464;150;576;1066;3469;1216;4045
310290;202201;1461;3678;1247;3321;145;474;799;1940;944;2414
310300;202201;1775;4800;1492;4332;162;571;880;2383;1042;2954
310310;202201;353;822;240;633;35;103;132;326;167;429
310320;202201;554;1340;396;1095;17;67;242;639;259;706
310330;202201;532;1226;331;875;45;130;139;330;184;460
310340;202201;8945;22150;7182;19200;835;2218;4025;10735;4860;12953
310350;202201;14288;33393;10213;27037;1518;4352;5315;13503;6833;17855
310360;202201;620;1340;504;1197;21;59;338;781;359;840
310370;202201;1340;4000;1163;3694;195;691;399;1359;594;2050
310375;202201;927;2210;678;1850;105;296;383;1052;488;1348
310380;202201;419;940;240;669;25;71;126;332;151;403
310390;202201;563;1592;454;1391;72;253;191;526;263;779
310400;202201;12546;29597;9428;24979;648;2094;6267;15964;6915;18058
310410;202201;1141;3204;646;2142;75;278;241;729;316;1007
310420;202201;5228;13001;3868;10628;499;1526;1870;4745;2369;6271
310430;202201;1831;4731;1275;3750;194;603;556;1454;750;2057
310440;202201;717;1807;510;1445;47;172;271;716;318;888
310445;202201;1486;4025;1117;3342;78;236;785;2296;863;2532
310450;202201;4818;11698;3705;9973;140;526;2910;7622;3050;8148
310460;202201;1923;4933;1500;4197;201;642;648;1655;849;2297
310470;202201;3925;8446;3063;7334;301;627;2174;5348;2475;5975
310480;202201;1096;2728;853;2337;98;318;526;1357;624;1675
310490;202201;3092;8060;2460;7063;265;933;1454;3889;1719;4822
310500;202201;1523;3971;1171;3412;181;588;673;1895;854;2483
310510;202201;2394;6042;1711;4817;258;773;799;2208;1057;2981
310520;202201;1253;3128;930;2553;137;369;500;1386;637;1755
310530;202201;818;2012;572;1603;93;298;215;503;308;801
310540;202201;3273;8933;2723;7955;437;1458;1426;3853;1863;5311
310550;202201;1383;3312;1008;2704;72;254;617;1523;689;1777
310560;202201;17391;43614;12667;35330;1499;4704;6109;15401;7608;20105
310570;202201;1134;2855;905;2537;47;175;713;1959;760;2134
310590;202201;4647;11637;3749;10027;223;723;2345;5865;2568;6588
310600;202201;1483;4152;1227;3639;149;495;674;1883;823;2378
310610;202201;520;1382;347;1107;115;388;81;250;196;638
310620;202201;214981;522271;163688;432989;17881;56303;92134;222212;110015;278515
310630;202201;5066;13260;3971;11161;409;1228;2441;6676;2850;7904
310640;202201;1391;3742;1145;3297;143;495;656;1763;799;2258
310650;202201;2669;6997;1994;5762;147;517;1298;3560;1445;4077
310660;202201;1501;3823;1244;3470;33;98;1077;2988;1110;3086
310665;202201;1511;3653;1244;3303;23;71;1013;2730;1036;2801
310670;202201;66295;162257;56389;146222;4342;13239;40380;99609;44722;112848
310680;202201;849;1889;709;1698;20;83;606;1388;626;1471
310690;202201;2359;5641;1749;4700;126;423;1146;2886;1272;3309
310700;202201;528;1117;408;972;8;24;311;713;319;737
310710;202201;6637;17781;4876;15155;971;3688;1070;3021;2041;6709
310720;202201;1170;2587;919;2280;30;108;707;1676;737;1784
310730;202201;11111;27774;9536;25388;361;1251;7307;18923;7668;20174
310740;202201;7159;18794;5343;15291;686;2276;2398;6237;3084;8513
310750;202201;1421;3216;1106;2774;77;237;689;1593;766;1830
310760;202201;752;1825;542;1509;45;129;323;894;368;1023
310770;202201;1141;2981;806;2483;71;279;439;1245;510;1524
310780;202201;4608;10413;3820;9389;147;392;3006;7382;3153;7774
310790;202201;1965;5992;1698;5425;380;1358;349;948;729;2306
310800;202201;2570;7342;1901;6037;486;1756;149;426;635;2182
310810;202201;1445;3393;1202;3009;49;142;891;2137;940;2279
310820;202201;1295;3186;812;2398;164;495;225;676;389;1171
310825;202201;2844;7906;2297;7038;70;366;1898;5641;1968;6007
310830;202201;2147;5719;1632;4793;297;1020;732;1997;1029;3017
310840;202201;2375;6193;1816;5262;386;1318;586;1488;972;2806
310850;202201;1500;4003;1251;3638;47;226;981;2746;1028;2972
310855;202201;3376;8529;2638;7367;163;496;1930;5302;2093;5798
310860;202201;7372;20347;6046;17943;597;1742;3863;11556;4460;13298
310870;202201;1025;2364;821;2083;54;156;612;1520;666;1676
310880;202201;1041;3012;841;2621;101;327;495;1523;596;1850
310890;202201;2422;6724;1610;5114;322;1116;280;780;602;1896
310900;202201;4264;11476;3103;9084;467;1528;1424;3818;1891;5346
310910;202201;2381;5577;1697;4518;236;680;439;1078;675;1758
310920;202201;2034;5068;1561;4387;139;431;1027;2817;1166;3248
310925;202201;1109;2763;906;2459;41;152;697;1800;738;1952
310930;202201;6113;15187;4410;12538;802;2256;2175;6458;2977;8714
310940;202201;7431;16439;6064;14514;211;609;4872;11341;5083;11950
310945;202201;1420;3492;1125;3021;144;447;665;1694;809;2141
310950;202201;2048;5884;1385;4440;232;839;441;1226;673;2065
310960;202201;783;2016;467;1381;81;275;118;325;199;600
310970;202201;1259;3611;927;2943;227;750;194;591;421;1341
310980;202201;371;842;204;559;21;60;111;299;132;359
310990;202201;1487;3842;1197;3364;135;432;721;1931;856;2363
311000;202201;4226;11267;3184;9623;602;2010;1593;4629;2195;6639
311010;202201;1041;2723;853;2406;186;555;451;1262;637;1817
311020;202201;1259;3107;839;2379;46;149;464;1265;510;1414
311030;202201;1957;4684;1436;3846;291;904;667;1660;958;2564
311040;202201;318;952;267;847;75;258;86;258;161;516
311050;202201;3276;7882;2499;6753;349;1056;1343;3518;1692;4574
311060;202201;3609;8909;2749;7403;383;1158;1205;3018;1588;4176
311070;202201;2597;6155;1929;5148;168;590;1180;2951;1348;3541
311080;202201;1244;2719;1005;2358;42;152;807;1787;849;1939
311090;202201;2522;7489;2073;6677;406;1434;774;2449;1180;3883
311100;202201;2640;7170;1666;5280;335;1180;410;1142;745;2322
311110;202201;3984;7973;2302;5639;426;1057;825;2079;1251;3136
311115;202201;1506;3182;1262;2869;48;119;1059;2360;1107;2479
311120;202201;7606;19217;5952;16384;840;2629;2429;5951;3269;8580
311130;202201;2038;5170;1557;4526;113;406;956;2712;1069;3118
311140;202201;1624;3878;1290;3428;95;282;925;2415;1020;2697
311150;202201;1582;4825;1257;4219;162;609;681;2224;843;2833
311160;202201;4316;11844;3175;9808;604;2133;1275;3742;1879;5875
311170;202201;995;2456;816;2224;43;128;518;1502;561;1630
311180;202201;1514;3272;1003;2543;170;431;518;1298;688;1729
311190;202201;935;2536;709;2099;106;355;294;751;400;1106
311200;202201;2358;6107;1729;4919;274;861;707;1807;981;2668
311205;202201;980;2696;821;2414;35;141;564;1554;599;1695
311210;202201;1125;3122;990;2937;110;291;728;2242;838;2533
311220;202201;863;2200;736;1978;23;90;544;1365;567;1455
311230;202201;8718;24791;6719;20898;1069;3480;2806;8818;3875;12298
311240;202201;1166;2880;911;2529;149;444;471;1282;620;1726
311250;202201;1340;3629;1062;3135;187;607;464;1269;651;1876
311260;202201;3000;7038;1969;5303;259;806;958;2285;1217;3091
311265;202201;1401;3443;1038;2863;46;173;750;2014;796;2187
311270;202201;3216;9157;2807;8515;158;716;2070;6022;2228;6738
311280;202201;1207;3091;664;2033;120;413;141;376;261;789
311290;202201;2005;5803;1825;5456;112;386;1285;3804;1397;4190
311300;202201;5038;13245;4175;11838;198;725;3388;9408;3586;10133
311310;202201;623;1659;530;1495;32;98;363;986;395;1084
311320;202201;3521;10262;3073;9315;278;1072;1700;4705;1978;5777
311330;202201;6349;15231;5079;13282;481;1330;2992;7856;3473;9186
311340;202201;11634;30899;9353;27035;2018;6419;3380;9259;5398;15678
311350;202201;2632;6132;1949;4977;159;462;1137;2623;1296;3085
311360;202201;1190;2818;822;2308;200;608;328;943;528;1551
311370;202201;5209;12072;3902;10083;282;928;2501;6053;2783;6981
311380;202201;393;1160;294;964;57;192;149;492;206;684
311390;202201;1878;5487;1503;4993;624;2341;449;1344;1073;3685
311400;202201;1747;4576;1299;3751;225;674;421;1059;646;1733
311410;202201;2023;5668;1630;5056;223;823;956;2857;1179;3680
311420;202201;1698;4786;1274;3985;264;957;402;1059;666;2016
311430;202201;4779;12096;3278;9258;468;1390;1378;3705;1846;5095
311440;202201;3294;8729;2537;7506;643;2186;660;1897;1303;4083
311450;202201;2080;5963;1526;4944;388;1454;399;1086;787;2540
311455;202201;1125;2439;792;1964;112;264;431;1066;543;1330
311460;202201;596;1735;406;1342;76;295;96;266;172;561
311470;202201;563;1658;393;1288;101;368;63;212;164;580
311480;202201;1192;2820;984;2512;70;178;763;1931;833;2109
311490;202201;276;794;217;696;35;139;97;276;132;415
311500;202201;521;1242;410;1076;28;86;270;685;298;771
311510;202201;3599;8850;2573;7165;287;933;1213;3123;1500;4056
311520;202201;688;1831;606;1683;59;197;373;1021;432;1218
311530;202201;9464;21331;6378;16599;1227;3638;2290;5707;3517;9345
311535;202201;910;2380;645;1842;97;294;272;722;369;1016
311540;202201;535;1603;477;1498;57;213;357;1093;414;1306
311545;202201;2126;5853;1839;5422;94;345;1447;4207;1541;4552
311547;202201;1669;3904;1461;3605;52;106;1151;2804;1203;2910
311550;202201;3204;8338;2611;7329;362;1114;1220;3231;1582;4345
311560;202201;332;688;220;525;41;110;101;206;142;316
311570;202201;1657;3732;1174;3073;40;111;907;2411;947;2522
311580;202201;2374;4399;1644;3538;138;267;1154;2457;1292;2724
311590;202201;579;1477;474;1324;66;201;288;790;354;991
311600;202201;1747;3966;1458;3585;116;336;1151;2760;1267;3096
311610;202201;2465;7294;2068;6563;136;536;1352;4149;1488;4685
311615;202201;3590;9491;2897;8391;124;467;2350;6672;2474;7139
311620;202201;550;1340;438;1193;59;179;307;820;366;999
311630;202201;1442;3805;1208;3356;130;378;760;2071;890;2449
311640;202201;798;2070;640;1826;66;236;353;929;419;1165
311650;202201;2093;5019;1705;4445;176;496;1077;2730;1253;3226
311660;202201;3219;8923;2456;7469;375;1302;696;1733;1071;3035
311670;202201;1743;4259;1301;3484;147;445;650;1718;797;2163
311680;202201;2429;6424;1875;5470;113;340;1374;4009;1487;4349
311690;202201;660;1364;513;1181;29;59;395;943;424;1002
311700;202201;2304;5315;1797;4601;25;118;1520;3786;1545;3904
311710;202201;1690;4662;1249;3916;268;883;492;1566;760;2449
311720;202201;455;1289;371;1147;39;141;203;630;242;771
311730;202201;4156;10274;2846;7749;682;1943;1049;2754;1731;4697
311740;202201;1042;2585;871;2353;66;158;726;2015;792;2173
311750;202201;4363;12190;3572;10859;339;1227;2376;6873;2715;8100
311760;202201;720;1938;592;1731;87;309;257;633;344;942
311770;202201;2378;6458;1886;5621;284;939;922;2613;1206;3552
311780;202201;1496;4120;1130;3453;187;641;425;1151;612;1792
311783;202201;2463;6269;2014;5548;58;243;1649;4374;1707;4617
311787;202201;899;2478;719;2090;101;327;333;850;434;1177
311790;202201;1624;4313;1109;3376;223;766;367;1028;590;1794
311800;202201;5547;15958;4546;13921;928;2944;848;2159;1776;5103
311810;202201;1011;2871;810;2526;50;176;552;1698;602;1874
311820;202201;918;2121;717;1831;46;160;486;1160;532;1320
311830;202201;9163;25067;6678;19933;1884;5831;1265;3721;3149;9552
311840;202201;4095;9740;3325;8671;202;549;2563;6658;2765;7207
311850;202201;393;989;323;870;17;60;218;548;235;608
311860;202201;71795;172488;56801;147680;6177;18109;35665;87771;41842;105880
311870;202201;2016;5171;1454;4231;251;882;653;1758;904;2640
311880;202201;6994;17127;5870;15586;339;837;4440;11998;4779;12835
311890;202201;1879;4268;1472;3731;63;207;1102;2639;1165;2846
311900;202201;803;1973;612;1718;76;220;372;1063;448;1283
311910;202201;4491;10883;3444;9526;585;1691;1842;5171;2427;6862
311920;202201;2302;5740;1864;5124;125;327;1253;3481;1378;3808
311930;202201;4553;10079;3368;8500;725;1989;1521;3622;2246;5611
311940;202201;17307;43136;12925;35266;1675;5038;6150;15616;7825;20654
311950;202201;2548;6412;1956;5424;155;471;1262;3472;1417;3943
311960;202201;521;1251;414;1093;41;133;230;551;271;684
311970;202201;465;1436;347;1153;71;274;94;272;165;546
311980;202201;502;1301;277;879;28;93;110;326;138;419
311990;202201;569;1310;373;1019;58;193;162;401;220;594
311995;202201;1025;2792;558;1734;34;126;77;149;111;275
312000;202201;864;1988;654;1679;42;121;464;1179;506;1300
312010;202201;1120;2849;894;2504;40;160;644;1716;684;1876
312015;202201;1499;4098;1335;3841;57;236;1085;3040;1142;3276
312020;202201;1884;5593;1382;4478;252;873;326;950;578;1823
312030;202201;2228;5129;1927;4798;15;63;1823;4523;1838;4586
312040;202201;899;2579;656;2106;86;288;308;956;394;1244
312050;202201;1306;3839;1082;3441;235;935;418;1183;653;2118
312060;202201;1025;2393;677;1933;140;412;336;944;476;1356
312070;202201;985;2684;722;2177;40;149;441;1233;481;1382
312080;202201;2983;7086;2299;6096;121;376;1604;4046;1725;4422
312083;202201;1012;2482;787;2147;51;183;591;1559;642;1742
312087;202201;2732;6683;2220;5906;48;146;1835;4880;1883;5026
312090;202201;11792;29518;9410;25834;1037;3334;5456;14186;6493;17520
312100;202201;1718;4687;1385;4094;92;382;914;2542;1006;2924
312110;202201;1087;3236;907;2881;175;661;387;1122;562;1783
312120;202201;1089;2879;778;2355;178;639;262;675;440;1314
312125;202201;1969;4777;1688;4405;89;269;1352;3438;1441;3707
312130;202201;1195;2798;901;2315;79;233;434;1011;513;1244
312140;202201;764;2150;643;1914;94;305;322;906;416;1211
312150;202201;515;1355;441;1221;28;86;293;759;321;845
312160;202201;10069;25903;7933;22280;883;2870;4171;11136;5054;14006
312170;202201;975;2449;750;2041;45;147;496;1307;541;1454
312180;202201;1505;3825;1226;3338;126;382;713;1863;839;2245
312190;202201;777;2031;591;1708;69;234;294;805;363;1039
312200;202201;4918;12736;3895;11135;590;1683;2165;6126;2755;7809
312210;202201;1478;3172;1115;2682;46;163;875;2039;921;2202
312220;202201;1739;5087;1510;4683;106;386;1026;3164;1132;3550
312230;202201;17794;43673;12875;35186;2597;8069;4149;9806;6746;17875
312235;202201;2190;5189;1749;4581;116;361;1287;3266;1403;3627
312240;202201;824;2528;647;2171;135;474;218;721;353;1195
312245;202201;2945;6995;2457;6289;50;138;2117;5370;2167;5508
312247;202201;1121;2499;832;2099;82;224;558;1373;640;1597
312250;202201;1004;2597;644;1912;88;282;238;679;326;961
312260;202201;1048;2636;845;2337;45;174;675;1783;720;1957
312270;202201;764;2063;596;1741;32;127;334;898;366;1025
312280;202201;445;1261;350;1093;81;275;88;255;169;530
312290;202201;927;2560;769;2299;147;494;287;805;434;1299
312300;202201;1139;3333;811;2554;175;616;183;477;358;1093
312310;202201;1045;2962;849;2588;115;417;458;1327;573;1744
312320;202201;2242;5488;1664;4537;338;940;447;1203;785;2143
312330;202201;970;2646;808;2334;84;275;507;1400;591;1675
312340;202201;279;691;203;573;28;107;118;295;146;402
312350;202201;287;573;210;488;15;45;150;328;165;373
312352;202201;1647;4811;1460;4467;162;488;826;2740;988;3228
312360;202201;3412;9415;2606;7960;432;1544;1091;3064;1523;4608
312370;202201;2090;5155;1755;4634;154;488;1155;2896;1309;3384
312380;202201;2362;5131;1965;4633;7;24;1756;4072;1763;4096
312385;202201;1377;3539;1077;3014;295;861;329;959;624;1820
312390;202201;2087;5660;1558;4696;238;822;470;1249;708;2071
312400;202201;3193;8683;2722;7928;716;2249;1019;3020;1735;5269
312410;202201;13928;36034;11528;32251;1471;4463;7287;19764;8758;24227
312420;202201;4324;10899;3586;9743;653;1925;1938;5107;2591;7032
312430;202201;8869;22125;7311;19482;296;981;5466;14152;5762;15133
312440;202201;1047;3231;879;2888;392;1357;191;612;583;1969
312450;202201;1365;3844;1053;3292;236;761;433;1393;669;2154
312460;202201;501;1213;365;1012;40;122;223;614;263;736
312470;202201;510;1215;327;892;43;133;110;256;153;389
312480;202201;1122;2718;807;2259;70;247;466;1235;536;1482
312490;202201;2524;5613;2046;4963;167;447;1282;3045;1449;3492
312500;202201;1140;2629;953;2382;33;119;735;1815;768;1934
312510;202201;4547;11771;3402;9680;780;2186;1089;2985;1869;5171
312520;202201;313;765;245;663;41;132;133;351;174;483
312530;202201;743;1653;631;1524;27;61;507;1271;534;1332
312540;202201;1729;4523;1209;3564;129;394;698;1984;827;2378
312550;202201;867;2201;673;1841;47;165;446;1121;493;1286
312560;202201;2030;5155;1631;4540;101;301;1181;3268;1282;3569
312570;202201;2746;6131;2091;5333;428;984;1119;2961;1547;3945
312580;202201;650;1710;465;1349;56;194;213;570;269;764
312590;202201;1686;4634;1317;3914;114;408;794;2160;908;2568
312595;202201;2223;6104;1850;5519;247;644;1163;3683;1410;4327
312600;202201;1315;3078;859;2179;123;373;205;577;328;950
312610;202201;7788;19068;5361;14719;713;2227;2090;5147;2803;7374
312620;202201;2684;6633;2026;5719;65;262;1620;4615;1685;4877
312630;202201;344;930;252;766;39;149;105;304;144;453
312640;202201;573;1514;425;1278;37;143;228;657;265;800
312650;202201;2263;5391;1630;4259;63;201;1180;2895;1243;3096
312660;202201;1417;3280;1095;2762;94;237;756;1831;850;2068
312670;202201;5725;13891;4801;12491;150;631;3763;9279;3913;9910
312675;202201;1371;3350;1125;3004;42;132;934;2450;976;2582
312680;202201;1591;4121;1401;3839;47;195;1195;3176;1242;3371
312690;202201;3130;6433;2397;5554;72;150;1997;4621;2069;4771
312695;202201;1101;2734;936;2478;39;87;752;1973;791;2060
312700;202201;2211;5648;1661;4695;145;482;983;2654;1128;3136
312705;202201;1573;3507;1367;3217;13;53;1272;2966;1285;3019
312707;202201;1534;4175;1159;3543;72;308;768;2225;840;2533
312710;202201;7309;16320;4658;12349;1051;2734;1644;4539;2695;7273
312720;202201;1177;2953;891;2512;97;319;582;1554;679;1873
312730;202201;1730;3936;1231;3263;104;322;770;1983;874;2305
312733;202201;1456;3714;1108;3075;47;164;763;1993;810;2157
312735;202201;825;2072;665;1775;59;165;418;1039;477;1204
312737;202201;868;1847;634;1523;54;150;455;1060;509;1210
312738;202201;826;1984;603;1612;50;153;380;950;430;1103
312740;202201;461;1144;282;851;53;186;84;189;137;375
312750;202201;1643;4529;1243;3799;159;558;611;1751;770;2309
312760;202201;1952;5495;1440;4470;223;726;585;1753;808;2479
312770;202201;48545;112954;31805;85006;5377;15552;12617;32430;17994;47982
312780;202201;2654;7405;2260;6768;220;720;1525;4485;1745;5205
312790;202201;263;607;143;418;6;26;38;76;44;102
312800;202201;5640;14950;4412;12709;617;2017;2296;6272;2913;8289
312810;202201;1712;4429;1165;3536;259;854;458;1299;717;2153
312820;202201;1899;4827;1550;4238;82;241;1138;3063;1220;3304
312825;202201;1534;3330;1331;3078;21;61;1159;2621;1180;2682
312830;202201;3000;8139;1948;6086;401;1385;567;1683;968;3068
312840;202201;1578;3949;1248;3425;89;323;767;1989;856;2312
312850;202201;1076;2442;770;2010;25;107;509;1226;534;1333
312860;202201;1171;2915;812;2375;187;586;247;663;434;1249
312870;202201;6599;17048;4324;12859;702;2231;1270;3458;1972;5689
312880;202201;1582;3813;1243;3268;71;181;742;1960;813;2141
312890;202201;2430;5790;1824;4833;124;290;1035;2715;1159;3005
312900;202201;1408;3440;1155;3106;110;340;689;1910;799;2250
312910;202201;1623;2929;929;2043;145;300;453;957;598;1257
312920;202201;1049;2718;746;2243;121;441;298;797;419;1238
312930;202201;2606;6114;2004;5230;352;946;1041;2763;1393;3709
312940;202201;1097;2849;888;2567;69;264;546;1505;615;1769
312950;202201;3346;7896;2304;6278;390;1196;1072;2801;1462;3997
312960;202201;1976;4950;1670;4497;93;222;1259;3489;1352;3711
312965;202201;1772;4566;1476;4119;123;369;1018;2819;1141;3188
312970;202201;1614;4318;1303;3837;143;504;846;2378;989;2882
312980;202201;27285;71715;22386;63245;3786;11709;11399;30316;15185;42025
312990;202201;574;1353;399;1067;56;173;221;544;277;717
313000;202201;506;1393;382;1181;26;113;237;687;263;800
313005;202201;2714;7478;2309;6821;126;405;1700;4896;1826;5301
313010;202201;5936;15352;4797;13549;652;2066;3030;8356;3682;10422
313020;202201;1194;3495;898;2859;152;555;219;615;371;1170
313030;202201;1232;2681;854;2162;53;177;598;1446;651;1623
313040;202201;906;2690;754;2399;36;163;482;1475;518;1638
313050;202201;1965;5171;1405;4353;239;892;448;1256;687;2148
313055;202201;2088;5298;1843;4946;280;738;1362;3651;1642;4389
313060;202201;1061;2520;786;2061;166;520;201;486;367;1006
313065;202201;1748;4961;1544;4634;56;237;1233;3598;1289;3835
313070;202201;1006;2556;791;2212;70;204;480;1316;550;1520
313080;202201;419;1143;318;959;58;198;120;308;178;506
313090;202201;5762;14275;4903;12957;300;860;3458;9062;3758;9922
313100;202201;1423;3555;1125;3131;37;142;844;2289;881;2431
313110;202201;1603;4058;1197;3374;95;336;672;1738;767;2074
313115;202201;3050;8241;2478;7201;257;923;1420;3801;1677;4724
313120;202201;4103;9411;3046;8043;198;540;2111;5634;2309;6174
313130;202201;35029;86169;27046;72198;2544;7931;15897;39866;18441;47797
313140;202201;745;1561;487;1212;30;75;370;915;400;990
313150;202201;1490;4078;1129;3447;369;1264;242;668;611;1932
313160;202201;1355;3259;1067;2838;26;96;817;2102;843;2198
313170;202201;12359;33421;9365;27982;1540;5101;3740;10160;5280;15261
313180;202201;2518;6377;1867;5074;222;572;1153;3078;1375;3650
313190;202201;4795;13237;3598;10912;627;2071;1359;3804;1986;5875
313200;202201;1244;3199;1074;2903;17;75;924;2430;941;2505
313210;202201;4295;11466;3574;10273;393;1272;2272;6309;2665;7581
313220;202201;1917;4836;1309;3686;155;485;609;1536;764;2021
313230;202201;3060;8266;2500;7567;66;214;2047;6371;2113;6585
313240;202201;11364;26923;7847;21530;932;3011;4141;10692;5073;13703
313250;202201;6738;18983;5227;15806;882;2697;2530;7348;3412;10045
313260;202201;808;1970;592;1620;82;296;314;755;396;1051
313270;202201;6472;15045;5307;13487;458;1052;4043;10458;4501;11510
313280;202201;501;1333;340;1019;43;151;145;417;188;568
313290;202201;1089;3271;835;2818;183;707;346;1152;529;1859
313300;202201;1884;4875;1451;4154;315;986;509;1320;824;2306
313310;202201;1405;4023;1131;3473;186;687;390;1021;576;1708
313320;202201;2215;5672;1611;4716;310;958;642;1951;952;2909
313330;202201;4507;11245;3463;9722;207;653;2344;6518;2551;7171
313340;202201;1600;3468;1189;2908;79;224;889;2139;968;2363
313350;202201;3242;8652;2226;6471;218;750;965;2443;1183;3193
313360;202201;1690;3998;1187;3217;173;586;656;1638;829;2224
313370;202201;1715;4536;1395;3933;250;769;595;1532;845;2301
313375;202201;2021;5107;1344;3903;240;797;374;972;614;1769
313380;202201;7111;17137;5336;14013;747;2310;2835;6637;3582;8947
313390;202201;857;2618;746;2425;58;256;518;1617;576;1873
313400;202201;4048;9476;3138;8197;146;445;2415;6185;2561;6630
313410;202201;1516;3713;1139;3073;127;389;731;1875;858;2264
313420;202201;17056;37032;9600;24957;2353;6594;1620;4205;3973;10799
313430;202201;1118;2986;910;2593;93;360;544;1378;637;1738
313440;202201;6809;14188;4773;11624;220;595;3483;8366;3703;8961
313450;202201;809;2061;590;1666;99;304;226;546;325;850
313460;202201;2373;6449;1901;5716;343;1146;966;2830;1309;3976
313470;202201;3024;7431;2405;6533;157;475;1804;4859;1961;5334
313480;202201;1130;3126;709;2226;70;241;255;734;325;975
313490;202201;3271;7924;1839;5349;325;1051;583;1596;908;2647
313500;202201;617;1601;463;1295;32;96;209;535;241;631
313505;202201;10924;27585;9333;25432;337;1103;7577;20631;7914;21734
313507;202201;1539;3799;1247;3355;44;171;1004;2628;1048;2799
313510;202201;15691;41351;12366;34947;1294;3920;6558;17703;7852;21623
313520;202201;16265;42459;13098;37218;672;2305;10037;27855;10709;30160
313530;202201;626;1782;474;1464;57;206;179;473;236;679
313535;202201;2520;6764;2082;5940;201;551;1349;3813;1550;4364
313540;202201;902;2533;737;2156;110;341;354;956;464;1297
313545;202201;1233;3883;1054;3546;111;460;613;1957;724;2417
313550;202201;2063;5815;1747;5107;194;646;1147;3244;1341;3890
313560;202201;3001;5540;2254;4650;44;81;1961;4033;2005;4114
313570;202201;1082;2968;904;2663;168;501;445;1301;613;1802
313580;202201;6491;15415;5140;13241;420;1174;3412;8594;3832;9768
313590;202201;1203;3130;980;2811;177;510;542;1643;719;2153
313600;202201;4500;11118;3769;10020;84;317;3294;8596;3378;8913
313610;202201;1135;2708;927;2361;66;194;631;1529;697;1723
313620;202201;5884;14948;4769;12980;439;1430;3028;7953;3467;9383
313630;202201;9579;22285;6923;18389;634;2023;4364;11204;4998;13227
313640;202201;1346;2764;866;2164;87;243;560;1378;647;1621
313650;202201;1776;5147;1406;4541;109;418;918;2997;1027;3415
313652;202201;893;2530;806;2379;64;233;601;1696;665;1929
313655;202201;1241;2946;970;2606;77;217;691;1865;768;2082
313657;202201;1242;3142;979;2737;33;120;748;1972;781;2092
313660;202201;1112;2933;923;2613;61;233;656;1775;717;2008
313665;202201;5758;14463;4635;12568;365;1141;3123;8034;3488;9175
313670;202201;56788;134532;38709;104952;4789;14637;19348;49524;24137;64161
313680;202201;1154;2889;962;2579;49;145;681;1774;730;1919
313690;202201;986;2829;720;2321;146;518;237;711;383;1229
313695;202201;1995;5046;1505;4247;115;308;1001;2906;1116;3214
313700;202201;3056;9170;2651;8650;226;799;2107;6905;2333;7704
313710;202201;1604;3488;1163;2920;86;223;806;2028;892;2251
313720;202201;6597;17336;4859;13895;647;2030;2136;5558;2783;7588
313730;202201;1542;3212;1151;2715;81;168;771;1818;852;1986
313740;202201;1795;6215;1526;5545;339;1422;369;1192;708;2614
313750;202201;2285;5792;1831;5034;282;874;1013;2585;1295;3459
313753;202201;2356;5541;1596;4328;161;488;862;2264;1023;2752
313760;202201;6198;16454;4936;14120;800;2544;2502;6643;3302;9187
313770;202201;4394;11773;3504;10401;200;564;2658;8028;2858;8592
313780;202201;4420;11128;3328;9405;430;1150;1164;3423;1594;4573
313790;202201;601;1673;531;1545;59;187;341;961;400;1148
313800;202201;1507;3225;1110;2687;97;270;651;1495;748;1765
313810;202201;1812;4313;1474;3845;54;201;1190;3018;1244;3219
313820;202201;19250;47710;12810;34352;2044;5682;3785;9650;5829;15332
313830;202201;443;1243;326;993;58;187;136;383;194;570
313835;202201;955;2676;794;2405;69;275;458;1302;527;1577
313840;202201;8435;21246;6683;18457;1365;4013;1983;5541;3348;9554
313850;202201;1053;2485;838;2197;119;366;456;1103;575;1469
313860;202201;2930;7379;2258;6201;286;963;1156;2877;1442;3840
313862;202201;1338;2774;684;1845;40;123;326;896;366;1019
313865;202201;2786;7024;2300;6259;80;272;1769;4664;1849;4936
313867;202201;1512;4406;1262;3953;227;714;681;2219;908;2933
313868;202201;1858;5338;1532;4742;57;242;1185;3535;1242;3777
313870;202201;1131;2785;768;2147;87;249;346;886;433;1135
313880;202201;2089;5229;1573;4375;161;527;878;2255;1039;2782
313890;202201;2372;4718;1784;3973;39;106;1399;3027;1438;3133
313900;202201;5291;14349;3865;11483;818;2737;1202;3175;2020;5912
313910;202201;778;2194;595;1837;113;368;147;443;260;811
313920;202201;3132;8976;2642;8013;426;1361;1458;4390;1884;5751
313925;202201;1784;4243;1464;3712;121;311;1018;2553;1139;2864
313930;202201;5252;14506;4275;12840;261;984;2995;8763;3256;9747
313940;202201;10085;27857;7752;24021;1187;3944;2172;7446;3359;11390
313950;202201;5892;12343;4569;10749;266;704;3224;7603;3490;8307
313960;202201;6230;14390;4226;11087;743;2248;1565;3708;2308;5956
313970;202201;1669;4273;1426;3881;55;159;952;2526;1007;2685
313980;202201;1370;3481;937;2840;161;552;425;1233;586;1785
313990;202201;2131;6383;1630;5330;292;1136;766;2245;1058;3381
314000;202201;11068;26684;9208;23656;606;1980;6255;15793;6861;17773
314010;202201;1533;3524;1215;3096;41;145;932;2288;973;2433
314015;202201;2231;5842;1782;5104;170;585;1078;2949;1248;3534
314020;202201;571;1487;392;1182;100;352;73;236;173;588
314030;202201;876;2387;691;2052;97;297;344;1012;441;1309
314040;202201;636;1689;534;1507;61;206;309;841;370;1047
314050;202201;2074;5285;1556;4345;119;409;932;2426;1051;2835
314053;202201;2122;5964;1701;5138;249;730;1031;3204;1280;3934
314055;202201;2398;5982;2033;5448;53;203;1716;4558;1769;4761
314060;202201;1424;3622;1085;3090;31;114;775;2175;806;2289
314070;202201;5279;13627;4258;11895;627;1844;2287;6227;2914;8071
314080;202201;2282;5705;1654;4698;159;522;794;2070;953;2592
314085;202201;2523;6559;2060;5891;185;557;1314;3766;1499;4323
314090;202201;5401;13452;4675;12422;335;900;3197;8814;3532;9714
314100;202201;3235;7581;2520;6603;44;145;1878;4964;1922;5109
314110;202201;5500;14689;4545;12978;457;1489;2633;6930;3090;8419
314120;202201;756;1705;350;983;67;220;111;279;178;499
314130;202201;713;1826;475;1391;27;94;294;841;321;935
314140;202201;4935;12986;3985;11306;417;1303;2300;6316;2717;7619
314150;202201;1605;3876;1184;3170;74;224;812;2121;886;2345
314160;202201;2522;6182;1885;5088;197;578;940;2494;1137;3072
314170;202201;1008;2694;826;2344;42;174;559;1464;601;1638
314180;202201;5980;15630;4842;13875;407;1231;2984;8568;3391;9799
314190;202201;682;1642;512;1403;58;190;306;783;364;973
314200;202201;3220;8636;2683;7769;178;564;1880;5344;2058;5908
314210;202201;2261;5609;1823;4865;277;767;810;2086;1087;2853
314220;202201;1680;4406;1322;3830;199;674;630;1704;829;2378
314225;202201;1174;3262;969;2899;84;243;689;2023;773;2266
314230;202201;918;2290;753;2073;77;223;507;1403;584;1626
314240;202201;1171;3037;917;2663;189;584;407;1167;596;1751
314250;202201;504;1410;335;1050;36;125;142;398;178;523
314260;202201;1195;2974;947;2647;176;500;506;1375;682;1875
314270;202201;3587;9632;2974;8686;106;398;2236;6466;2342;6864
314280;202201;3813;8533;2677;6857;253;731;1639;3953;1892;4684
314290;202201;4875;12004;4105;10694;265;732;2925;7434;3190;8166
314300;202201;2200;6006;1447;4440;260;874;521;1447;781;2321
314310;202201;4175;10653;2903;8559;844;2783;488;1285;1332;4068
314315;202201;1040;3157;883;2840;57;239;631;1985;688;2224
314320;202201;3449;8978;2357;6993;370;1245;979;2727;1349;3972
314330;202201;56300;151854;43866;130651;10183;31497;12707;38475;22890;69972
314340;202201;2759;6703;1825;5095;343;1073;583;1446;926;2519
314345;202201;1541;4297;1258;3808;108;347;873;2581;981;2928
314350;202201;900;2385;613;1881;143;483;163;405;306;888
314360;202201;592;1664;403;1277;59;207;131;378;190;585
314370;202201;811;2053;661;1834;49;166;453;1203;502;1369
314380;202201;1228;3216;839;2566;205;701;225;671;430;1372
314390;202201;15888;38353;11193;30347;1553;4759;4602;11106;6155;15865
314400;202201;4293;12382;3354;10566;788;2572;1410;4641;2198;7213
314410;202201;3162;8582;2248;6836;341;1183;650;1996;991;3179
314420;202201;882;2092;658;1748;30;113;452;1138;482;1251
314430;202201;8772;20051;6328;16210;861;2326;3241;7946;4102;10272
314435;202201;2026;5240;1586;4547;183;574;975;2731;1158;3305
314437;202201;960;2350;695;1927;56;170;405;1110;461;1280
314440;202201;667;1852;485;1504;142;483;117;316;259;799
314450;202201;1584;3990;1314;3562;149;456;763;1969;912;2425
314460;202201;3523;10213;2692;8598;633;2185;883;2642;1516;4827
314465;202201;2435;6638;2085;6014;51;213;1633;4560;1684;4773
314467;202201;1021;2569;867;2319;33;106;680;1742;713;1848
314470;202201;2491;6806;2078;6020;287;925;1080;2937;1367;3862
314480;202201;8471;22520;6607;18811;955;3050;2915;7426;3870;10476
314490;202201;1161;2904;861;2328;62;194;580;1509;642;1703
314500;202201;1863;4301;1363;3663;301;777;586;1611;887;2388
314505;202201;2298;5244;1880;4671;95;279;1451;3478;1546;3757
314510;202201;2187;5508;1590;4629;321;1023;725;2074;1046;3097
314520;202201;5898;17168;4659;14803;1052;3722;972;2803;2024;6525
314530;202201;5800;17479;5209;16435;297;1238;3961;12155;4258;13393
314535;202201;2839;6879;2300;6118;101;325;1811;4805;1912;5130
314537;202201;1285;3454;994;2995;57;181;731;2172;788;2353
314540;202201;460;1098;336;905;13;43;211;535;224;578
314545;202201;2097;4748;1883;4503;34;82;1658;4042;1692;4124
314550;202201;813;1883;577;1525;41;148;351;846;392;994
314560;202201;5126;14427;3897;11884;514;1891;1640;4400;2154;6291
314570;202201;337;914;241;738;21;76;127;392;148;468
314580;202201;496;1431;400;1251;91;285;163;493;254;778
314585;202201;711;2084;558;1760;53;198;272;817;325;1015
314587;202201;2408;6143;1882;5323;293;737;1167;3348;1460;4085
314590;202201;4614;11884;3573;10055;401;1313;1794;4673;2195;5986
314600;202201;2009;5275;1276;3930;306;970;190;545;496;1515
314610;202201;9994;24004;7713;20615;950;3083;3830;10645;4780;13728
314620;202201;2506;5544;2025;4949;70;200;1717;4176;1787;4376
314625;202201;1650;4287;1418;3966;30;161;1225;3361;1255;3522
314630;202201;5747;13789;4695;12376;161;527;3893;10186;4054;10713
314640;202201;790;1761;596;1461;49;151;399;903;448;1054
314650;202201;902;2026;595;1555;60;192;356;838;416;1030
314655;202201;1671;4423;1224;3664;159;469;634;1918;793;2387
314660;202201;356;782;254;611;13;32;173;397;186;429
314670;202201;1778;3854;1249;3129;28;85;868;2112;896;2197
314675;202201;1831;4533;1555;4092;81;236;1230;3172;1311;3408
314690;202201;2200;5798;1669;5019;404;1245;698;2101;1102;3346
314700;202201;12257;32250;8538;25483;1404;4578;3672;10512;5076;15090
314710;202201;8925;24036;6727;19554;940;3075;2782;7146;3722;10221
314720;202201;2420;6966;1754;5626;337;1178;423;1235;760;2413
314730;202201;2629;6601;1919;5374;312;967;772;1990;1084;2957
314740;202201;3354;9044;2681;7901;367;1145;1444;4145;1811;5290
314750;202201;307;798;239;660;26;92;147;363;173;455
314760;202201;2067;5889;1385;4427;223;829;384;998;607;1827
314770;202201;1150;3227;701;2187;79;246;223;647;302;893
314780;202201;392;952;282;784;29;101;162;407;191;508
314790;202201;13023;33310;9551;27139;1351;4486;4391;11790;5742;16276
314795;202201;1635;4123;1398;3739;35;159;1129;2893;1164;3052
314800;202201;12013;29715;8036;22723;1347;4178;2558;6504;3905;10682
314810;202201;10266;26078;7729;21889;1814;5470;2978;8200;4792;13670
314820;202201;1416;3257;1120;2821;71;234;730;1750;801;1984
314830;202201;1837;5086;1543;4580;161;536;904;2600;1065;3136
314840;202201;927;2780;729;2428;50;237;524;1664;574;1901
314850;202201;2461;5164;2000;4598;46;139;1762;4022;1808;4161
314860;202201;3542;9722;2974;8735;148;599;2176;6188;2324;6787
314870;202201;7050;15938;5406;13918;260;667;4157;10831;4417;11498
314875;202201;2018;5736;1797;5458;148;398;1446;4483;1594;4881
314880;202201;891;2094;692;1789;37;113;452;1138;489;1251
314890;202201;494;1401;388;1199;54;189;192;544;246;733
314900;202201;902;2226;696;1885;88;260;340;895;428;1155
314910;202201;1833;4964;1372;4225;191;706;726;2110;917;2816
314915;202201;2293;6465;1915;5798;128;476;1309;3874;1437;4350
314920;202201;544;1361;377;1123;18;58;258;779;276;837
314930;202201;6268;16990;4911;14524;753;2553;2220;6045;2973;8598
314940;202201;444;1028;371;911;27;63;262;613;289;676
314950;202201;617;1501;438;1233;37;144;243;624;280;768
314960;202201;943;2112;741;1801;37;109;555;1281;592;1390
314970;202201;1133;3243;880;2745;134;469;428;1234;562;1703
314980;202201;1791;4411;1386;3822;192;609;815;2185;1007;2794
314990;202201;2863;7978;2125;6393;357;1144;582;1585;939;2729
314995;202201;1792;4772;1445;4165;41;183;991;2690;1032;2873
315000;202201;1204;2964;881;2467;79;260;576;1576;655;1836
315010;202201;422;1101;333;961;41;154;190;513;231;667
315015;202201;2550;6781;2229;6265;199;667;1531;4203;1730;4870
315020;202201;831;2363;612;1917;67;266;293;849;360;1115
315030;202201;679;1721;478;1371;130;368;124;314;254;682
315040;202201;1029;2610;864;2357;110;326;571;1478;681;1804
315050;202201;1307;3202;990;2725;72;234;553;1461;625;1695
315053;202201;1288;3185;979;2675;59;213;603;1556;662;1769
315057;202201;1920;5408;1558;4817;149;404;1032;3354;1181;3758
315060;202201;693;1992;518;1646;109;362;142;423;251;785
315070;202201;660;1598;500;1339;104;304;211;512;315;816
315080;202201;3466;9007;2705;7681;133;467;1953;5275;2086;5742
315090;202201;873;2534;673;2185;91;324;298;917;389;1241
315100;202201;1474;4167;1010;3151;128;486;479;1310;607;1796
315110;202201;2280;5183;1686;4321;144;355;965;2470;1109;2825
315120;202201;13851;30819;10399;25800;1093;2555;6388;16063;7481;18618
315130;202201;1812;4795;1542;4346;156;533;716;1875;872;2408
315140;202201;3228;8608;2574;7495;469;1527;1366;3758;1835;5285
315150;202201;4755;11287;3452;9265;455;1390;1736;4601;2191;5991
315160;202201;2021;4781;1401;3826;232;678;721;1926;953;2604
315170;202201;1466;4485;1079;3596;222;795;321;1019;543;1814
315180;202201;19110;45216;11600;31940;1535;4764;4291;10474;5826;15238
315190;202201;2365;5042;1863;4395;165;383;1405;3337;1570;3720
315200;202201;4523;12146;3433;10328;883;2870;1095;3189;1978;6059
315210;202201;9700;24052;6984;18728;640;1938;3676;8872;4316;10810
315213;202201;1165;2991;1013;2780;23;94;843;2260;866;2354
315217;202201;3012;8272;2299;7089;117;512;1590;4697;1707;5209
315220;202201;9192;24063;7326;20946;689;1856;4224;12184;4913;14040
315230;202201;3205;7088;2651;6357;183;375;1850;4677;2033;5052
315240;202201;2615;7263;2198;6563;422;1328;1138;3407;1560;4735
315250;202201;15357;39933;11547;33050;1657;5218;5284;14292;6941;19510
315260;202201;988;2603;583;1795;130;399;60;163;190;562
315270;202201;966;2679;731;2236;109;383;291;786;400;1169
315280;202201;3188;7759;2103;5904;538;1571;486;1360;1024;2931
315290;202201;1277;3039;789;2289;186;586;276;788;462;1374
315300;202201;718;1727;526;1439;32;102;352;957;384;1059
315310;202201;1348;3487;1042;2952;76;265;657;1716;733;1981
315320;202201;691;1971;494;1591;62;236;210;634;272;870
315330;202201;840;2610;507;1792;68;265;197;618;265;883
315340;202201;3207;7541;2251;6120;351;1003;1116;2982;1467;3985
315350;202201;1821;4629;1504;4147;110;368;1056;2839;1166;3207
315360;202201;1899;5332;1514;4602;206;654;699;1997;905;2651
315370;202201;603;1604;494;1409;68;197;261;719;329;916
315380;202201;279;752;197;588;37;111;25;58;62;169
315390;202201;1308;3537;1076;3140;106;394;617;1657;723;2051
315400;202201;4465;11444;3582;9936;359;1156;2261;5926;2620;7082
315410;202201;2669;5839;1987;4852;368;967;520;1330;888;2297
315415;202201;1547;4061;1264;3621;252;842;479;1351;731;2193
315420;202201;1637;4388;1165;3543;224;716;310;869;534;1585
315430;202201;3927;9252;2786;7571;410;1280;1398;3654;1808;4934
315440;202201;1120;2849;892;2489;75;255;534;1390;609;1645
315445;202201;2139;4817;1589;4042;74;252;1267;3151;1341;3403
315450;202201;2499;6500;2057;5798;208;565;1364;3812;1572;4377
315460;202201;44729;116884;37661;104990;4084;13629;23662;61884;27746;75513
315470;202201;733;1956;526;1479;42;127;283;749;325;876
315480;202201;1333;3641;969;2900;151;480;404;1156;555;1636
315490;202201;3147;7609;2238;6177;274;847;986;2524;1260;3371
315500;202201;571;1474;369;1064;31;116;203;509;234;625
315510;202201;1399;3439;1184;3151;10;53;1049;2730;1059;2783
315520;202201;1128;2844;939;2557;46;153;761;2015;807;2168
315530;202201;699;1810;569;1588;77;245;372;983;449;1228
315540;202201;1787;4569;1236;3552;106;378;554;1505;660;1883
315550;202201;1994;5165;1388;4062;246;837;430;1262;676;2099
315560;202201;6968;19741;5996;18065;363;1110;4291;12935;4654;14045
315570;202201;2290;5800;1846;5086;227;756;990;2526;1217;3282
315580;202201;3441;7723;2712;6602;398;1045;1134;2607;1532;3652
315590;202201;1058;2493;849;2186;40;158;603;1438;643;1596
315600;202201;2735;7971;1951;6478;339;1018;982;3486;1321;4504
315610;202201;1070;2596;812;2159;112;377;404;939;516;1316
315620;202201;563;1450;436;1260;51;156;233;680;284;836
315630;202201;1150;2953;885;2482;120;390;452;1158;572;1548
315640;202201;391;937;294;819;30;108;186;493;216;601
315645;202201;1062;2637;757;2162;150;472;228;627;378;1099
315650;202201;1858;4181;1512;3707;60;158;1213;2915;1273;3073
315660;202201;2430;5961;1875;5005;109;323;1313;3404;1422;3727
315670;202201;15978;41350;12569;35412;1931;5983;6494;17201;8425;23184
315680;202201;3439;9358;2607;7868;298;1034;1446;4191;1744;5225
315690;202201;3965;9401;2518;7025;479;1315;799;2350;1278;3665
315700;202201;9246;24056;7113;20019;795;2505;3746;9896;4541;12401
315710;202201;2008;4720;1457;3916;70;233;1024;2677;1094;2910
315720;202201;4744;12613;3941;11236;198;807;2830;7723;3028;8530
315725;202201;2424;5968;1899;5143;178;470;1256;3511;1434;3981
315727;202201;623;1551;477;1312;67;215;228;594;295;809
315730;202201;661;1912;578;1757;129;428;222;608;351;1036
315733;202201;1481;3594;1140;3062;162;484;491;1214;653;1698
315737;202201;1269;3384;980;2834;37;143;698;1930;735;2073
315740;202201;868;2358;705;2040;58;226;489;1330;547;1556
315750;202201;1362;3396;1092;2984;81;242;744;2026;825;2268
315760;202201;1247;2840;1084;2628;37;121;914;2148;951;2269
315765;202201;2091;5182;1716;4704;29;121;1536;4204;1565;4325
315770;202201;1101;2924;872;2618;332;1076;234;654;566;1730
315780;202201;33613;87682;28411;78719;1679;5875;19701;51787;21380;57662
315790;202201;3818;11279;3272;10276;306;978;2056;6679;2362;7657
315800;202201;1424;4561;1109;3831;147;627;442;1329;589;1956
315810;202201;1433;3386;1196;2994;55;158;955;2323;1010;2481
315820;202201;2970;7272;2381;6494;215;622;1721;4698;1936;5320
315830;202201;1323;3793;917;2913;98;347;296;798;394;1145
315840;202201;963;2226;692;1771;53;173;382;876;435;1049
315850;202201;1291;3556;1037;3145;145;457;577;1695;722;2152
315860;202201;543;1474;389;1208;78;284;146;389;224;673
315870;202201;503;1321;398;1149;24;83;291;806;315;889
315880;202201;1203;2931;860;2339;114;338;324;808;438;1146
315890;202201;1905;5129;1572;4689;357;1099;838;2567;1195;3666
315895;202201;6943;18039;5311;15005;515;1716;2816;7361;3331;9077
315900;202201;841;2131;718;1959;54;184;541;1412;595;1596
315910;202201;575;1511;490;1387;58;174;352;988;410;1162
315920;202201;1533;3797;913;2655;140;482;339;900;479;1382
315930;202201;1224;2615;846;2088;92;226;443;1062;535;1288
315935;202201;1055;3041;858;2667;170;534;345;1080;515;1614
315940;202201;672;1721;542;1541;77;224;299;828;376;1052
315950;202201;1249;3316;1044;2997;102;310;793;2263;895;2573
315960;202201;6107;16487;4359;13118;1023;3419;1059;2562;2082;5981
315970;202201;607;1573;489;1416;50;159;336;1000;386;1159
315980;202201;4601;9601;2670;6574;469;1215;1188;2666;1657;3881
315990;202201;3779;9438;2988;8114;287;849;1742;4560;2029;5409
316000;202201;749;1719;590;1497;55;172;354;853;409;1025
316010;202201;823;2214;615;1848;66;224;298;785;364;1009
316020;202201;1010;2840;815;2467;100;362;491;1393;591;1755
316030;202201;2963;7878;2299;6702;243;721;1538;4543;1781;5264
316040;202201;2872;7913;2135;6547;367;1314;646;1725;1013;3039
316045;202201;2300;5510;2121;5292;64;133;1909;4808;1973;4941
316050;202201;422;1133;331;990;37;120;189;517;226;637
316060;202201;760;1769;563;1513;29;105;414;1070;443;1175
316070;202201;5969;15787;4940;13926;727;2140;2590;7045;3317;9185
316080;202201;828;2492;658;2151;182;627;129;379;311;1006
316090;202201;474;1266;386;1107;49;176;216;543;265;719
316095;202201;1410;4181;1111;3451;251;841;475;1384;726;2225
316100;202201;2644;7344;1986;6020;324;1148;824;2253;1148;3401
316105;202201;886;2189;722;1937;47;132;475;1330;522;1462
316110;202201;14920;40407;12512;36479;847;2940;8988;25719;9835;28659
316120;202201;1335;3561;898;2614;142;449;323;756;465;1205
316130;202201;1361;2991;921;2285;71;216;582;1372;653;1588
316140;202201;1325;3394;855;2516;101;320;377;1100;478;1420
316150;202201;2330;5074;1867;4411;153;440;998;2236;1151;2676
316160;202201;1089;2784;880;2414;41;147;638;1703;679;1850
316165;202201;968;2227;779;1949;83;236;508;1212;591;1448
316170;202201;1356;3167;1051;2733;55;199;756;1854;811;2053
316180;202201;1621;4406;1166;3542;201;686;324;889;525;1575
316190;202201;2899;7953;1777;5346;246;789;750;2015;996;2804
316200;202201;3683;10078;2895;8751;482;1675;1237;3568;1719;5243
316210;202201;5395;15360;3866;11843;1365;4584;329;866;1694;5450
316220;202201;727;2127;515;1703;105;347;78;291;183;638
316225;202201;1688;3721;1289;3130;47;170;985;2202;1032;2372
316230;202201;496;1292;389;1116;71;225;194;538;265;763
316240;202201;5989;16625;5243;15317;367;1224;3988;11441;4355;12665
316245;202201;3430;10332;3112;9817;151;767;2492;7514;2643;8281
316250;202201;11891;27472;9111;23060;1600;4386;3775;9525;5375;13911
316255;202201;3215;8533;2801;7896;134;345;2103;6037;2237;6382
316257;202201;1537;3546;1127;2857;66;178;782;1903;848;2081
316260;202201;2494;5783;1981;4982;201;492;1177;2987;1378;3479
316265;202201;1198;3132;951;2724;19;73;717;1991;736;2064
316270;202201;3993;11715;3448;10596;405;1368;1962;5738;2367;7106
316280;202201;3248;8593;2761;7709;325;1035;1627;4377;1952;5412
316290;202201;3969;10508;3225;9124;406;1296;1312;3550;1718;4846
316292;202201;6097;15287;4923;13455;521;1543;3288;8706;3809;10249
316294;202201;944;2683;726;2327;110;439;215;624;325;1063
316295;202201;3651;9887;3032;8864;179;687;2119;5912;2298;6599
316300;202201;1089;2955;875;2636;44;153;612;1825;656;1978
316310;202201;856;2223;592;1767;140;479;168;459;308;938
316320;202201;734;1966;576;1723;121;388;157;461;278;849
316330;202201;1148;2864;883;2431;47;140;683;1843;730;1983
316340;202201;1055;2762;799;2318;78;290;472;1294;550;1584
316350;202201;1450;3858;1214;3461;150;434;802;2252;952;2686
316360;202201;694;1748;589;1584;43;116;467;1263;510;1379
316370;202201;6193;15113;4848;12876;558;1751;2599;6220;3157;7971
316380;202201;1840;4261;1463;3736;74;168;1035;2638;1109;2806
316390;202201;815;2152;600;1789;238;802;108;291;346;1093
316400;202201;1309;3555;883;2737;101;345;338;933;439;1278
316410;202201;1225;3203;1029;2914;32;112;873;2413;905;2525
316420;202201;2111;5528;1833;5166;40;174;1534;4210;1574;4384
316430;202201;948;2372;668;1924;101;343;310;807;411;1150
316440;202201;922;2734;751;2433;130;510;222;645;352;1155
316443;202201;598;1596;445;1314;103;354;119;334;222;688
316447;202201;2232;5625;1938;5187;34;100;1694;4479;1728;4579
316450;202201;2296;6541;1787;5523;202;724;1123;3323;1325;4047
316460;202201;1354;3380;1115;3012;104;315;757;1937;861;2252
316470;202201;7824;21524;5896;17697;800;2777;2642;7193;3442;9970
316480;202201;219;566;192;534;38;110;110;295;148;405
316490;202201;348;925;255;760;42;142;91;231;133;373
316500;202201;1376;4045;969;3123;206;738;243;705;449;1443
316510;202201;863;2701;698;2383;109;394;377;1275;486;1669
316520;202201;1476;3463;1165;2951;154;461;600;1378;754;1839
316530;202201;1219;3094;905;2546;103;387;470;1193;573;1580
316540;202201;1062;2596;877;2337;93;307;499;1212;592;1519
316550;202201;1481;4075;1257;3675;56;200;1001;2900;1057;3100
316553;202201;4913;13803;3686;11031;459;1554;1664;4405;2123;5959
316555;202201;2831;8176;2535;7781;85;327;2172;6617;2257;6944
316556;202201;561;1327;438;1117;37;122;275;621;312;743
316557;202201;1206;3505;1045;3262;292;1008;455;1377;747;2385
316560;202201;368;995;270;849;36;135;131;384;167;519
316570;202201;1519;4097;1280;3693;285;786;482;1482;767;2268
316580;202201;422;868;278;642;35;90;148;322;183;412
316590;202201;1439;3511;1010;2715;135;342;581;1496;716;1838
316600;202201;1022;2961;883;2698;123;393;512;1538;635;1931
316610;202201;656;1922;544;1750;47;195;343;1067;390;1262
316620;202201;2385;5827;2100;5428;105;285;1706;4387;1811;4672
316630;202201;1679;4805;1408;4309;355;1025;594;2056;949;3081
316640;202201;170;454;141;413;32;107;56;133;88;240
316650;202201;1166;3361;946;3025;75;293;654;2034;729;2327
316660;202201;205;473;96;256;15;42;26;50;41;92
316670;202201;1874;4573;1441;3908;342;956;532;1396;874;2352
316680;202201;2471;6152;1868;5044;134;416;1345;3503;1479;3919
316690;202201;1520;4128;1166;3514;193;639;518;1514;711;2153
316695;202201;1079;3026;901;2713;27;107;622;1836;649;1943
316700;202201;443;941;369;861;9;27;313;707;322;734
316710;202201;3568;10873;2849;9459;440;1643;1497;4789;1937;6432
316720;202201;22905;60007;17680;50494;2629;8168;8557;23117;11186;31285
316730;202201;534;1315;439;1153;45;135;235;571;280;706
316740;202201;854;2345;742;2173;98;310;498;1457;596;1767
316750;202201;435;1204;340;1044;61;198;159;470;220;668
316760;202201;3881;11692;3335;10688;1089;3787;1270;4042;2359;7829
316770;202201;1735;3719;1330;3191;36;88;1076;2636;1112;2724
316780;202201;608;1717;493;1521;159;535;148;427;307;962
316790;202201;777;2032;580;1654;75;235;180;489;255;724
316800;202201;7030;18892;5656;16475;638;2030;2902;8214;3540;10244
316805;202201;1189;2429;966;2184;44;111;799;1791;843;1902
316810;202201;695;1838;515;1513;64;215;329;937;393;1152
316820;202201;355;815;209;570;18;61;104;267;122;328
316830;202201;906;2251;716;1949;81;223;457;1239;538;1462
316840;202201;3066;7475;2471;6547;146;502;1862;4720;2008;5222
316850;202201;2217;5423;1671;4514;172;554;964;2410;1136;2964
316860;202201;22572;55015;17005;46777;2170;7028;8805;23372;10975;30400
316870;202201;9069;23304;7029;19592;831;2685;3656;9420;4487;12105
316880;202201;1072;2760;898;2521;117;375;532;1423;649;1798
316890;202201;1238;2715;764;2100;79;284;506;1328;585;1612
316900;202201;2595;6656;2089;5736;368;1037;836;2184;1204;3221
316905;202201;536;1548;440;1365;100;318;202;649;302;967
316910;202201;1023;2553;676;1965;189;604;140;373;329;977
316920;202201;1970;4568;1435;3802;183;555;870;2189;1053;2744
316930;202201;9224;25054;7195;21583;1435;4703;2733;7600;4168;12303
316935;202201;4611;11884;3475;9859;549;1754;1590;4180;2139;5934
316940;202201;6945;19608;5537;16892;691;2461;2662;7513;3353;9974
316950;202201;2086;4659;1631;4047;37;106;1392;3412;1429;3518
316960;202201;5557;11998;4060;10035;279;761;2951;7137;3230;7898
316970;202201;4303;11312;3701;10279;455;1367;1832;4768;2287;6135
316980;202201;770;2236;603;1921;205;727;141;448;346;1175
316990;202201;13722;35427;10443;29065;2312;6894;2155;5584;4467;12478
317000;202201;2713;7533;2399;7095;203;526;1846;5503;2049;6029
317005;202201;2807;7481;2237;6362;300;918;1300;3578;1600;4496
317010;202201;27127;62263;18064;48664;3020;8838;8219;22219;11239;31057
317020;202201;70997;165453;44843;121272;7535;22345;16536;41470;24071;63815
317030;202201;734;1857;584;1655;12;46;456;1272;468;1318
317040;202201;12166;29602;8752;23941;1827;5267;3351;9516;5178;14783
317043;202201;971;2081;712;1735;42;109;537;1278;579;1387
317047;202201;1243;2899;869;2307;57;186;598;1526;655;1712
317050;202201;1311;3916;962;3137;124;472;402;1132;526;1604
317052;202201;2633;6852;2127;6065;190;599;1487;4189;1677;4788
317057;202201;2150;4686;1609;3888;41;109;1190;2787;1231;2896
317060;202201;563;1453;354;1031;50;155;149;388;199;543
317065;202201;1209;3450;998;3055;64;245;649;1858;713;2103
317070;202201;8055;21844;6110;18179;942;3170;2453;6854;3395;10024
317075;202201;1067;2650;813;2228;93;295;457;1182;550;1477
317080;202201;6950;15603;5278;13015;1072;2804;2392;5761;3464;8565
317090;202201;5189;14185;4611;13285;260;775;3553;10190;3813;10965
317100;202201;2800;6490;1874;5010;368;1004;798;2100;1166;3104
317103;202201;2434;5994;2084;5511;73;324;1697;4323;1770;4647
317107;202201;1596;4025;1222;3356;66;239;787;1949;853;2188
317110;202201;699;1613;390;1132;77;261;141;407;218;668
317115;202201;1180;3254;1003;2935;96;305;656;1910;752;2215
317120;202201;18774;47974;15625;43048;1056;3612;10511;27502;11567;31114
317130;202201;12572;28335;8748;22173;1201;3319;3428;8704;4629;12023
317140;202201;1025;2347;808;2019;56;140;568;1441;624;1581
317150;202201;1041;2418;812;2129;34;113;662;1700;696;1813
317160;202201;3875;8942;2607;6964;237;591;1455;4022;1692;4613
317170;202201;2074;5025;1580;4161;110;363;978;2341;1088;2704
317180;202201;2140;6365;1611;5138;319;1089;488;1421;807;2510
317190;202201;1251;3293;933;2778;128;413;523;1532;651;1945
317200;202201;6778;17312;5118;14093;909;2717;1639;4103;2548;6820
317210;202201;1297;3034;1013;2654;39;139;740;1962;779;2101
317220;202201;315;905;274;835;49;151;148;444;197;595
320010;202201;5084;14310;4007;12173;392;1372;2484;7298;2876;8670
320013;202201;2287;5965;1646;4748;237;680;793;2387;1030;3067
320016;202201;3190;7889;2536;6913;181;483;1839;5037;2020;5520
320020;202201;4637;11609;3545;9755;564;1731;1627;4523;2191;6254
320030;202201;1908;5128;1289;3938;212;704;478;1402;690;2106
320035;202201;2100;5440;1739;4852;333;1029;962;2602;1295;3631
320040;202201;4778;13053;4033;11769;493;1570;2350;6577;2843;8147
320050;202201;1958;4349;1713;4000;197;539;1066;2378;1263;2917
320060;202201;15391;40359;11723;33224;1681;5175;5635;14743;7316;19918
320070;202201;1897;4978;1413;4071;221;741;633;1625;854;2366
320080;202201;6200;15418;4481;12116;796;2267;1878;4794;2674;7061
320090;202201;9398;24144;6422;18243;1318;3975;2587;6853;3905;10828
320100;202201;3478;9023;2855;7969;393;1161;1632;4552;2025;5713
320110;202201;2358;5320;1693;4302;165;512;1001;2373;1166;2885
320115;202201;2359;7024;2060;6555;657;2141;894;2975;1551;5116
320120;202201;27745;68112;20269;55270;2559;7676;10287;26343;12846;34019
320130;202201;57348;150065;47885;133656;5180;16144;29799;80075;34979;96219
320140;202201;4149;11004;2923;8639;372;1293;1333;3773;1705;5066
320150;202201;15741;39260;11597;31766;2725;8257;2151;5353;4876;13610
320160;202201;7002;18640;5306;15529;684;2242;2584;7363;3268;9605
320170;202201;1950;5399;1417;4356;354;1080;575;1857;929;2937
320180;202201;809;2435;663;2157;223;780;190;589;413;1369
320190;202201;3252;9965;2590;8566;670;2450;674;2049;1344;4499
320200;202201;1450;3834;1020;3077;217;700;348;1059;565;1759
320210;202201;4926;12154;3840;10333;580;1707;2113;5382;2693;7089
320220;202201;3654;9092;2875;7855;399;1206;1577;4094;1976;5300
320225;202201;1558;4624;1110;3614;334;1188;304;980;638;2168
320230;202201;5853;15313;4496;13087;925;2885;1741;5036;2666;7921
320240;202201;18907;46112;14363;39083;3467;10009;4733;12834;8200;22843
320245;202201;3508;9940;2698;8277;873;2838;550;1644;1423;4482
320250;202201;2981;7745;2080;5761;370;1179;877;2118;1247;3297
320255;202201;2198;6464;1918;5964;386;1266;1073;3385;1459;4651
320260;202201;1595;4348;1032;3164;204;691;282;723;486;1414
320265;202201;2605;7770;2106;6792;878;3025;398;1247;1276;4272
320270;202201;2466;6810;1938;5772;427;1407;761;2261;1188;3668
320280;202201;8501;21475;6990;18994;1132;3411;4085;10652;5217;14063
320290;202201;1501;4314;1003;3159;239;831;269;805;508;1636
320300;202201;4580;12923;3735;11297;957;3196;1367;3925;2324;7121
320305;202201;5761;15574;4499;13199;795;2517;2226;6351;3021;8868
320310;202201;2490;6513;1786;5102;308;960;821;2200;1129;3160
320313;202201;2757;6572;1912;5065;363;1066;639;1499;1002;2565
320316;202201;1790;4791;1376;4108;201;602;760;2280;961;2882
320320;202201;24959;62912;18296;51779;3877;11428;7261;20550;11138;31978
320330;202201;3153;8229;2475;7045;377;1113;1397;4002;1774;5115
320332;202201;9210;23759;7431;20568;1407;4185;3604;9730;5011;13915
320334;202201;2037;5550;1442;4339;289;1049;377;879;666;1928
320335;202201;1740;4914;1239;3776;234;833;390;1096;624;1929
320340;202201;5664;13334;4728;12005;458;1253;2982;7608;3440;8861
320350;202201;5962;14078;4283;11185;417;1261;2466;6005;2883;7266
320360;202201;1558;3863;1174;3170;140;387;582;1512;722;1899
320370;202201;3006;8741;2285;7228;624;2142;790;2428;1414;4570
320380;202201;3033;7638;2526;6832;253;790;1619;4238;1872;5028
320390;202201;8501;21719;6354;17577;1230;3665;2707;7070;3937;10735
320400;202201;3657;9950;2771;8097;710;2224;1030;2872;1740;5096
320405;202201;5855;14583;4511;12319;555;1671;2508;6608;3063;8279
320410;202201;5361;13300;4128;11366;683;1892;2133;6003;2816;7895
320420;202201;4016;9786;3165;8430;687;1943;1175;3003;1862;4946
320425;202201;2380;5543;1843;4656;168;431;1157;2849;1325;3280
320430;202201;3576;8712;2869;7515;356;980;1780;4516;2136;5496
320435;202201;2477;7432;1954;6353;535;1868;769;2537;1304;4405
320440;202201;1711;4571;1300;3811;204;667;602;1651;806;2318
320450;202201;2093;5672;1662;4893;294;1017;837;2281;1131;3298
320455;202201;4975;14557;3464;11113;822;2922;952;2754;1774;5676
320460;202201;2335;6629;1728;5404;419;1458;528;1547;947;3005
320465;202201;1596;4279;1193;3526;218;670;602;1784;820;2454
320470;202201;4280;11188;3243;9111;639;1993;1103;2832;1742;4825
320480;202201;2289;5593;1880;4927;182;527;1301;3300;1483;3827
320490;202201;26676;65099;20485;54747;3177;8880;9746;25783;12923;34663
320495;202201;1563;4123;1162;3346;272;897;314;822;586;1719
320500;202201;62396;159028;50977;140259;5844;18181;31502;82701;37346;100882
320501;202201;5286;14761;4033;12497;1056;3644;1342;4120;2398;7764
320503;202201;2612;7257;1757;5544;483;1636;498;1527;981;3163
320506;202201;2997;8719;2278;7194;675;2303;286;901;961;3204
320510;202201;12476;32050;10299;28484;833;2740;6751;17852;7584;20592
320515;202201;1972;5272;1561;4455;374;1178;577;1591;951;2769
320517;202201;2410;6905;1955;5973;552;1797;718;2162;1270;3959
320520;202201;43759;108843;33728;92439;5065;15472;15981;41938;21046;57410
320530;202201;38272;96269;30829;83717;2445;8098;19926;50823;22371;58921
330010;202201;27421;67624;23178;61052;2039;6153;16919;43045;18958;49198
330015;202201;1574;3692;1269;3265;171;500;795;1962;966;2462
330020;202201;21819;52588;18522;47977;2060;5766;13492;34525;15552;40291
330022;202201;2152;5564;1714;4869;235;673;933;2670;1168;3343
330023;202201;6446;14478;5046;12604;643;1776;3345;8129;3988;9905
330025;202201;7865;17446;5121;13067;1023;2918;1706;4085;2729;7003
330030;202201;11573;29368;9091;25571;690;2483;6131;16343;6821;18826
330040;202201;17493;43434;14402;38528;847;2840;10485;26763;11332;29603
330045;202201;98481;219468;82624;200039;4128;10778;69316;165618;73444;176396
330050;202201;3147;7882;2460;6794;399;1238;1379;3594;1778;4832
330060;202201;6156;15202;4905;13078;829;2569;2325;5665;3154;8234
330070;202201;28136;66493;23371;59953;2700;7604;15691;39625;18391;47229
330080;202201;10427;24450;8969;22455;926;2507;6364;15819;7290;18326
330090;202201;3701;7485;2665;6091;148;357;1959;4468;2107;4825
330093;202201;3073;7038;2330;6051;114;322;1806;4637;1920;4959
330095;202201;1599;4185;1255;3585;120;387;740;1992;860;2379
330100;202201;80973;201825;70229;186689;3038;10206;56176;146646;59214;156852
330110;202201;2385;6267;1919;5556;223;722;1241;3464;1464;4186
330115;202201;3021;6911;2183;5639;322;908;1226;3027;1548;3935
330120;202201;3968;8225;3053;7102;164;460;2369;5278;2533;5738
330130;202201;4795;12325;3974;11165;425;1284;2703;7481;3128;8765
330140;202201;4320;10381;3533;9334;285;931;2621;6689;2906;7620
330150;202201;2731;6793;2194;5968;334;957;1271;3315;1605;4272
330160;202201;1571;4082;1210;3468;211;651;669;1830;880;2481
330170;202201;134334;310955;110993;280417;11876;29530;81579;206221;93455;235751
330180;202201;2242;5068;1768;4438;95;301;1308;3172;1403;3473
330185;202201;11696;27255;9885;24820;410;1318;8292;20300;8702;21618
330187;202201;5508;12964;4446;11301;520;1361;2862;7103;3382;8464
330190;202201;43583;97087;37569;89082;1795;4888;31140;72460;32935;77348
330200;202201;18809;44862;15567;40953;2158;5466;11127;29556;13285;35022
330205;202201;2502;5929;1934;5028;136;395;1320;3289;1456;3684
330210;202201;3724;8749;2791;7213;309;824;1558;3849;1867;4673
330220;202201;14611;34258;10898;28280;1776;5145;4951;11983;6727;17128
330225;202201;4417;10589;3438;9157;194;650;2535;6576;2729;7226
330227;202201;20035;45501;17017;41925;545;1555;14905;36225;15450;37780
330230;202201;2307;4922;1540;3946;141;412;827;2112;968;2524
330240;202201;27373;67022;23223;60971;1702;5180;17365;44390;19067;49570
330245;202201;1932;4591;1233;3420;242;666;490;1331;732;1997
330250;202201;45688;109174;38349;98736;4566;12581;26593;67410;31159;79991
330260;202201;5608;12742;4339;11058;281;871;3354;8284;3635;9155
330270;202201;36830;81652;23675;60526;3304;9145;10728;25991;14032;35136
330280;202201;2760;6695;2161;5732;182;580;1416;3542;1598;4122
330285;202201;29731;66513;24056;58618;1246;3664;19067;44993;20313;48657
330290;202201;4692;10630;3831;9531;268;841;2970;7082;3238;7923
330300;202201;6438;14378;4823;12157;320;929;3530;8629;3850;9558
330310;202201;3029;7006;2247;5780;131;375;1602;4007;1733;4382
330320;202201;19638;43513;15444;38371;1555;3356;11677;29256;13232;32612
330330;202201;49803;103581;39662;90272;2772;6992;29811;65999;32583;72991
330340;202201;20515;46524;15200;38580;1938;5727;8509;20205;10447;25932
330350;202201;168767;367482;141508;335097;5895;15098;122136;286012;128031;301110
330360;202201;8179;18956;7026;17568;264;655;5995;14941;6259;15596
330370;202201;5736;15423;4559;13521;880;2758;2254;6691;3134;9449
330380;202201;6627;16472;5183;13994;622;2027;3246;8281;3868;10308
330385;202201;4551;12194;3762;11093;632;2096;2161;6185;2793;8281
330390;202201;31907;80179;25226;69476;2667;8810;16385;42539;19052;51349
330395;202201;3619;8422;2975;7635;123;415;2308;5766;2431;6181
330400;202201;3888;9670;3351;8860;158;570;2602;6487;2760;7057
330410;202201;3849;9467;2840;7814;444;1400;1547;3991;1991;5391
330411;202201;3201;8325;2543;7176;158;565;1809;4866;1967;5431
330412;202201;1855;4913;1541;4405;122;420;1056;2862;1178;3282
330414;202201;26695;64086;22054;57898;1232;3789;17433;44885;18665;48674
330415;202201;5464;13889;4108;11590;382;1225;2431;6600;2813;7825
330420;202201;14281;33963;10611;28242;1019;3244;6196;15344;7215;18588
330430;202201;11265;25037;9619;22888;258;886;8080;18649;8338;19535
330440;202201;3208;7936;2487;6777;256;846;1656;4292;1912;5138
330450;202201;1621;4330;1318;3831;126;398;816;2299;942;2697
330452;202201;20786;49995;16945;44300;1689;5123;11667;29440;13356;34563
330455;202201;664855;1485181;535466;1307568;53138;139968;384444;917310;437582;1057278
330460;202201;1298;3361;1003;2950;155;495;582;1684;737;2179
330470;202201;6178;14414;4551;11987;1067;2935;1758;4601;2825;7536
330475;202201;10871;26264;8866;23746;1012;3220;6196;16103;7208;19323
330480;202201;6593;16193;5595;14782;439;1286;3986;10206;4425;11492
330490;202201;126559;278367;104041;248871;9102;22990;78050;184046;87152;207036
330500;202201;8940;20565;7530;18726;490;1376;5763;14077;6253;15453
330510;202201;47123;110369;36084;95359;4081;11800;24753;64182;28834;75982
330513;202201;1469;3537;1207;3201;162;462;758;2017;920;2479
330515;202201;2857;7297;2347;6599;328;1040;1464;3960;1792;5000
330520;202201;13830;34048;11597;30765;997;3087;8164;20945;9161;24032
330530;202201;1878;4347;1403;3666;225;638;744;1928;969;2566
330540;202201;3233;8083;2538;6939;581;1696;1076;2895;1657;4591
330550;202201;11731;27133;9274;24027;1804;4986;5252;13464;7056;18450
330555;202201;21419;42476;18035;38598;629;1444;15444;33359;16073;34803
330560;202201;4542;11348;3709;10049;490;1399;2400;6310;2890;7709
330570;202201;3097;7944;2692;7378;361;1049;1877;5098;2238;6147
330575;202201;6415;15583;5581;14244;271;811;4598;11362;4869;12173
330580;202201;21828;54547;17801;47643;2264;6852;10416;26290;12680;33142
330590;202201;1644;4179;1382;3850;188;505;940;2687;1128;3192
330600;202201;14232;35248;11721;31367;775;2543;8074;20839;8849;23382
330610;202201;10848;27216;8896;24258;782;2383;6103;16251;6885;18634
330615;202201;2378;6090;1919;5475;285;782;1306;3810;1591;4592
330620;202201;4705;12575;3786;11064;739;2382;1771;4969;2510;7351
330630;202201;29895;71014;23885;61916;1183;3927;17638;43871;18821;47798
350010;202201;2378;6130;1442;4215;298;925;358;822;656;1747
350020;202201;776;1928;476;1377;63;188;162;443;225;631
350030;202201;3896;10415;3035;8985;600;2048;1593;4400;2193;6448
350040;202201;837;2309;514;1636;72;292;173;422;245;714
350050;202201;1581;3745;1096;2956;203;631;432;978;635;1609
350055;202201;1017;2575;827;2294;102;285;500;1339;602;1624
350060;202201;265;652;154;422;24;78;63;162;87;240
350070;202201;3585;9220;2453;7235;446;1512;964;2554;1410;4066
350075;202201;671;1857;519;1575;185;586;102;316;287;902
350080;202201;726;1847;511;1490;49;167;232;620;281;787
350090;202201;646;1488;408;1097;70;208;190;481;260;689
350100;202201;2713;6877;1941;5593;123;466;1255;3377;1378;3843
350110;202201;538;1303;390;1053;18;59;249;654;267;713
350115;202201;1328;3715;1103;3278;166;561;590;1594;756;2155
350120;202201;700;1605;414;1111;40;142;220;529;260;671
350130;202201;3547;9135;2831;7847;438;1266;1497;3854;1935;5120
350140;202201;830;2215;600;1802;45;170;332;911;377;1081
350150;202201;567;1653;473;1486;101;336;158;446;259;782
350160;202201;12840;32028;9008;24989;1081;3457;5438;14256;6519;17713
350170;202201;2722;7386;2310;6538;316;1018;1295;3338;1611;4356
350180;202201;1107;2603;651;1805;97;293;279;709;376;1002
350190;202201;3308;9202;2334;7075;353;1270;1072;2806;1425;4076
350200;202201;498;1348;388;1142;18;72;263;724;281;796
350210;202201;6633;15009;4671;12028;407;1235;3065;7489;3472;8724
350220;202201;3238;8632;2290;6839;418;1330;905;2462;1323;3792
350230;202201;1123;2752;934;2500;154;455;578;1481;732;1936
350240;202201;683;1913;467;1426;91;288;129;358;220;646
350250;202201;3600;9553;2733;8164;637;2036;997;2882;1634;4918
350260;202201;945;2112;623;1598;63;176;387;938;450;1114
350270;202201;5059;12891;4116;11202;510;1560;2396;6066;2906;7626
350275;202201;2758;7138;2244;6388;235;799;1534;4164;1769;4963
350280;202201;20380;45542;13227;34266;2014;5451;6045;14929;8059;20380
350290;202201;3458;9294;2476;7365;440;1416;1086;3018;1526;4434
350300;202201;730;1878;560;1573;61;189;341;896;402;1085
350310;202201;1046;2850;808;2407;105;361;384;1057;489;1418
350315;202201;654;1586;455;1274;33;114;250;630;283;744
350320;202201;17537;43754;13376;36641;2334;7090;6172;15722;8506;22812
350330;202201;15353;36566;11374;29376;1022;3003;7549;18363;8571;21366
350335;202201;418;1142;331;982;46;146;152;433;198;579
350340;202201;1336;3322;860;2489;115;397;404;1055;519;1452
350350;202201;811;1960;633;1769;72;218;410;1137;482;1355
350360;202201;1156;3338;917;2881;174;571;388;1219;562;1790
350370;202201;748;1805;546;1445;157;387;214;542;371;929
350380;202201;4966;13287;3674;10661;892;2651;1296;3655;2188;6306
350390;202201;12143;30521;9738;26675;1444;4212;5602;14636;7046;18848
350395;202201;480;1184;255;761;38;116;87;243;125;359
350400;202201;9209;21897;6622;17843;1582;4481;2154;5774;3736;10255
350410;202201;11540;31088;8810;26074;1575;5172;3932;10856;5507;16028
350420;202201;1004;2571;707;1993;127;345;206;506;333;851
350430;202201;761;1934;605;1703;68;235;381;986;449;1221
350440;202201;2291;5500;1873;4891;108;348;1295;3244;1403;3592
350450;202201;7199;19314;5665;16755;1136;3770;2567;7125;3703;10895
350460;202201;2129;5373;1295;3774;180;570;518;1366;698;1936
350470;202201;280;688;227;607;11;38;163;418;174;456
350480;202201;1091;2608;752;2068;160;498;215;507;375;1005
350490;202201;2150;5392;1569;4484;280;892;622;1593;902;2485
350500;202201;702;1845;530;1561;60;197;242;665;302;862
350510;202201;1310;3232;1005;2710;96;299;629;1611;725;1910
350520;202201;2511;7204;2009;6293;314;1137;920;2602;1234;3739
350530;202201;3276;8053;2520;6655;238;738;1533;3754;1771;4492
350535;202201;1636;4283;1397;3943;171;529;899;2474;1070;3003
350540;202201;2165;4852;1645;4116;137;358;1161;2786;1298;3144
350550;202201;9171;22078;6518;17788;616;2098;3915;9849;4531;11947
350560;202201;4178;11190;3405;9939;263;913;2328;6533;2591;7446
350570;202201;29345;78465;24405;69611;3659;11580;13733;37488;17392;49068
350580;202201;2323;5979;1508;4397;369;1202;449;1102;818;2304
350590;202201;5416;14198;4069;11327;466;1476;2486;6411;2952;7887
350600;202201;37750;85799;24564;63733;3282;9703;12284;29370;15566;39073
350610;202201;7809;20557;5712;16580;760;2573;3058;8296;3818;10869
350620;202201;467;1164;294;888;33;113;164;463;197;576
350630;202201;1716;4096;1290;3393;76;260;871;2118;947;2378
350635;202201;10949;25678;8345;21715;926;2684;5450;13618;6376;16302
350640;202201;1013;2655;576;1732;105;326;169;431;274;757
350650;202201;9549;24617;6831;19540;1126;3530;3007;7994;4133;11524
350660;202201;5079;12668;4006;10974;514;1436;2417;6527;2931;7963
350670;202201;1887;4952;1545;4458;195;591;1007;2914;1202;3505
350680;202201;1217;3201;854;2557;141;430;372;1077;513;1507
350690;202201;1449;3623;1050;2959;143;453;590;1612;733;2065
350700;202201;5345;13067;4094;11205;732;2219;2124;5569;2856;7788
350710;202201;3207;8376;2741;7588;477;1487;1528;3943;2005;5430
350715;202201;841;2318;721;2127;119;423;388;1029;507;1452
350720;202201;174;442;131;377;22;71;51;126;73;197
350730;202201;668;1807;563;1628;35;121;402;1102;437;1223
350740;202201;1912;4843;1378;3843;233;718;543;1360;776;2078
350745;202201;656;1616;398;1154;28;115;185;476;213;591
350750;202201;11326;28849;9075;25080;1459;4773;4698;11830;6157;16603
350760;202201;17054;40879;12781;33783;2162;6509;6450;15428;8612;21937
350770;202201;1171;2785;725;2029;58;179;440;1189;498;1368
350775;202201;777;1741;551;1419;74;175;295;767;369;942
350780;202201;2605;6115;1925;5187;508;1250;712;2239;1220;3489
350790;202201;2310;6018;1529;4581;281;885;479;1225;760;2110
350800;202201;3928;10783;3393;9899;241;839;2419;6829;2660;7668
350810;202201;3206;7448;2472;6400;426;1078;1267;3239;1693;4317
350820;202201;1022;2340;619;1645;62;188;315;781;377;969
350830;202201;943;2513;572;1739;95;314;180;451;275;765
350840;202201;3711;10574;2897;9122;505;1825;1438;4190;1943;6015
350850;202201;8894;23562;7166;20562;1111;3502;4009;10860;5120;14362
350860;202201;3966;10134;3434;9433;132;487;2713;7374;2845;7861
350870;202201;2917;7778;2211;6670;230;787;1383;4063;1613;4850
350880;202201;1508;4110;1228;3583;351;1030;345;974;696;2004
350890;202201;561;1440;373;1058;51;159;140;347;191;506
350900;202201;9376;24170;6594;18606;1134;3482;3091;7992;4225;11474
350910;202201;1012;2349;865;2137;83;216;667;1609;750;1825
350920;202201;13335;31854;11408;28897;379;1283;9506;23224;9885;24507
350925;202201;4487;11763;3280;9708;512;1715;1714;4703;2226;6418
350930;202201;1595;4085;1140;3222;82;261;702;1933;784;2194
350940;202201;2527;6333;1992;5494;196;657;1313;3416;1509;4073
350945;202201;966;2630;762;2249;117;371;408;1120;525;1491
350950;202201;101545;251974;79988;213044;8711;25746;51887;131869;60598;157615
350960;202201;6989;18397;5504;15713;662;2186;3341;9045;4003;11231
350970;202201;3840;10382;2825;8564;818;2725;820;2134;1638;4859
350980;202201;725;1890;597;1669;131;378;301;828;432;1206
350990;202201;2066;5427;1580;4668;339;1142;658;1866;997;3008
350995;202201;910;2711;833;2566;66;252;591;1747;657;1999
351000;202201;3175;8212;2205;6403;476;1414;798;2243;1274;3657
351010;202201;416;1000;270;755;35;105;126;338;161;443
351015;202201;998;2880;834;2565;128;436;409;1131;537;1567
351020;202201;9374;24668;7213;21097;1379;4266;3628;10230;5007;14496
351030;202201;3148;9001;2557;7860;325;1132;1479;4401;1804;5533
351040;202201;5559;13325;4692;12065;174;571;3923;9810;4097;10381
351050;202201;18749;44254;14164;37513;2225;6200;7554;19638;9779;25838
351060;202201;54342;132021;42492;112548;3493;10492;29817;76200;33310;86692
351070;202201;1484;3584;873;2581;243;741;161;458;404;1199
351080;202201;2983;6990;2194;6077;223;716;1504;4004;1727;4720
351090;202201;349;965;267;823;53;175;91;274;144;449
351100;202201;2993;7808;2039;5971;427;1363;676;1970;1103;3333
351110;202201;6800;16932;4735;13293;685;2192;2325;6120;3010;8312
351120;202201;796;2057;572;1669;92;270;227;633;319;903
351130;202201;1227;3138;608;1822;96;309;175;464;271;773
351140;202201;2455;6621;1879;5583;354;1198;913;2428;1267;3626
351150;202201;3125;8656;2213;6778;305;1069;869;2402;1174;3471
351160;202201;1211;3621;909;2952;190;665;241;651;431;1316
351170;202201;1524;4025;1327;3698;116;375;938;2491;1054;2866
351190;202201;1094;2968;775;2350;145;427;292;845;437;1272
351200;202201;1741;4043;1319;3459;74;236;969;2401;1043;2637
351210;202201;1699;4048;1127;3035;85;305;668;1632;753;1937
351220;202201;3727;9914;3233;9148;243;785;2334;6428;2577;7213
351230;202201;2111;5426;1638;4642;273;869;857;2238;1130;3107
351240;202201;2640;6585;1702;4723;376;1056;627;1574;1003;2630
351250;202201;1186;3064;734;2170;76;246;287;843;363;1089
351260;202201;988;2392;729;1938;136;387;295;738;431;1125
351270;202201;568;1486;407;1177;41;144;204;499;245;643
351280;202201;4279;10909;3369;9293;630;1841;1557;4132;2187;5973
351290;202201;1386;3349;998;2694;104;323;659;1697;763;2020
351300;202201;21484;55894;15613;45196;2556;8124;7671;21078;10227;29202
351310;202201;3806;9037;2948;7751;142;514;2219;5552;2361;6066
351320;202201;996;2802;735;2291;131;444;247;681;378;1125
351330;202201;522;1265;421;1072;25;94;294;660;319;754
351340;202201;7186;19202;5945;17108;1182;3595;3161;8879;4343;12474
351350;202201;13283;32095;11092;28686;747;2151;8594;21461;9341;23612
351360;202201;4185;10718;3480;9713;679;2136;1740;4491;2419;6627
351370;202201;2247;6056;1540;4651;340;1129;492;1318;832;2447
351380;202201;51257;120127;37234;96769;3955;11329;23022;57104;26977;68433
351385;202201;436;1092;189;569;28;85;63;166;91;251
351390;202201;1443;3429;918;2674;111;363;567;1584;678;1947
351400;202201;1092;2900;913;2564;87;260;621;1678;708;1938
351410;202201;2884;7708;2141;6320;362;1074;915;2610;1277;3684
351420;202201;539;1282;322;913;33;102;191;494;224;596
351430;202201;1061;2719;878;2441;57;168;640;1726;697;1894
351440;202201;3769;9637;2617;7401;489;1463;817;1993;1306;3456
351450;202201;1868;4809;1296;3811;249;841;309;714;558;1555
351460;202201;985;2463;795;2179;108;333;508;1346;616;1679
351470;202201;1317;3225;1056;2811;68;232;731;1828;799;2060
351480;202201;2675;7530;2122;6655;346;1277;1028;2964;1374;4241
351490;202201;2217;6035;1925;5525;74;316;1592;4423;1666;4739
351492;202201;381;993;329;886;5;18;254;666;259;684
351495;202201;219;554;173;473;15;35;109;294;124;329
351500;202201;44037;103695;34421;88533;4066;11108;22431;55355;26497;66463
351510;202201;13925;33053;10402;27341;1043;3158;6930;17453;7973;20611
351512;202201;525;1368;392;1088;72;209;156;402;228;611
351515;202201;3579;7941;2342;5983;458;1234;683;1846;1141;3080
351518;202201;2746;6703;1875;5223;237;774;1010;2501;1247;3275
351519;202201;683;1818;436;1359;74;237;89;246;163;483
351520;202201;1383;3378;657;1945;70;242;310;820;380;1062
351530;202201;384;979;236;681;36;112;109;263;145;375
351535;202201;1953;4682;1447;3838;215;624;751;1910;966;2534
351540;202201;2913;7000;2006;5436;210;681;977;2349;1187;3030
351550;202201;8017;19416;5649;15298;533;1673;3272;8205;3805;9878
351560;202201;518;1430;414;1232;106;349;134;373;240;722
351565;202201;279;757;222;655;48;168;66;164;114;332
351570;202201;24098;61532;18946;51805;1673;5108;12489;32733;14162;37841
351580;202201;247;611;145;437;8;26;71;212;79;238
351590;202201;540;1211;284;764;25;90;167;410;192;500
351600;202201;1444;3802;1135;3233;151;479;636;1690;787;2169
351610;202201;803;1863;522;1383;35;105;303;759;338;864
351620;202201;25993;66606;19497;56054;2858;9566;9640;25413;12498;34979
351630;202201;31429;78616;25685;69370;2478;7722;17829;46061;20307;53783
351640;202201;19724;49179;15764;42491;1196;3962;11167;28565;12363;32527
351650;202201;396;1049;209;652;24;88;60;169;84;257
351660;202201;775;2090;528;1596;87;265;123;325;210;590
351670;202201;6722;17516;4552;12976;843;2408;2015;5339;2858;7747
351680;202201;471;1269;330;978;60;187;88;213;148;400
351685;202201;450;1245;367;1114;89;263;134;372;223;635
351690;202201;1282;3166;761;2182;95;323;354;926;449;1249
351700;202201;1443;3488;1072;2877;188;556;567;1425;755;1981
351710;202201;852;2183;648;1824;56;195;385;990;441;1185
351720;202201;1638;4090;1144;3255;174;543;527;1399;701;1942
351730;202201;1043;2631;867;2363;70;221;545;1410;615;1631
351740;202201;3715;9054;3031;7824;459;1312;1687;3991;2146;5303
351750;202201;1745;4338;1060;3139;156;494;490;1385;646;1879
351760;202201;3610;9691;2751;8094;510;1701;1286;3448;1796;5149
351770;202201;2057;5701;1700;5062;234;797;1056;2998;1290;3795
351780;202201;1300;3208;804;2325;100;341;345;928;445;1269
351790;202201;1519;3554;1212;3146;155;411;790;2021;945;2432
351800;202201;552;1242;304;802;34;103;127;284;161;387
351810;202201;1172;3018;974;2724;74;209;663;1765;737;1974
351820;202201;3003;8074;2212;6605;514;1688;669;1805;1183;3493
351830;202201;4953;12703;3830;10828;327;1092;2471;6642;2798;7734
351840;202201;9813;25819;7613;21977;854;2849;4512;12097;5366;14946
351850;202201;1645;4405;1115;3396;183;632;410;1043;593;1675
351860;202201;2898;8053;2255;6918;270;922;1352;4130;1622;5052
351870;202201;26795;65858;20545;55910;4377;12168;9617;26245;13994;38413
351880;202201;155862;382744;120899;325395;19203;57905;69995;178691;89198;236596
351885;202201;1030;2635;824;2310;53;202;577;1556;630;1758
351890;202201;947;2401;630;1887;124;412;152;397;276;809
351900;202201;1299;3311;999;2872;99;285;645;1826;744;2111
351905;202201;501;1359;367;1111;36;125;187;501;223;626
351907;202201;23580;59908;18733;51670;1805;5772;12595;33182;14400;38954
351910;202201;1832;4569;1343;3591;100;300;802;1922;902;2222
351920;202201;971;2547;755;2137;112;358;336;860;448;1218
351925;202201;989;2535;778;2170;108;356;439;1129;547;1485
351930;202201;3561;9610;3221;9006;297;921;2499;6840;2796;7761
351940;202201;1154;2920;856;2402;130;420;442;1223;572;1643
351950;202201;1852;4018;1433;3433;65;193;1054;2425;1119;2618
351960;202201;5587;13691;4209;11350;882;2571;2005;5100;2887;7671
351970;202201;8657;23973;7018;21287;1047;3640;4173;12140;5220;15780
351980;202201;1130;2620;762;2028;87;291;460;1121;547;1412
351990;202201;1605;3698;1188;3096;64;230;623;1433;687;1663
352000;202201;2901;7957;2537;7243;233;813;1739;4648;1972;5461
352010;202201;2548;6471;2093;5758;580;1665;574;1615;1154;3280
352020;202201;1565;4105;1232;3557;188;624;622;1677;810;2301
352030;202201;6449;16313;5156;14264;742;2300;3038;8052;3780;10352
352040;202201;4444;10892;3226;8643;517;1529;1233;2963;1750;4492
352042;202201;3592;8368;2502;6683;326;1019;1413;3647;1739;4666
352044;202201;2344;6061;1459;4423;249;841;335;932;584;1773
352050;202201;14322;36995;9914;28623;2464;7710;2469;6220;4933;13930
352060;202201;820;2140;631;1803;105;339;282;726;387;1065
352070;202201;1001;2004;669;1574;43;120;394;855;437;975
352080;202201;509;1280;323;930;39;108;113;304;152;412
352090;202201;1677;4773;1420;4300;166;586;717;1977;883;2563
352100;202201;3885;10520;3157;9182;546;1775;1574;4348;2120;6123
352110;202201;727;2034;553;1705;120;379;234;685;354;1064
352115;202201;605;1594;499;1430;74;232;300;835;374;1067
352120;202201;951;2673;779;2344;81;259;480;1342;561;1601
352130;202201;2238;6054;1513;4338;218;635;659;1781;877;2416
352140;202201;1252;3345;917;2692;155;476;442;1280;597;1756
352150;202201;983;2516;765;2155;78;250;528;1437;606;1687
352160;202201;1076;2600;789;2139;71;241;454;1179;525;1420
352170;202201;3256;8429;2640;7293;269;856;1697;4418;1966;5274
352180;202201;2695;7028;2097;6005;464;1467;830;2161;1294;3628
352190;202201;1432;3716;1156;3303;144;442;697;1962;841;2404
352200;202201;350;1055;260;885;39;129;96;322;135;451
352210;202201;22520;50691;17871;44559;847;2586;14356;34903;15203;37489
352215;202201;725;1815;602;1627;84;238;348;922;432;1160
352220;202201;25865;60853;19128;49741;2624;7679;11001;26363;13625;34042
352230;202201;16780;45973;13306;39773;2943;9690;5405;15013;8348;24703
352240;202201;11093;27641;8686;23804;1602;4749;4307;11104;5909;15853
352250;202201;24847;67191;20578;60112;2289;7397;14032;40101;16321;47498
352260;202201;5479;13305;3838;10228;480;1486;2316;5576;2796;7062
352265;202201;1010;2740;900;2590;97;307;626;1753;723;2060
352270;202201;1721;4945;1335;4148;264;918;527;1505;791;2423
352280;202201;2548;6208;1944;5367;205;669;1177;3029;1382;3698
352290;202201;1473;4026;1203;3550;129;435;668;1781;797;2216
352300;202201;984;2527;687;1945;80;258;385;1026;465;1284
352310;202201;44563;115179;34112;97888;6131;18458;18277;51929;24408;70387
352320;202201;7316;18147;5786;15437;742;2230;3419;8282;4161;10512
352330;202201;2577;6407;2010;5634;250;874;1304;3431;1554;4305
352340;202201;7213;18581;5539;15588;801;2529;2955;7669;3756;10198
352350;202201;2532;6858;2024;5798;156;555;1339;3616;1495;4171
352360;202201;1448;3724;1180;3260;81;271;884;2346;965;2617
352370;202201;1153;3156;1005;2922;28;118;817;2335;845;2453
352380;202201;934;2437;713;2065;151;445;294;814;445;1259
352390;202201;16284;39190;11434;30835;1656;5010;6534;16579;8190;21589
352400;202201;3903;10623;3224;9385;798;2547;1587;4409;2385;6956
352410;202201;3789;9402;2964;8091;225;717;1891;4950;2116;5667
352420;202201;909;2222;653;1844;111;361;275;730;386;1091
352430;202201;9103;21699;6813;17873;984;2925;3799;9458;4783;12383
352440;202201;20695;54752;15998;46016;3495;10618;6556;18169;10051;28787
352450;202201;856;2036;469;1396;71;224;187;521;258;745
352460;202201;3353;8784;2421;7189;432;1361;1131;3175;1563;4536
352470;202201;3614;9036;2807;7758;248;814;1825;4758;2073;5572
352480;202201;4664;10766;3227;8294;411;1243;1649;3791;2060;5034
352490;202201;875;2416;711;2137;114;393;350;992;464;1385
352500;202201;11706;29330;8242;23105;3234;10381;1627;2940;4861;13321
352510;202201;4341;11515;3368;9832;530;1697;1870;5240;2400;6937
352520;202201;3193;8026;2503;6922;349;1105;1547;3924;1896;5029
352530;202201;12374;30699;8823;24303;1537;4783;3490;8357;5027;13140
352540;202201;619;1756;474;1466;70;219;187;538;257;757
352550;202201;1061;2829;756;2290;125;443;289;788;414;1231
352560;202201;653;1745;524;1519;65;238;320;844;385;1082
352570;202201;2588;7132;1748;5426;429;1444;261;604;690;2048
352580;202201;679;1713;577;1533;55;167;388;986;443;1153
352585;202201;379;1011;281;844;25;96;178;496;203;592
352590;202201;14461;37074;10532;29953;2046;6445;5615;14874;7661;21319
352600;202201;2109;5533;1687;4808;140;462;1100;2939;1240;3401
352610;202201;2962;7941;2256;6767;392;1397;1083;3042;1475;4439
352620;202201;6163;14958;4742;12980;1071;2929;2341;6402;3412;9331
352630;202201;922;2217;699;1903;92;277;381;996;473;1273
352640;202201;3293;8196;2456;6762;234;704;1470;3857;1704;4561
352650;202201;649;1772;462;1392;62;213;191;539;253;752
352660;202201;1180;3345;1000;3000;105;385;645;1833;750;2218
352670;202201;10920;28256;7786;22351;1539;4954;3286;8573;4825;13527
352680;202201;3517;9972;2545;7853;383;1366;1229;3373;1612;4739
352690;202201;29616;72372;23657;62804;1161;3847;17404;44362;18565;48209
352700;202201;765;1879;573;1597;121;351;254;706;375;1057
352710;202201;5865;14663;4322;11963;939;2828;1971;5114;2910;7942
352720;202201;9415;24185;7604;21007;1531;4516;3634;9490;5165;14006
352725;202201;608;1410;354;966;24;73;196;493;220;566
352730;202201;5758;16583;5240;15465;640;2113;2541;6499;3181;8612
352740;202201;2549;5970;1953;5102;169;517;1230;3024;1399;3541
352750;202201;477;1172;308;878;39;132;145;359;184;491
352760;202201;1857;4973;1482;4285;152;416;840;2404;992;2820
352770;202201;987;2539;716;2046;98;291;349;927;447;1218
352780;202201;704;1931;515;1544;96;268;164;495;260;763
352790;202201;471;1202;362;1002;35;100;166;408;201;508
352800;202201;1481;4267;1065;3364;297;976;230;580;527;1556
352810;202201;1320;3028;872;2265;111;285;539;1342;650;1627
352820;202201;490;1341;364;1121;73;238;96;268;169;506
352830;202201;634;1557;324;942;30;95;108;267;138;362
352840;202201;4345;11870;3589;10555;918;2928;1619;4608;2537;7536
352850;202201;12204;28795;8785;23525;1899;5613;3866;9497;5765;15110
352860;202201;1164;3154;915;2721;147;484;374;1053;521;1537
352870;202201;940;2299;667;1771;51;157;431;1094;482;1251
352880;202201;1851;4341;1318;3426;207;573;614;1526;821;2099
352885;202201;341;886;266;764;24;74;167;469;191;543
352890;202201;754;1780;523;1322;42;130;319;702;361;832
352900;202201;20204;51046;13833;38855;2076;6234;6224;16355;8300;22589
352910;202201;430;1106;261;773;18;61;102;251;120;312
352920;202201;2948;7317;2241;6163;114;373;1605;4241;1719;4614
352930;202201;6399;16752;4963;14039;803;2562;2533;6701;3336;9263
352940;202201;25779;66631;19794;54814;3054;9354;10934;28533;13988;37887
352950;202201;611;1586;403;1210;93;297;115;300;208;597
352960;202201;813;2087;501;1455;77;248;166;388;243;636
352965;202201;268;734;182;572;44;143;49;145;93;288
352970;202201;3258;7558;2556;6436;161;440;1887;4626;2048;5066
352980;202201;1475;3694;1170;3259;223;661;678;1860;901;2521
352990;202201;4732;12374;3614;10576;598;1932;1986;5626;2584;7558
353000;202201;522;1383;318;928;50;168;90;205;140;373
353010;202201;2890;6981;1993;5366;329;1052;958;2353;1287;3405
353020;202201;3776;9564;2343;6716;345;1068;905;2455;1250;3523
353030;202201;5056;12396;3578;9931;764;2304;1188;3140;1952;5444
353040;202201;722;1621;517;1321;87;222;280;701;367;923
353050;202201;5715;15693;4175;12642;685;2243;2082;6038;2767;8281
353060;202201;52908;130952;44135;117453;2712;8725;33927;87276;36639;96001
353070;202201;11171;30653;8382;24814;1272;4251;4000;10852;5272;15103
353080;202201;4963;12998;3396;10071;610;2058;1448;3762;2058;5820
353090;202201;662;1895;552;1685;36;130;364;1074;400;1204
353100;202201;324;836;162;493;29;92;48;115;77;207
353110;202201;8192;20587;6631;18459;1457;3966;3514;10216;4971;14182
353120;202201;445;1097;346;935;46;164;180;422;226;586
353130;202201;2870;6587;1882;4932;421;1204;765;1784;1186;2988
353140;202201;2998;7157;2265;5993;104;359;1660;4186;1764;4545
353150;202201;1723;4165;1261;3424;239;704;587;1502;826;2206
353160;202201;716;1810;523;1494;77;243;246;640;323;883
353170;202201;585;1514;449;1329;77;238;219;664;296;902
353180;202201;11134;26435;8875;22943;1510;4060;5411;13607;6921;17667
353190;202201;3720;9667;2963;8200;361;1111;1799;4676;2160;5787
353200;202201;1948;5096;1194;3640;176;624;409;1124;585;1748
353205;202201;468;1358;402;1221;49;162;219;643;268;805
353210;202201;986;2163;655;1638;23;67;480;1160;503;1227
353215;202201;423;1098;339;957;46;160;166;426;212;586
353220;202201;817;2148;571;1671;120;347;136;365;256;712
353230;202201;862;2295;687;2027;157;537;283;764;440;1301
353240;202201;2545;6672;2149;6068;260;851;1369;3725;1629;4576
353250;202201;1298;2894;838;2172;92;269;475;1178;567;1447
353260;202201;1261;2854;730;2003;112;330;345;883;457;1213
353270;202201;781;1940;656;1728;61;194;460;1138;521;1332
353280;202201;761;1987;551;1641;126;377;180;530;306;907
353282;202201;1969;5361;1671;4855;151;514;1085;2992;1236;3506
353284;202201;396;880;232;606;22;75;117;263;139;338
353286;202201;195;470;122;353;24;63;33;80;57;143
353290;202201;1575;4050;997;2935;156;483;350;914;506;1397
353300;202201;2354;6089;1758;4972;287;940;840;2105;1127;3045
353310;202201;436;1035;331;860;17;55;224;545;241;600
353320;202201;752;1820;643;1670;13;48;521;1320;534;1368
353325;202201;751;2117;553;1692;100;293;220;651;320;944
353330;202201;670;1663;456;1283;66;207;232;597;298;804
353340;202201;3392;8952;2633;7513;446;1448;1403;3687;1849;5135
353350;202201;4125;10066;3063;8126;653;1739;1137;2744;1790;4483
353360;202201;716;1944;573;1684;55;193;349;980;404;1173
353370;202201;615;1703;515;1546;45;165;368;1065;413;1230
353380;202201;323;914;262;806;32;116;128;363;160;479
353390;202201;6985;16821;5321;14162;411;1279;3443;8710;3854;9989
353400;202201;547;1425;422;1199;68;230;188;445;256;675
353410;202201;563;1459;430;1225;57;162;262;741;319;903
353420;202201;484;1231;322;907;73;189;55;140;128;329
353430;202201;2495;6614;1992;5727;350;1075;1050;2879;1400;3954
353440;202201;74838;194019;56834;160243;7613;23972;33632;89623;41245;113595
353450;202201;409;1018;287;816;41;147;146;374;187;521
353460;202201;3607;9452;2736;7894;411;1276;928;2523;1339;3799
353470;202201;9486;24206;7045;19759;1104;3512;3411;8856;4515;12368
353475;202201;1817;4424;1266;3400;148;463;682;1648;830;2111
353480;202201;1731;4445;1425;3958;61;222;1054;2822;1115;3044
353490;202201;1185;3021;852;2420;108;323;408;1098;516;1421
353500;202201;1126;2625;827;2176;135;373;510;1295;645;1668
353510;202201;938;2649;698;2130;176;600;235;621;411;1221
353520;202201;1123;2827;743;2185;74;242;372;988;446;1230
353530;202201;2650;6742;2138;5854;242;783;1244;3186;1486;3969
353540;202201;2283;5940;1890;5332;244;745;1184;3221;1428;3966
353550;202201;6471;16023;5314;14218;631;1827;3368;8631;3999;10458
353560;202201;2524;6484;1970;5681;475;1508;771;2030;1246;3538
353570;202201;707;1804;498;1438;84;293;234;609;318;902
353580;202201;2401;6146;1860;5122;314;895;969;2552;1283;3447
353590;202201;781;1938;560;1568;63;181;323;892;386;1073
353600;202201;1822;4443;1405;3747;157;458;818;2108;975;2566
353610;202201;749;2132;552;1749;104;375;216;631;320;1006
353620;202201;3105;7843;2275;6486;434;1332;899;2352;1333;3684
353625;202201;615;1493;397;1115;40;136;217;585;257;721
353630;202201;1563;4532;1350;4124;235;784;672;1913;907;2697
353640;202201;1418;3600;1147;3187;159;451;690;1889;849;2340
353650;202201;8290;21611;6497;18430;702;2216;3854;10323;4556;12539
353657;202201;410;1048;313;901;26;92;151;395;177;487
353660;202201;1416;2916;994;2367;197;470;549;1285;746;1755
353670;202201;4491;12028;3560;10314;593;1962;1819;4847;2412;6809
353680;202201;763;1935;574;1675;67;229;357;974;424;1203
353690;202201;468;1206;240;714;32;99;61;169;93;268
353700;202201;2228;5608;1857;5030;120;419;1381;3586;1501;4005
353710;202201;5720;12744;3561;9005;314;862;1967;4413;2281;5275
353715;202201;479;1245;298;892;14;58;118;320;132;378
353720;202201;2178;5522;1708;4833;252;773;976;2678;1228;3451
353730;202201;4732;12103;3709;10375;461;1531;2190;5653;2651;7184
353740;202201;2198;5588;1591;4553;340;1116;635;1633;975;2749
353750;202201;1004;2923;761;2483;171;589;231;721;402;1310
353760;202201;14590;32116;11383;27987;2062;5204;6647;16099;8709;21303
353770;202201;672;1903;433;1393;80;291;74;203;154;494
353780;202201;6400;16484;5248;14485;818;2582;3099;8017;3917;10599
353790;202201;3090;8954;2333;7413;556;1940;567;1603;1123;3543
353800;202201;20527;51808;16532;45654;2353;6487;9660;26336;12013;32823
353810;202201;1328;3484;914;2644;135;433;415;1156;550;1589
353820;202201;1920;4990;1334;3875;261;863;454;1216;715;2079
353830;202201;691;1684;520;1419;76;235;255;657;331;892
353850;202201;1731;4609;1366;3955;264;774;594;1655;858;2429
353860;202201;2893;7588;2236;6536;442;1490;1127;2996;1569;4486
353870;202201;33058;83997;24621;68528;2975;9327;13345;34204;16320;43531
353880;202201;3375;9031;2711;7843;210;732;1714;4731;1924;5463
353890;202201;3253;6759;2397;5561;147;403;1723;3695;1870;4098
353900;202201;791;2152;597;1795;82;282;262;722;344;1004
353910;202201;2848;7537;2430;6909;193;645;1780;4951;1973;5596
353920;202201;2112;5610;1570;4642;365;1181;426;1078;791;2259
353930;202201;5034;13009;3572;10315;605;2049;1632;4170;2237;6219
353940;202201;1306;3660;949;2975;142;489;351;981;493;1470
353950;202201;3576;9348;2791;7946;559;1720;1408;3778;1967;5498
353960;202201;886;2226;644;1799;147;400;237;622;384;1022
353970;202201;694;1613;528;1375;46;141;374;951;420;1092
353980;202201;17670;43228;14032;37253;739;2441;10428;26453;11167;28894
353990;202201;1014;2405;644;1765;106;318;317;818;423;1136
354000;202201;2785;6531;1642;4412;376;1039;375;911;751;1950
354010;202201;359;915;262;765;42;132;146;417;188;549
354020;202201;4081;10632;3294;9109;579;1727;1681;4328;2260;6055
354025;202201;770;2050;525;1589;77;261;160;461;237;722
354030;202201;540;1143;312;790;56;140;161;382;217;522
354040;202201;864;1950;569;1495;31;93;421;1061;452;1154
354050;202201;1024;2836;737;2325;142;514;306;921;448;1435
354060;202201;3838;10510;2802;8381;499;1666;1261;3408;1760;5074
354070;202201;4269;10743;2999;8335;474;1515;1445;3566;1919;5081
354075;202201;3079;8376;2493;7374;266;861;1588;4545;1854;5406
354080;202201;1537;4110;1070;3211;202;626;377;1019;579;1645
354085;202201;470;936;377;821;1;3;296;597;297;600
354090;202201;1755;4785;1520;4323;84;264;1187;3282;1271;3546
354100;202201;21933;56984;15764;46757;3262;10119;7030;20566;10292;30685
354105;202201;1524;3748;1117;3050;135;425;549;1399;684;1824
354110;202201;469;1296;351;1079;60;210;132;381;192;591
354120;202201;1484;3877;1062;3017;209;647;375;935;584;1582
354130;202201;5989;15397;4079;11787;1133;3439;458;1016;1591;4455
354140;202201;21570;52039;15444;41162;2235;6630;7533;18417;9768;25047
354150;202201;3132;7253;2470;6257;509;1317;1085;2713;1594;4030
354160;202201;3095;8636;2418;7341;601;2004;908;2544;1509;4548
354165;202201;745;2135;589;1834;86;327;321;941;407;1268
354170;202201;2055;5517;1709;4901;128;415;1025;2801;1153;3216
354180;202201;438;1191;340;1000;40;119;186;508;226;627
354190;202201;1708;4685;1238;3732;81;290;645;1834;726;2124
354200;202201;955;2247;738;1921;62;195;507;1236;569;1431
354210;202201;1001;2572;831;2310;47;165;596;1551;643;1716
354220;202201;3383;8802;2613;7372;366;1147;1452;3871;1818;5018
354230;202201;866;2084;709;1903;27;110;547;1413;574;1523
354240;202201;1913;5167;1323;4000;237;792;463;1261;700;2053
354250;202201;666;1594;431;1202;89;248;147;382;236;630
354260;202201;8704;21995;6752;18732;1051;3217;3619;9547;4670;12764
354270;202201;1088;3145;914;2835;161;527;404;1171;565;1698
354280;202201;884;2108;762;1936;61;187;540;1278;601;1465
354290;202201;1000;3073;851;2782;138;478;466;1541;604;2019
354300;202201;3785;10746;3224;9746;736;2287;1553;4631;2289;6918
354310;202201;777;2237;655;2019;145;473;284;826;429;1299
354320;202201;1052;2486;707;1927;97;297;321;786;418;1083
354323;202201;532;1236;340;893;44;107;155;381;199;488
354325;202201;1609;4662;1145;3635;200;662;347;1057;547;1719
354330;202201;10356;25310;7352;19515;709;2157;4664;11531;5373;13688
354340;202201;37548;91536;26856;73587;3224;10106;16083;42028;19307;52134
354350;202201;1301;3231;1047;2834;125;374;650;1669;775;2043
354360;202201;669;1652;422;1259;94;291;127;361;221;652
354370;202201;1072;2952;871;2637;119;411;562;1635;681;2046
354380;202201;715;1841;534;1558;101;382;172;408;273;790
354390;202201;15489;36405;10715;28347;1550;4510;5644;13972;7194;18482
354400;202201;1710;5303;1374;4547;263;910;529;1725;792;2635
354410;202201;6994;17766;5476;15006;821;2506;3047;7773;3868;10279
354420;202201;1627;4101;1223;3390;140;444;772;1996;912;2440
354425;202201;2979;7095;2184;5752;429;1181;996;2601;1425;3782
354430;202201;1652;4268;1318;3782;106;346;846;2323;952;2669
354440;202201;663;1661;449;1253;62;190;225;572;287;762
354450;202201;493;1281;303;937;42;138;107;284;149;422
354460;202201;918;2279;637;1804;96;295;322;880;418;1175
354470;202201;493;1223;349;963;18;59;176;421;194;480
354480;202201;1426;3142;947;2403;79;223;609;1447;688;1670
354490;202201;874;2490;654;2025;121;400;310;876;431;1276
354500;202201;2354;6354;1910;5676;571;1751;568;1697;1139;3448
354510;202201;789;2131;652;1884;45;153;393;1036;438;1189
354515;202201;397;1093;283;866;39;132;120;352;159;484
354520;202201;7592;20123;5532;15931;635;2163;3247;8673;3882;10836
354530;202201;4970;13539;3987;11715;853;2536;1644;4910;2497;7446
354540;202201;1461;3693;1090;3055;210;596;460;1262;670;1858
354550;202201;643;1667;519;1448;68;216;296;768;364;984
354560;202201;2473;5837;1401;3849;165;465;749;1880;914;2345
354570;202201;1336;3280;582;1611;129;359;87;229;216;588
354580;202201;9144;23597;6238;18147;933;3003;3262;9051;4195;12054
354600;202201;2210;5563;1769;4817;220;661;1146;2966;1366;3627
354610;202201;504;1274;294;847;31;92;142;385;173;477
354620;202201;520;1403;328;1043;38;148;145;430;183;578
354625;202201;330;880;201;636;33;119;52;134;85;253
354630;202201;2438;6922;2018;6136;601;1874;549;1590;1150;3464
354640;202201;3777;10369;2918;8746;405;1409;1351;3715;1756;5124
354650;202201;944;2424;764;2140;99;271;437;1209;536;1480
354660;202201;3908;8969;2220;6261;215;747;1015;2595;1230;3342
354670;202201;1170;3167;845;2534;166;546;350;972;516;1518
354680;202201;5827;14645;4486;12548;782;2334;2556;7191;3338;9525
354690;202201;551;1659;406;1351;78;272;146;458;224;730
354700;202201;1005;2610;731;2093;79;263;401;1051;480;1314
354710;202201;549;1439;390;1132;43;128;186;479;229;607
354720;202201;327;766;154;440;61;158;32;105;93;263
354730;202201;10953;30093;8610;25786;1062;3553;5177;14869;6239;18422
354740;202201;336;893;151;476;23;85;31;84;54;169
354750;202201;3043;7604;2022;5731;275;872;910;2284;1185;3156
354760;202201;2348;6091;1727;4991;344;1105;674;1763;1018;2868
354765;202201;389;1031;177;549;17;68;54;148;71;216
354770;202201;2719;6550;2040;5385;314;873;993;2479;1307;3352
354780;202201;62940;153655;49291;127904;3754;11548;33973;82493;37727;94041
354790;202201;1091;2908;854;2530;72;262;550;1559;622;1821
354800;202201;2841;7159;2201;6140;402;1186;1115;2924;1517;4110
354805;202201;1476;3297;1060;2709;108;274;671;1607;779;1881
354810;202201;686;1963;430;1435;70;267;138;435;208;702
354820;202201;1040;2875;753;2359;132;467;233;601;365;1068
354830;202201;538;1291;341;938;80;230;116;290;196;520
354840;202201;974;2400;626;1707;62;187;343;862;405;1049
354850;202201;23102;57669;16749;46912;1655;5374;10687;28369;12342;33743
354860;202201;1858;4972;1220;3690;190;645;456;1270;646;1915
354870;202201;67037;164599;52933;139403;4515;13683;35582;88372;40097;102055
354880;202201;6407;15441;3351;9213;390;1270;1386;3124;1776;4394
354890;202201;17461;42906;13835;36935;1814;5494;8094;21023;9908;26517
354900;202201;437;1072;293;828;60;198;110;246;170;444
354910;202201;6482;16696;4184;12633;937;3032;1055;2932;1992;5964
354920;202201;559;1447;296;937;38;129;78;206;116;335
354925;202201;319;881;195;618;24;78;52;152;76;230
354930;202201;412;981;287;766;34;95;141;353;175;448
354940;202201;2615;7483;1973;6157;639;2070;580;1650;1219;3720
354950;202201;1660;4068;1335;3655;63;220;1006;2632;1069;2852
354960;202201;962;2493;735;2158;72;261;405;1123;477;1384
354970;202201;4551;12226;3623;10705;354;1274;2427;6948;2781;8222
354980;202201;36952;85751;25930;67343;2421;7549;16598;40274;19019;47823
354990;202201;78326;190146;58615;155639;4103;13148;39911;99445;44014;112593
354995;202201;3163;6780;2437;5863;124;380;1901;4415;2025;4795
355000;202201;1717;4121;1307;3540;181;585;695;1734;876;2319
355010;202201;4420;11569;2945;8531;929;2651;648;1850;1577;4501
355020;202201;3925;10545;2952;8890;546;1883;1346;3788;1892;5671
355030;202201;1509455;3627235;1136720;2933767;146948;421643;632237;1512993;779185;1934636
355040;202201;3331;7844;2605;6925;195;571;2011;5316;2206;5887
355050;202201;1124;2436;847;2068;187;497;416;924;603;1421
355060;202201;6853;17766;5152;14769;805;2680;2797;7353;3602;10033
355070;202201;10817;26604;8948;23719;970;3022;5946;14861;6916;17883
355080;202201;1033;2882;671;2233;151;551;121;334;272;885
355090;202201;1347;3637;1086;3223;189;621;554;1530;743;2151
355100;202201;24234;61319;19170;54000;2492;7561;12487;34588;14979;42149
355110;202201;960;2576;723;2233;214;745;108;305;322;1050
355120;202201;790;2004;578;1710;65;214;266;765;331;979
355130;202201;882;1941;479;1230;26;81;306;727;332;808
355140;202201;2162;4673;1826;4219;81;230;1549;3494;1630;3724
355150;202201;4753;12073;3841;10537;412;1249;2513;6620;2925;7869
355160;202201;2439;6461;1794;5352;370;1188;542;1510;912;2698
355170;202201;12345;30049;9877;26084;1524;4344;5622;14458;7146;18802
355180;202201;3070;7876;2236;6543;414;1380;1036;2798;1450;4178
355190;202201;2016;5190;1603;4534;390;1055;844;2570;1234;3625
355200;202201;874;2612;748;2421;181;640;359;1121;540;1761
355210;202201;3301;8724;2584;7265;440;1361;1324;3515;1764;4876
355220;202201;52570;134115;42858;116154;7187;21203;22236;56057;29423;77260
355230;202201;1270;3131;714;2067;120;333;280;759;400;1092
355240;202201;27401;70660;19937;56423;2082;6686;11698;31010;13780;37696
355250;202201;41536;107220;31903;89397;6826;19895;14603;39131;21429;59026
355255;202201;700;1700;390;1147;44;132;154;445;198;577
355260;202201;1697;3930;1237;3217;114;378;791;1902;905;2280
355270;202201;1237;3535;977;3032;207;689;437;1256;644;1945
355280;202201;34381;84494;25478;68661;2947;8910;14395;36390;17342;45300
355290;202201;1007;2632;789;2276;124;366;381;1033;505;1399
355300;202201;1463;4144;1212;3694;223;729;515;1453;738;2182
355310;202201;1002;2699;757;2290;86;282;460;1381;546;1663
355320;202201;573;1462;441;1226;86;288;194;445;280;733
355330;202201;3203;7931;2511;6754;104;371;1932;4963;2036;5334
355340;202201;4444;9721;3419;8383;471;1160;2168;5383;2639;6543
355350;202201;1477;4066;1134;3415;200;657;498;1431;698;2088
355360;202201;1300;3190;1014;2763;89;260;647;1722;736;1982
355365;202201;387;976;210;672;53;163;37;126;90;289
355370;202201;5702;14287;4481;12390;938;2425;2154;6380;3092;8805
355380;202201;3121;8098;2411;6840;411;1323;984;2456;1395;3779
355385;202201;1569;3979;1309;3625;107;391;866;2196;973;2587
355390;202201;887;2381;652;1894;112;359;293;771;405;1130
355395;202201;2112;5654;1567;4618;246;796;621;1613;867;2409
355400;202201;10105;27919;8179;24257;1714;5802;3534;9545;5248;15347
355410;202201;25415;68116;16602;50301;3236;10697;5433;15982;8669;26679
355420;202201;657;2039;555;1857;139;534;186;586;325;1120
355430;202201;3984;9806;3080;8223;535;1499;1604;4174;2139;5673
355440;202201;823;2176;532;1583;96;290;151;415;247;705
355450;202201;3615;9095;2514;7016;377;1173;1165;2928;1542;4101
355460;202201;548;1295;342;954;33;114;170;429;203;543
355465;202201;489;1225;395;1078;53;157;242;644;295;801
355470;202201;1229;3072;737;2111;171;557;242;629;413;1186
355475;202201;385;870;323;793;10;26;255;611;265;637
355480;202201;4387;11738;3573;10528;412;1407;2432;7043;2844;8450
355490;202201;1009;2631;589;1801;51;188;292;819;343;1007
355495;202201;912;2464;683;2098;99;362;266;739;365;1101
355500;202201;7501;18746;4837;13774;680;2107;1949;5101;2629;7208
355510;202201;1506;3578;995;2747;158;482;431;1080;589;1562
355520;202201;400;908;211;606;41;103;69;205;110;308
355530;202201;370;854;149;433;7;20;71;191;78;211
355535;202201;570;1510;448;1323;86;286;229;647;315;933
355540;202201;12064;28945;10087;26261;1028;3079;7321;18442;8349;21521
355550;202201;650;1884;546;1694;52;205;317;901;369;1106
355560;202201;1244;3131;748;2197;195;635;53;165;248;800
355570;202201;318;846;178;551;30;99;49;132;79;231
355580;202201;1313;3067;833;2286;141;452;314;775;455;1227
355590;202201;178;450;140;392;12;36;89;241;101;277
355600;202201;1683;4047;1129;3129;185;549;383;1050;568;1599
355610;202201;1994;4787;1361;3716;137;404;753;1921;890;2325
355620;202201;5554;14308;4238;11815;460;1576;2423;6159;2883;7735
355630;202201;2725;7125;1995;5831;273;847;1143;3196;1416;4043
355635;202201;980;2773;734;2299;116;388;256;751;372;1139
355640;202201;3657;9750;2583;7711;561;1677;804;2395;1365;4072
355645;202201;4436;12019;3312;10100;470;1590;1867;5493;2337;7083
355650;202201;7008;18499;5523;15853;1316;3882;2193;5934;3509;9816
355660;202201;1527;3836;1073;3049;201;529;354;965;555;1494
355670;202201;4240;11083;3024;8460;371;1264;1580;3866;1951;5130
355680;202201;3143;8388;1577;4805;393;1314;134;403;527;1717
355690;202201;858;2440;589;1951;174;627;16;47;190;674
355695;202201;285;785;179;550;18;70;39;91;57;161
355700;202201;8242;22755;6930;20003;912;2939;4162;11354;5074;14293
355710;202201;10145;23517;6971;17884;906;2710;3708;8416;4614;11126
355715;202201;517;1371;297;893;66;210;57;153;123;363
355720;202201;1566;4272;1260;3753;158;521;735;2056;893;2577
355730;202201;1019;2718;846;2418;114;370;473;1268;587;1638
410010;202201;1330;3639;1040;3053;206;656;286;795;492;1451
410020;202201;1133;3269;883;2735;233;702;274;805;507;1507
410030;202201;1665;4426;1435;4082;189;589;846;2446;1035;3035
410040;202201;14235;38186;10715;31815;2193;7092;3802;10505;5995;17597
410045;202201;859;2267;634;1834;99;312;264;694;363;1006
410050;202201;2444;5986;1727;4790;258;794;712;1859;970;2653
410060;202201;2239;6130;1792;5308;393;1245;589;1663;982;2908
410070;202201;2121;5242;1612;4381;241;761;664;1619;905;2380
410080;202201;1428;3740;1042;3081;246;768;243;692;489;1460
410090;202201;1189;2922;1022;2682;87;234;600;1637;687;1871
410100;202201;2134;5945;1503;4509;250;833;164;468;414;1301
410105;202201;527;1312;317;917;30;90;123;335;153;425
410110;202201;3560;8652;2582;6928;321;940;1273;3200;1594;4140
410115;202201;607;1534;447;1258;62;196;186;470;248;666
410120;202201;2957;7736;2571;7185;374;1109;1633;4466;2007;5575
410130;202201;1378;3569;1203;3248;150;464;705;1825;855;2289
410140;202201;18205;43298;12467;33418;2191;6381;3837;9513;6028;15894
410150;202201;17828;41243;9717;25967;1655;4742;2669;6430;4324;11172
410160;202201;3238;8748;2640;7740;567;1798;1022;2935;1589;4733
410165;202201;692;1831;558;1564;63;208;318;836;381;1044
410170;202201;3126;7882;2119;5812;450;1319;243;643;693;1962
410180;202201;16934;45969;13333;39019;1935;6170;6902;18739;8837;24909
410185;202201;479;1346;358;1053;48;163;131;337;179;500
410190;202201;2364;5756;1742;4697;362;1038;509;1267;871;2305
410200;202201;6360;14028;3647;9529;696;1881;583;1473;1279;3354
410210;202201;3474;8463;2255;6363;347;1126;790;1936;1137;3062
410220;202201;580;1467;394;1140;63;193;117;311;180;504
410230;202201;1966;5165;1515;4302;227;744;677;1729;904;2473
410240;202201;5640;14459;3998;11346;824;2610;675;1768;1499;4378
410250;202201;2669;6306;1992;5245;152;494;994;2551;1146;3045
410260;202201;2013;4912;1274;3554;164;500;640;1714;804;2214
410270;202201;524;1363;391;1128;50;174;158;425;208;599
410275;202201;662;1819;476;1427;73;262;210;565;283;827
410280;202201;2556;6562;1745;5041;219;736;759;2004;978;2740
410290;202201;3603;9840;2558;7721;625;1873;785;2340;1410;4213
410300;202201;752;1812;596;1573;57;180;297;707;354;887
410302;202201;368;928;222;660;21;74;109;318;130;392
410304;202201;1399;3439;1194;3073;124;347;792;1939;916;2286
410305;202201;1818;4257;1292;3522;96;305;853;2262;949;2567
410310;202201;2889;7738;2381;6832;266;915;1424;3951;1690;4866
410315;202201;712;1614;458;1215;151;410;138;371;289;781
410320;202201;1105;3022;769;2383;112;377;130;375;242;752
410322;202201;688;1791;368;1069;44;140;158;398;202;538
410330;202201;1650;3948;1159;3068;187;504;379;982;566;1486
410335;202201;911;2383;698;1995;101;321;313;828;414;1149
410337;202201;889;2153;639;1680;97;268;230;545;327;813
410340;202201;542;1511;376;1123;30;102;159;384;189;486
410345;202201;2763;7105;1631;4745;314;982;516;1338;830;2320
410347;202201;815;2068;609;1711;64;192;208;589;272;781
410350;202201;1761;4228;1302;3515;139;422;660;1653;799;2075
410360;202201;4491;11015;3454;9246;586;1674;1417;3664;2003;5338
410370;202201;15082;39453;10103;28252;1168;3600;4284;10468;5452;14068
410380;202201;1818;4410;1357;3648;227;679;462;1108;689;1787
410390;202201;2963;7159;2046;5618;407;1266;803;1967;1210;3233
410395;202201;1000;2765;810;2395;140;416;353;1060;493;1476
410400;202201;7611;19140;5842;15908;716;2195;3246;8291;3962;10486
410405;202201;938;2127;665;1723;81;233;356;862;437;1095
410410;202201;1414;3638;1329;3519;144;443;919;2508;1063;2951
410420;202201;12359;32527;9542;27154;1343;4284;4382;11289;5725;15573
410425;202201;3723;10068;2647;7929;448;1459;1023;2770;1471;4229
410430;202201;14213;34837;10336;28036;1527;4630;4053;10193;5580;14823
410440;202201;2497;7132;2142;6493;309;1040;1176;3502;1485;4542
410442;202201;2632;7568;2138;6545;525;1703;660;1915;1185;3618
410445;202201;2438;6760;1788;5531;399;1364;316;1059;715;2423
410450;202201;1637;3925;1254;3356;222;630;543;1361;765;1991
410460;202201;2418;5858;1800;4834;235;689;864;2182;1099;2871
410465;202201;3060;8542;2444;7439;431;1386;902;2570;1333;3956
410470;202201;2376;6311;1696;5130;419;1434;281;923;700;2357
410480;202201;41869;98448;24309;68453;3710;11602;6545;15986;10255;27588
410490;202201;12499;33405;9248;27037;1439;4549;4052;10977;5491;15526
410500;202201;2033;5145;1389;3969;253;802;378;919;631;1721
410510;202201;1956;4761;1367;3742;267;699;463;1257;730;1956
410520;202201;3238;9799;2873;9115;848;2838;1054;3373;1902;6211
410530;202201;1737;4122;859;2380;105;326;231;515;336;841
410540;202201;3026;7982;2126;6202;320;1025;947;2640;1267;3665
410550;202201;8315;21583;5754;16315;997;3101;1718;4200;2715;7301
410560;202201;1668;4255;1240;3420;236;710;462;1084;698;1794
410570;202201;2825;7421;2098;6205;633;2175;259;798;892;2973
410580;202201;29627;74420;22317;61638;3364;10396;11049;28515;14413;38911
410590;202201;1714;4717;1242;3674;185;580;397;999;582;1579
410600;202201;1926;4951;1518;4175;315;870;543;1534;858;2404
410610;202201;770;1930;586;1611;68;218;280;712;348;930
410620;202201;2796;7595;1989;5817;461;1425;386;1065;847;2490
410630;202201;2757;6939;1868;5253;333;1147;472;1094;805;2241
410640;202201;5256;12060;3734;9448;834;2361;617;1589;1451;3950
410645;202201;1191;3216;986;2967;204;652;585;1771;789;2423
410650;202201;2617;6900;1845;5395;315;969;749;2028;1064;2997
410655;202201;955;2244;685;1794;39;103;345;852;384;955
410657;202201;662;1773;409;1233;62;193;125;317;187;510
410660;202201;3848;9427;2397;6409;410;1155;835;2011;1245;3166
410670;202201;1094;2671;690;1946;125;352;240;621;365;973
410680;202201;2687;7832;1887;5896;530;1709;390;1206;920;2915
410685;202201;565;1409;427;1177;87;262;183;482;270;744
410690;202201;148524;351004;104205;272861;15555;45830;45423;106343;60978;152173
410700;202201;2652;6567;2221;5933;393;1107;1085;2768;1478;3875
410710;202201;955;2360;631;1771;97;299;291;746;388;1045
410712;202201;703;1900;587;1693;102;317;306;854;408;1171
410715;202201;929;2620;588;1864;69;235;244;729;313;964
410720;202201;3695;9172;3038;8050;469;1496;995;2587;1464;4083
410725;202201;1221;2929;744;2070;172;524;133;312;305;836
410730;202201;796;2053;623;1747;128;403;156;446;284;849
410740;202201;928;2521;700;2100;72;261;308;911;380;1172
410750;202201;1967;4724;1591;4070;245;655;819;2009;1064;2664
410752;202201;402;956;227;628;34;97;114;287;148;384
410753;202201;374;1080;274;862;37;129;71;206;108;335
410754;202201;1163;2915;970;2634;64;162;682;1929;746;2091
410755;202201;613;1538;453;1252;50;142;215;544;265;686
410760;202201;3973;10041;2909;8171;618;1997;929;2454;1547;4451
410765;202201;16588;44534;13288;38343;2620;8386;3804;9615;6424;18001
410770;202201;1140;2648;809;2096;85;194;422;1115;507;1309
410773;202201;1388;3562;1218;3310;112;349;826;2193;938;2542
410775;202201;1672;3962;1461;3660;52;142;1028;2486;1080;2628
410780;202201;689;1670;475;1281;87;250;152;380;239;630
410785;202201;765;1932;595;1660;90;300;220;609;310;909
410790;202201;1002;2760;846;2492;193;594;124;287;317;881
410800;202201;3674;8024;2962;7023;82;251;1931;4434;2013;4685
410810;202201;486;1256;379;1060;38;125;155;374;193;499
410820;202201;1051;2894;574;1686;111;351;112;267;223;618
410830;202201;45290;105721;32589;85084;5892;17066;13978;34526;19870;51592
410832;202201;1107;2844;898;2492;80;270;563;1465;643;1735
410840;202201;9640;23564;5922;16791;1122;3381;1749;4546;2871;7927
410845;202201;1240;2994;971;2592;145;421;468;1196;613;1617
410850;202201;2349;6488;2071;6021;306;969;1042;2968;1348;3937
410855;202201;833;2032;547;1496;67;179;261;649;328;828
410860;202201;4858;11524;3853;9950;227;746;2527;6199;2754;6945
410865;202201;1553;4330;1336;3940;129;437;799;2412;928;2849
410870;202201;1310;3430;1073;3039;88;269;709;1987;797;2256
410880;202201;5041;13036;3604;10507;697;2180;719;2053;1416;4233
410890;202201;1104;2971;871;2549;160;509;330;919;490;1428
410895;202201;1088;3334;925;3005;284;1001;269;837;553;1838
410900;202201;923;2403;657;1912;114;371;173;419;287;790
410910;202201;458;1032;292;729;11;40;155;345;166;385
410920;202201;942;2226;705;1866;91;265;357;925;448;1190
410930;202201;1869;4623;1321;3706;335;1035;265;727;600;1762
410940;202201;25314;66578;18844;55441;3487;11232;7007;20068;10494;31300
410950;202201;2067;5841;1866;5533;70;246;1541;4536;1611;4782
410960;202201;8576;20405;6114;16462;1340;3902;2685;7156;4025;11058
410965;202201;1275;3101;887;2416;74;218;570;1509;644;1727
410970;202201;4466;11735;3203;9327;757;2538;533;1327;1290;3865
410975;202201;1501;3533;1158;3019;155;452;580;1472;735;1924
410980;202201;8254;20015;5535;15388;614;1919;2581;6542;3195;8461
410990;202201;1545;3594;1069;2866;180;552;481;1258;661;1810
411000;202201;743;1947;551;1610;86;279;173;444;259;723
411005;202201;503;1221;308;823;46;136;110;256;156;392
411007;202201;2694;7104;2051;5945;390;1282;821;2253;1211;3535
411010;202201;4554;13255;3671;11590;950;3240;468;1391;1418;4631
411020;202201;2523;6888;2089;6152;518;1610;707;2017;1225;3627
411030;202201;823;1981;590;1524;44;139;309;704;353;843
411040;202201;1062;2649;591;1660;83;257;179;424;262;681
411050;202201;2155;6490;1798;5756;427;1507;355;993;782;2500
411060;202201;2291;5934;1543;4441;307;956;396;1071;703;2027
411065;202201;452;1131;292;818;29;90;125;338;154;428
411070;202201;8210;20124;6588;17541;739;2244;3626;9266;4365;11510
411080;202201;1999;5204;1671;4660;374;1215;484;1325;858;2540
411090;202201;872;2282;589;1745;88;270;153;400;241;670
411095;202201;2870;6582;1653;4455;252;696;391;950;643;1646
411100;202201;1321;3347;947;2689;111;340;349;964;460;1304
411110;202201;696;1762;352;1042;44;129;28;63;72;192
411120;202201;1493;3891;1250;3488;328;1048;416;1032;744;2080
411125;202201;5666;16068;5078;15027;955;2858;2691;8149;3646;11007
411130;202201;781;2012;563;1618;123;303;199;643;322;946
411140;202201;2446;7183;2054;6398;527;1731;699;2188;1226;3919
411150;202201;4351;10729;3033;8188;636;1842;334;741;970;2583
411155;202201;1072;2701;691;2005;94;302;329;868;423;1170
411160;202201;408;918;283;734;39;114;84;213;123;327
411170;202201;831;2324;658;1963;138;454;262;743;400;1197
411180;202201;6205;15872;4942;13807;682;2138;2574;6697;3256;8835
411190;202201;2051;5130;1558;4265;202;630;664;1616;866;2246
411200;202201;5252;13782;3921;11419;885;2912;1132;2914;2017;5826
411210;202201;3615;7965;2548;6277;391;1087;1031;2416;1422;3503
411220;202201;956;2374;680;1876;155;444;220;580;375;1024
411230;202201;926;2401;693;1971;144;462;245;652;389;1114
411240;202201;1745;4028;1214;3137;132;394;611;1474;743;1868
411250;202201;2445;6261;1810;5162;367;1197;586;1580;953;2777
411260;202201;353;871;236;650;22;66;104;256;126;322
411270;202201;2171;5636;1645;4612;241;713;813;2111;1054;2824
411275;202201;1612;3613;1138;2864;138;416;599;1399;737;1815
411280;202201;1447;3823;1021;3043;252;816;207;561;459;1377
411290;202201;899;2298;583;1691;65;203;309;868;374;1071
411295;202201;1351;3338;988;2679;126;365;456;1151;582;1516
411300;202201;1113;2746;750;2072;79;240;337;812;416;1052
411310;202201;967;2158;759;1882;105;260;355;848;460;1108
411320;202201;5930;14808;4429;12263;628;1876;2057;5145;2685;7021
411325;202201;1547;4207;1289;3742;232;688;675;2012;907;2700
411330;202201;3569;9344;2662;7748;552;1749;885;2588;1437;4337
411340;202201;906;2433;554;1670;81;264;176;484;257;748
411342;202201;1142;2698;648;1744;117;327;226;554;343;881
411345;202201;1224;3026;944;2588;59;193;684;1867;743;2060
411350;202201;3163;8220;2133;6231;547;1694;439;1164;986;2858
411360;202201;802;1870;597;1563;68;197;292;702;360;899
411370;202201;65324;157712;48590;130091;3629;11694;29060;72154;32689;83848
411373;202201;1538;3785;1250;3367;131;384;676;1849;807;2233
411375;202201;1219;2974;873;2337;124;339;363;944;487;1283
411380;202201;1233;2797;866;2135;48;125;555;1260;603;1385
411390;202201;1636;4379;1309;3715;189;576;540;1358;729;1934
411400;202201;2552;6127;1956;5075;162;500;1084;2652;1246;3152
411410;202201;2964;8036;2255;6614;483;1510;565;1548;1048;3058
411420;202201;4729;11231;2681;7499;408;1232;553;1199;961;2431
411430;202201;4045;10495;3131;8849;645;2026;1135;2944;1780;4970
411435;202201;465;1248;303;927;57;182;99;268;156;450
411440;202201;2726;7377;2214;6448;438;1422;765;2112;1203;3534
411450;202201;2627;6833;2014;5850;214;680;1206;3492;1420;4172
411460;202201;4736;11966;3090;8887;514;1645;684;1727;1198;3372
411470;202201;878;2158;659;1780;111;308;275;661;386;969
411480;202201;5771;14807;4249;12032;666;2237;1708;4414;2374;6651
411490;202201;1780;4434;1371;3794;163;539;630;1553;793;2092
411500;202201;1428;3710;1004;2855;162;523;228;528;390;1051
411510;202201;2495;6075;2010;5307;327;978;673;1842;1000;2820
411520;202201;37155;89170;22945;62070;2732;8505;9436;22730;12168;31235
411530;202201;1032;2614;644;1901;113;363;120;308;233;671
411535;202201;541;1535;367;1145;46;165;114;320;160;485
411540;202201;2813;6745;1978;5287;100;328;1146;3007;1246;3335
411545;202201;965;2720;818;2471;62;213;544;1640;606;1853
411550;202201;768;1890;579;1561;79;222;152;398;231;620
411560;202201;2160;5802;1268;3928;203;681;98;254;301;935
411570;202201;7759;17608;5456;14246;1256;3550;1359;3497;2615;7047
411573;202201;829;2183;686;1936;127;396;318;843;445;1239
411575;202201;2162;5705;1643;4719;299;913;503;1386;802;2299
411580;202201;5265;12025;3325;9082;554;1701;680;1685;1234;3386
411585;202201;642;1864;323;1034;58;184;66;192;124;376
411590;202201;461;1218;352;1015;36;121;191;510;227;631
411600;202201;366;892;232;681;37;120;88;241;125;361
411605;202201;1673;3807;1088;2909;161;459;562;1529;723;1988
411610;202201;2861;6500;2061;5125;60;211;1454;3367;1514;3578
411620;202201;3034;7791;2578;7123;352;1023;1490;4123;1842;5146
411630;202201;887;2204;570;1641;63;221;217;549;280;770
411640;202201;503;1264;358;968;48;123;118;280;166;403
411650;202201;216;613;145;460;27;93;31;77;58;170
411660;202201;993;2483;712;1953;67;203;289;727;356;930
411670;202201;1584;3693;1095;2812;104;290;596;1405;700;1695
411680;202201;1534;4005;1174;3320;235;733;458;1250;693;1983
411690;202201;4280;10553;3241;8794;643;1701;1047;3001;1690;4702
411695;202201;684;1993;491;1504;47;163;206;587;253;750
411700;202201;1836;4606;1245;3522;271;812;254;678;525;1490
411705;202201;2484;7030;2120;6416;348;997;1289;4138;1637;5135
411710;202201;2185;5433;1526;4225;342;978;440;1144;782;2122
411720;202201;1166;2689;835;2130;135;350;348;852;483;1202
411721;202201;1094;2642;833;2181;131;359;304;750;435;1109
411722;202201;1007;2668;577;1710;89;304;201;492;290;796
411725;202201;1325;3610;895;2776;189;641;224;665;413;1306
411727;202201;1603;4328;1074;3214;251;769;150;411;401;1180
411729;202201;702;1684;405;1108;45;153;145;340;190;493
411730;202201;5796;14796;4572;12518;671;1976;2431;6469;3102;8445
411740;202201;553;1413;308;900;76;202;68;175;144;377
411745;202201;868;2419;630;1909;72;273;171;404;243;677
411750;202201;6266;16046;4677;13062;586;1809;2320;6081;2906;7890
411760;202201;7564;19441;5959;16827;1793;5104;1503;4678;3296;9782
411770;202201;3439;9606;2561;7761;571;1864;570;1565;1141;3429
411780;202201;2850;7826;2493;7210;601;1843;1035;3034;1636;4877
411790;202201;3153;7425;1918;5292;363;1141;539;1286;902;2427
411800;202201;1223;3432;883;2618;179;574;192;495;371;1069
411810;202201;1727;4357;1323;3592;217;610;575;1452;792;2062
411820;202201;13540;36829;11284;33060;2380;7495;5697;16232;8077;23727
411830;202201;573;1392;440;1172;113;283;85;242;198;525
411840;202201;13502;34929;9599;27188;1539;4756;3009;7687;4548;12443
411845;202201;663;1832;412;1264;74;260;102;264;176;524
411850;202201;8261;20378;5801;16188;1313;3943;1355;3509;2668;7452
411860;202201;760;2054;572;1681;87;273;139;364;226;637
411870;202201;631;1782;454;1397;113;368;109;315;222;683
411880;202201;2511;6003;1817;4921;245;753;765;1950;1010;2703
411885;202201;1192;3038;878;2492;109;363;281;703;390;1066
411890;202201;1527;3976;1138;3313;223;709;152;427;375;1136
411900;202201;897;2382;589;1759;111;342;153;447;264;789
411910;202201;1181;3354;890;2783;177;672;351;998;528;1670
411915;202201;16832;40580;12007;32092;1637;4889;5342;12994;6979;17883
411920;202201;1286;3561;1071;3162;204;686;437;1214;641;1900
411925;202201;532;1364;392;1120;67;203;185;496;252;699
411930;202201;5382;15556;4556;14101;1832;5987;628;2268;2460;8255
411940;202201;3573;10041;2839;8564;628;2014;1086;2958;1714;4972
411950;202201;15892;41655;13314;37566;1483;4849;8373;22618;9856;27467
411960;202201;6570;16844;5271;14408;844;2399;2365;6212;3209;8611
411965;202201;527;1399;389;1129;53;179;192;520;245;699
411970;202201;1268;2785;994;2426;192;419;450;1268;642;1687
411980;202201;1596;3754;1173;3102;226;632;536;1339;762;1971
411990;202201;41815;106195;28008;82125;4693;15207;11166;31138;15859;46345
411995;202201;4524;10773;3558;9304;973;2826;1130;2832;2103;5658
412000;202201;1977;4476;1396;3532;39;136;982;2307;1021;2443
412010;202201;675;2002;514;1658;79;284;138;379;217;663
412015;202201;576;1583;470;1392;56;154;278;835;334;989
412020;202201;479;1309;314;976;51;187;136;399;187;586
412030;202201;652;1816;497;1535;72;246;203;607;275;853
412033;202201;1013;2609;742;2092;79;233;281;690;360;923
412035;202201;768;2039;501;1561;62;202;266;796;328;998
412040;202201;750;1968;439;1340;58;167;73;199;131;366
412050;202201;1694;4135;1158;3177;255;770;293;795;548;1565
412060;202201;7948;22166;6613;19583;1627;5400;2072;5976;3699;11376
412065;202201;673;1831;506;1497;103;348;152;424;255;772
412070;202201;1345;3407;1059;2875;120;380;436;1073;556;1453
412080;202201;2523;6666;1816;5329;257;838;695;1780;952;2618
412085;202201;349;836;133;402;13;48;34;83;47;131
412090;202201;6768;16872;5049;13806;941;2709;2205;6083;3146;8792
412100;202201;1916;4902;1438;4074;408;1261;415;1233;823;2494
412110;202201;994;2557;664;1905;84;269;238;631;322;900
412120;202201;2359;6429;1835;5497;412;1361;536;1409;948;2770
412125;202201;714;1968;484;1488;95;304;118;343;213;647
412130;202201;872;2103;606;1627;126;336;170;450;296;786
412135;202201;658;1706;331;969;54;168;106;270;160;438
412140;202201;1954;4638;1417;3717;221;665;358;914;579;1579
412150;202201;3022;7576;2525;6696;482;1370;1252;3110;1734;4480
412160;202201;968;2923;584;1912;71;269;62;155;133;424
412170;202201;4745;12581;4019;11462;671;2150;1934;5138;2605;7288
412175;202201;1415;3900;1190;3533;258;789;536;1581;794;2370
412180;202201;1827;4912;1363;4082;171;600;617;1715;788;2315
412190;202201;3617;8847;2676;7209;319;953;1163;3047;1482;4000
412200;202201;2055;5729;1393;4284;340;1131;276;793;616;1924
412210;202201;720;1659;457;1238;63;199;192;473;255;672
412215;202201;3481;9151;2616;7473;626;1791;1116;3313;1742;5104
412217;202201;1061;2690;891;2406;35;107;648;1654;683;1761
412220;202201;6138;16866;5139;15149;1298;3808;1849;5600;3147;9408
412230;202201;2902;8222;2317;7176;447;1507;595;1616;1042;3123
412240;202201;8315;21074;5521;15733;914;2815;1759;4522;2673;7337
412250;202201;2186;5479;1634;4464;354;1034;400;1005;754;2039
412260;202201;1412;3637;1091;3016;174;516;379;966;553;1482
412265;202201;1016;2634;815;2298;146;436;400;1077;546;1513
412270;202201;1085;2910;723;2171;88;296;287;793;375;1089
412280;202201;443;1161;347;1004;61;174;109;304;170;478
412290;202201;1112;2764;796;2218;131;404;304;773;435;1177
412300;202201;1821;4639;1323;3806;244;725;366;1057;610;1782
412310;202201;776;2168;596;1817;101;365;195;545;296;910
412320;202201;829;2071;534;1482;44;147;158;427;202;574
412330;202201;1705;4391;1191;3477;207;637;463;1373;670;2010
412340;202201;1337;3546;932;2715;147;489;139;378;286;867
412350;202201;3282;8400;2188;6303;412;1281;497;1299;909;2580
412360;202201;288;766;217;620;5;21;142;384;147;405
412370;202201;914;2527;651;1996;134;429;117;354;251;783
412380;202201;1649;4399;1192;3521;343;1073;152;498;495;1571
412382;202201;523;1247;349;964;42;149;173;393;215;542
412385;202201;2421;6371;1985;5566;524;1436;830;2407;1354;3843
412390;202201;2694;6265;2172;5476;359;988;841;2095;1200;3083
412395;202201;767;2096;563;1651;75;203;265;756;340;959
412400;202201;980;2513;722;2046;128;382;242;656;370;1038
412402;202201;2506;6007;1775;4861;434;1164;396;1109;830;2273
412405;202201;3370;8672;2283;6752;626;1919;260;746;886;2665
412410;202201;6757;17150;5060;14463;784;2653;1761;4775;2545;7428
412420;202201;582;1421;396;1064;29;93;196;445;225;538
412430;202201;619;1537;342;971;36;106;144;380;180;486
412440;202201;3097;7935;2160;6279;503;1484;617;1779;1120;3263
412450;202201;536;1498;371;1094;75;219;35;71;110;290
412460;202201;1188;2973;934;2556;149;458;459;1198;608;1656
412470;202201;1648;4989;1377;4412;339;1184;351;1090;690;2274
412480;202201;1193;3013;826;2291;128;384;334;821;462;1205
412490;202201;1427;3390;1123;2871;121;325;615;1465;736;1790
412500;202201;2186;5347;1676;4449;298;859;579;1375;877;2234
412510;202201;2093;6176;1509;4775;371;1243;255;717;626;1960
412520;202201;1417;3524;841;2368;185;526;154;404;339;930
412530;202201;734;1894;536;1515;78;240;125;334;203;574
412535;202201;858;2211;599;1727;119;383;114;266;233;649
412540;202201;1235;3063;909;2513;99;340;309;898;408;1238
412545;202201;733;1858;523;1463;88;273;171;450;259;723
412550;202201;37796;97578;27879;78700;4069;12654;12379;31788;16448;44442
412555;202201;310;800;217;610;21;75;71;164;92;239
412560;202201;5453;15073;4212;12380;735;2371;1353;3901;2088;6272
412570;202201;4789;11786;2939;8358;593;1874;475;1335;1068;3209
412575;202201;1131;2779;925;2449;122;340;512;1288;634;1628
412580;202201;1597;3996;1162;3214;90;291;647;1690;737;1981
412590;202201;441;1139;258;778;45;154;36;95;81;249
412600;202201;1771;4563;1374;3831;149;474;723;1867;872;2341
412610;202201;921;2402;676;1903;93;281;316;778;409;1059
412620;202201;1371;3466;1065;3019;217;692;400;1059;617;1751
412625;202201;9411;24333;6138;18080;1112;3530;513;1434;1625;4964
412627;202201;1186;3264;814;2526;140;492;263;804;403;1296
412630;202201;3021;8624;2226;6972;426;1424;677;1925;1103;3349
412635;202201;460;1218;323;944;47;148;104;240;151;388
412640;202201;1114;2859;684;1999;92;270;184;461;276;731
412650;202201;1826;4819;1453;4088;229;730;601;1501;830;2231
412660;202201;2790;6981;2076;5687;253;755;801;1980;1054;2735
412665;202201;423;1023;327;857;56;173;153;375;209;548
412667;202201;1933;4940;1432;3967;200;591;647;1731;847;2322
412670;202201;921;2120;623;1647;123;343;186;460;309;803
412680;202201;2245;5785;1585;4588;200;678;578;1460;778;2138
412690;202201;1243;3200;886;2524;157;488;311;823;468;1311
412700;202201;2066;5279;1748;4794;200;623;1005;2700;1205;3323
412710;202201;6296;17752;4803;14710;933;3170;1384;3715;2317;6885
412720;202201;1298;3632;1040;3105;159;527;298;732;457;1259
412730;202201;2783;7071;2007;5618;313;989;830;2163;1143;3152
412740;202201;2081;5678;1487;4536;286;948;225;681;511;1629
412750;202201;4309;10924;3558;9883;281;948;2350;6220;2631;7168
412760;202201;3125;8270;2627;7469;438;1416;1508;4060;1946;5476
412770;202201;11788;29868;6803;20350;903;2931;1486;3748;2389;6679
412780;202201;1273;3298;984;2787;220;690;378;998;598;1688
412785;202201;2318;5318;1653;4238;161;440;1130;2830;1291;3270
412788;202201;1536;4217;1264;3752;293;872;553;1596;846;2468
412790;202201;1460;3769;889;2655;134;447;296;768;430;1215
412795;202201;1345;3404;759;2244;127;401;146;409;273;810
412796;202201;2471;6803;2084;6146;432;1386;728;1989;1160;3375
412800;202201;3994;9453;2877;7458;310;957;1425;3284;1735;4241
412810;202201;13356;33492;9092;25190;1069;3492;3818;9463;4887;12955
412820;202201;6685;17858;4853;14307;1027;3243;1667;4836;2694;8079
412830;202201;362;998;276;829;33;98;75;209;108;307
412840;202201;2021;4856;1474;3860;142;418;767;1838;909;2256
412850;202201;2966;7560;2230;6370;276;877;1048;2819;1324;3696
412853;202201;1644;4036;1394;3633;172;521;762;1741;934;2262
412855;202201;1462;3706;870;2500;122;415;226;544;348;959
412860;202201;803;1975;556;1576;74;230;294;770;368;1000
412862;202201;717;1733;500;1386;89;256;207;550;296;806
412863;202201;1365;3936;1219;3677;309;993;464;1340;773;2333
412865;202201;750;1995;555;1611;133;409;172;497;305;906
412870;202201;927;2358;682;1971;158;505;219;685;377;1190
412880;202201;951;2513;670;1986;125;404;187;499;312;903
420005;202201;442;1261;269;867;24;69;133;433;157;502
420010;202201;3537;8428;2360;6456;158;464;1755;4828;1913;5292
420020;202201;468;1415;321;1043;58;222;86;223;144;445
420030;202201;103;361;67;270;18;79;19;80;37;159
420040;202201;562;1643;359;1208;88;342;37;111;125;453
420050;202201;760;1700;515;1279;96;252;300;680;396;932
420055;202201;171;516;96;331;20;83;30;99;50;182
420060;202201;125;344;85;251;14;42;21;53;35;95
420070;202201;807;2340;608;1932;121;399;267;836;388;1235
420075;202201;84;212;47;140;6;21;12;20;18;41
420080;202201;421;1155;334;960;68;230;138;371;206;601
420090;202201;454;1372;297;1017;67;245;71;213;138;458
420100;202201;1384;3400;1166;3088;53;161;955;2489;1008;2650
420110;202201;279;870;248;803;40;149;138;436;178;585
420120;202201;637;1683;452;1298;52;175;250;645;302;820
420125;202201;380;1116;267;871;56;212;104;313;160;525
420127;202201;333;860;143;434;20;72;58;170;78;242
420130;202201;4100;11019;3208;9593;522;1862;1504;4133;2026;5995
420140;202201;4180;10895;3184;9272;862;2755;793;2287;1655;5042
420150;202201;702;1738;497;1403;48;176;302;814;350;990
420160;202201;198;469;80;245;12;43;24;70;36;113
420165;202201;171;480;109;348;20;62;43;117;63;179
420170;202201;288;877;201;667;33;117;66;193;99;310
420180;202201;173;548;111;390;17;78;29;96;46;174
420190;202201;224;662;133;439;33;112;55;173;88;285
420195;202201;1695;4243;1305;3668;368;1207;440;1114;808;2321
420200;202201;5895;13967;3864;10338;505;1608;1790;4168;2295;5776
420205;202201;2121;5514;1476;4226;231;712;801;2269;1032;2981
420207;202201;2141;5367;1381;3973;215;706;593;1574;808;2280
420208;202201;350;972;207;692;64;226;61;179;125;405
420209;202201;165;512;113;355;13;46;56;155;69;201
420210;202201;3677;9210;2643;7540;368;1285;1469;3972;1837;5257
420213;202201;857;2493;726;2238;134;463;325;967;459;1430
420215;202201;226;663;164;523;37;130;51;158;88;288
420220;202201;324;946;212;713;33;134;92;282;125;416
420230;202201;5735;15013;4497;12790;538;1750;2583;6975;3121;8725
420240;202201;15762;42789;10539;31036;1239;4307;5185;13373;6424;17680
420243;202201;420;1130;353;1011;40;141;241;664;281;805
420245;202201;1672;4181;1269;3494;106;346;820;2126;926;2472
420250;202201;492;1335;426;1227;43;150;293;809;336;959
420253;202201;486;1148;355;971;31;92;211;576;242;668
420257;202201;165;416;106;314;18;53;61;184;79;237
420260;202201;1196;3001;901;2613;86;297;670;1923;756;2220
420270;202201;584;1503;314;914;38;123;128;347;166;470
420280;202201;1419;4080;1154;3552;180;651;526;1529;706;2180
420285;202201;136;311;74;216;11;45;26;49;37;94
420287;202201;475;1068;344;895;71;184;164;429;235;613
420290;202201;5299;14710;4182;12302;526;1779;2509;6893;3035;8672
420300;202201;7993;22069;4917;14953;868;2938;1710;4615;2578;7553
420310;202201;883;1983;489;1302;49;148;291;719;340;867
420315;202201;841;2278;590;1867;78;278;307;950;385;1228
420320;202201;5810;15098;4293;12701;1190;3900;1373;3867;2563;7767
420325;202201;364;1013;264;820;40;135;115;339;155;474
420330;202201;1037;2964;683;2244;122;463;225;674;347;1137
420340;202201;1042;2780;794;2345;177;569;218;564;395;1133
420350;202201;1270;3172;966;2652;92;306;670;1805;762;2111
420360;202201;3126;8336;1768;5476;362;1210;177;542;539;1752
420370;202201;1361;3467;1118;3068;75;274;839;2202;914;2476
420380;202201;4748;12080;3309;9544;598;1918;1453;3924;2051;5842
420390;202201;1122;2695;798;2069;143;434;336;645;479;1079
420395;202201;1277;3556;918;2849;175;622;181;410;356;1032
420400;202201;1108;2980;795;2376;105;360;391;1123;496;1483
420410;202201;617;1581;487;1321;29;87;360;960;389;1047
420415;202201;321;903;243;737;56;191;105;335;161;526
420417;202201;627;1807;502;1563;118;374;237;751;355;1125
420419;202201;147;518;116;444;53;222;13;50;66;272
420420;202201;13183;33633;9157;26382;2277;7378;3236;8688;5513;16066
420425;202201;674;1778;479;1381;40;129;253;700;293;829
420430;202201;3329;8702;2068;6030;393;1322;817;2146;1210;3468
420435;202201;291;737;154;481;26;93;78;232;104;325
420440;202201;743;1927;481;1394;101;312;194;534;295;846
420445;202201;275;649;189;502;27;85;87;196;114;281
420450;202201;819;2358;612;1915;98;375;233;634;331;1009
420455;202201;2189;5108;1644;4320;263;741;857;2196;1120;2937
420460;202201;10023;26029;7767;22004;998;3241;4265;11541;5263;14782
420470;202201;659;1680;360;1073;76;256;93;232;169;488
420475;202201;74;197;35;110;7;29;5;12;12;41
420480;202201;5561;13411;3592;10260;586;1865;1488;4227;2074;6092
420490;202201;399;1086;282;838;45;145;128;366;173;511
420500;202201;1399;3716;925;2880;133;475;456;1390;589;1865
420510;202201;167;472;93;308;20;74;25;73;45;147
420515;202201;89;245;60;185;10;37;19;60;29;97
420517;202201;785;2111;667;1896;72;219;429;1213;501;1432
420519;202201;325;776;239;651;22;67;147;403;169;470
420520;202201;286;752;153;499;24;79;12;35;36;114
420530;202201;854;2429;609;1926;97;368;244;658;341;1026
420535;202201;238;684;108;351;15;53;41;124;56;177
420540;202201;42238;99536;29578;78871;3953;12070;11774;27705;15727;39775
420543;202201;231;667;185;569;23;77;86;239;109;316
420545;202201;1366;4005;1053;3344;209;731;395;1146;604;1877
420550;202201;3891;9987;2636;7939;385;1335;1290;3958;1675;5293
420555;202201;318;894;232;720;23;81;135;399;158;480
420560;202201;411;1010;282;821;39;113;184;542;223;655
420570;202201;2778;7123;2167;6029;361;1105;1111;2971;1472;4076
420580;202201;1868;4801;1339;3971;268;834;480;1397;748;2231
420590;202201;2945;7799;1875;5523;327;1110;553;1310;880;2420
420600;202201;1152;3201;916;2780;93;362;572;1659;665;2021
420610;202201;420;1192;288;915;57;188;129;408;186;596
420620;202201;831;1978;587;1599;125;361;250;659;375;1020
420630;202201;975;2906;728;2316;90;321;437;1315;527;1636
420640;202201;532;1414;285;919;89;297;65;198;154;495
420650;202201;3906;10081;2583;7427;376;1199;1109;2804;1485;4003
420660;202201;455;1160;297;831;68;212;78;194;146;406
420665;202201;724;1848;490;1464;79;257;225;614;304;871
420670;202201;1343;3666;878;2712;138;506;314;844;452;1350
420675;202201;195;505;119;364;16;61;69;199;85;260
420680;202201;319;717;172;514;27;100;91;255;118;355
420690;202201;895;2579;588;1891;84;328;168;459;252;787
420700;202201;2922;7506;2278;6465;187;598;1512;4176;1699;4774
420710;202201;1155;3192;928;2724;105;408;561;1456;666;1864
420720;202201;1320;3544;976;2951;142;479;567;1617;709;2096
420730;202201;3421;8717;2604;7415;382;1214;1485;4064;1867;5278
420740;202201;522;1533;304;1058;74;274;25;94;99;368
420750;202201;2115;5955;1434;4431;241;893;588;1654;829;2547
420757;202201;90;220;41;127;4;13;20;59;24;72
420760;202201;336;954;197;598;34;109;64;170;98;279
420765;202201;507;1423;265;843;31;105;146;450;177;555
420768;202201;1428;3866;1248;3578;101;309;995;2834;1096;3143
420770;202201;434;1192;206;725;24;107;60;197;84;304
420775;202201;298;848;212;662;43;154;85;225;128;379
420780;202201;1013;2828;631;1960;116;378;104;297;220;675
420785;202201;215;560;160;449;19;71;78;178;97;249
420790;202201;1106;3196;842;2668;140;525;506;1522;646;2047
420800;202201;712;1729;405;1154;68;224;203;559;271;783
420810;202201;1568;4661;1316;4195;306;1165;628;1759;934;2924
420820;202201;13973;34353;10383;28703;1649;5101;5261;13577;6910;18678
420830;202201;4951;12655;3767;10607;578;1822;1751;4698;2329;6520
420840;202201;513;1541;266;985;70;246;36;137;106;383
420845;202201;2786;6993;1859;5381;341;1198;823;2264;1164;3462
420850;202201;1171;3616;767;2591;143;535;197;607;340;1142
420860;202201;394;1015;230;722;43;152;66;193;109;345
420870;202201;840;2317;625;1894;141;469;228;649;369;1118
420880;202201;1139;3353;902;2877;181;660;379;1128;560;1788
420890;202201;8566;22954;5592;16937;786;2652;2058;5585;2844;8237
420895;202201;186;532;126;381;23;72;50;147;73;219
420900;202201;1621;3922;1014;2891;155;552;484;1202;639;1754
420910;202201;34902;90413;23407;69142;3352;11487;10140;26656;13492;38143
420915;202201;536;1874;409;1519;55;234;232;862;287;1096
420917;202201;477;1193;224;609;34;87;114;309;148;396
420920;202201;88;225;42;132;5;17;11;34;16;51
420930;202201;17924;45235;13203;37245;2072;6548;6498;17418;8570;23966
420940;202201;3450;8272;2183;6182;483;1532;546;1287;1029;2819
420945;202201;154;434;114;344;22;86;48;130;70;216
420950;202201;378;1066;239;749;38;130;67;192;105;322
420960;202201;1131;2732;824;2235;113;343;415;1037;528;1380
420970;202201;2559;6744;1773;5331;398;1251;628;1906;1026;3157
420980;202201;287;956;251;879;95;338;86;308;181;646
420985;202201;351;986;201;680;47;178;57;179;104;357
420990;202201;352;1064;209;716;35;129;52;168;87;297
421000;202201;581;1698;441;1415;105;373;115;308;220;681
421003;202201;483;1133;186;531;15;37;18;42;33;79
421005;202201;86;245;62;204;19;64;23;78;42;142
421010;202201;3622;9571;2684;7916;499;1630;895;2359;1394;3989
421020;202201;408;1233;327;1085;46;189;172;539;218;728
421030;202201;909;2554;717;2196;161;558;309;893;470;1451
421040;202201;690;1623;431;1232;37;109;273;772;310;881
421050;202201;1126;2981;780;2255;128;398;327;853;455;1251
421055;202201;182;492;108;327;17;59;62;171;79;230
421060;202201;718;2036;520;1624;81;297;271;782;352;1079
421070;202201;703;2061;445;1416;59;213;190;552;249;765
421080;202201;543;1531;446;1354;57;219;250;725;307;944
421085;202201;396;1102;182;605;20;65;32;82;52;147
421090;202201;281;722;164;461;19;65;55;133;74;198
421100;202201;849;1881;393;1144;92;299;124;303;216;602
421105;202201;1708;4499;1227;3620;161;537;641;1788;802;2325
421110;202201;1228;3151;1003;2827;73;253;655;1910;728;2163
421120;202201;1121;3284;807;2612;136;474;239;684;375;1158
421125;202201;311;790;225;639;72;218;96;250;168;468
421130;202201;5482;15504;4550;13682;793;2639;2576;7417;3369;10056
421140;202201;366;975;248;738;33;107;108;292;141;399
421145;202201;460;1220;308;911;68;218;99;256;167;474
421150;202201;728;1981;500;1532;86;303;218;599;304;902
421160;202201;558;1521;430;1283;57;226;273;752;330;978
421165;202201;237;678;148;467;25;80;69;208;94;288
421170;202201;1146;3069;975;2797;94;277;672;1945;766;2222
421175;202201;996;2412;609;1828;97;359;300;858;397;1217
421180;202201;414;1072;242;737;37;139;119;330;156;469
421185;202201;336;845;241;663;23;77;138;358;161;435
421187;202201;283;861;183;609;35;110;64;211;99;321
421189;202201;413;1154;326;983;49;167;134;374;183;541
421190;202201;12808;33659;9203;27019;1569;5172;3830;10303;5399;15475
421200;202201;759;2058;622;1830;89;324;374;1042;463;1366
421205;202201;200;519;147;437;21;76;75;210;96;286
421210;202201;1162;2861;685;2063;125;389;269;806;394;1195
421220;202201;1465;4214;1166;3623;280;985;431;1226;711;2211
421223;202201;334;894;213;679;44;151;119;374;163;525
421225;202201;913;2582;787;2380;105;372;512;1535;617;1907
421227;202201;745;2069;493;1547;76;245;247;805;323;1050
421230;202201;615;1568;404;1181;72;235;169;483;241;718
421240;202201;309;878;163;552;21;88;33;98;54;186
421250;202201;2249;5540;1628;4569;185;596;1010;2731;1195;3327
421260;202201;230;718;59;210;11;51;8;26;19;77
421265;202201;775;1943;679;1815;26;76;592;1565;618;1641
421270;202201;375;997;179;593;44;151;59;180;103;331
421280;202201;2206;5692;1677;4838;212;752;1002;2733;1214;3485
421290;202201;1062;2879;562;1698;100;313;139;378;239;691
421300;202201;296;763;150;484;19;77;24;74;43;151
421310;202201;214;611;149;484;30;96;78;254;108;350
421315;202201;260;654;180;495;39;87;68;197;107;284
421320;202201;648;2019;369;1230;49;164;40;71;89;235
421330;202201;660;1901;487;1555;103;370;142;409;245;779
421335;202201;379;1129;308;1009;48;181;152;486;200;667
421340;202201;1474;3965;1076;3276;153;543;565;1626;718;2169
421350;202201;1658;4170;1111;3261;190;640;465;1301;655;1941
421360;202201;2418;6270;1487;4454;270;905;602;1596;872;2501
421370;202201;801;2491;532;1803;97;369;171;477;268;846
421380;202201;890;2256;771;2077;86;274;491;1269;577;1543
421390;202201;170;448;70;230;18;56;25;72;43;128
421400;202201;480;1304;314;975;50;180;171;487;221;667
421410;202201;193;506;96;323;20;64;33;112;53;176
421415;202201;200;551;142;405;19;63;60;147;79;210
421420;202201;602;1574;486;1360;42;139;302;820;344;959
421430;202201;103;322;76;256;12;46;17;48;29;94
421440;202201;693;1824;423;1308;82;255;182;548;264;803
421450;202201;507;1454;308;1013;51;185;49;155;100;340
421460;202201;373;1129;206;756;16;59;19;58;35;117
421470;202201;333;901;225;686;33;105;82;263;115;368
421480;202201;2938;7708;2036;5946;332;1139;896;2408;1228;3547
421490;202201;119;399;75;280;14;55;16;49;30;104
421500;202201;2287;6527;1610;5135;376;1431;452;1277;828;2708
421505;202201;321;852;270;780;25;93;189;529;214;622
421507;202201;449;1214;264;828;46;160;114;339;160;499
421510;202201;385;1038;265;770;34;116;134;339;168;455
421520;202201;514;1356;331;948;43;126;164;422;207;548
421530;202201;304;886;179;610;28;126;36;97;64;223
421535;202201;415;1068;258;781;33;121;141;401;174;522
421540;202201;332;755;187;536;27;97;67;173;94;270
421545;202201;657;1909;508;1653;92;355;260;797;352;1152
421550;202201;2185;5665;1770;5035;272;855;1069;2994;1341;3849
421555;202201;174;528;74;267;6;20;11;23;17;43
421560;202201;93;310;65;242;10;39;25;83;35;122
421565;202201;992;2460;696;2013;163;519;283;784;446;1303
421567;202201;488;1472;354;1132;107;383;110;321;217;704
421568;202201;339;975;238;739;41;149;95;273;136;422
421569;202201;156;441;77;250;6;24;48;153;54;177
421570;202201;1452;3892;1059;3093;215;704;409;1076;624;1780
421575;202201;311;873;239;686;32;92;125;336;157;428
421580;202201;4683;12400;3132;9317;438;1567;1242;3165;1680;4732
421590;202201;181;529;135;432;25;93;58;175;83;268
421600;202201;614;1595;433;1229;85;276;170;419;255;695
421605;202201;731;1892;540;1597;91;272;283;858;374;1130
421610;202201;1083;2834;738;2193;144;454;246;715;390;1169
421620;202201;4139;10729;2669;8147;512;1761;969;2827;1481;4588
421625;202201;140;389;77;241;13;45;24;61;37;106
421630;202201;2833;7285;1882;5527;313;1040;727;1856;1040;2896
421635;202201;284;753;201;594;15;66;129;347;144;413
421640;202201;712;1880;527;1614;107;357;245;739;352;1096
421650;202201;2644;7054;1851;5646;416;1483;667;1840;1083;3323
421660;202201;11722;31656;8568;25662;1175;4112;4175;11449;5350;15561
421670;202201;813;2262;603;1778;96;335;298;830;394;1165
421680;202201;1351;3324;1081;2895;102;370;814;2010;916;2380
421690;202201;1495;4140;1054;3254;201;688;371;1100;572;1788
421700;202201;594;1720;443;1399;98;344;140;414;238;758
421710;202201;209;643;111;362;15;56;37;102;52;158
421715;202201;132;336;100;271;19;58;64;164;83;222
421720;202201;2155;5697;1306;3928;299;991;400;1041;699;2032
421725;202201;280;674;165;482;27;97;76;191;103;288
421730;202201;437;1207;276;787;41;129;148;384;189;513
421740;202201;828;2297;570;1768;99;342;212;588;311;930
421750;202201;923;2140;465;1314;87;289;209;546;296;835
421755;202201;174;474;102;309;15;54;42;109;57;163
421760;202201;1082;2761;758;2193;145;477;280;707;425;1184
421770;202201;2566;6584;1856;5389;389;1108;786;2329;1175;3437
421775;202201;220;567;139;415;16;53;65;179;81;232
421780;202201;889;2540;595;1923;119;435;263;783;382;1218
421790;202201;905;2416;525;1700;101;342;226;722;327;1064
421795;202201;179;494;127;372;28;92;42;111;70;203
421800;202201;2933;7637;2198;6321;260;865;1323;3607;1583;4472
421810;202201;653;1761;455;1405;45;151;263;801;308;952
421820;202201;1052;3002;682;2122;115;408;249;659;364;1067
421825;202201;1448;3823;1297;3607;91;300;1000;2715;1091;3015
421830;202201;1872;5185;1518;4556;325;1078;566;1629;891;2707
421835;202201;252;613;174;491;34;121;79;197;113;318
421840;202201;213;671;160;560;28;111;41;130;69;241
421850;202201;402;1114;243;816;52;206;64;168;116;374
421860;202201;324;893;197;635;31;109;76;218;107;327
421870;202201;4924;12050;3725;9890;444;1444;2160;5155;2604;6599
421875;202201;329;954;150;467;25;81;33;85;58;166
421880;202201;706;1959;486;1478;91;311;158;455;249;766
421885;202201;249;666;162;479;29;88;74;200;103;288
421890;202201;938;2666;711;2233;108;426;424;1258;532;1684
421895;202201;423;1046;366;971;41;90;264;747;305;837
421900;202201;1107;2908;872;2444;114;389;430;1079;544;1468
421910;202201;335;965;225;704;38;143;53;135;91;278
421915;202201;414;1143;264;807;62;196;63;174;125;370
421917;202201;618;1384;355;1048;112;340;110;351;222;691
421920;202201;401;1192;290;972;107;353;106;372;213;725
421930;202201;2875;7135;1634;4841;330;1089;631;1668;961;2757
421935;202201;426;1285;345;1119;56;187;216;698;272;885
421940;202201;396;1126;199;620;27;84;52;131;79;215
421950;202201;3286;8092;1951;5609;393;1253;546;1389;939;2642
421960;202201;186;451;101;298;16;61;32;71;48;132
421970;202201;2061;5183;1371;3818;223;720;619;1535;842;2255
421985;202201;322;871;217;671;27;89;92;265;119;354
422000;202201;2042;5081;1685;4559;129;439;1191;3181;1320;3620
430003;202201;600;1563;404;1215;75;233;196;590;271;823
430005;202201;285;754;192;594;17;58;106;317;123;375
430010;202201;1919;4358;1519;3761;266;650;936;2337;1202;2987
430020;202201;613;1370;464;1178;43;128;314;762;357;890
430030;202201;1052;2395;613;1623;118;308;270;684;388;992
430040;202201;11075;25294;7048;18597;1813;4880;1611;4257;3424;9137
430045;202201;515;1243;377;995;35;110;269;686;304;796
430047;202201;254;545;106;282;17;40;37;101;54;141
430050;202201;923;2263;580;1603;113;335;207;528;320;863
430055;202201;286;686;149;409;16;49;78;192;94;241
430057;202201;87;183;34;94;9;26;8;20;17;46
430060;202201;19499;50022;15542;43990;2567;7839;8337;23217;10904;31056
430063;202201;846;2288;706;2020;129;362;417;1186;546;1548
430064;202201;1201;3117;904;2550;146;432;480;1325;626;1757
430066;202201;103;216;74;173;9;28;60;130;69;158
430070;202201;759;1942;157;499;32;110;25;59;57;169
430080;202201;973;2332;607;1626;100;331;325;755;425;1086
430085;202201;980;2094;605;1513;77;199;307;738;384;937
430087;202201;898;2103;753;1918;56;167;555;1389;611;1556
430090;202201;483;1234;187;602;24;95;48;143;72;238
430100;202201;991;2325;626;1659;120;358;196;460;316;818
430105;202201;1357;3452;951;2773;129;437;477;1351;606;1788
430107;202201;182;521;99;301;14;38;33;89;47;127
430110;202201;2393;5817;1804;4953;289;851;916;2458;1205;3309
430120;202201;1343;3750;921;2756;156;453;432;1262;588;1715
430130;202201;3787;8304;2840;7016;924;2216;718;2068;1642;4284
430140;202201;1087;2717;787;2192;100;323;459;1217;559;1540
430150;202201;597;1515;343;1024;74;232;102;306;176;538
430155;202201;251;634;131;389;29;90;29;73;58;163
430160;202201;21985;49039;17573;43027;1681;4490;11389;27479;13070;31969
430163;202201;3472;7750;2485;6274;85;300;1879;4628;1964;4928
430165;202201;330;806;118;368;12;32;23;60;35;92
430170;202201;1006;2606;386;1282;62;225;58;149;120;374
430175;202201;792;2103;693;1915;129;327;371;1051;500;1378
430180;202201;706;1687;549;1435;68;164;324;857;392;1021
430185;202201;732;1830;391;1115;108;276;74;209;182;485
430187;202201;843;1753;619;1480;75;170;415;981;490;1151
430190;202201;1521;3743;1218;3285;226;671;620;1577;846;2248
430192;202201;132;347;54;156;10;28;13;31;23;59
430195;202201;467;1319;88;288;6;22;17;43;23;65
430200;202201;1165;3273;935;2871;294;930;281;908;575;1838
430205;202201;490;1191;441;1102;11;39;402;988;413;1027
430210;202201;6731;17003;4681;12836;793;2370;1478;3249;2271;5619
430215;202201;346;861;222;622;32;95;98;276;130;371
430220;202201;680;1668;234;763;30;98;62;169;92;267
430222;202201;226;592;164;476;24;78;55;157;79;235
430223;202201;275;698;214;598;17;53;129;353;146;406
430225;202201;16;32;11;26;0;0;7;16;7;16
430230;202201;2093;5484;1743;4969;119;389;1340;3756;1459;4145
430235;202201;411;1112;271;824;54;178;71;182;125;360
430237;202201;548;1244;417;1040;21;66;325;794;346;860
430240;202201;1445;3291;836;2254;96;308;436;1073;532;1381
430245;202201;775;2043;618;1757;107;299;359;1037;466;1336
430250;202201;997;2311;747;1933;292;794;111;244;403;1038
430258;202201;147;399;110;324;4;19;60;170;64;189
430260;202201;752;1884;529;1482;65;200;306;866;371;1066
430265;202201;241;683;164;540;25;78;66;228;91;306
430270;202201;3194;7504;2568;6580;295;857;1739;4308;2034;5165
430280;202201;5496;12318;3962;9825;657;1672;1959;4738;2616;6410
430290;202201;2380;5306;1964;4829;70;243;1643;3937;1713;4180
430300;202201;11159;26661;8575;22409;1160;3306;4961;12536;6121;15842
430310;202201;13615;32672;9677;25704;1138;3354;5139;12755;6277;16109
430320;202201;1099;2654;634;1767;52;158;393;1083;445;1241
430330;202201;744;1754;467;1236;61;173;208;503;269;676
430340;202201;662;1506;444;1168;57;147;283;722;340;869
430350;202201;8871;20970;6933;17800;633;1830;4595;11201;5228;13031
430355;202201;352;948;141;446;23;73;19;48;42;121
430360;202201;938;2172;638;1662;118;367;253;615;371;982
430367;202201;372;805;225;567;41;116;120;284;161;400
430370;202201;568;1480;244;714;38;116;70;160;108;276
430380;202201;729;1746;372;1115;74;233;108;315;182;548
430390;202201;3746;8723;2431;6438;547;1558;391;803;938;2361
430400;202201;1091;2277;838;1942;84;231;496;1110;580;1341
430410;202201;582;1327;419;1076;38;107;294;733;332;840
430420;202201;2912;7314;2307;6123;342;1011;1386;3462;1728;4473
430430;202201;613;1510;290;874;56;181;67;197;123;378
430435;202201;1696;4140;1325;3556;206;586;720;1918;926;2504
430440;202201;4207;11005;3413;9730;279;877;2235;6347;2514;7224
430450;202201;7309;17410;5949;15124;1003;2740;3266;7920;4269;10660
430460;202201;38059;92980;29257;78873;3916;11780;16418;42499;20334;54279
430461;202201;236;614;84;254;14;53;35;85;49;138
430462;202201;338;862;188;573;37;119;50;138;87;257
430463;202201;6878;17454;5192;14448;936;2943;2567;6836;3503;9779
430465;202201;479;1182;387;1015;51;146;265;675;316;821
430466;202201;4858;11692;3927;10310;667;1836;2192;5493;2859;7329
430467;202201;524;1233;376;1017;47;155;216;538;263;693
430468;202201;1402;3319;1130;2930;87;283;837;2104;924;2387
430469;202201;604;1615;99;305;13;39;20;42;33;81
430470;202201;6090;15231;4168;11892;1132;3567;1235;3331;2367;6898
430471;202201;610;1674;507;1488;75;228;309;876;384;1104
430480;202201;679;1846;446;1366;64;211;114;295;178;506
430485;202201;178;457;80;236;12;29;22;62;34;91
430490;202201;468;1160;260;762;29;100;121;308;150;408
430495;202201;416;1092;282;849;44;149;132;368;176;517
430500;202201;1048;2617;744;2125;207;661;272;715;479;1376
430510;202201;29984;74995;21943;60316;3406;10439;10598;26948;14004;37387
430511;202201;383;1033;158;504;23;71;20;58;43;129
430512;202201;1068;2312;841;1981;168;396;373;883;541;1279
430513;202201;839;2023;412;1150;59;185;207;528;266;713
430515;202201;407;1091;300;882;41;136;167;488;208;624
430517;202201;1292;3652;1004;3023;139;422;597;1790;736;2212
430520;202201;1464;3556;826;2240;145;421;218;534;363;955
430530;202201;1035;2526;465;1350;71;223;135;376;206;599
430535;202201;3848;9544;2870;7829;411;1152;1503;3942;1914;5094
430537;202201;445;1316;379;1186;27;76;291;913;318;989
430540;202201;639;1506;368;1045;51;155;197;543;248;698
430543;202201;1079;1849;663;1373;128;217;264;627;392;844
430544;202201;795;2145;553;1634;130;398;204;577;334;975
430545;202201;2625;6360;2003;5460;270;770;1242;3368;1512;4138
430550;202201;371;1019;273;813;53;172;106;291;159;463
430558;202201;142;323;63;174;7;21;23;63;30;84
430560;202201;303;695;162;463;24;73;63;166;87;239
430570;202201;926;2227;675;1786;108;347;340;801;448;1148
430580;202201;887;2149;650;1798;133;377;320;926;453;1303
430583;202201;203;500;45;133;2;5;12;27;14;32
430585;202201;237;577;131;363;25;76;47;116;72;192
430587;202201;212;557;160;472;16;55;70;199;86;254
430590;202201;1436;3387;1187;3014;86;264;939;2331;1025;2595
430593;202201;22;65;16;44;2;4;6;17;8;21
430595;202201;441;1100;125;397;14;45;22;52;36;97
430597;202201;471;1168;261;760;25;85;81;195;106;280
430600;202201;2102;5344;922;2602;143;399;228;595;371;994
430605;202201;1401;3530;1036;2893;119;368;534;1443;653;1811
430607;202201;668;1463;485;1186;24;70;350;840;374;910
430610;202201;6224;14069;4298;11283;1154;3306;1137;2997;2291;6303
430613;202201;297;680;90;260;13;37;23;55;36;92
430620;202201;708;1684;543;1386;78;239;327;743;405;982
430630;202201;447;1193;141;438;22;76;40;103;62;179
430632;202201;470;1191;214;609;36;93;91;250;127;343
430635;202201;604;1341;461;1108;20;60;366;862;386;922
430637;202201;482;1128;377;980;32;102;265;670;297;772
430640;202201;1160;3029;798;2313;117;362;344;915;461;1277
430642;202201;381;1017;276;792;45;139;142;373;187;512
430645;202201;163;385;72;191;13;39;23;48;36;87
430650;202201;1873;4967;1493;4356;412;1111;704;2234;1116;3345
430655;202201;322;771;196;540;28;91;102;243;130;334
430660;202201;5548;13591;4312;11662;725;2086;2242;5951;2967;8037
430670;202201;678;1589;521;1335;71;196;259;646;330;842
430673;202201;567;1260;262;716;40;114;110;274;150;388
430675;202201;263;759;70;240;10;35;12;35;22;70
430676;202201;5678;13570;4645;12064;543;1529;3032;7719;3575;9248
430680;202201;1128;2890;703;2063;198;585;210;553;408;1138
430690;202201;3162;8135;2542;7058;737;2106;979;2683;1716;4789
430692;202201;218;652;172;575;11;38;133;458;144;496
430693;202201;1017;2600;639;1890;122;403;183;511;305;914
430695;202201;427;1044;266;727;28;79;145;380;173;459
430697;202201;478;1140;367;980;60;167;214;593;274;760
430700;202201;8449;19987;5462;14690;1103;3224;1522;3711;2625;6935
430705;202201;413;948;212;596;23;67;88;221;111;288
430710;202201;1820;3723;1284;3023;130;348;821;1886;951;2234
430720;202201;866;1995;440;1258;41;132;240;650;281;782
430730;202201;1065;2818;765;2261;87;256;402;1151;489;1407
430740;202201;708;1875;379;1195;59;196;115;367;174;563
430745;202201;400;1005;287;778;52;169;136;313;188;482
430750;202201;1616;3897;1123;3046;286;801;457;1193;743;1994
430755;202201;475;1142;321;842;29;81;175;424;204;505
430760;202201;2319;5506;1816;4773;348;998;924;2316;1272;3314
430770;202201;7267;17568;5750;15348;601;1872;3855;9918;4456;11790
430780;202201;2111;5118;1375;3892;213;667;686;1869;899;2536
430781;202201;502;1344;308;910;76;217;99;257;175;474
430783;202201;363;819;231;619;26;82;137;349;163;431
430786;202201;34;118;25;93;4;15;5;23;9;38
430790;202201;4966;11767;3610;9504;345;1095;2258;5573;2603;6668
430800;202201;833;1831;634;1558;38;93;443;1068;481;1161
430805;202201;392;978;265;726;12;47;188;489;200;536
430807;202201;590;1423;351;969;44;139;177;439;221;578
430810;202201;792;1859;369;1048;55;185;131;314;186;499
430820;202201;1289;3447;792;2466;119;403;275;784;394;1187
430825;202201;294;704;111;284;15;34;38;97;53;131
430830;202201;1892;5026;1550;4398;134;368;1088;3054;1222;3422
430840;202201;1132;2625;778;2074;103;262;514;1385;617;1647
430843;202201;187;440;91;248;5;13;30;71;35;84
430845;202201;512;1178;345;920;30;89;199;502;229;591
430850;202201;2478;6265;1757;4956;321;922;694;2054;1015;2976
430860;202201;1006;2348;507;1410;60;206;236;567;296;773
430865;202201;563;1408;394;1114;106;322;107;286;213;608
430870;202201;598;1546;276;851;35;118;84;228;119;346
430880;202201;1589;3501;1120;2801;136;355;700;1697;836;2052
430885;202201;174;463;96;304;13;38;54;170;67;208
430890;202201;1144;2714;771;2106;78;296;149;379;227;675
430900;202201;3288;6923;2347;5622;133;454;1681;3780;1814;4234
430905;202201;946;2292;650;1765;115;338;285;738;400;1076
430910;202201;2303;6049;1789;5034;262;849;898;2266;1160;3115
430912;202201;537;1473;383;1170;29;87;247;763;276;850
430915;202201;526;1537;386;1242;118;394;130;422;248;816
430920;202201;25970;63820;20667;55331;2377;7106;13272;34492;15649;41598
430925;202201;89;199;40;116;4;13;20;58;24;71
430930;202201;11677;26572;8036;21208;1240;3301;4024;10703;5264;14004
430940;202201;1120;2806;727;2045;141;421;262;673;403;1094
430950;202201;886;1903;576;1395;39;126;396;883;435;1009
430955;202201;409;1053;114;323;25;80;35;75;60;155
430957;202201;179;583;160;544;29;98;101;348;130;446
430960;202201;1484;3427;884;2377;180;525;378;941;558;1466
430965;202201;1622;3762;1272;3234;68;159;972;2524;1040;2683
430970;202201;398;929;222;604;28;81;119;294;147;375
430975;202201;538;1518;420;1257;76;250;200;582;276;832
430980;202201;419;931;248;649;22;70;128;298;150;368
430990;202201;615;1664;424;1251;72;231;188;532;260;763
430995;202201;586;1456;446;1236;59;171;255;687;314;858
431000;202201;1463;3399;674;1926;135;419;59;142;194;561
431010;202201;2584;6643;1849;5403;369;1164;635;1686;1004;2850
431020;202201;8622;18363;5275;13430;934;2713;2156;4899;3090;7612
431030;202201;373;1004;194;635;43;154;31;101;74;255
431033;202201;4190;9533;2833;7436;572;1518;1185;3061;1757;4579
431036;202201;340;741;80;234;8;26;23;50;31;76
431040;202201;949;2307;624;1763;59;216;339;875;398;1091
431041;202201;462;1046;332;853;36;89;195;499;231;588
431043;202201;344;842;216;613;36;124;113;307;149;431
431046;202201;110;282;46;137;8;24;10;27;18;51
431050;202201;1407;3317;1003;2679;180;473;504;1380;684;1853
431053;202201;716;1796;410;1201;75;251;141;352;216;603
431055;202201;628;1471;515;1292;34;86;395;975;429;1061
431057;202201;236;671;140;449;27;98;52;152;79;250
431060;202201;6143;14760;4240;11662;938;2801;1479;3917;2417;6718
431065;202201;422;1016;316;843;39;102;170;453;209;555
431070;202201;441;1153;274;802;63;213;76;206;139;419
431075;202201;231;645;144;452;30;110;46;146;76;256
431080;202201;609;1613;439;1269;75;238;167;450;242;688
431085;202201;823;2074;530;1452;49;149;288;760;337;909
431087;202201;437;1171;354;1006;42;118;214;603;256;721
431090;202201;423;974;178;531;30;96;46;145;76;241
431100;202201;3794;8077;2696;6688;240;662;1710;4155;1950;4817
431110;202201;1518;3390;1066;2616;191;509;527;1180;718;1689
431112;202201;670;1716;555;1516;39;141;401;1032;440;1173
431113;202201;445;1146;374;1017;69;194;209;555;278;749
431115;202201;1003;2771;791;2389;64;251;527;1514;591;1765
431120;202201;2878;7172;2037;5622;492;1461;690;1778;1182;3239
431123;202201;389;1035;263;766;50;132;151;446;201;578
431125;202201;1088;2891;844;2446;237;683;411;1242;648;1925
431127;202201;204;551;73;231;6;21;12;35;18;56
431130;202201;3261;7931;2504;6775;280;813;1509;4024;1789;4837
431140;202201;6256;14525;3925;10286;493;1405;1717;3931;2210;5336
431142;202201;583;1424;449;1213;53;146;301;817;354;963
431150;202201;1109;2833;836;2369;144;435;418;1165;562;1600
431160;202201;724;1960;486;1457;99;317;154;449;253;766
431162;202201;569;1395;358;1019;31;109;192;500;223;609
431164;202201;184;424;50;154;7;23;9;22;16;45
431170;202201;470;1256;348;1016;95;284;109;302;204;586
431171;202201;759;1688;642;1547;120;262;419;1021;539;1283
431173;202201;474;1183;347;1007;90;301;144;395;234;696
431175;202201;1386;3131;904;2338;138;363;384;957;522;1320
431177;202201;885;2269;693;1971;101;343;459;1257;560;1600
431179;202201;347;746;106;303;21;64;32;92;53;156
431180;202201;2407;5959;1522;4256;329;965;511;1348;840;2313
431190;202201;626;1545;284;809;39;123;84;196;123;319
431198;202201;416;1176;346;1045;92;288;137;444;229;732
431200;202201;379;933;109;294;23;63;15;34;38;97
431205;202201;230;605;123;375;33;108;40;125;73;233
431210;202201;682;1547;556;1375;130;312;262;694;392;1006
431213;202201;277;715;212;590;11;29;119;324;130;353
431215;202201;664;1550;330;939;31;104;168;443;199;547
431217;202201;171;437;119;336;23;84;57;134;80;218
431220;202201;594;1491;378;1088;40;131;203;539;243;670
431225;202201;1593;3629;1248;3087;101;270;900;2205;1001;2475
431230;202201;727;1976;591;1697;80;261;355;965;435;1226
431235;202201;182;487;24;84;2;4;4;19;6;23
431237;202201;372;1134;302;979;51;198;148;446;199;644
431238;202201;34;96;28;83;5;16;14;35;19;51
431240;202201;5116;12036;4155;10571;395;1196;2787;6728;3182;7924
431242;202201;294;712;259;658;24;76;191;461;215;537
431244;202201;383;943;203;567;25;78;79;194;104;272
431245;202201;1393;3156;909;2346;61;164;513;1269;574;1433
431247;202201;298;717;183;491;29;94;86;198;115;292
431250;202201;1900;4560;1448;3977;306;782;807;2347;1113;3129
431260;202201;305;798;189;584;24;86;77;234;101;320
431261;202201;282;825;229;732;21;86;131;398;152;484
431262;202201;345;957;178;580;17;60;104;339;121;399
431265;202201;1653;3835;743;2106;99;321;242;587;341;908
431267;202201;254;631;166;450;9;28;119;303;128;331
431270;202201;2997;6501;1664;4288;324;854;595;1564;919;2418
431275;202201;138;372;80;241;22;67;24;65;46;132
431280;202201;245;654;90;289;11;37;15;37;26;74
431290;202201;373;1097;264;827;62;221;44;113;106;334
431295;202201;75;181;27;75;6;21;7;15;13;36
431300;202201;316;826;75;232;7;20;27;70;34;90
431301;202201;297;838;78;255;15;54;10;28;25;82
431303;202201;668;1668;426;1186;26;87;194;484;220;571
431306;202201;2435;5655;1551;4209;159;486;726;1795;885;2281
431308;202201;31;86;28;80;8;24;17;49;25;73
431310;202201;586;1534;430;1215;61;179;204;540;265;719
431320;202201;718;1922;425;1316;83;261;125;346;208;607
431330;202201;1871;4303;990;2753;132;441;445;1110;577;1551
431333;202201;224;579;127;367;17;59;49;118;66;177
431335;202201;38;113;23;81;8;30;2;4;10;34
431337;202201;3067;7605;2417;6621;262;878;1639;4296;1901;5174
431339;202201;471;1172;352;969;73;191;163;451;236;642
431340;202201;19696;46892;14174;37891;1967;5887;7379;18510;9346;24397
431342;202201;444;991;331;814;31;67;252;618;283;685
431344;202201;420;1028;250;722;33;108;114;320;147;428
431346;202201;225;547;86;264;13;43;20;48;33;91
431349;202201;815;1947;530;1368;86;230;272;663;358;893
431350;202201;4673;11425;3605;9686;406;1258;2157;5545;2563;6803
431360;202201;608;1412;316;867;80;242;96;248;176;490
431365;202201;2278;5040;1819;4424;103;305;1451;3452;1554;3757
431370;202201;5091;11726;3821;9773;658;1763;2091;5338;2749;7101
431380;202201;925;2406;756;2133;80;237;500;1412;580;1649
431390;202201;2855;6888;1869;5169;187;642;1005;2441;1192;3083
431395;202201;1555;3589;1185;3050;169;438;727;1858;896;2296
431400;202201;315;869;183;580;37;122;40;110;77;232
431402;202201;958;2065;719;1707;82;210;511;1178;593;1388
431403;202201;222;606;171;504;32;100;78;217;110;317
431405;202201;5376;13534;4293;11810;654;2078;2277;5878;2931;7956
431406;202201;610;1632;433;1265;83;232;194;588;277;820
431407;202201;547;1406;405;1119;58;171;257;694;315;865
431410;202201;19364;46389;13751;37089;1664;5271;7936;19980;9600;25251
431413;202201;251;684;65;218;8;25;13;42;21;67
431415;202201;747;1774;498;1363;81;254;247;608;328;862
431417;202201;611;1316;411;1003;64;180;230;530;294;710
431420;202201;1740;3764;1339;3240;123;318;855;2005;978;2323
431430;202201;616;1537;331;991;51;179;114;303;165;482
431440;202201;33484;75512;24271;61769;3739;10414;11328;26951;15067;37365
431442;202201;147;415;78;266;15;60;16;50;31;110
431445;202201;384;1059;115;369;10;30;18;44;28;74
431446;202201;294;827;227;701;27;94;125;375;152;469
431447;202201;809;2042;479;1380;86;248;143;424;229;672
431449;202201;832;2092;547;1538;94;254;228;636;322;890
431450;202201;2425;4787;1913;4072;52;122;1577;3267;1629;3389
431454;202201;41;130;32;108;8;29;15;46;23;75
431455;202201;622;1425;329;847;24;69;170;391;194;460
431460;202201;3108;7163;2187;5588;527;1367;745;1892;1272;3259
431470;202201;1460;3931;1095;3188;185;563;465;1319;650;1882
431475;202201;257;684;64;215;4;18;9;19;13;37
431477;202201;457;1140;280;796;46;124;107;281;153;405
431478;202201;228;597;57;173;9;26;6;15;15;41
431480;202201;3675;8823;2967;7756;641;1712;1586;4127;2227;5839
431490;202201;118127;269130;91496;229601;5594;17451;68311;164249;73905;181700
431500;202201;521;1292;397;1075;55;157;217;563;272;720
431505;202201;266;625;188;513;12;40;136;369;148;409
431507;202201;341;799;149;430;43;132;24;61;67;193
431510;202201;1768;4345;1237;3332;285;807;463;1250;748;2057
431513;202201;240;518;133;343;40;104;29;59;69;163
431514;202201;125;314;96;264;3;8;66;168;69;176
431515;202201;503;1208;378;998;66;194;243;595;309;789
431517;202201;58;167;50;149;3;13;27;74;30;87
431520;202201;403;986;180;533;18;59;82;213;100;272
431530;202201;5414;11509;3345;8468;610;1525;1410;3519;2020;5044
431531;202201;217;506;146;379;22;60;55;133;77;193
431532;202201;578;1307;373;953;65;187;165;418;230;605
431535;202201;267;696;129;391;24;76;27;76;51;152
431540;202201;1857;5733;1719;5552;76;291;1392;4540;1468;4831
431545;202201;374;940;80;232;6;16;27;72;33;88
431550;202201;2302;5596;1692;4503;263;762;922;2331;1185;3093
431555;202201;707;1569;435;1121;44;129;256;653;300;782
431560;202201;26731;61686;18449;49026;3717;9612;7111;19856;10828;29468
431570;202201;4739;10899;4053;9929;311;865;3149;7471;3460;8336
431575;202201;355;841;295;751;75;156;156;413;231;569
431580;202201;615;1574;406;1170;45;154;223;612;268;766
431590;202201;683;1834;519;1505;107;303;197;559;304;862
431595;202201;389;1025;257;756;50;156;94;253;144;409
431600;202201;1636;3789;1189;3123;223;631;581;1489;804;2120
431610;202201;1495;3643;1037;2836;164;424;537;1508;701;1932
431620;202201;510;1272;261;714;49;148;124;307;173;455
431630;202201;1385;3343;689;1962;115;360;268;713;383;1073
431640;202201;6889;15520;5897;14285;439;1173;4512;10911;4951;12084
431642;202201;670;1511;418;1059;46;103;203;489;249;592
431643;202201;394;947;191;544;23;64;60;160;83;224
431645;202201;2024;4282;1604;3736;46;142;1359;3120;1405;3262
431647;202201;324;766;111;324;10;32;34;90;44;122
431650;202201;134;346;95;283;11;37;37;90;48;127
431660;202201;939;2412;466;1438;84;304;115;307;199;611
431670;202201;1279;2961;774;2071;137;388;365;899;502;1287
431673;202201;241;622;102;331;14;45;19;46;33;91
431675;202201;398;1003;117;388;15;56;23;68;38;124
431680;202201;9155;22217;6907;18241;1267;3510;3428;8702;4695;12212
431690;202201;26849;63600;19131;50277;3036;8735;9752;24875;12788;33610
431695;202201;226;530;127;354;16;63;73;181;89;244
431697;202201;490;1118;384;961;45;104;242;616;287;720
431700;202201;1481;3609;1215;3158;169;403;721;1893;890;2296
431710;202201;14634;33179;10647;27691;1381;3784;6350;16410;7731;20194
431720;202201;7186;17004;4508;12195;1028;2932;1165;2879;2193;5811
431725;202201;33;82;25;68;6;20;12;29;18;49
431730;202201;4418;10162;2893;7869;570;1550;1227;3413;1797;4963
431740;202201;5690;12968;3902;10136;948;2757;1198;2832;2146;5589
431750;202201;8365;20927;6432;17944;1388;4152;2737;7506;4125;11658
431755;202201;343;912;95;306;13;45;23;62;36;107
431760;202201;5711;12525;4008;9891;407;1153;2550;5971;2957;7124
431770;202201;2106;4647;1608;4006;148;363;1188;2928;1336;3291
431775;202201;211;526;116;343;26;80;22;57;48;137
431780;202201;2314;5449;1534;4076;227;622;665;1741;892;2363
431790;202201;822;2106;546;1565;63;179;264;747;327;926
431795;202201;296;721;146;429;25;74;43;122;68;196
431800;202201;8888;20430;5755;15658;1516;4742;688;1983;2204;6725
431805;202201;292;715;74;254;5;13;4;9;9;22
431810;202201;3529;7910;2290;5752;349;917;1162;2764;1511;3681
431820;202201;2304;5876;1800;5096;447;1364;786;2223;1233;3587
431830;202201;9519;20284;7169;17188;1971;5412;1682;4197;3653;9609
431840;202201;2896;7110;2359;6286;236;657;1624;4330;1860;4987
431842;202201;525;1280;196;582;30;101;77;206;107;307
431843;202201;339;885;249;708;31;95;121;323;152;418
431844;202201;205;543;75;245;11;47;23;74;34;121
431845;202201;535;1367;374;1053;30;86;232;641;262;727
431846;202201;294;722;255;666;7;24;230;595;237;619
431848;202201;165;417;92;263;12;43;25;53;37;96
431849;202201;416;1009;91;263;8;25;19;43;27;68
431850;202201;4548;11682;3548;9855;803;2393;1321;3494;2124;5887
431860;202201;667;1543;376;998;44;126;231;601;275;727
431861;202201;97;257;61;179;10;31;20;52;30;83
431862;202201;501;1529;417;1385;83;314;217;683;300;997
431870;202201;23356;56449;18907;49834;1834;5588;12310;31226;14144;36814
431880;202201;4184;10402;3050;8466;359;1171;1641;4334;2000;5505
431890;202201;5062;12331;3301;9064;1010;2702;766;2284;1776;4986
431900;202201;1059;2589;696;1945;110;330;355;929;465;1259
431910;202201;808;1849;327;882;42;112;104;229;146;341
431912;202201;537;1371;429;1193;65;190;281;777;346;967
431915;202201;1168;2649;925;2279;32;87;717;1728;749;1815
431920;202201;1319;2919;1093;2633;36;86;940;2243;976;2329
431930;202201;734;1853;511;1458;143;382;223;659;366;1041
431935;202201;89;231;64;183;11;36;19;44;30;80
431936;202201;321;878;197;578;35;99;93;263;128;362
431937;202201;154;383;99;280;16;49;44;113;60;162
431940;202201;3230;7333;2035;5265;143;420;1202;2968;1345;3388
431950;202201;2170;5385;1736;4712;374;1089;785;2076;1159;3165
431960;202201;3211;7550;2483;6302;683;1769;870;2145;1553;3914
431970;202201;417;1022;194;541;45;135;50;127;95;262
431971;202201;83;200;37;114;3;11;8;19;11;30
431973;202201;504;1579;411;1402;44;170;291;987;335;1157
431975;202201;118;239;32;88;6;21;7;15;13;36
431980;202201;1128;2748;892;2391;122;392;552;1377;674;1769
431990;202201;6260;14618;4573;12263;420;1347;2747;7140;3167;8487
432000;202201;13659;31126;10193;25945;1594;4318;5800;14365;7394;18683
432010;202201;2911;6591;1987;5109;390;1070;845;2022;1235;3092
432020;202201;1843;4716;1169;3316;260;782;378;1032;638;1814
432023;202201;574;1339;288;783;37;106;132;314;169;420
432026;202201;1065;2823;821;2362;219;627;313;925;532;1552
432030;202201;445;1004;252;667;17;46;154;373;171;419
432032;202201;352;867;246;660;19;63;146;355;165;418
432035;202201;693;1885;605;1741;164;436;294;904;458;1340
432040;202201;1166;2710;460;1386;59;213;195;527;254;740
432045;202201;180;482;118;356;20;64;51;143;71;207
432050;202201;592;1405;438;1145;65;202;233;594;298;796
432055;202201;684;1728;488;1383;157;434;145;403;302;837
432057;202201;177;471;146;397;8;21;79;200;87;221
432060;202201;456;1097;143;451;23;80;39;112;62;192
432065;202201;225;606;173;503;40;111;68;203;108;314
432067;202201;813;2237;697;1987;59;203;521;1429;580;1632
432070;202201;1793;4404;1290;3507;228;678;608;1556;836;2234
432080;202201;5281;11834;4037;10004;564;1605;2050;4864;2614;6469
432085;202201;411;1089;312;932;56;190;170;486;226;676
432090;202201;2593;6221;1563;4292;232;715;754;1916;986;2631
432100;202201;1027;2509;525;1561;95;307;124;316;219;623
432110;202201;2263;5674;1663;4654;424;1285;313;839;737;2124
432120;202201;3586;9220;2931;8186;462;1414;1541;4116;2003;5530
432130;202201;2835;6798;2381;6142;376;979;1420;3681;1796;4660
432132;202201;229;628;122;390;19;64;56;160;75;224
432135;202201;1059;2389;720;1825;68;176;504;1275;572;1451
432140;202201;1866;5218;1465;4460;172;597;965;2845;1137;3442
432143;202201;1564;3963;1197;3403;69;219;785;2189;854;2408
432145;202201;1897;4879;1268;3640;186;575;441;1081;627;1656
432146;202201;114;310;91;281;30;109;30;84;60;193
432147;202201;519;1373;315;971;107;341;73;218;180;559
432149;202201;473;1126;256;699;31;90;105;258;136;348
432150;202201;3725;8948;2841;7498;489;1364;1411;3601;1900;4965
432160;202201;6047;14878;4540;12580;1073;3132;1734;4821;2807;7953
432162;202201;238;520;40;115;7;21;13;25;20;46
432163;202201;160;375;32;86;2;8;6;8;8;16
432166;202201;683;1834;555;1592;99;329;221;571;320;900
432170;202201;1657;4347;1174;3505;208;671;531;1490;739;2161
432180;202201;3254;7510;1840;4944;277;821;810;1920;1087;2741
432183;202201;405;1129;297;900;55;211;124;339;179;550
432185;202201;852;2164;505;1507;64;201;241;686;305;887
432190;202201;2107;4954;1505;4039;124;403;975;2458;1099;2861
432195;202201;992;2456;672;1881;140;374;289;805;429;1179
432200;202201;3797;9070;2835;7630;285;821;1855;4928;2140;5749
432210;202201;424;1091;284;829;53;156;134;362;187;518
432215;202201;674;1862;608;1764;49;109;451;1328;500;1437
432218;202201;267;640;128;354;17;56;50;107;67;163
432220;202201;3879;8819;2810;7111;501;1256;1456;3648;1957;4904
432225;202201;120;316;85;250;10;32;53;150;63;182
432230;202201;816;1886;432;1193;57;170;194;497;251;667
432232;202201;529;1265;350;976;56;179;164;414;220;593
432234;202201;288;707;148;421;30;71;29;71;59;142
432235;202201;44;126;19;60;5;17;5;16;10;33
432237;202201;325;815;290;759;12;33;242;619;254;652
432240;202201;17849;41561;13267;35619;1291;3153;8881;24421;10172;27574
432250;202201;6165;16781;4669;13879;890;2830;2306;6806;3196;9636
432252;202201;494;1153;324;843;35;96;181;438;216;534
432253;202201;953;2724;669;2037;176;574;83;234;259;808
432254;202201;709;1639;225;654;30;77;40;102;70;179
432255;202201;108;277;63;183;8;26;30;80;38;106
432260;202201;5628;13854;4268;11396;949;2653;1883;4813;2832;7466
432270;202201;2227;5749;1846;5075;493;1471;699;1832;1192;3303
432280;202201;1488;3608;819;2368;125;390;285;700;410;1090
432285;202201;148;439;28;84;2;4;6;17;8;21
432290;202201;377;1001;236;696;68;220;67;156;135;376
432300;202201;29662;70976;22601;60148;2386;7410;14754;37683;17140;45093
432310;202201;930;2364;677;1914;65;197;482;1366;547;1563
432320;202201;203;464;85;254;9;34;28;69;37;103
432330;202201;221;496;76;237;13;32;10;31;23;63
432335;202201;168;481;67;236;9;31;15;50;24;81
432340;202201;348;865;162;522;22;76;46;147;68;223
432345;202201;811;1703;700;1572;11;28;603;1327;614;1355
432350;202201;361;889;198;583;30;93;72;211;102;304
432360;202201;234;687;46;155;4;10;14;43;18;53
432370;202201;353;815;222;600;21;63;137;363;158;426
432375;202201;493;1185;373;957;86;227;178;460;264;687
432377;202201;168;512;38;131;1;4;9;18;10;22
432380;202201;2003;5275;1411;4223;209;669;736;2151;945;2820
500020;202201;3392;8067;2388;6478;206;680;1527;4004;1733;4684
500025;202201;1231;2980;790;2175;99;264;402;1065;501;1329
500060;202201;8601;23587;6019;18277;693;2267;3619;11137;4312;13404
500070;202201;5008;12180;3640;9956;665;1939;1712;4698;2377;6637
500080;202201;1731;4093;1079;2941;178;542;444;1100;622;1642
500085;202201;2134;5220;1525;4177;327;965;766;1989;1093;2954
500090;202201;2256;5746;1569;4609;267;851;540;1713;807;2564
500100;202201;3982;9757;3065;8314;429;1337;1604;4093;2033;5430
500110;202201;9587;23433;6627;18897;1425;4096;2625;8205;4050;12301
500124;202201;2257;6280;1827;5611;267;837;1065;3341;1332;4178
500150;202201;1519;3283;1031;2621;165;464;540;1303;705;1767
500190;202201;5468;13778;3631;10327;713;2098;1191;3161;1904;5259
500200;202201;2879;6502;2000;5056;178;444;1281;3134;1459;3578
500210;202201;5143;11684;3669;9767;942;2423;1856;5054;2798;7477
500215;202201;1522;4036;1126;3326;93;304;682;1990;775;2294
500220;202201;3204;8415;2307;6872;372;1208;1036;2967;1408;4175
500230;202201;2187;4889;1693;4225;168;474;1192;2881;1360;3355
500240;202201;4440;12564;3276;10207;513;1706;1455;4624;1968;6330
500260;202201;3533;7355;2327;5768;218;645;1439;3341;1657;3986
500270;202201;153042;350916;98445;263074;13970;41596;41901;103642;55871;145238
500280;202201;1492;3654;1020;2941;172;539;515;1467;687;2006
500290;202201;3967;9397;2456;6820;362;1147;877;2139;1239;3286
500295;202201;4028;9472;2721;7248;453;1361;1199;2845;1652;4206
500310;202201;1071;2099;747;1706;128;261;419;963;547;1224
500315;202201;4254;11051;3433;9881;229;695;2599;7557;2828;8252
500320;202201;21881;56157;15350;45649;3598;10946;5956;18849;9554;29795
500325;202201;5739;12357;4036;10076;397;995;2577;6423;2974;7418
500330;202201;7223;15890;4818;12517;483;1224;2613;7004;3096;8228
500345;202201;2209;5284;1517;4220;261;757;656;1794;917;2551
500348;202201;2530;6312;1901;5254;218;640;1185;3310;1403;3950
500350;202201;1367;3643;807;2479;105;330;326;958;431;1288
500370;202201;29797;74129;22006;61862;2535;8221;12185;33677;14720;41898
500375;202201;2720;6954;1880;5278;275;842;736;1893;1011;2735
500380;202201;3714;8993;2633;7226;772;2192;621;1772;1393;3964
500390;202201;686;1406;435;1104;56;162;254;635;310;797
500400;202201;1696;4214;1147;3171;218;699;416;1036;634;1735
500410;202201;2591;6047;1839;4970;202;498;1073;3038;1275;3536
500430;202201;2977;7049;2072;5742;294;829;940;2793;1234;3622
500440;202201;1689;3900;938;2662;141;409;353;1057;494;1466
500450;202201;1797;4281;1140;3174;215;601;356;924;571;1525
500460;202201;3971;10206;2431;7222;452;1483;750;2137;1202;3620
500470;202201;2686;7017;1749;5198;461;1490;449;1196;910;2686
500480;202201;2209;6597;1850;6041;147;517;1414;4673;1561;5190
500490;202201;1233;2767;758;2054;140;452;210;587;350;1039
500500;202201;4536;11555;3017;9204;886;2977;438;1427;1324;4404
500510;202201;741;1815;496;1388;40;121;305;814;345;935
500515;202201;1748;4438;1367;3847;177;571;826;2212;1003;2783
500520;202201;3639;10211;2831;8868;583;1851;1436;4721;2019;6572
500525;202201;1035;2883;830;2600;101;339;528;1637;629;1976
500540;202201;5293;13341;3234;9739;920;3060;485;1366;1405;4426
500560;202201;5669;14966;4550;13591;226;708;3780;11477;4006;12185
500568;202201;4806;10218;3009;7571;627;1573;1251;3044;1878;4617
500570;202201;8756;19813;5949;15313;874;2560;2926;7021;3800;9581
500580;202201;3376;8555;2496;7038;531;1540;1191;3383;1722;4923
500600;202201;3763;9156;2783;7625;569;1583;1171;3309;1740;4892
500620;202201;8704;22122;6083;17291;937;2910;2876;7782;3813;10692
500625;202201;569;1496;386;1141;61;195;133;371;194;566
500627;202201;864;2227;548;1687;95;303;177;520;272;823
500630;202201;8029;17576;4667;12250;863;2423;1562;4003;2425;6426
500635;202201;3092;9540;2391;8604;254;810;1672;6559;1926;7369
500640;202201;1923;4030;1273;3188;66;179;842;2041;908;2220
500660;202201;20892;50659;14676;41847;4506;13123;4639;13844;9145;26967
500690;202201;2779;7143;1855;5650;494;1686;653;1918;1147;3604
500710;202201;3387;8683;2566;7306;624;1971;886;2394;1510;4365
500720;202201;5486;13499;3730;10641;781;2341;1391;3949;2172;6290
500730;202201;1191;2839;676;1916;127;358;196;550;323;908
500740;202201;5079;11718;3364;9151;451;1354;1692;4378;2143;5732
500750;202201;1117;2757;797;2238;108;305;347;911;455;1216
500755;202201;1108;2804;684;2021;114;352;193;531;307;883
500769;202201;5658;13524;3310;9294;698;2077;569;1476;1267;3553
500770;202201;1471;3890;1025;3168;191;611;362;1115;553;1726
500780;202201;1288;3058;849;2363;171;559;267;660;438;1219
500790;202201;7712;19905;5851;16688;1117;3437;2633;7508;3750;10945
500793;202201;2209;5421;1629;4469;336;992;649;1659;985;2651
500795;202201;2893;6972;2283;6180;135;353;1786;5042;1921;5395
500797;202201;821;2068;542;1565;149;422;184;566;333;988
500800;202201;3734;8258;2385;6284;677;2001;461;1319;1138;3320
500830;202201;20068;48431;14110;38033;2830;8094;5340;13826;8170;21920
500840;202201;1531;3626;976;2613;117;334;457;1156;574;1490
510010;202201;1945;4260;1354;3516;125;300;969;2520;1094;2820
510020;202201;4470;10858;2481;7061;448;1407;756;1905;1204;3312
510025;202201;7445;17458;4815;13425;589;1869;2433;6523;3022;8392
510030;202201;3337;7079;2287;5550;237;621;1332;3059;1569;3680
510035;202201;1296;3305;858;2625;146;439;454;1530;600;1969
510040;202201;2581;5571;1941;4761;216;447;1271;3272;1487;3719
510050;202201;2380;4775;1639;3845;201;506;1110;2588;1311;3094
510060;202201;1475;3632;971;2754;174;514;285;767;459;1281
510080;202201;1565;3937;1086;3199;203;675;554;1541;757;2216
510100;202201;720;1613;524;1319;58;162;317;758;375;920
510120;202201;290;519;163;369;7;15;128;284;135;299
510125;202201;2232;5482;1786;4839;156;558;1054;2682;1210;3240
510130;202201;1656;4035;1159;3268;244;710;470;1350;714;2060
510140;202201;3278;8201;2232;6900;738;2506;866;2795;1604;5301
510160;202201;1896;4690;1430;4100;82;258;1181;3416;1263;3674
510170;202201;5260;13334;4024;11391;759;2337;1938;5409;2697;7746
510180;202201;15914;34393;10689;27179;2080;5470;4457;12219;6537;17689
510185;202201;1898;4829;1230;3868;523;1651;268;1124;791;2775
510190;202201;2315;6385;1518;5103;390;1449;388;1379;778;2828
510250;202201;18889;45803;14206;38888;2171;6387;7971;22250;10142;28637
510260;202201;1878;7908;1590;7430;253;1227;1001;5161;1254;6388
510263;202201;3591;9906;2325;7359;408;1490;493;1381;901;2871
510267;202201;5867;16338;3502;11135;660;2331;629;1710;1289;4041
510268;202201;1385;3457;1015;2842;133;388;506;1370;639;1758
510269;202201;1104;2902;728;2223;149;495;287;825;436;1320
510270;202201;3245;8880;2274;7233;370;1290;983;3126;1353;4416
510279;202201;1926;4845;1160;3513;163;576;436;1204;599;1780
510285;202201;1208;3089;818;2415;197;624;287;801;484;1425
510300;202201;4076;9937;3084;8650;365;1037;2038;5914;2403;6951
510305;202201;1545;4159;997;3144;200;656;255;868;455;1524
510310;202201;1047;2486;731;1990;191;532;260;744;451;1276
510320;202201;4017;9628;2868;7750;572;1630;845;2277;1417;3907
510325;202201;4596;13117;3345;10830;848;2886;1072;3549;1920;6435
510330;202201;2706;7900;1848;6450;402;1415;672;2722;1074;4137
510335;202201;5167;14561;3954;12602;625;2199;2112;6790;2737;8989
510336;202201;473;1295;350;1113;43;126;201;706;244;832
510337;202201;1537;4290;1022;3402;315;1133;325;1121;640;2254
510340;202201;101837;222006;69389;176853;14468;40757;27519;68057;41987;108814
510343;202201;1215;3001;799;2290;113;380;403;1088;516;1468
510345;202201;1332;3706;1027;3138;160;500;496;1479;656;1979
510350;202201;3313;8147;2298;6521;467;1404;1054;2980;1521;4384
510360;202201;2170;4307;1386;3404;57;114;1005;2622;1062;2736
510370;202201;1854;5120;1396;4387;172;609;881;2822;1053;3431
510380;202201;645;1519;380;1085;65;212;171;484;236;696
510385;202201;1277;4169;952;3588;87;374;651;2559;738;2933
510390;202201;1423;3509;973;2984;315;880;379;1370;694;2250
510395;202201;755;1610;511;1262;35;76;349;893;384;969
510410;202201;5271;13907;3868;11559;672;2036;2128;6595;2800;8631
510420;202201;2673;5364;1821;4257;90;211;1307;3047;1397;3258
510450;202201;607;1445;359;1023;82;249;90;246;172;495
510452;202201;892;2471;672;2063;76;262;422;1259;498;1521
510454;202201;1061;2821;824;2433;94;248;522;1637;616;1885
510455;202201;1037;2695;718;2120;121;419;303;823;424;1242
510460;202201;2085;5099;1543;4312;226;689;874;2302;1100;2991
510480;202201;5245;12293;3626;9430;599;1718;1611;3972;2210;5690
510490;202201;1815;4521;1361;3955;194;562;905;2657;1099;3219
510500;202201;1648;3952;1033;3013;211;671;333;946;544;1617
510510;202201;4065;11033;2939;9193;697;2373;1055;3421;1752;5794
510515;202201;5649;13943;3828;10852;792;2557;1365;3491;2157;6048
510517;202201;1560;3839;1055;3102;315;1022;286;805;601;1827
510520;202201;2422;4777;1364;3469;110;299;654;1797;764;2096
510523;202201;1350;3094;971;2536;121;340;640;1655;761;1995
510525;202201;8349;22112;6305;18268;946;3013;3021;8286;3967;11299
510530;202201;567;1454;418;1246;30;105;277;816;307;921
510550;202201;2642;7401;1989;6333;361;1225;1062;3347;1423;4572
510558;202201;2504;6524;1887;5621;237;653;969;3129;1206;3782
510560;202201;1765;4924;1115;3689;257;865;293;1036;550;1901
510562;202201;6295;15131;4633;12361;750;2028;2153;6033;2903;8061
510590;202201;3166;7730;2349;6682;157;451;1735;5091;1892;5542
510600;202201;1556;3336;1066;2644;128;334;594;1442;722;1776
510610;202201;2801;6537;1936;5433;289;918;1105;3064;1394;3982
510615;202201;3025;7194;2133;5816;272;822;1323;3613;1595;4435
510617;202201;1063;3123;848;2794;79;312;613;2063;692;2375
510618;202201;1310;3398;960;2852;190;625;479;1412;669;2037
510619;202201;827;2039;500;1482;75;221;109;285;184;506
510620;202201;1501;3338;746;2136;221;725;67;156;288;881
510621;202201;1706;4422;1049;3219;232;761;320;893;552;1654
510622;202201;5328;14328;3735;11128;1258;4013;633;1767;1891;5780
510623;202201;2969;7171;2185;5961;481;1440;848;2309;1329;3749
510624;202201;1730;4412;929;2957;122;433;209;606;331;1039
510625;202201;3438;8013;2040;5644;353;1091;614;1683;967;2774
510626;202201;1570;3733;1030;2896;250;800;269;766;519;1566
510627;202201;689;1711;384;1145;80;261;117;368;197;629
510628;202201;1593;3529;1069;2863;221;639;494;1325;715;1964
510629;202201;1817;4925;1308;4033;256;843;446;1397;702;2240
510630;202201;3647;9766;2282;7297;510;1762;543;1848;1053;3610
510631;202201;625;1435;463;1201;22;46;357;952;379;998
510637;202201;3969;9083;2858;7526;569;1586;1109;3008;1678;4594
510642;202201;5948;16113;4613;14168;924;3131;2494;7666;3418;10797
510645;202201;1132;2159;712;1652;161;339;362;876;523;1215
510650;202201;7572;18434;5970;16704;822;1538;4235;13229;5057;14767
510665;202201;1913;4094;1243;3055;246;555;508;1363;754;1918
510670;202201;455;964;272;715;36;94;156;413;192;507
510675;202201;6736;17904;4655;14123;1281;4304;986;2872;2267;7176
510677;202201;2405;6013;1713;5025;231;774;994;2878;1225;3652
510680;202201;752;1866;444;1327;93;320;125;316;218;636
510682;202201;1670;4608;1230;3920;370;1322;418;1286;788;2608
510685;202201;527;1461;376;1168;48;147;211;674;259;821
510700;202201;4357;9967;3049;8227;194;614;2414;6483;2608;7097
510704;202201;11801;27290;8115;21259;1979;5399;2357;5982;4336;11381
510706;202201;2387;6830;1669;5650;326;1141;755;2824;1081;3965
510710;202201;3143;7500;2059;5487;414;1168;720;1825;1134;2993
510715;202201;652;1377;470;1141;34;90;288;689;322;779
510718;202201;2486;5575;1514;4269;333;908;680;2247;1013;3155
510719;202201;490;1007;299;760;26;76;183;433;209;509
510720;202201;968;2171;654;1732;131;362;317;821;448;1183
510724;202201;939;2501;667;1997;93;308;359;1011;452;1319
510726;202201;1078;1940;618;1403;58;134;340;785;398;919
510729;202201;652;1492;313;883;38;117;90;276;128;393
510730;202201;3175;7425;2202;5995;251;766;1215;3199;1466;3965
510735;202201;1229;3285;960;2916;79;281;743;2236;822;2517
510740;202201;1077;2576;716;1948;71;228;419;1073;490;1301
510757;202201;514;1618;400;1441;132;544;145;487;277;1031
510760;202201;48543;104001;30497;77616;5836;16476;11026;26159;16862;42635
510770;202201;4499;9832;3138;8144;246;554;2216;6011;2462;6565
510774;202201;394;963;288;807;45;122;166;471;211;593
510775;202201;693;1772;439;1357;102;336;111;319;213;655
510776;202201;625;1501;453;1215;75;236;225;577;300;813
510777;202201;1669;4290;1224;3719;123;454;892;2676;1015;3130
510779;202201;847;2183;645;1871;64;167;404;1240;468;1407
510780;202201;4263;10428;3195;8936;660;1724;1600;4959;2260;6683
510785;202201;2156;5480;1293;3968;327;1044;310;1037;637;2081
510787;202201;3185;8769;2095;6608;617;2006;240;733;857;2739
510788;202201;606;1365;419;1089;61;151;204;604;265;755
510790;202201;20439;50768;13598;39088;3484;10784;2446;6729;5930;17513
510792;202201;10329;27770;6657;20849;1474;5163;1361;3963;2835;9126
510794;202201;1286;3413;937;2862;296;1041;240;668;536;1709
510795;202201;10047;25184;6983;19907;1519;4739;2341;6419;3860;11158
510800;202201;1670;4222;1168;3440;371;1169;185;497;556;1666
510805;202201;1634;4389;1155;3566;249;867;471;1347;720;2214
510810;202201;717;1404;474;1098;142;280;204;527;346;807
510820;202201;854;1570;495;1144;33;72;290;672;323;744
510830;202201;969;2184;737;1900;53;116;571;1542;624;1658
510835;202201;634;1487;426;1191;43;131;281;766;324;897
510840;202201;62826;129707;44190;107367;7455;16562;24673;63957;32128;80519
510850;202201;2015;4819;1284;3719;492;1597;151;380;643;1977
510860;202201;2708;6808;1755;5301;535;1754;345;1095;880;2849
510880;202201;831;2241;624;1880;133;399;221;694;354;1093
510885;202201;704;1644;475;1318;93;265;141;394;234;659
510890;202201;850;2331;655;2011;132;433;329;1013;461;1446
510895;202201;1413;3517;933;2727;160;566;439;1208;599;1774
520005;202201;3265;8167;2561;7267;732;1809;1131;3713;1863;5522
520010;202201;2787;7454;2044;6073;425;1437;776;2081;1201;3518
520013;202201;3587;8704;2421;6696;528;1438;790;2350;1318;3788
520015;202201;546;1327;400;1114;80;222;176;516;256;738
520017;202201;1334;3253;991;2752;206;611;438;1152;644;1763
520020;202201;486;1042;376;914;15;45;320;763;335;808
520025;202201;36999;99000;31666;91753;3611;11171;22197;64364;25808;75535
520030;202201;6555;15611;5398;14083;270;776;4257;11020;4527;11796
520050;202201;445;1039;274;741;31;70;159;446;190;516
520055;202201;2011;4716;1320;3403;188;452;660;1662;848;2114
520060;202201;1815;4581;1315;3736;285;927;362;1030;647;1957
520080;202201;1989;5000;1547;4418;268;687;823;2571;1091;3258
520082;202201;1008;2441;752;2023;106;295;361;1025;467;1320
520085;202201;1091;2653;868;2336;151;421;464;1233;615;1654
520090;202201;915;1755;649;1469;46;74;515;1193;561;1267
520110;202201;41066;106668;29255;87508;8857;29587;4105;11746;12962;41333
520120;202201;249;575;145;401;14;42;62;166;76;208
520130;202201;4270;9939;3333;8512;612;1596;1512;3885;2124;5481
520140;202201;48230;123563;34380;100483;11566;35695;5810;17879;17376;53574
520145;202201;647;1440;438;1142;94;256;221;534;315;790
520150;202201;684;1559;510;1349;70;190;279;735;349;925
520160;202201;934;2152;655;1680;123;271;258;708;381;979
520170;202201;5054;10166;3393;8283;200;582;2584;6253;2784;6835
520180;202201;2701;6896;2207;6195;302;986;1358;3694;1660;4680
520215;202201;1869;4386;1357;3630;252;689;636;1680;888;2369
520235;202201;790;1713;533;1355;76;210;291;744;367;954
520250;202201;1660;4082;1203;3358;377;1069;361;1147;738;2216
520260;202201;863;1969;553;1483;87;225;234;641;321;866
520280;202201;908;2012;715;1729;140;322;384;957;524;1279
520310;202201;1105;2304;717;1738;164;424;255;674;419;1098
520320;202201;1906;4932;1480;4267;159;478;886;2607;1045;3085
520330;202201;5101;12840;3905;10894;577;1856;2135;5739;2712;7595
520340;202201;2640;5612;1645;4276;156;334;1015;2747;1171;3081
520350;202201;3075;7182;2202;5909;469;1240;1069;2951;1538;4191
520355;202201;2037;5406;1496;4374;452;1421;295;765;747;2186
520357;202201;863;2029;632;1685;37;80;484;1319;521;1399
520360;202201;798;1992;626;1720;116;335;250;694;366;1029
520380;202201;1531;3736;946;2695;145;438;386;1029;531;1467
520390;202201;1200;2647;753;2075;196;567;237;717;433;1284
520393;202201;689;1567;457;1201;62;173;199;501;261;674
520396;202201;947;2348;802;2138;39;113;572;1502;611;1615
520400;202201;1704;4038;1319;3528;107;308;1002;2685;1109;2993
520410;202201;2254;4771;1509;3686;197;549;861;1981;1058;2530
520420;202201;411;913;320;777;21;54;250;587;271;641
520425;202201;1692;4043;962;2661;264;770;187;507;451;1277
520430;202201;2537;5673;1537;4141;386;1125;150;386;536;1511
520440;202201;3190;7508;1861;5158;394;1211;475;1257;869;2468
520450;202201;13651;31392;9596;25562;2722;7413;2745;7767;5467;15180
520455;202201;783;2080;573;1762;145;453;182;581;327;1034
520460;202201;1116;2506;869;2194;73;159;677;1758;750;1917
520465;202201;905;2193;745;1980;66;216;580;1487;646;1703
520470;202201;2303;5568;1784;4905;441;1182;838;2514;1279;3696
520480;202201;959;2570;683;2115;162;543;259;776;421;1319
520485;202201;1674;4725;1356;4275;197;678;812;2489;1009;3167
520490;202201;4427;11610;3362;9960;672;2034;1782;5468;2454;7502
520495;202201;1671;3563;1278;3044;70;177;998;2399;1068;2576
520500;202201;1646;4042;1213;3286;163;484;680;1804;843;2288
520505;202201;863;1825;620;1532;45;118;453;1111;498;1229
520510;202201;8449;20387;6010;16747;1104;3426;2417;6750;3521;10176
520520;202201;1306;3150;999;2687;197;561;456;1238;653;1799
520530;202201;2655;6967;1985;5812;340;1029;1026;3129;1366;4158
520540;202201;3247;8235;2184;6232;404;1225;653;1763;1057;2988
520545;202201;1339;3222;1055;2786;221;574;527;1401;748;1975
520547;202201;1182;2972;913;2517;181;505;498;1365;679;1870
520549;202201;15915;40465;13333;36881;1523;4569;9289;25354;10812;29923
520551;202201;5045;13002;4240;11860;383;1235;3106;8514;3489;9749
520552;202201;873;2178;707;1964;133;365;428;1247;561;1612
520570;202201;586;1296;395;1005;85;192;166;432;251;624
520580;202201;2408;5218;1814;4537;184;488;1242;3114;1426;3602
520590;202201;1410;3338;975;2647;234;631;355;964;589;1595
520620;202201;9004;23268;7199;20663;1466;4348;3850;11166;5316;15514
520630;202201;924;2245;663;1819;71;185;317;876;388;1061
520640;202201;2600;6126;1994;5119;415;1039;934;2483;1349;3522
520650;202201;1120;2405;800;1969;144;317;419;1105;563;1422
520660;202201;586;1407;322;936;49;149;92;278;141;427
520670;202201;1017;2675;858;2455;63;199;613;1731;676;1930
520680;202201;876;2031;688;1752;122;267;395;1038;517;1305
520690;202201;336;774;229;613;75;191;78;213;153;404
520710;202201;467;1091;335;884;16;39;222;563;238;602
520725;202201;1532;3563;1054;2766;129;396;625;1593;754;1989
520735;202201;924;2153;643;1705;145;340;259;735;404;1075
520740;202201;2667;5754;2025;4975;403;836;1123;2992;1526;3828
520750;202201;748;1734;538;1421;83;245;281;707;364;952
520753;202201;1396;3633;1057;3024;187;591;459;1234;646;1825
520760;202201;1468;3094;1243;2827;28;55;1137;2614;1165;2669
520780;202201;1595;3670;1159;3062;148;370;639;1682;787;2052
520790;202201;3681;8523;2616;6847;348;879;1448;3941;1796;4820
520800;202201;18185;45032;14328;39507;1790;4929;9101;25760;10891;30689
520810;202201;1385;2811;1065;2456;167;335;691;1765;858;2100
520815;202201;619;1857;470;1539;91;320;145;480;236;800
520830;202201;1989;4156;1419;3498;94;244;1129;2759;1223;3003
520840;202201;3031;7742;2463;7016;785;2450;884;2630;1669;5080
520850;202201;780;1818;590;1548;142;438;245;649;387;1087
520860;202201;8228;21191;6246;17948;1324;4067;2723;7634;4047;11701
520870;202201;130734;295649;92842;239582;17190;46487;40888;102718;58078;149205
520880;202201;8690;23976;6897;20789;1390;4487;2863;8563;4253;13050
520890;202201;4746;10682;3331;8543;494;1414;1660;4185;2154;5599
520910;202201;5007;12130;3307;9328;699;2136;1002;2739;1701;4875
520915;202201;788;2101;509;1518;108;349;170;472;278;821
520920;202201;4844;10437;3498;8803;608;1320;1924;5177;2532;6497
520929;202201;726;1682;564;1460;71;145;313;877;384;1022
520940;202201;1032;2665;801;2332;37;135;637;1833;674;1968
520945;202201;535;1157;387;962;33;74;250;618;283;692
520960;202201;1210;2704;944;2326;237;513;468;1270;705;1783
520970;202201;3175;8153;2464;7041;662;2039;603;1901;1265;3940
520980;202201;839;1922;619;1632;107;272;291;750;398;1022
520990;202201;3175;7988;2558;7225;257;737;1846;5255;2103;5992
520993;202201;1233;2808;854;2233;126;371;465;1187;591;1558
520995;202201;2628;6403;1996;5546;316;857;818;2399;1134;3256
521000;202201;9827;25031;6643;19226;1123;3473;2061;5820;3184;9293
521010;202201;3915;9908;2943;8258;354;1011;1620;4516;1974;5527
521015;202201;832;2030;597;1627;38;123;393;1024;431;1147
521020;202201;4041;9915;2470;6971;688;2025;367;1025;1055;3050
521030;202201;624;1326;462;1088;39;84;332;787;371;871
521040;202201;8592;20429;6468;17188;1322;3494;2755;7812;4077;11306
521056;202201;976;2488;762;2170;212;572;276;863;488;1435
521060;202201;1074;2775;790;2244;138;402;334;956;472;1358
521080;202201;1188;2481;639;1662;87;243;316;754;403;997
521090;202201;3306;8629;2238;6485;583;1859;301;889;884;2748
521100;202201;2035;4442;1525;3748;186;454;1023;2541;1209;2995
521120;202201;5045;11645;3842;10179;453;981;1827;5744;2280;6725
521130;202201;1066;2376;564;1488;48;98;279;785;327;883
521140;202201;1560;3844;1183;3201;134;367;677;1785;811;2152
521150;202201;13523;29086;8670;22274;1568;4300;3999;10584;5567;14884
521160;202201;767;1524;525;1192;63;128;331;735;394;863
521170;202201;1159;2627;864;2189;90;253;505;1223;595;1476
521180;202201;8536;22180;7003;19682;1102;3389;3799;10381;4901;13770
521190;202201;11741;28154;7346;21149;1804;5497;1991;5843;3795;11340
521200;202201;756;1756;539;1434;48;135;338;877;386;1012
521205;202201;684;1608;526;1369;21;66;415;1030;436;1096
521210;202201;814;2075;473;1380;83;255;122;284;205;539
521220;202201;4030;9359;2769;7478;470;1397;1329;3599;1799;4996
521225;202201;418;875;307;753;48;112;200;501;248;613
521230;202201;1492;3656;1305;3429;370;930;698;1985;1068;2915
521250;202201;35966;89514;28807;79466;8614;23479;12402;35892;21016;59371
521260;202201;571;1290;439;1099;68;174;257;634;325;808
521270;202201;2014;4756;1760;4464;110;259;1381;3559;1491;3818
521280;202201;1935;5019;1464;4272;314;967;649;1957;963;2924
521290;202201;588;1283;408;1060;48;147;260;653;308;800
521295;202201;1305;2768;1040;2485;118;213;814;2032;932;2245
521300;202201;2017;4830;1583;4226;249;614;1008;2778;1257;3392
521305;202201;745;1702;541;1426;55;162;338;883;393;1045
521308;202201;5221;13240;3674;10488;334;1062;2265;6257;2599;7319
521310;202201;9757;24117;6899;19265;1155;3594;3387;9036;4542;12630
521340;202201;430;952;311;787;28;64;206;516;234;580
521350;202201;2179;5393;1672;4635;131;423;1211;3272;1342;3695
521370;202201;1331;3300;840;2491;235;771;143;460;378;1231
521375;202201;1468;3589;1016;2871;204;586;348;1080;552;1666
521377;202201;1589;3291;1183;2792;102;175;932;2325;1034;2500
521380;202201;6683;17185;4406;13067;697;1996;1054;3368;1751;5364
521385;202201;740;1712;564;1475;79;177;303;878;382;1055
521390;202201;769;1862;545;1519;149;437;175;544;324;981
521400;202201;3101;6943;2510;6256;229;525;1837;4670;2066;5195
521405;202201;1537;3825;1079;3010;129;372;621;1698;750;2070
521410;202201;910;2261;715;1953;116;310;392;1096;508;1406
521440;202201;1399;3287;1062;2805;312;837;440;1170;752;2007
521450;202201;4325;12310;3201;10180;844;2720;815;2744;1659;5464
521460;202201;6231;15555;4537;12636;1229;3532;1645;4585;2874;8117
521470;202201;780;1977;525;1506;57;169;240;657;297;826
521480;202201;479;1122;316;839;54;147;121;294;175;441
521483;202201;2529;5864;1795;4797;323;876;870;2376;1193;3252
521486;202201;1926;4477;1467;3837;121;244;1001;2659;1122;2903
521487;202201;433;1006;310;842;55;129;181;520;236;649
521490;202201;956;2482;720;2099;42;161;506;1420;548;1581
521500;202201;2287;5493;1746;4731;132;476;1226;3188;1358;3664
521520;202201;821;1842;615;1555;88;188;322;852;410;1040
521523;202201;13156;37864;10869;34376;2822;9373;3966;12875;6788;22248
521525;202201;1178;2650;904;2269;58;178;653;1602;711;1780
521530;202201;2501;6271;1589;4494;339;972;453;1258;792;2230
521540;202201;888;2229;627;1805;111;350;277;812;388;1162
521550;202201;1796;4392;1002;2840;182;544;281;818;463;1362
521560;202201;5377;13225;3804;11122;857;2341;1830;5847;2687;8188
521565;202201;714;1666;514;1351;67;172;270;705;337;877
521570;202201;3839;10159;2725;8051;600;2059;199;615;799;2674
521580;202201;535;1256;332;908;49;152;139;347;188;499
521590;202201;785;1715;583;1441;73;187;353;855;426;1042
521600;202201;452;1157;296;867;30;82;141;406;171;488
521630;202201;1848;3878;1187;2964;277;676;431;1084;708;1760
521640;202201;2116;4805;1419;3794;282;794;538;1412;820;2206
521645;202201;598;1496;384;1115;92;243;121;359;213;602
521680;202201;1362;3796;1060;3267;278;925;271;851;549;1776
521690;202201;586;1390;493;1269;67;188;321;818;388;1006
521710;202201;3663;8723;2434;6734;436;1334;771;1935;1207;3269
521720;202201;2511;5501;1682;4309;247;632;988;2557;1235;3189
521730;202201;4030;10657;3158;9269;853;2881;957;2479;1810;5360
521740;202201;4399;11011;3392;9548;954;2762;1024;3063;1978;5825
521760;202201;16315;42323;12953;37472;2785;8260;5832;18166;8617;26426
521770;202201;3512;7993;2414;6340;636;1739;665;1812;1301;3551
521800;202201;7250;18467;5325;15355;1228;3504;2263;7157;3491;10661
521805;202201;973;2006;683;1648;152;333;357;927;509;1260
521810;202201;723;1667;530;1402;103;258;309;850;412;1108
521830;202201;6019;15918;4848;14138;291;1051;3646;10416;3937;11467
521839;202201;913;2074;683;1709;79;230;451;1045;530;1275
521850;202201;6918;15316;4353;11517;1073;2793;927;2525;2000;5318
521860;202201;1735;4528;1212;3586;203;657;405;1128;608;1785
521870;202201;754;2031;552;1654;105;349;159;409;264;758
521878;202201;810;2012;581;1584;73;242;340;859;413;1101
521880;202201;21049;50413;14888;41009;3558;10086;6014;16565;9572;26651
521890;202201;3647;9025;2502;7068;636;1848;709;1875;1345;3723
521900;202201;1503;3456;811;2302;248;688;54;159;302;847
521910;202201;1494;3076;1072;2589;142;329;605;1520;747;1849
521920;202201;565;1427;416;1189;47;152;232;632;279;784
521925;202201;822;2075;602;1745;102;336;325;925;427;1261
521930;202201;5945;13803;4006;10972;958;2176;1780;5421;2738;7597
521935;202201;1140;2638;790;2045;59;166;468;1153;527;1319
521940;202201;1426;2988;929;2324;164;439;470;1138;634;1577
521945;202201;707;1786;534;1486;81;234;308;872;389;1106
521950;202201;821;1920;585;1557;105;273;277;751;382;1024
521960;202201;763;1907;528;1483;56;189;293;754;349;943
521970;202201;3094;6870;2360;6016;184;419;1741;4676;1925;5095
521971;202201;809;1868;578;1525;144;367;189;490;333;857
521973;202201;1616;4028;1353;3686;55;135;1124;3075;1179;3210
521975;202201;13403;34031;11055;30825;1678;4821;7052;19762;8730;24583
521980;202201;2674;6020;2064;5234;137;334;1595;4127;1732;4461
521990;202201;1261;3281;1028;2911;206;623;511;1449;717;2072
522000;202201;2928;7369;2326;6619;414;1197;1363;4094;1777;5291
522005;202201;375;865;274;718;39;108;136;359;175;467
522010;202201;4593;10983;3373;9078;668;1948;1377;3587;2045;5535
522015;202201;1132;2831;848;2410;223;624;361;1056;584;1680
522020;202201;5919;13528;3923;10498;778;2035;1705;4789;2483;6824
522026;202201;898;2265;591;1754;105;359;179;460;284;819
522028;202201;537;1298;376;1029;88;263;136;362;224;625
522040;202201;3664;7783;2648;6453;256;683;1888;4518;2144;5201
522045;202201;19689;52165;15009;44467;3222;10291;5072;14590;8294;24881
522050;202201;1301;3220;912;2567;174;553;381;979;555;1532
522060;202201;3224;8153;2337;6743;321;867;1258;3721;1579;4588
522068;202201;2007;4835;1611;4369;89;212;1331;3665;1420;3877
522070;202201;803;1798;665;1614;20;48;574;1368;594;1416
522100;202201;846;2068;586;1646;59;178;325;881;384;1059
522108;202201;1195;2693;952;2361;45;147;792;1921;837;2068
522119;202201;1930;4447;1544;3962;228;558;891;2442;1119;3000
522130;202201;489;1185;366;1024;32;89;263;752;295;841
522140;202201;23436;58680;17073;47768;3882;11520;5814;15489;9696;27009
522145;202201;863;2042;615;1683;126;363;316;848;442;1211
522150;202201;1164;2734;815;2188;195;524;269;734;464;1258
522155;202201;1122;2749;880;2404;144;333;542;1543;686;1876
522157;202201;721;1558;590;1402;30;67;486;1181;516;1248
522160;202201;6254;15545;4120;11805;1170;3572;534;1684;1704;5256
522170;202201;2838;7079;2169;6110;271;778;1342;3846;1613;4624
522180;202201;641;1498;435;1113;85;227;123;325;208;552
522185;202201;22318;52919;16287;44829;5461;16084;4486;13536;9947;29620
522190;202201;845;1914;596;1511;122;317;272;666;394;983
522200;202201;1913;5135;1375;4190;331;1032;321;990;652;2022
522205;202201;1847;4260;1390;3644;187;484;807;2133;994;2617
522220;202201;1410;3276;1058;2786;104;274;713;1923;817;2197
522230;202201;1371;3273;1115;2910;169;513;647;1683;816;2196
530010;202201;203730;533485;170245;485598;20985;66424;110202;307698;131187;374122
